Brand,Item Number,Item Name,Warehouse,On Hand,Available,Reserved,In Transit,On Sales Order,On Purchase Order
,001 FP 2000 F gold Rondo 4014519270386,Lamy 001 FP 2000 F gold Rondo 4014519270386,Default Ridgefield,31,31,0,0,0,0
,001 FP 2000 F gold Rondo 4014519270386,Lamy 001 FP 2000 F gold Rondo 4014519270386,FBALYB Amazon,11,11,0,0,0,0
,012 FP vista EF T10bl Rondo  4014519276173,012 FP vista EF T10bl Rondo  4014519276173,Default Ridgefield,274,274,0,0,0,0
,012 FP vista EF T10bl Rondo  4014519276173,012 FP vista EF T10bl Rondo  4014519276173,FBALYB Amazon,-7,-7,0,0,0,0
,012 FP vista EF T10bl Rondo  4014519276173,012 FP vista EF T10bl Rondo  4014519276173,FBALYB Canada,-1,-1,0,0,0,0
,012 FP vista F T10bl Rondo  4014519276203,012 FP vista F T10bl Rondo  4014519276203,Default Ridgefield,260,260,0,0,0,0
,012 FP vista F T10bl Rondo  4014519276203,012 FP vista F T10bl Rondo  4014519276203,FBALYB Amazon,76,71,5,3,5,0
,012 FP vista M T10bl Rondo  4014519276234,012 FP vista M T10bl Rondo  4014519276234,FBALYB Amazon,-2,-2,0,0,0,0
,013 FP safari green M T10bl Rondo  4014519661566,013 FP safari green M T10bl Rondo  4014519661566,FBALYB Amazon,-2,-2,0,0,0,0
,014 FP safari blue F T10bl Rondo  4014519273684,014 FP safari blue F T10bl Rondo  4014519273684,Default Ridgefield,140,140,0,0,0,0
,014 FP safari blue F T10bl Rondo  4014519273684,014 FP safari blue F T10bl Rondo  4014519273684,FBALYB Amazon,-72,-72,0,51,0,0
,"015 FP joy black 1,1 T10bl E112  4014519651116","015 FP joy black 1,1 T10bl E112  4014519651116",FBALYB Amazon,-5,-5,0,0,0,0
,016 FP safari red F T10bl Rondo  4014519272298,016 FP safari red F T10bl Rondo  4014519272298,FBALYB Amazon,-11,-12,1,52,1,0
,016 FP safari red M T10bl Rondo  4014519272328,016 FP safari red M T10bl Rondo  4014519272328,FBALYB Amazon,48,48,0,0,0,0
,017 FP safari umbra EF T10bl Rondo  4014519271024,017 FP safari umbra EF T10bl Rondo  4014519271024,Default,0,-200,200,0,0,0
,017 FP safari umbra EF T10bl Rondo  4014519271024,017 FP safari umbra EF T10bl Rondo  4014519271024,Default Ridgefield,401,401,0,0,0,0
,017 FP safari umbra EF T10bl Rondo  4014519271024,017 FP safari umbra EF T10bl Rondo  4014519271024,FBALYB Amazon,292,289,3,0,3,0
,017 FP safari umbra F T10bl Rondo  4014519271055,017 FP safari umbra F T10bl Rondo  4014519271055,Default,0,-5005,5005,0,0,0
,017 FP safari umbra F T10bl Rondo  4014519271055,017 FP safari umbra F T10bl Rondo  4014519271055,Default Ridgefield,50,50,0,0,0,0
,017 FP safari umbra F T10bl Rondo  4014519271055,017 FP safari umbra F T10bl Rondo  4014519271055,FBALYB Amazon,-76,-77,1,9,1,0
,017 FP safari umbra M T10bl Rondo  4014519270997,017 FP safari umbra M T10bl Rondo  4014519270997,Default,0,-50,50,0,0,0
,017 FP safari umbra M T10bl Rondo  4014519270997,017 FP safari umbra M T10bl Rondo  4014519270997,Default Ridgefield,600,600,0,0,0,0
,017 FP safari umbra M T10bl Rondo  4014519270997,017 FP safari umbra M T10bl Rondo  4014519270997,FBALYB Amazon,-4,-5,1,0,1,0
,018 FP safari yellow F T10bl Rondo  4014519273073,018 FP safari yellow F T10bl Rondo  4014519273073,Default Ridgefield,300,300,0,0,0,0
,018 FP safari yellow F T10bl Rondo  4014519273073,018 FP safari yellow F T10bl Rondo  4014519273073,FBALYB Amazon,81,71,10,2,10,0
,018 FP safari yellow M T10bl Rondo  4014519273103,018 FP safari yellow M T10bl Rondo  4014519273103,Default,0,-80,80,0,0,0
,018 FP safari yellow M T10bl Rondo  4014519273103,018 FP safari yellow M T10bl Rondo  4014519273103,Default Ridgefield,140,140,0,0,0,0
,019 FP safari black F T10bl Rondo  4014519279334,019 FP safari black F T10bl Rondo  4014519279334,Default Ridgefield,164,164,0,0,0,0
,019 FP safari black F T10bl Rondo  4014519279334,019 FP safari black F T10bl Rondo  4014519279334,FBALYB Amazon,6,4,2,0,2,0
,019 FP safari black M T10bl Rondo  4014519279372,019 FP safari black M T10bl Rondo  4014519279372,Default,0,-40,40,0,0,0
,019 FP safari white EF T10bl Rondo  4014519282419,019 FP safari white EF T10bl Rondo  4014519282419,FBALYB Amazon,-4,-4,0,0,0,0
,019 FP safari white F T10bl Rondo  4014519279273,019 FP safari white F T10bl Rondo  4014519279273,Default Ridgefield,451,451,0,0,0,0
,019 FP safari white F T10bl Rondo  4014519279273,019 FP safari white F T10bl Rondo  4014519279273,FBALYB Amazon,114,111,3,19,3,0
,019 FP safari white M T10bl Rondo  4014519279303,019 FP safari white M T10bl Rondo  4014519279303,Default,0,-30,30,0,0,0
,019 FP safari white M T10bl Rondo  4014519279303,019 FP safari white M T10bl Rondo  4014519279303,Default Ridgefield,410,349,61,0,0,0
,019 FP safari white M T10bl Rondo  4014519279303,019 FP safari white M T10bl Rondo  4014519279303,FBALYB Amazon,-1,-2,1,0,1,0
,026 FP AL-star graphite F T10bl Rondo  4014519280293,026 FP AL-star graphite F T10bl Rondo  4014519280293,Default Ridgefield,146,146,0,0,0,0
,026 FP AL-star graphite M T10bl Rondo  4014519280323,026 FP AL-star graphite M T10bl Rondo  4014519280323,Default Ridgefield,161,161,0,0,0,0
,028 FP AL-star oceanblue EF T10bl Rondo  4014519279976,028 FP AL-star oceanblue EF T10bl Rondo  4014519279976,Default Ridgefield,50,50,0,0,0,0
,028 FP AL-star oceanblue EF T10bl Rondo  4014519279976,028 FP AL-star oceanblue EF T10bl Rondo  4014519279976,FBALYB Amazon,-8,-8,0,1,0,0
,028 FP AL-star oceanblue F T10bl Rondo  4014519279754,028 FP AL-star oceanblue F T10bl Rondo  4014519279754,Default,0,-50,50,0,0,0
,028 FP AL-star oceanblue F T10bl Rondo  4014519279754,028 FP AL-star oceanblue F T10bl Rondo  4014519279754,FBALYB Amazon,35,35,0,0,0,0
,028 FP AL-star oceanblue M T10bl Rondo  4014519279785,028 FP AL-star oceanblue M T10bl Rondo  4014519279785,FBALYB Amazon,-2,-2,0,0,0,0
,029 FP AL-star black purple F T10bl Rondo  4014519282167,029 FP AL-star black purple F T10bl Rondo  4014519282167,Default Ridgefield,710,710,0,0,0,0
,029 FP AL-star black purple F T10bl Rondo  4014519282167,029 FP AL-star black purple F T10bl Rondo  4014519282167,FBALYB Amazon,196,196,0,0,0,0
,032 FP AL-star bluegreen EF T10bl Rondo  4014519669913,032 FP AL-star bluegreen EF T10bl Rondo  4014519669913,FBALYB Amazon,-2,-3,1,0,1,0
,032 FP AL-star bluegreen F T10bl Rondo  4014519669937,032 FP AL-star bluegreen F T10bl Rondo  4014519669937,FBALYB Amazon,-2,-2,0,1,0,0
,057 FP Lx Ru F T10bl E2204014519676096,057 FP Lx Ru F T10bl E2204014519676096,Default Ridgefield,55,55,0,0,0,0
,057 FP Lx Ru F T10bl E2204014519676096,057 FP Lx Ru F T10bl E2204014519676096,FBALYB Amazon,-7,-7,0,0,0,0
,060 FP imporium BlkAu M gold +T10bl E182,060 FP imporium BlkAu M gold +T10bl E182,Default Ridgefield,45,45,0,0,0,0
,065 FP studio brushed EF +T10bl Rondo  4014519277002,065 FP studio brushed EF +T10bl Rondo  4014519277002,FBALYB Amazon,3,3,0,0,0,0
,067 FP studio black F +T10bl Rondo  4014519277347,067 FP studio black F +T10bl Rondo  4014519277347,FBALYB Amazon,-1,-1,0,0,0,0
,067 FP studio imperialblue EF +T10bl Rondo  4014519283942,067 FP studio imperialblue EF +T10bl Rondo  4014519283942,FBALYB Amazon,-2,-2,0,0,0,0
,067 FP studio imperialblue F +T10bl Rondo  4014519283973,067 FP studio imperialblue F +T10bl Rondo  4014519283973,Default Ridgefield,90,90,0,0,0,0
,067 FP studio imperialblue F +T10bl Rondo  4014519283973,067 FP studio imperialblue F +T10bl Rondo  4014519283973,FBALYB Amazon,21,21,0,1,0,0
,071 FP AL-star black F T10bl Rondo  4014519286493,071 FP AL-star black F T10bl Rondo  4014519286493,FBALYB Amazon,-7,-7,0,2,0,0
,076 FP Lx RAu EF T10bl E2184014519676218,076 FP Lx RAu EF T10bl E2184014519676218,FBALYB Amazon,13,13,0,0,0,0
,076 FP Lx RAu F T10bl E2184014519676225,076 FP Lx RAu F T10bl E2184014519676225,Default Ridgefield,50,50,0,0,0,0
,076 FP Lx RAu F T10bl E2184014519676225,076 FP Lx RAu F T10bl E2184014519676225,FBALYB Amazon,1,1,0,0,0,0
,0D-ANG7-AOZQ,Beggin' Strips Bacon - 3lbs (48 oz),FBALYB Amazon,-32,-32,0,37,0,0
,10001-001M10W12 CrocsClassic Clog CLR- Black/841158002474 Size M10 W12,10001-001M10W12 CrocsClassic Clog CLR- Black/841158002474 Size M10 W12,Default Ridgefield,10,10,0,0,0,0
,10001-001M10W12 CrocsClassic Clog CLR- Black/841158002474 Size M10 W12,10001-001M10W12 CrocsClassic Clog CLR- Black/841158002474 Size M10 W12,FBALYB Amazon,-72,-72,0,3,0,0
,10001-001M11 CrocsClassic Clog CLR- Black/841158002481 Size M11 W13,10001-001M11 CrocsClassic Clog CLR- Black/841158002481 Size M11 W13,Default Ridgefield,1,1,0,0,0,0
,10001-001M11 CrocsClassic Clog CLR- Black/841158002481 Size M11 W13,10001-001M11 CrocsClassic Clog CLR- Black/841158002481 Size M11 W13,FBALYB Amazon,-17,-18,1,0,1,0
,10001-001M12 CrocsClassic Clog CLR- Black/841158002498 Size M12 W14,10001-001M12 CrocsClassic Clog CLR- Black/841158002498 Size M12 W14,Default Ridgefield,6,6,0,0,0,0
,10001-001M12 CrocsClassic Clog CLR- Black/841158002498 Size M12 W14,10001-001M12 CrocsClassic Clog CLR- Black/841158002498 Size M12 W14,FBALYB Amazon,-8,-8,0,0,0,0
,10001-001M4W6 CrocsClassic Clog CLR- Black/841158002412 Size M4 W6,10001-001M4W6 CrocsClassic Clog CLR- Black/841158002412 Size M4 W6,Default Ridgefield,1,1,0,0,0,0
,10001-001M4W6 CrocsClassic Clog CLR- Black/841158002412 Size M4 W6,10001-001M4W6 CrocsClassic Clog CLR- Black/841158002412 Size M4 W6,FBALYB Amazon,-21,-24,3,0,3,0
,10001-001M5W7 CrocsClassic Clog CLR- Black/841158002429 Size M5 W7,10001-001M5W7 CrocsClassic Clog CLR- Black/841158002429 Size M5 W7,Default Ridgefield,1,0,1,0,0,0
,10001-001M5W7 CrocsClassic Clog CLR- Black/841158002429 Size M5 W7,10001-001M5W7 CrocsClassic Clog CLR- Black/841158002429 Size M5 W7,FBALYB Amazon,-256,-283,27,210,27,0
,10001-001M6W8 CrocsClassic Clog CLR- Black/841158002436 Size M6 W8,10001-001M6W8 CrocsClassic Clog CLR- Black/841158002436 Size M6 W8,Default Ridgefield,10,8,2,0,0,0
,10001-001M6W8 CrocsClassic Clog CLR- Black/841158002436 Size M6 W8,10001-001M6W8 CrocsClassic Clog CLR- Black/841158002436 Size M6 W8,FBALYB Amazon,-82,-102,20,11,20,0
,10001-001M7W9 CrocsClassic Clog CLR- Black/841158002443 Size M7 W9,10001-001M7W9 CrocsClassic Clog CLR- Black/841158002443 Size M7 W9,FBALYB Amazon,-29,-29,0,2,0,0
,10001-001M8W10 CrocsClassic Clog CLR- Black/841158002450 Size M8 W10,10001-001M8W10 CrocsClassic Clog CLR- Black/841158002450 Size M8 W10,Default Ridgefield,3,3,0,0,0,0
,10001-001M8W10 CrocsClassic Clog CLR- Black/841158002450 Size M8 W10,10001-001M8W10 CrocsClassic Clog CLR- Black/841158002450 Size M8 W10,FBALYB Amazon,-86,-90,4,31,4,0
,10001-001M9W11 CrocsClassic Clog CLR- Black/841158002467 Size M9 W11,10001-001M9W11 CrocsClassic Clog CLR- Black/841158002467 Size M9 W11,Default Ridgefield,7,7,0,0,0,0
,10001-001M9W11 CrocsClassic Clog CLR- Black/841158002467 Size M9 W11,10001-001M9W11 CrocsClassic Clog CLR- Black/841158002467 Size M9 W11,FBALYB Amazon,-18,-18,0,0,0,0
,10001-0DAM10W12 CrocsClassic Clog CLR- Slate Grey/191448101661 Size M10 W12,10001-0DAM10W12 CrocsClassic Clog CLR- Slate Grey/191448101661 Size M10 W12,FBALYB Amazon,111,68,43,36,43,0
,10001-0DAM11 CrocsClassic Clog CLR- Slate Grey/191448101678 Size M11 W13,10001-0DAM11 CrocsClassic Clog CLR- Slate Grey/191448101678 Size M11 W13,Default Ridgefield,5,5,0,0,0,0
,10001-0DAM11 CrocsClassic Clog CLR- Slate Grey/191448101678 Size M11 W13,10001-0DAM11 CrocsClassic Clog CLR- Slate Grey/191448101678 Size M11 W13,FBALYB Amazon,-36,-36,0,36,0,0
,10001-0DAM12 CrocsClassic Clog CLR- Slate Grey/191448101685 M12 W14,10001-0DAM12 CrocsClassic Clog CLR- Slate Grey/191448101685 M12 W14,FBALYB Amazon,-5,-5,0,0,0,0
,10001-0DAM4W6 CrocsClassic Clog CLR- Slate Grey/191448101746 Size M4 W6,10001-0DAM4W6 CrocsClassic Clog CLR- Slate Grey/191448101746 Size M4 W6,FBALYB Amazon,-5,-6,1,0,1,0
,10001-0DAM5W7 CrocsClassic Clog CLR- Slate Grey/191448101753 Size M5 W7,10001-0DAM5W7 CrocsClassic Clog CLR- Slate Grey/191448101753 Size M5 W7,FBALYB Amazon,241,225,16,0,16,0
,10001-0DAM6W8 CrocsClassic Clog CLR- Slate Grey/191448101760 Size M6 W8,10001-0DAM6W8 CrocsClassic Clog CLR- Slate Grey/191448101760 Size M6 W8,FBALYB Amazon,333,305,28,79,28,0
,10001-0DAM7W9 CrocsClassic Clog CLR- Slate Grey/191448101777 Size M7 W9,10001-0DAM7W9 CrocsClassic Clog CLR- Slate Grey/191448101777 Size M7 W9,FBALYB Amazon,158,139,19,72,19,0
,10001-0DAM8W10 CrocsClassic Clog CLR- Slate Grey/191448101784 Size M8 W10,10001-0DAM8W10 CrocsClassic Clog CLR- Slate Grey/191448101784 Size M8 W10,FBALYB Amazon,106,98,8,0,8,0
,10001-0DAM9W11 CrocsClassic Clog CLR- Slate Grey/191448101791 Size M9 W11,10001-0DAM9W11 CrocsClassic Clog CLR- Slate Grey/191448101791 Size M9 W11,Default Ridgefield,1,1,0,0,0,0
,10001-0DAM9W11 CrocsClassic Clog CLR- Slate Grey/191448101791 Size M9 W11,10001-0DAM9W11 CrocsClassic Clog CLR- Slate Grey/191448101791 Size M9 W11,FBALYB Amazon,-61,-73,12,71,12,0
,10001-100M10W12 CrocsClassic Clog CLR- White/883503185661 Size M10 W12,10001-100M10W12 CrocsClassic Clog CLR- White/883503185661 Size M10 W12,Default Ridgefield,1,1,0,0,0,0
,10001-100M10W12 CrocsClassic Clog CLR- White/883503185661 Size M10 W12,10001-100M10W12 CrocsClassic Clog CLR- White/883503185661 Size M10 W12,FBALYB Amazon,80,56,24,4,24,0
,10001-100M11 CrocsClassic Clog CLR- White/883503185678 Size M11 W13,10001-100M11 CrocsClassic Clog CLR- White/883503185678 Size M11 W13,FBALYB Amazon,-11,-11,0,0,0,0
,10001-100M12 CrocsClassic Clog CLR- White/883503185685 Size M12 W14,10001-100M12 CrocsClassic Clog CLR- White/883503185685 Size M12 W14,FBALYB Amazon,-6,-6,0,0,0,0
,10001-100M4W6 CrocsClassic Clog CLR- White/883503185609 Size M4 W6,10001-100M4W6 CrocsClassic Clog CLR- White/883503185609 Size M4 W6,FBALYB Amazon,-28,-28,0,0,0,0
,10001-100M5W7 CrocsClassic Clog CLR- White/883503185616 Size M5 W7,10001-100M5W7 CrocsClassic Clog CLR- White/883503185616 Size M5 W7,Default Ridgefield,1,1,0,0,0,0
,10001-100M5W7 CrocsClassic Clog CLR- White/883503185616 Size M5 W7,10001-100M5W7 CrocsClassic Clog CLR- White/883503185616 Size M5 W7,FBALYB Amazon,-13,-35,22,0,22,0
,10001-100M6W8 CrocsClassic Clog CLR- White/883503185623 Size M6 W8,10001-100M6W8 CrocsClassic Clog CLR- White/883503185623 Size M6 W8,Default Ridgefield,1,1,0,0,0,0
,10001-100M6W8 CrocsClassic Clog CLR- White/883503185623 Size M6 W8,10001-100M6W8 CrocsClassic Clog CLR- White/883503185623 Size M6 W8,FBALYB Amazon,-42,-45,3,0,3,0
,10001-100M7W9 CrocsClassic Clog CLR- White/883503185630 Size M7 W9,10001-100M7W9 CrocsClassic Clog CLR- White/883503185630 Size M7 W9,FBALYB Amazon,-16,-16,0,1,0,0
,10001-100M8W10 CrocsClassic Clog CLR- White/883503185647 Size M8 W10,10001-100M8W10 CrocsClassic Clog CLR- White/883503185647 Size M8 W10,FBALYB Amazon,-8,-8,0,0,0,0
,10001-100M9W11 CrocsClassic Clog CLR- White/883503185654 Size M9 W11,10001-100M9W11 CrocsClassic Clog CLR- White/883503185654 Size M9 W11,FBALYB Amazon,-10,-10,0,0,0,0
,10001-200M10W12 CrocsClassic Clog CLR- Chocolate/841158012084 Size M10 W12,10001-200M10W12 CrocsClassic Clog CLR- Chocolate/841158012084 Size M10 W12,Default Ridgefield,19,19,0,0,0,0
,10001-200M10W12 CrocsClassic Clog CLR- Chocolate/841158012084 Size M10 W12,10001-200M10W12 CrocsClassic Clog CLR- Chocolate/841158012084 Size M10 W12,FBALYB Amazon,-1,-3,2,0,2,0
,10001-200M11 CrocsClassic Clog CLR- Chocolate/841158012091 Size M11 W13,10001-200M11 CrocsClassic Clog CLR- Chocolate/841158012091 Size M11 W13,Default Ridgefield,1,1,0,0,0,0
,10001-200M11 CrocsClassic Clog CLR- Chocolate/841158012091 Size M11 W13,10001-200M11 CrocsClassic Clog CLR- Chocolate/841158012091 Size M11 W13,FBALYB Amazon,-3,-3,0,0,0,0
,10001-200M4W6 CrocsClassic Clog CLR- Chocolate/841158012022 Size M4 W6,10001-200M4W6 CrocsClassic Clog CLR- Chocolate/841158012022 Size M4 W6,FBALYB Amazon,-2,-2,0,0,0,0
,10001-200M5W7 CrocsClassic Clog CLR- Chocolate/841158012039 Size M5 W7,10001-200M5W7 CrocsClassic Clog CLR- Chocolate/841158012039 Size M5 W7,Default Ridgefield,5,5,0,0,0,0
,10001-200M5W7 CrocsClassic Clog CLR- Chocolate/841158012039 Size M5 W7,10001-200M5W7 CrocsClassic Clog CLR- Chocolate/841158012039 Size M5 W7,FBALYB Amazon,-16,-18,2,0,2,0
,10001-200M6W8 CrocsClassic Clog CLR- Chocolate/841158012046 Size M6 W8,10001-200M6W8 CrocsClassic Clog CLR- Chocolate/841158012046 Size M6 W8,Default Ridgefield,5,5,0,0,0,0
,10001-200M6W8 CrocsClassic Clog CLR- Chocolate/841158012046 Size M6 W8,10001-200M6W8 CrocsClassic Clog CLR- Chocolate/841158012046 Size M6 W8,FBALYB Amazon,-14,-14,0,0,0,0
,10001-200M7W9 CrocsClassic Clog CLR- Chocolate/841158012053 Size M7 W9,10001-200M7W9 CrocsClassic Clog CLR- Chocolate/841158012053 Size M7 W9,FBALYB Amazon,-12,-12,0,0,0,0
,10001-200M8W10 CrocsClassic Clog CLR- Chocolate/841158012060 Size M8 W10,10001-200M8W10 CrocsClassic Clog CLR- Chocolate/841158012060 Size M8 W10,FBALYB Amazon,-4,-4,0,0,0,0
,10001-200M9W11 CrocsClassic Clog CLR- Chocolate/841158012077 Size M9 W11,10001-200M9W11 CrocsClassic Clog CLR- Chocolate/841158012077 Size M9 W11,Default Ridgefield,1,1,0,0,0,0
,10001-200M9W11 CrocsClassic Clog CLR- Chocolate/841158012077 Size M9 W11,10001-200M9W11 CrocsClassic Clog CLR- Chocolate/841158012077 Size M9 W11,FBALYB Amazon,-1,-1,0,0,0,0
,10001-309M10W12 CrocsClassic Clog CLR- Army Green/841158050802 Size M10 W12,10001-309M10W12 CrocsClassic Clog CLR- Army Green/841158050802 Size M10 W12,FBALYB Amazon,-4,-4,0,0,0,0
,10001-309M4W6 CrocsClassic Clog CLR- Army Green/841158050741 Size M4 W6,10001-309M4W6 CrocsClassic Clog CLR- Army Green/841158050741 Size M4 W6,FBALYB Amazon,-4,-4,0,0,0,0
,10001-309M5W7 CrocsClassic Clog CLR- Army Green/841158050758 Size M5 W7,10001-309M5W7 CrocsClassic Clog CLR- Army Green/841158050758 Size M5 W7,FBALYB Amazon,-3,-3,0,0,0,0
,10001-309M6W8 CrocsClassic Clog CLR- Army Green/841158050765 Size M6 W8,10001-309M6W8 CrocsClassic Clog CLR- Army Green/841158050765 Size M6 W8,FBALYB Amazon,-4,-4,0,0,0,0
,10001-309M7W9 CrocsClassic Clog CLR- Army Green/841158050772 Size M7 W9,10001-309M7W9 CrocsClassic Clog CLR- Army Green/841158050772 Size M7 W9,FBALYB Amazon,-4,-4,0,0,0,0
,10001-309M8W10 CrocsClassic Clog CLR- Army Green/841158050789 Size M8 W10,10001-309M8W10 CrocsClassic Clog CLR- Army Green/841158050789 Size M8 W10,FBALYB Amazon,-5,-5,0,0,0,0
,10001-309M9W11 CrocsClassic Clog CLR- Army Green/841158050796 Size M9 W11,10001-309M9W11 CrocsClassic Clog CLR- Army Green/841158050796 Size M9 W11,FBALYB Amazon,-11,-11,0,0,0,0
,10001-3TJM10W12 CrocsClassic Clog CLR- Deep Green/191448440821 Size M10 W12,10001-3TJM10W12 CrocsClassic Clog CLR- Deep Green/191448440821 Size M10 W12,Default Ridgefield,1,1,0,0,0,0
,10001-3TJM10W12 CrocsClassic Clog CLR- Deep Green/191448440821 Size M10 W12,10001-3TJM10W12 CrocsClassic Clog CLR- Deep Green/191448440821 Size M10 W12,FBALYB Amazon,-9,-11,2,0,2,0
,10001-3TJM11 CrocsClassic Clog CLR- Deep Green/191448440838 Size M11 W13,10001-3TJM11 CrocsClassic Clog CLR- Deep Green/191448440838 Size M11 W13,FBALYB Amazon,-2,-2,0,0,0,0
,10001-3TJM4W6 CrocsClassic Clog CLR- Deep Green/191448440906 Size M4 W6,10001-3TJM4W6 CrocsClassic Clog CLR- Deep Green/191448440906 Size M4 W6,FBALYB Amazon,-6,-6,0,0,0,0
,10001-3TJM5W7 CrocsClassic Clog CLR- Deep Green/191448440913 Size M5 W7,10001-3TJM5W7 CrocsClassic Clog CLR- Deep Green/191448440913 Size M5 W7,Default Ridgefield,22,22,0,0,0,0
,10001-3TJM5W7 CrocsClassic Clog CLR- Deep Green/191448440913 Size M5 W7,10001-3TJM5W7 CrocsClassic Clog CLR- Deep Green/191448440913 Size M5 W7,FBALYB Amazon,-9,-11,2,0,2,0
,10001-3TJM6W8 CrocsClassic Clog CLR- Deep Green/191448440920 Size M6 W8,10001-3TJM6W8 CrocsClassic Clog CLR- Deep Green/191448440920 Size M6 W8,Default Ridgefield,12,12,0,0,0,0
,10001-3TJM6W8 CrocsClassic Clog CLR- Deep Green/191448440920 Size M6 W8,10001-3TJM6W8 CrocsClassic Clog CLR- Deep Green/191448440920 Size M6 W8,FBALYB Amazon,-4,-4,0,0,0,0
,10001-3TJM7W9 CrocsClassic Clog CLR- Deep Green/191448440937 Size M7 W9,10001-3TJM7W9 CrocsClassic Clog CLR- Deep Green/191448440937 Size M7 W9,FBALYB Amazon,-4,-6,2,0,2,0
,10001-3TJM8W10 CrocsClassic Clog CLR- Deep Green/191448440944 Size M8 W10,10001-3TJM8W10 CrocsClassic Clog CLR- Deep Green/191448440944 Size M8 W10,FBALYB Amazon,-5,-5,0,0,0,0
,10001-3TJM9W11 CrocsClassic Clog CLR- Deep Green/191448440951 Size M9 W11,10001-3TJM9W11 CrocsClassic Clog CLR- Deep Green/191448440951 Size M9 W11,Default Ridgefield,1,1,0,0,0,0
,10001-3TJM9W11 CrocsClassic Clog CLR- Deep Green/191448440951 Size M9 W11,10001-3TJM9W11 CrocsClassic Clog CLR- Deep Green/191448440951 Size M9 W11,FBALYB Amazon,-3,-3,0,0,0,0
,10001-3U3M10W12 CrocsClassic Clog CLR- Pistachio/191448650145 Size M10 W12,10001-3U3M10W12 CrocsClassic Clog CLR- Pistachio/191448650145 Size M10 W12,Default Ridgefield,0,-18,18,0,0,0
,10001-3U3M10W12 CrocsClassic Clog CLR- Pistachio/191448650145 Size M10 W12,10001-3U3M10W12 CrocsClassic Clog CLR- Pistachio/191448650145 Size M10 W12,FBALYB Amazon,-1,-1,0,0,0,0
,10001-3U3M11 CrocsClassic Clog CLR- Pistachio/191448650152 Size M11 W13,10001-3U3M11 CrocsClassic Clog CLR- Pistachio/191448650152 Size M11 W13,Default Ridgefield,0,-18,18,0,0,0
,10001-3U3M4W6 CrocsClassic Clog CLR- Pistachio/191448650206 Size M4 W6,10001-3U3M4W6 CrocsClassic Clog CLR- Pistachio/191448650206 Size M4 W6,FBALYB Amazon,-4,-4,0,0,0,0
,10001-3U3M5W7 CrocsClassic Clog CLR- Pistachio/191448650213 Size M5 W7,10001-3U3M5W7 CrocsClassic Clog CLR- Pistachio/191448650213 Size M5 W7,Default Ridgefield,1,-16,17,0,0,0
,10001-3U3M6W8 CrocsClassic Clog CLR- Pistachio/191448650220 Size M6 W8,10001-3U3M6W8 CrocsClassic Clog CLR- Pistachio/191448650220 Size M6 W8,FBALYB Amazon,-7,-7,0,0,0,0
,10001-3U3M7W9 CrocsClassic Clog CLR- Pistachio/191448650237 Size M7 W9,10001-3U3M7W9 CrocsClassic Clog CLR- Pistachio/191448650237 Size M7 W9,FBALYB Amazon,-2,-2,0,0,0,0
,10001-3U3M8W10 CrocsClassic Clog CLR- Pistachio/191448650244 Size M8 W10,10001-3U3M8W10 CrocsClassic Clog CLR- Pistachio/191448650244 Size M8 W10,FBALYB Amazon,-1,-1,0,0,0,0
,10001-3U3M9W11 CrocsClassic Clog CLR- Pistachio/191448650251 Size M9 W11,10001-3U3M9W11 CrocsClassic Clog CLR- Pistachio/191448650251 Size M9 W11,FBALYB Amazon,-2,-2,0,0,0,0
,10001-3U4M10W12 CrocsClassic Clog CLR- Lime Zest/191448650381 Size M10 W12,10001-3U4M10W12 CrocsClassic Clog CLR- Lime Zest/191448650381 Size M10 W12,FBALYB Amazon,1,-1,2,0,2,0
,10001-3U4M11 CrocsClassic Clog CLR- Lime Zest/191448650398 Size M11 W13,10001-3U4M11 CrocsClassic Clog CLR- Lime Zest/191448650398 Size M11 W13,FBALYB Amazon,6,6,0,0,0,0
,10001-3U4M12 CrocsClassic Clog CLR- Lime Zest/191448650404 Size M12 W14,10001-3U4M12 CrocsClassic Clog CLR- Lime Zest/191448650404 Size M12 W14,FBALYB Amazon,8,8,0,0,0,0
,10001-3U4M4W6 CrocsClassic Clog CLR- Lime Zest/191448650442 Size M4 W6,10001-3U4M4W6 CrocsClassic Clog CLR- Lime Zest/191448650442 Size M4 W6,Default Ridgefield,0,-12,12,0,0,0
,10001-3U4M4W6 CrocsClassic Clog CLR- Lime Zest/191448650442 Size M4 W6,10001-3U4M4W6 CrocsClassic Clog CLR- Lime Zest/191448650442 Size M4 W6,FBALYB Amazon,-4,-4,0,0,0,0
,10001-3U4M6W8 CrocsClassic Clog CLR- Lime Zest/191448650466 Size M6 W8,10001-3U4M6W8 CrocsClassic Clog CLR- Lime Zest/191448650466 Size M6 W8,FBALYB Amazon,-1,-1,0,0,0,0
,10001-3U4M7W9 CrocsClassic Clog CLR- Lime Zest/191448650473 Size M7 W9,10001-3U4M7W9 CrocsClassic Clog CLR- Lime Zest/191448650473 Size M7 W9,FBALYB Amazon,-5,-5,0,0,0,0
,10001-3U4M8W10 CrocsClassic Clog CLR- Lime Zest/191448650480 Size M8 W10,10001-3U4M8W10 CrocsClassic Clog CLR- Lime Zest/191448650480 Size M8 W10,FBALYB Amazon,-15,-15,0,12,0,0
,10001-3U4M9W11 CrocsClassic Clog CLR- Lime Zest/191448650497 Size M9 W11,10001-3U4M9W11 CrocsClassic Clog CLR- Lime Zest/191448650497 Size M9 W11,FBALYB Amazon,19,18,1,0,1,0
,10001-410M10W12 CrocsClassic Clog CLR- Navy/841158002757 Size M10 W12,10001-410M10W12 CrocsClassic Clog CLR- Navy/841158002757 Size M10 W12,Default Ridgefield,1,1,0,0,0,0
,10001-410M10W12 CrocsClassic Clog CLR- Navy/841158002757 Size M10 W12,10001-410M10W12 CrocsClassic Clog CLR- Navy/841158002757 Size M10 W12,FBALYB Amazon,-30,-30,0,0,0,0
,10001-410M11 CrocsClassic Clog CLR- Navy/841158002764 Size M11 W13,10001-410M11 CrocsClassic Clog CLR- Navy/841158002764 Size M11 W13,FBALYB Amazon,-4,-5,1,0,1,0
,10001-410M12 CrocsClassic Clog CLR- Navy/841158002771 Size M12 W14,10001-410M12 CrocsClassic Clog CLR- Navy/841158002771 Size M12 W14,Default Ridgefield,1,1,0,0,0,0
,10001-410M12 CrocsClassic Clog CLR- Navy/841158002771 Size M12 W14,10001-410M12 CrocsClassic Clog CLR- Navy/841158002771 Size M12 W14,FBALYB Amazon,-3,-4,1,0,1,0
,10001-410M4W6 CrocsClassic Clog CLR- Navy/841158002696 Size M4 W6,10001-410M4W6 CrocsClassic Clog CLR- Navy/841158002696 Size M4 W6,FBALYB Amazon,90,87,3,0,3,0
,10001-410M5W7 CrocsClassic Clog CLR- Navy/841158002702 Size M5 W7,10001-410M5W7 CrocsClassic Clog CLR- Navy/841158002702 Size M5 W7,FBALYB Amazon,-76,-97,21,36,21,0
,10001-410M6W8 CrocsClassic Clog CLR- Navy/841158002719 Size M6 W8,10001-410M6W8 CrocsClassic Clog CLR- Navy/841158002719 Size M6 W8,FBALYB Amazon,-24,-47,23,0,23,0
,10001-410M7W9 CrocsClassic Clog CLR- Navy/841158002726 Size M7 W9,10001-410M7W9 CrocsClassic Clog CLR- Navy/841158002726 Size M7 W9,Default Ridgefield,1,1,0,0,0,0
,10001-410M7W9 CrocsClassic Clog CLR- Navy/841158002726 Size M7 W9,10001-410M7W9 CrocsClassic Clog CLR- Navy/841158002726 Size M7 W9,FBALYB Amazon,-43,-47,4,0,4,0
,10001-410M8W10 CrocsClassic Clog CLR- Navy/841158002733 M8 W10,10001-410M8W10 CrocsClassic Clog CLR- Navy/841158002733 M8 W10,FBALYB Amazon,-15,-18,3,0,3,0
,10001-410M9W11 CrocsClassic Clog CLR- Navy/841158002740 Size M9 W11,10001-410M9W11 CrocsClassic Clog CLR- Navy/841158002740 Size M9 W11,Default Ridgefield,1,1,0,0,0,0
,10001-410M9W11 CrocsClassic Clog CLR- Navy/841158002740 Size M9 W11,10001-410M9W11 CrocsClassic Clog CLR- Navy/841158002740 Size M9 W11,FBALYB Amazon,-6,-6,0,0,0,0
,10001-4JLM10W12 CrocsClassic Clog CLR- Bright Cobalt/191448383869 Size M10 W12,10001-4JLM10W12 CrocsClassic Clog CLR- Bright Cobalt/191448383869 Size M10 W12,FBALYB Amazon,18,9,9,0,9,0
,10001-4JLM12 CrocsClassic Clog CLR- Bright Cobalt/191448383883 Size M12 W14,10001-4JLM12 CrocsClassic Clog CLR- Bright Cobalt/191448383883 Size M12 W14,FBALYB Amazon,-3,-4,1,0,1,0
,10001-4JLM4W6 CrocsClassic Clog CLR- Bright Cobalt/191448383944 Size M4 W6,10001-4JLM4W6 CrocsClassic Clog CLR- Bright Cobalt/191448383944 Size M4 W6,Default Ridgefield,17,17,0,0,0,0
,10001-4JLM4W6 CrocsClassic Clog CLR- Bright Cobalt/191448383944 Size M4 W6,10001-4JLM4W6 CrocsClassic Clog CLR- Bright Cobalt/191448383944 Size M4 W6,FBALYB Amazon,-14,-17,3,8,3,0
,10001-4JLM5W7 CrocsClassic Clog CLR- Bright Cobalt/191448383951 Size M5 W7,10001-4JLM5W7 CrocsClassic Clog CLR- Bright Cobalt/191448383951 Size M5 W7,FBALYB Amazon,222,209,13,0,13,0
,10001-4JLM6W8 CrocsClassic Clog CLR- Bright Cobalt/191448383968 Size M6 W8,10001-4JLM6W8 CrocsClassic Clog CLR- Bright Cobalt/191448383968 Size M6 W8,Default Ridgefield,1,1,0,0,0,0
,10001-4JLM6W8 CrocsClassic Clog CLR- Bright Cobalt/191448383968 Size M6 W8,10001-4JLM6W8 CrocsClassic Clog CLR- Bright Cobalt/191448383968 Size M6 W8,FBALYB Amazon,128,119,9,0,9,0
,10001-4JLM7W9 CrocsClassic Clog CLR- Bright Cobalt/191448383975 Size M7 W9,10001-4JLM7W9 CrocsClassic Clog CLR- Bright Cobalt/191448383975 Size M7 W9,FBALYB Amazon,-6,-9,3,0,3,0
,10001-4JLM8W10 CrocsClassic Clog CLR- Bright Cobalt/191448383982 Size M8 W10,10001-4JLM8W10 CrocsClassic Clog CLR- Bright Cobalt/191448383982 Size M8 W10,FBALYB Amazon,40,29,11,0,11,0
,10001-4JLM9W11 CrocsClassic Clog CLR- Bright Cobalt/191448383999 Size M9 W11,10001-4JLM9W11 CrocsClassic Clog CLR- Bright Cobalt/191448383999 Size M9 W11,Default Ridgefield,1,1,0,0,0,0
,10001-4JLM9W11 CrocsClassic Clog CLR- Bright Cobalt/191448383999 Size M9 W11,10001-4JLM9W11 CrocsClassic Clog CLR- Bright Cobalt/191448383999 Size M9 W11,FBALYB Amazon,-7,-9,2,0,2,0
,10001-4JQM10W12 CrocsClassic Clog CLR- Mineral Blue/191448650626 Size M10 W12,10001-4JQM10W12 CrocsClassic Clog CLR- Mineral Blue/191448650626 Size M10 W12,FBALYB Amazon,-1,-1,0,0,0,0
,10001-4JQM11 CrocsClassic Clog CLR- Mineral Blue/191448650633 Size M11 W13,10001-4JQM11 CrocsClassic Clog CLR- Mineral Blue/191448650633 Size M11 W13,FBALYB Amazon,-2,-2,0,0,0,0
,10001-4JQM5W7 CrocsClassic Clog CLR- Mineral Blue/191448650732 Size M5 W7,10001-4JQM5W7 CrocsClassic Clog CLR- Mineral Blue/191448650732 Size M5 W7,FBALYB Amazon,-1,-1,0,0,0,0
,10001-4JQM6W8 CrocsClassic Clog CLR- Mineral Blue/191448650749 Size M6 W8,10001-4JQM6W8 CrocsClassic Clog CLR- Mineral Blue/191448650749 Size M6 W8,FBALYB Amazon,-3,-3,0,0,0,0
,10001-4JQM7W9 CrocsClassic Clog CLR- Mineral Blue/191448650756 Size M7 W9,10001-4JQM7W9 CrocsClassic Clog CLR- Mineral Blue/191448650756 Size M7 W9,FBALYB Amazon,-3,-3,0,0,0,0
,10001-4JQM8W10 CrocsClassic Clog CLR- Mineral Blue/191448650763 Size M8 W10,10001-4JQM8W10 CrocsClassic Clog CLR- Mineral Blue/191448650763 Size M8 W10,FBALYB Amazon,-4,-4,0,0,0,0
,10001-4JQM9W11 CrocsClassic Clog CLR- Mineral Blue/191448650770 Size M9 W11,10001-4JQM9W11 CrocsClassic Clog CLR- Mineral Blue/191448650770 Size M9 W11,FBALYB Amazon,-2,-2,0,0,0,0
,10001-4O9M10W12 CrocsClassic Clog CLR- Ice Blue/887350963649 M10 W12,10001-4O9M10W12 CrocsClassic Clog CLR- Ice Blue/887350963649 M10 W12,FBALYB Amazon,-3,-3,0,0,0,0
,10001-4O9M11 CrocsClassic Clog CLR- Ice Blue/887350963656 Size M11 W13,10001-4O9M11 CrocsClassic Clog CLR- Ice Blue/887350963656 Size M11 W13,FBALYB Amazon,-2,-2,0,0,0,0
,10001-4O9M12 CrocsClassic Clog CLR- Ice Blue/887350963663 Size M12 W14,10001-4O9M12 CrocsClassic Clog CLR- Ice Blue/887350963663 Size M12 W14,FBALYB Amazon,-1,-1,0,0,0,0
,10001-4O9M4W6 CrocsClassic Clog CLR- Ice Blue/887350968323 Size M4 W6,10001-4O9M4W6 CrocsClassic Clog CLR- Ice Blue/887350968323 Size M4 W6,FBALYB Amazon,-8,-8,0,0,0,0
,10001-4O9M5W7 CrocsClassic Clog CLR- Ice Blue/887350968330 Size M5 W7,10001-4O9M5W7 CrocsClassic Clog CLR- Ice Blue/887350968330 Size M5 W7,Default Ridgefield,5,5,0,0,0,0
,10001-4O9M5W7 CrocsClassic Clog CLR- Ice Blue/887350968330 Size M5 W7,10001-4O9M5W7 CrocsClassic Clog CLR- Ice Blue/887350968330 Size M5 W7,FBALYB Amazon,-18,-24,6,0,6,0
,10001-4O9M6W8 CrocsClassic Clog CLR- Ice Blue/887350968347 Size M6 W8,10001-4O9M6W8 CrocsClassic Clog CLR- Ice Blue/887350968347 Size M6 W8,Default Ridgefield,6,6,0,0,0,0
,10001-4O9M6W8 CrocsClassic Clog CLR- Ice Blue/887350968347 Size M6 W8,10001-4O9M6W8 CrocsClassic Clog CLR- Ice Blue/887350968347 Size M6 W8,FBALYB Amazon,-23,-24,1,0,1,0
,10001-4O9M7W9 CrocsClassic Clog CLR- Ice Blue/887350968354 Size M7 W9,10001-4O9M7W9 CrocsClassic Clog CLR- Ice Blue/887350968354 Size M7 W9,FBALYB Amazon,-22,-25,3,0,3,0
,10001-4O9M8W10 CrocsClassic Clog CLR- Ice Blue/887350968361 Size M8 W10,10001-4O9M8W10 CrocsClassic Clog CLR- Ice Blue/887350968361 Size M8 W10,FBALYB Amazon,-7,-10,3,0,3,0
,10001-4O9M9W11 CrocsClassic Clog CLR- Ice Blue/887350968378 Size M9 W11,10001-4O9M9W11 CrocsClassic Clog CLR- Ice Blue/887350968378 Size M9 W11,Default Ridgefield,1,1,0,0,0,0
,10001-4O9M9W11 CrocsClassic Clog CLR- Ice Blue/887350968378 Size M9 W11,10001-4O9M9W11 CrocsClassic Clog CLR- Ice Blue/887350968378 Size M9 W11,FBALYB Amazon,-10,-10,0,0,0,0
,10001-4SLM10W12 CrocsClassic Clog CLR- Digital Aqua/191448650947 Size M10 W12,10001-4SLM10W12 CrocsClassic Clog CLR- Digital Aqua/191448650947 Size M10 W12,FBALYB Amazon,-2,-2,0,0,0,0
,10001-4SLM11 CrocsClassic Clog CLR- Digital Aqua/191448650954 Size M11 W13,10001-4SLM11 CrocsClassic Clog CLR- Digital Aqua/191448650954 Size M11 W13,FBALYB Amazon,-2,-2,0,0,0,0
,10001-4SLM5W7 CrocsClassic Clog CLR- Digital Aqua/191448651050 Size M5 W7,10001-4SLM5W7 CrocsClassic Clog CLR- Digital Aqua/191448651050 Size M5 W7,FBALYB Amazon,-2,-2,0,0,0,0
,10001-4SLM6W8 CrocsClassic Clog CLR- Digital Aqua/191448651067 Size M6 W8,10001-4SLM6W8 CrocsClassic Clog CLR- Digital Aqua/191448651067 Size M6 W8,FBALYB Amazon,-2,-2,0,0,0,0
,10001-4SLM7W9 CrocsClassic Clog CLR- Digital Aqua/191448651074 Size M7 W9,10001-4SLM7W9 CrocsClassic Clog CLR- Digital Aqua/191448651074 Size M7 W9,FBALYB Amazon,-3,-3,0,0,0,0
,10001-4SLM8W10 CrocsClassic Clog CLR- Digital Aqua/191448651081 Size M8 W10,10001-4SLM8W10 CrocsClassic Clog CLR- Digital Aqua/191448651081 Size M8 W10,FBALYB Amazon,-1,-1,0,0,0,0
,10001-518M11 CrocsClassic Clog CLR- Neon Purple/191448616585 Size M11 W13,10001-518M11 CrocsClassic Clog CLR- Neon Purple/191448616585 Size M11 W13,FBALYB Amazon,-1,-1,0,0,0,0
,10001-518M12 CrocsClassic Clog CLR- Neon Purple/191448616592 Size M12 W14,10001-518M12 CrocsClassic Clog CLR- Neon Purple/191448616592 Size M12 W14,FBALYB Amazon,-3,-3,0,0,0,0
,10001-518M4W6 CrocsClassic Clog CLR- Neon Purple/191448260771 Size M4 W6,10001-518M4W6 CrocsClassic Clog CLR- Neon Purple/191448260771 Size M4 W6,Default Ridgefield,1,1,0,0,0,0
,10001-518M4W6 CrocsClassic Clog CLR- Neon Purple/191448260771 Size M4 W6,10001-518M4W6 CrocsClassic Clog CLR- Neon Purple/191448260771 Size M4 W6,FBALYB Amazon,-1,-3,2,0,2,0
,10001-518M5W7 CrocsClassic Clog CLR- Neon Purple/191448260788 Size M5 W7,10001-518M5W7 CrocsClassic Clog CLR- Neon Purple/191448260788 Size M5 W7,FBALYB Amazon,-31,-33,2,0,2,0
,10001-518M6W8 CrocsClassic Clog CLR- Neon Purple/191448260795 Size M6 W8,10001-518M6W8 CrocsClassic Clog CLR- Neon Purple/191448260795 Size M6 W8,FBALYB Amazon,-25,-28,3,0,3,0
,10001-518M7W9 CrocsClassic Clog CLR- Neon Purple/191448260801 Size M7 W9,10001-518M7W9 CrocsClassic Clog CLR- Neon Purple/191448260801 Size M7 W9,FBALYB Amazon,4,-10,14,0,14,0
,10001-518M8W10 CrocsClassic Clog CLR- Neon Purple/191448260818 Size M8 W10,10001-518M8W10 CrocsClassic Clog CLR- Neon Purple/191448260818 Size M8 W10,Default Ridgefield,1,1,0,0,0,0
,10001-518M8W10 CrocsClassic Clog CLR- Neon Purple/191448260818 Size M8 W10,10001-518M8W10 CrocsClassic Clog CLR- Neon Purple/191448260818 Size M8 W10,FBALYB Amazon,-7,-12,5,0,5,0
,10001-518M9W11 CrocsClassic Clog CLR- Neon Purple/191448260825 Size M9 W11,10001-518M9W11 CrocsClassic Clog CLR- Neon Purple/191448260825 Size M9 W11,FBALYB Amazon,-5,-5,0,0,0,0
,10001-530M10W12 CrocsClassic Clog CLR- Lavender/841158099658 Size M10 W12,10001-530M10W12 CrocsClassic Clog CLR- Lavender/841158099658 Size M10 W12,FBALYB Amazon,-4,-4,0,0,0,0
,10001-530M11 CrocsClassic Clog CLR- Lavender/191448616431 Size M11 W13,10001-530M11 CrocsClassic Clog CLR- Lavender/191448616431 Size M11 W13,FBALYB Amazon,-3,-3,0,0,0,0
,10001-530M12 CrocsClassic Clog CLR- Lavender/191448616448 Size M12 W14,10001-530M12 CrocsClassic Clog CLR- Lavender/191448616448 Size M12 W14,FBALYB Amazon,-26,-26,0,24,0,0
,10001-530M4W6 CrocsClassic Clog CLR- Lavender/841158099597 Size M4 W6,10001-530M4W6 CrocsClassic Clog CLR- Lavender/841158099597 Size M4 W6,FBALYB Amazon,-8,-8,0,0,0,0
,10001-530M5W7 CrocsClassic Clog CLR- Lavender/841158099603 Size M5 W7,10001-530M5W7 CrocsClassic Clog CLR- Lavender/841158099603 Size M5 W7,Default Ridgefield,1,1,0,0,0,0
,10001-530M5W7 CrocsClassic Clog CLR- Lavender/841158099603 Size M5 W7,10001-530M5W7 CrocsClassic Clog CLR- Lavender/841158099603 Size M5 W7,FBALYB Amazon,-19,-22,3,0,3,0
,10001-530M6W8 CrocsClassic Clog CLR- Lavender/841158099610 Size M6 W8,10001-530M6W8 CrocsClassic Clog CLR- Lavender/841158099610 Size M6 W8,Default Ridgefield,1,1,0,0,0,0
,10001-530M6W8 CrocsClassic Clog CLR- Lavender/841158099610 Size M6 W8,10001-530M6W8 CrocsClassic Clog CLR- Lavender/841158099610 Size M6 W8,FBALYB Amazon,-15,-19,4,0,4,0
,10001-530M7W9 CrocsClassic Clog CLR- Lavender/841158099627 Size M7 W9,10001-530M7W9 CrocsClassic Clog CLR- Lavender/841158099627 Size M7 W9,Default Ridgefield,5,5,0,0,0,0
,10001-530M7W9 CrocsClassic Clog CLR- Lavender/841158099627 Size M7 W9,10001-530M7W9 CrocsClassic Clog CLR- Lavender/841158099627 Size M7 W9,FBALYB Amazon,61,45,16,1,16,0
,10001-530M8W10 CrocsClassic Clog CLR- Lavender/841158099634 Size M8 W10,10001-530M8W10 CrocsClassic Clog CLR- Lavender/841158099634 Size M8 W10,FBALYB Amazon,-9,-11,2,0,2,0
,10001-530M9W11 CrocsClassic Clog CLR- Lavender/841158099641 Size M9 W11,10001-530M9W11 CrocsClassic Clog CLR- Lavender/841158099641 Size M9 W11,FBALYB Amazon,-5,-5,0,0,0,0
,10001-5PRM10W12 CrocsClassic Clog CLR- Orchid/191448651265 Size M10 W12,10001-5PRM10W12 CrocsClassic Clog CLR- Orchid/191448651265 Size M10 W12,FBALYB Amazon,-1,-1,0,0,0,0
,10001-5PRM11 CrocsClassic Clog CLR- Orchid/191448651272 Size M11 W13,10001-5PRM11 CrocsClassic Clog CLR- Orchid/191448651272 Size M11 W13,FBALYB Amazon,-1,-1,0,0,0,0
,10001-5PRM12 CrocsClassic Clog CLR- Orchid/191448651289 Size M12 W14,10001-5PRM12 CrocsClassic Clog CLR- Orchid/191448651289 Size M12 W14,FBALYB Amazon,4,4,0,0,0,0
,10001-5PRM4W6 CrocsClassic Clog CLR- Orchid/191448651326 Size M4 W6,10001-5PRM4W6 CrocsClassic Clog CLR- Orchid/191448651326 Size M4 W6,FBALYB Amazon,-2,-2,0,0,0,0
,10001-5PRM5W7 CrocsClassic Clog CLR- Orchid/191448651333 Size M5 W7,10001-5PRM5W7 CrocsClassic Clog CLR- Orchid/191448651333 Size M5 W7,Default Ridgefield,0,-18,18,0,0,0
,10001-5PRM5W7 CrocsClassic Clog CLR- Orchid/191448651333 Size M5 W7,10001-5PRM5W7 CrocsClassic Clog CLR- Orchid/191448651333 Size M5 W7,FBALYB Amazon,-1,-1,0,0,0,0
,10001-5PRM6W8 CrocsClassic Clog CLR- Orchid/191448651340 Size M6 W8,10001-5PRM6W8 CrocsClassic Clog CLR- Orchid/191448651340 Size M6 W8,FBALYB Amazon,-1,-1,0,0,0,0
,10001-5PRM7W9 CrocsClassic Clog CLR- Orchid/191448651357 Size M7 W9,10001-5PRM7W9 CrocsClassic Clog CLR- Orchid/191448651357 Size M7 W9,FBALYB Amazon,-1,-1,0,0,0,0
,10001-5PRM8W10 CrocsClassic Clog CLR- Orchid/191448651364 Size M8 W10,10001-5PRM8W10 CrocsClassic Clog CLR- Orchid/191448651364 Size M8 W10,FBALYB Amazon,-2,-2,0,0,0,0
,10001-669M10W12 CrocsClassic Clog CLR- Pink Lemonade/191448616394 Size M10 W12,10001-669M10W12 CrocsClassic Clog CLR- Pink Lemonade/191448616394 Size M10 W12,Default Ridgefield,2,2,0,0,0,0
,10001-669M10W12 CrocsClassic Clog CLR- Pink Lemonade/191448616394 Size M10 W12,10001-669M10W12 CrocsClassic Clog CLR- Pink Lemonade/191448616394 Size M10 W12,FBALYB Amazon,7,6,1,0,1,0
,10001-669M11 CrocsClassic Clog CLR- Pink Lemonade/191448616400 Size M11 W13,10001-669M11 CrocsClassic Clog CLR- Pink Lemonade/191448616400 Size M11 W13,FBALYB Amazon,-2,-2,0,0,0,0
,10001-669M12 CrocsClassic Clog CLR- Pink Lemonade/191448616417 Size M12 W14,10001-669M12 CrocsClassic Clog CLR- Pink Lemonade/191448616417 Size M12,FBALYB Amazon,0,0,0,23,0,0
,10001-669M4W6 CrocsClassic Clog CLR- Pink Lemonade/191448384149 Size M4 W6,10001-669M4W6 CrocsClassic Clog CLR- Pink Lemonade/191448384149 Size M4 W6,FBALYB Amazon,-3,-3,0,0,0,0
,10001-669M5W7 CrocsClassic Clog CLR- Pink Lemonade/191448384156 Size M5 W7,10001-669M5W7 CrocsClassic Clog CLR- Pink Lemonade/191448384156 Size M5 W7,FBALYB Amazon,-36,-36,0,36,0,0
,10001-669M6W8 CrocsClassic Clog CLR- Pink Lemonade/191448384163 Size M6 W8,10001-669M6W8 CrocsClassic Clog CLR- Pink Lemonade/191448384163 Size M6 W8,FBALYB Amazon,-4,-4,0,0,0,0
,10001-669M7W9 CrocsClassic Clog CLR- Pink Lemonade/191448384170 Size M7 W9,10001-669M7W9 CrocsClassic Clog CLR- Pink Lemonade/191448384170 Size M7 W9,FBALYB Amazon,-4,-4,0,0,0,0
,10001-669M8W10 CrocsClassic Clog CLR- Pink Lemonade/191448384187 Size M8 W10,10001-669M8W10 CrocsClassic Clog CLR- Pink Lemonade/191448384187 Size M8 W10,FBALYB Amazon,-1,-1,0,0,0,0
,10001-669M9W11 CrocsClassic Clog CLR- Pink Lemonade/191448384194 Size M9 W11,10001-669M9W11 CrocsClassic Clog CLR- Pink Lemonade/191448384194 Size M9 W11,FBALYB Amazon,-8,-8,0,0,0,0
,10001-6GDM11 CrocsClassic Clog CLR- Ballerina Pink/191448102798 Size M11 W13,10001-6GDM11 CrocsClassic Clog CLR- Ballerina Pink/191448102798 Size M11 W13,FBALYB Amazon,-1,-1,0,0,0,0
,10001-6GDM12 CrocsClassic Clog CLR- Ballerina Pink/191448102804 Size M12 W14,10001-6GDM12 CrocsClassic Clog CLR- Ballerina Pink/191448102804 Size M12 W14,FBALYB Amazon,-10,-10,0,0,0,0
,10001-6GDM4W6 CrocsClassic Clog CLR- Ballerina Pink/191448102866 Size M4 W6,10001-6GDM4W6 CrocsClassic Clog CLR- Ballerina Pink/191448102866 Size M4 W6,FBALYB Amazon,-1,-2,1,0,1,0
,10001-6GDM5W7 CrocsClassic Clog CLR- Ballerina Pink/191448102873 SIze M5 W7,10001-6GDM5W7 CrocsClassic Clog CLR- Ballerina Pink/191448102873 SIze M5 W7,Default Ridgefield,11,11,0,0,0,0
,10001-6GDM5W7 CrocsClassic Clog CLR- Ballerina Pink/191448102873 SIze M5 W7,10001-6GDM5W7 CrocsClassic Clog CLR- Ballerina Pink/191448102873 SIze M5 W7,FBALYB Amazon,207,183,24,1,24,0
,10001-6GDM6W8 CrocsClassic Clog CLR- Ballerina Pink/191448102880 Size M6 W8,10001-6GDM6W8 CrocsClassic Clog CLR- Ballerina Pink/191448102880 Size M6 W8,Default Ridgefield,3,3,0,0,0,0
,10001-6GDM6W8 CrocsClassic Clog CLR- Ballerina Pink/191448102880 Size M6 W8,10001-6GDM6W8 CrocsClassic Clog CLR- Ballerina Pink/191448102880 Size M6 W8,FBALYB Amazon,415,388,27,20,27,0
,10001-6GDM7W9 CrocsClassic Clog CLR- Ballerina Pink/191448102897 Size M7 W9,10001-6GDM7W9 CrocsClassic Clog CLR- Ballerina Pink/191448102897 Size M7 W9,Default Ridgefield,12,12,0,0,0,0
,10001-6GDM7W9 CrocsClassic Clog CLR- Ballerina Pink/191448102897 Size M7 W9,10001-6GDM7W9 CrocsClassic Clog CLR- Ballerina Pink/191448102897 Size M7 W9,FBALYB Amazon,67,59,8,9,8,0
,10001-6GDM8W10 CrocsClassic Clog CLR- Ballerina Pink/191448102903 Size M8 W10,10001-6GDM8W10 CrocsClassic Clog CLR- Ballerina Pink/191448102903 Size M8 W10,Default Ridgefield,12,12,0,0,0,0
,10001-6GDM8W10 CrocsClassic Clog CLR- Ballerina Pink/191448102903 Size M8 W10,10001-6GDM8W10 CrocsClassic Clog CLR- Ballerina Pink/191448102903 Size M8 W10,FBALYB Amazon,201,198,3,0,3,0
,10001-6GDM9W11 CrocsClassic Clog CLR- Ballerina Pink/191448102910 Size M9 W11,10001-6GDM9W11 CrocsClassic Clog CLR- Ballerina Pink/191448102910 Size M9 W11,Default Ridgefield,12,12,0,0,0,0
,10001-6GDM9W11 CrocsClassic Clog CLR- Ballerina Pink/191448102910 Size M9 W11,10001-6GDM9W11 CrocsClassic Clog CLR- Ballerina Pink/191448102910 Size M9 W11,FBALYB Amazon,-9,-10,1,0,1,0
,10001-6QQM10W12 CrocsClassic Clog CLR- Electric Pink/191448536371 Size M10 W12,10001-6QQM10W12 CrocsClassic Clog CLR- Electric Pink/191448536371 Size M10 W12,FBALYB Amazon,-5,-5,0,0,0,0
,10001-6QQM4W6 CrocsClassic Clog CLR- Electric Pink/191448441101 Size M4 W6,10001-6QQM4W6 CrocsClassic Clog CLR- Electric Pink/191448441101 Size M4 W6,FBALYB Amazon,15,15,0,0,0,0
,10001-6QQM5W7 CrocsClassic Clog CLR- Electric Pink/191448441118 Size M5 W7,10001-6QQM5W7 CrocsClassic Clog CLR- Electric Pink/191448441118 Size M5 W7,FBALYB Amazon,47,40,7,0,7,0
,10001-6QQM6W8 CrocsClassic Clog CLR- Electric Pink/191448441125 Size M6 W8,10001-6QQM6W8 CrocsClassic Clog CLR- Electric Pink/191448441125 Size M6 W8,FBALYB Amazon,83,72,11,0,11,0
,10001-6QQM7W9 CrocsClassic Clog CLR- Electric Pink/191448441132 Size M7 W9,10001-6QQM7W9 CrocsClassic Clog CLR- Electric Pink/191448441132 Size M7 W9,Default Ridgefield,24,24,0,0,0,0
,10001-6QQM7W9 CrocsClassic Clog CLR- Electric Pink/191448441132 Size M7 W9,10001-6QQM7W9 CrocsClassic Clog CLR- Electric Pink/191448441132 Size M7 W9,FBALYB Amazon,33,25,8,0,8,0
,10001-6QQM8W10 CrocsClassic Clog CLR- Electric Pink/191448441149 Size M8 W10,10001-6QQM8W10 CrocsClassic Clog CLR- Electric Pink/191448441149 Size M8 W10,FBALYB Amazon,-3,-5,2,0,2,0
,10001-6QQM9W11 CrocsClassic Clog CLR- Electric Pink/191448441156 Size M9 W11,10001-6QQM9W11 CrocsClassic Clog CLR- Electric Pink/191448441156 Size M9 W11,FBALYB Amazon,-9,-9,0,0,0,0
,10001-6SLM10W12 CrocsClassic Clog CLR- Fresco/191448651517 Size M10 W12,10001-6SLM10W12 CrocsClassic Clog CLR- Fresco/191448651517 Size M10 W12,FBALYB Amazon,5,4,1,0,1,0
,10001-6SLM12 CrocsClassic Clog CLR- Fresco/191448651531 Size M12 W14,10001-6SLM12 CrocsClassic Clog CLR- Fresco/191448651531 Size M12 W14,FBALYB Amazon,5,4,1,0,1,0
,10001-6SLM4W6 CrocsClassic Clog CLR- Fresco/191448651579 Size M4 W6,10001-6SLM4W6 CrocsClassic Clog CLR- Fresco/191448651579 Size M4 W6,FBALYB Amazon,-1,-1,0,0,0,0
,10001-6SLM6W8 CrocsClassic Clog CLR- Fresco/191448651593 Size M6 W8,10001-6SLM6W8 CrocsClassic Clog CLR- Fresco/191448651593 Size M6 W8,FBALYB Amazon,-5,-5,0,0,0,0
,10001-6SLM7W9 CrocsClassic Clog CLR- Fresco/191448651609 Size M7 W9,10001-6SLM7W9 CrocsClassic Clog CLR- Fresco/191448651609 Size M7 W9,FBALYB Amazon,-2,-2,0,0,0,0
,10001-6SLM8W10 CrocsClassic Clog CLR- Fresco/191448651616 Size M8 W10,10001-6SLM8W10 CrocsClassic Clog CLR- Fresco/191448651616 Size M8 W10,FBALYB Amazon,-4,-4,0,0,0,0
,10001-6SLM9W11 CrocsClassic Clog CLR- Fresco/191448651623 Size M9 W11,10001-6SLM9W11 CrocsClassic Clog CLR- Fresco/191448651623 Size M9 W11,FBALYB Amazon,-3,-3,0,0,0,0
,10001-7C1M10W12 CrocsClassic Clog CLR- Lemon/887350753707 Size M10 W12,10001-7C1M10W12 CrocsClassic Clog CLR- Lemon/887350753707 Size M10 W12,Default Ridgefield,1,1,0,0,0,0
,10001-7C1M10W12 CrocsClassic Clog CLR- Lemon/887350753707 Size M10 W12,10001-7C1M10W12 CrocsClassic Clog CLR- Lemon/887350753707 Size M10 W12,FBALYB Amazon,56,37,19,127,19,0
,10001-7C1M11 CrocsClassic Clog CLR- Lemon/887350753714 Size M11 W13,10001-7C1M11 CrocsClassic Clog CLR- Lemon/887350753714 Size M11 W13,FBALYB Amazon,-7,-7,0,0,0,0
,10001-7C1M12 CrocsClassic Clog CLR- Lemon/887350753721 Size M12 W14,10001-7C1M12 CrocsClassic Clog CLR- Lemon/887350753721 Size M12 W14,FBALYB Amazon,-5,-5,0,0,0,0
,10001-7C1M4W6 CrocsClassic Clog CLR- Lemon/887350753783 Size M4 W6,10001-7C1M4W6 CrocsClassic Clog CLR- Lemon/887350753783 Size M4 W6,Default Ridgefield,1,1,0,0,0,0
,10001-7C1M4W6 CrocsClassic Clog CLR- Lemon/887350753783 Size M4 W6,10001-7C1M4W6 CrocsClassic Clog CLR- Lemon/887350753783 Size M4 W6,FBALYB Amazon,-3,-3,0,0,0,0
,10001-7C1M5W7 CrocsClassic Clog CLR- Lemon/887350753790 Size M5 W7,10001-7C1M5W7 CrocsClassic Clog CLR- Lemon/887350753790 Size M5 W7,Default Ridgefield,1,1,0,0,0,0
,10001-7C1M5W7 CrocsClassic Clog CLR- Lemon/887350753790 Size M5 W7,10001-7C1M5W7 CrocsClassic Clog CLR- Lemon/887350753790 Size M5 W7,FBALYB Amazon,10,-22,32,0,32,0
,10001-7C1M6W8 CrocsClassic Clog CLR- Lemon/887350753806 Size M6 W8,10001-7C1M6W8 CrocsClassic Clog CLR- Lemon/887350753806 Size M6 W8,Default Ridgefield,1,0,1,0,0,0
,10001-7C1M6W8 CrocsClassic Clog CLR- Lemon/887350753806 Size M6 W8,10001-7C1M6W8 CrocsClassic Clog CLR- Lemon/887350753806 Size M6 W8,FBALYB Amazon,-17,-17,0,0,0,0
,10001-7C1M7W9 CrocsClassic Clog CLR- Lemon/887350753813 Size M7 W9,10001-7C1M7W9 CrocsClassic Clog CLR- Lemon/887350753813 Size M7 W9,FBALYB Amazon,-18,-18,0,0,0,0
,10001-7C1M8W10 CrocsClassic Clog CLR- Lemon/887350753820 Size M8 W10,10001-7C1M8W10 CrocsClassic Clog CLR- Lemon/887350753820 Size M8 W10,FBALYB Amazon,-20,-20,0,0,0,0
,10001-7C1M9W11 CrocsClassic Clog CLR- Lemon/887350753837 Size M9 W11,10001-7C1M9W11 CrocsClassic Clog CLR- Lemon/887350753837 Size M9 W11,FBALYB Amazon,-9,-10,1,0,1,0
,10024-05MM11 CrocsAthens Flip CLR- Black/Smoke/887350866216 Size M11 W13,10024-05MM11 CrocsAthens Flip CLR- Black/Smoke/887350866216 Size M11 W13,FBALYB Amazon,-4,-4,0,0,0,0
,10024-05MM12 CrocsAthens Flip CLR- Black/Smoke/887350866223 Size M12 W14,10024-05MM12 CrocsAthens Flip CLR- Black/Smoke/887350866223 Size M12 W14,FBALYB Amazon,-1,-1,0,0,0,0
,10024-05MM4W6 CrocsAthens Flip CLR- Black/Smoke/887350866261 Size M4 W6,10024-05MM4W6 CrocsAthens Flip CLR- Black/Smoke/887350866261 Size M4 W6,FBALYB Amazon,-1,-1,0,0,0,0
,10024-05MM5W7 CrocsAthens Flip CLR- Black/Smoke/887350866278 Size M5 W7,10024-05MM5W7 CrocsAthens Flip CLR- Black/Smoke/887350866278 Size M5 W7,FBALYB Amazon,-1,-1,0,0,0,0
,10024-05MM6W8 CrocsAthens Flip CLR- Black/Smoke/887350866285 Size M6 W8,10024-05MM6W8 CrocsAthens Flip CLR- Black/Smoke/887350866285 Size M6 W8,FBALYB Amazon,-3,-3,0,0,0,0
,10024-05MM7W9 CrocsAthens Flip CLR- Black/Smoke/887350866391 Size M7 W9,10024-05MM7W9 CrocsAthens Flip CLR- Black/Smoke/887350866391 Size M7 W9,FBALYB Amazon,-4,-4,0,0,0,0
,10024-05MM8W10 CrocsAthens Flip CLR- Black/Smoke/887350866407 Size M8 W10,10024-05MM8W10 CrocsAthens Flip CLR- Black/Smoke/887350866407 Size M8 W10,FBALYB Amazon,-3,-3,0,0,0,0
,10024-4EUM10W12 CrocsAthens Flip CLR- Navy/Cerulean Blue/887350867022 Size M10 W12,10024-4EUM10W12 CrocsAthens Flip CLR- Navy/Cerulean Blue/887350867022 Size M10 W12,FBALYB Amazon,1,1,0,0,0,0
,10024-4EUM12 CrocsAthens Flip CLR- Navy/Cerulean Blue/887350867046 Size M12 W14,10024-4EUM12 CrocsAthens Flip CLR- Navy/Cerulean Blue/887350867046 Size M12 W14,FBALYB Amazon,-2,-2,0,0,0,0
,10024-4EUM5W7 CrocsAthens Flip CLR- Navy/Cerulean Blue/887350867091 Size M5 W7,10024-4EUM5W7 CrocsAthens Flip CLR- Navy/Cerulean Blue/887350867091 Size M5 W7,FBALYB Amazon,-2,-2,0,0,0,0
,10024-4EUM6W8 CrocsAthens Flip CLR- Navy/Cerulean Blue/887350867107 Size M6 W8,10024-4EUM6W8 CrocsAthens Flip CLR- Navy/Cerulean Blue/887350867107 Size M6 W8,FBALYB Amazon,-1,-1,0,0,0,0
,10024-4EUM8W10 CrocsAthens Flip CLR- Navy/Cerulean Blue/887350867121 Size M8 W10,10024-4EUM8W10 CrocsAthens Flip CLR- Navy/Cerulean Blue/887350867121 Size M8 W10,FBALYB Amazon,-7,-7,0,0,0,0
,10043-060W10 CrocsWomen’s Cleo Sandal CLR- Black/Black/883503190931 Size 10,10043-060W10 CrocsWomen’s Cleo Sandal CLR- Black/Black/883503190931 Size 10,FBALYB Amazon,-2,-2,0,0,0,0
,10043-060W6 CrocsWomen’s Cleo Sandal CLR- Black/Black/883503190894 Size 6,10043-060W6 CrocsWomen’s Cleo Sandal CLR- Black/Black/883503190894 Size 6,FBALYB Amazon,3,3,0,0,0,0
,10043-060W7 CrocsWomen’s Cleo Sandal CLR- Black/Black/883503190900 Size 7,10043-060W7 CrocsWomen’s Cleo Sandal CLR- Black/Black/883503190900 Size 7,FBALYB Amazon,-1,-1,0,0,0,0
,10043-060W8 CrocsWomen’s Cleo Sandal CLR- Black/Black/883503190917 Size 8,10043-060W8 CrocsWomen’s Cleo Sandal CLR- Black/Black/883503190917 Size 8,FBALYB Amazon,-1,-1,0,0,0,0
,10043-13SW10 CrocsWomen’s Cleo Sandal CLR- Oyster/Gold/191448159778 Size 10,10043-13SW10 CrocsWomen’s Cleo Sandal CLR- Oyster/Gold/191448159778 Size 10,FBALYB Amazon,-1,-1,0,0,0,0
,10043-13SW6 CrocsWomen’s Cleo Sandal CLR- Oyster/Gold/191448159815 Size 6,10043-13SW6 CrocsWomen’s Cleo Sandal CLR- Oyster/Gold/191448159815 Size 6,FBALYB Amazon,-1,-1,0,0,0,0
,10043-23QW6 CrocsWomen’s Cleo Sandal CLR- Espresso/Gold/191448261693 Size 6,10043-23QW6 CrocsWomen’s Cleo Sandal CLR- Espresso/Gold/191448261693 Size 6,FBALYB Amazon,-1,-1,0,0,0,0
,10043-23QW7 CrocsWomen’s Cleo Sandal CLR- Espresso/Gold/191448261709 Size 7,10043-23QW7 CrocsWomen’s Cleo Sandal CLR- Espresso/Gold/191448261709 Size 7,FBALYB Amazon,-2,-2,0,0,0,0
,10043-23QW8 CrocsWomen’s Cleo Sandal CLR- Espresso/Gold/191448261716 Size 8,10043-23QW8 CrocsWomen’s Cleo Sandal CLR- Espresso/Gold/191448261716 Size 8,FBALYB Amazon,-2,-2,0,0,0,0
,10043-23QW9 CrocsWomen’s Cleo Sandal CLR- Espresso/Gold/191448261723 Size 9,10043-23QW9 CrocsWomen’s Cleo Sandal CLR- Espresso/Gold/191448261723 Size 9,FBALYB Amazon,-4,-4,0,0,0,0
,1007 Vetericyn + Wound / Skin Care Traveler 3 oz,1007 Vetericyn + Wound / Skin Care Traveler 3 oz,Default Ridgefield,283,283,0,0,0,0
,1007 Vetericyn + Wound / Skin Care Traveler 3 oz,1007 Vetericyn + Wound / Skin Care Traveler 3 oz,FBALYB Amazon,17,1,16,0,16,0
,1009 Vetericyn + Reptile Wound & Skin Care 3 oz,1009 Vetericyn + Reptile Wound & Skin Care 3 oz,FBALYB Amazon,-2,-2,0,4,0,0
,1009 Vetericyn + Reptile Wound & Skin Care 3 oz,1009 Vetericyn + Reptile Wound & Skin Care 3 oz,FBALYB Canada,6,6,0,0,0,0
,10126-001M10W12 CrocsBaya Clog CLR- Black/883503153332 Size M10 W12,10126-001M10W12 CrocsBaya Clog CLR- Black/883503153332 Size M10 W12,Default Ridgefield,0,0,0,0,0,83
,10126-001M10W12 CrocsBaya Clog CLR- Black/883503153332 Size M10 W12,10126-001M10W12 CrocsBaya Clog CLR- Black/883503153332 Size M10 W12,FBALYB Amazon,-4,-4,0,0,0,0
,10126-001M11 CrocsBaya Clog CLR- Black/883503153349 Size M11 W13,10126-001M11 CrocsBaya Clog CLR- Black/883503153349 Size M11 W13,Default Ridgefield,0,0,0,0,0,23
,10126-001M11 CrocsBaya Clog CLR- Black/883503153349 Size M11 W13,10126-001M11 CrocsBaya Clog CLR- Black/883503153349 Size M11 W13,FBALYB Amazon,41,40,1,0,1,0
,10126-001M4W6 CrocsBaya Clog CLR- Black/883503153271 Size M4 W6,10126-001M4W6 CrocsBaya Clog CLR- Black/883503153271 Size M4 W6,Default Ridgefield,0,0,0,0,0,35
,10126-001M4W6 CrocsBaya Clog CLR- Black/883503153271 Size M4 W6,10126-001M4W6 CrocsBaya Clog CLR- Black/883503153271 Size M4 W6,FBALYB Amazon,-1,-1,0,0,0,0
,10126-001M5W7 CrocsBaya Clog CLR- Black/883503153288 Size M5 W7,10126-001M5W7 CrocsBaya Clog CLR- Black/883503153288 Size M5 W7,Default Ridgefield,1,1,0,0,0,83
,10126-001M5W7 CrocsBaya Clog CLR- Black/883503153288 Size M5 W7,10126-001M5W7 CrocsBaya Clog CLR- Black/883503153288 Size M5 W7,FBALYB Amazon,-2,-2,0,0,0,0
,10126-001M6W8 CrocsBaya Clog CLR- Black/883503153295 Size M6 W8,10126-001M6W8 CrocsBaya Clog CLR- Black/883503153295 Size M6 W8,Default Ridgefield,0,0,0,0,0,71
,10126-001M6W8 CrocsBaya Clog CLR- Black/883503153295 Size M6 W8,10126-001M6W8 CrocsBaya Clog CLR- Black/883503153295 Size M6 W8,FBALYB Amazon,-6,-9,3,0,3,0
,10126-001M7W9 CrocsBaya Clog CLR- Black/883503153301 Size M7 W9,10126-001M7W9 CrocsBaya Clog CLR- Black/883503153301 Size M7 W9,Default Ridgefield,0,0,0,0,0,95
,10126-001M7W9 CrocsBaya Clog CLR- Black/883503153301 Size M7 W9,10126-001M7W9 CrocsBaya Clog CLR- Black/883503153301 Size M7 W9,FBALYB Amazon,-1,-1,0,0,0,0
,10126-001M8W10 CrocsBaya Clog CLR- Black/883503153318 Size M8 W10,10126-001M8W10 CrocsBaya Clog CLR- Black/883503153318 Size M8 W10,Default Ridgefield,0,0,0,0,0,71
,10126-001M8W10 CrocsBaya Clog CLR- Black/883503153318 Size M8 W10,10126-001M8W10 CrocsBaya Clog CLR- Black/883503153318 Size M8 W10,FBALYB Amazon,-7,-9,2,0,2,0
,10126-001M9W11 CrocsBaya Clog CLR- Black/883503153325 Size M9 W11,10126-001M9W11 CrocsBaya Clog CLR- Black/883503153325 Size M9 W11,Default Ridgefield,0,0,0,0,0,95
,10126-001M9W11 CrocsBaya Clog CLR- Black/883503153325 Size M9 W11,10126-001M9W11 CrocsBaya Clog CLR- Black/883503153325 Size M9 W11,FBALYB Amazon,-1,-1,0,0,0,0
,10126-014M10W12 CrocsBaya Clog CLR- Graphite/883503540217 Size M10 W12,10126-014M10W12 CrocsBaya Clog CLR- Graphite/883503540217 Size M10 W12,Default Ridgefield,0,0,0,0,0,12
,10126-014M10W12 CrocsBaya Clog CLR- Graphite/883503540217 Size M10 W12,10126-014M10W12 CrocsBaya Clog CLR- Graphite/883503540217 Size M10 W12,FBALYB Amazon,-3,-3,0,0,0,0
,10126-014M12 CrocsBaya Clog CLR- Graphite/883503540231 Size M12 W14,10126-014M12 CrocsBaya Clog CLR- Graphite/883503540231 Size M12 W14,FBALYB Amazon,-1,-1,0,0,0,0
,10126-014M4W6 CrocsBaya Clog CLR- Graphite/883503540156 Size M4 W6,10126-014M4W6 CrocsBaya Clog CLR- Graphite/883503540156 Size M4 W6,Default Ridgefield,0,0,0,0,0,12
,10126-014M5W7 CrocsBaya Clog CLR- Graphite/883503540163 Size M5 W7,10126-014M5W7 CrocsBaya Clog CLR- Graphite/883503540163 Size M5 W7,Default Ridgefield,0,0,0,0,0,24
,10126-014M5W7 CrocsBaya Clog CLR- Graphite/883503540163 Size M5 W7,10126-014M5W7 CrocsBaya Clog CLR- Graphite/883503540163 Size M5 W7,FBALYB Amazon,1,1,0,0,0,0
,10126-014M6W8 CrocsBaya Clog CLR- Graphite/883503540170 Size M6 W8,10126-014M6W8 CrocsBaya Clog CLR- Graphite/883503540170 Size M6 W8,Default Ridgefield,1,1,0,0,0,12
,10126-014M6W8 CrocsBaya Clog CLR- Graphite/883503540170 Size M6 W8,10126-014M6W8 CrocsBaya Clog CLR- Graphite/883503540170 Size M6 W8,FBALYB Amazon,1,1,0,0,0,0
,10126-014M7W9 CrocsBaya Clog CLR- Graphite/883503540187 Size M7 W9,10126-014M7W9 CrocsBaya Clog CLR- Graphite/883503540187 Size M7 W9,Default Ridgefield,0,0,0,0,0,12
,10126-014M8W10 CrocsBaya Clog CLR- Graphite/883503540194 Size M8 W10,10126-014M8W10 CrocsBaya Clog CLR- Graphite/883503540194 Size M8 W10,Default Ridgefield,0,0,0,0,0,12
,10126-014M8W10 CrocsBaya Clog CLR- Graphite/883503540194 Size M8 W10,10126-014M8W10 CrocsBaya Clog CLR- Graphite/883503540194 Size M8 W10,FBALYB Amazon,-3,-3,0,0,0,0
,10126-014M9W11 CrocsBaya Clog CLR- Graphite/883503540200 Size M9 W11,10126-014M9W11 CrocsBaya Clog CLR- Graphite/883503540200 Size M9 W11,Default Ridgefield,0,0,0,0,0,12
,10126-100M10W12 CrocsBaya Clog CLR- White/883503153431 Size M10 W12,10126-100M10W12 CrocsBaya Clog CLR- White/883503153431 Size M10 W12,Default Ridgefield,0,0,0,0,0,12
,10126-100M10W12 CrocsBaya Clog CLR- White/883503153431 Size M10 W12,10126-100M10W12 CrocsBaya Clog CLR- White/883503153431 Size M10 W12,FBALYB Amazon,-2,-2,0,0,0,0
,10126-100M11 CrocsBaya Clog CLR- White/883503153448 Size M11 W13,10126-100M11 CrocsBaya Clog CLR- White/883503153448 Size M11 W13,Default Ridgefield,36,36,0,0,0,0
,10126-100M11 CrocsBaya Clog CLR- White/883503153448 Size M11 W13,10126-100M11 CrocsBaya Clog CLR- White/883503153448 Size M11 W13,FBALYB Amazon,-1,-3,2,0,2,0
,10126-100M6W8 CrocsBaya Clog CLR- White/883503153394 Size M6 W8,10126-100M6W8 CrocsBaya Clog CLR- White/883503153394 Size M6 W8,Default Ridgefield,0,0,0,0,0,119
,10126-100M6W8 CrocsBaya Clog CLR- White/883503153394 Size M6 W8,10126-100M6W8 CrocsBaya Clog CLR- White/883503153394 Size M6 W8,FBALYB Amazon,-7,-7,0,0,0,0
,10126-100M7W9 CrocsBaya Clog CLR- White/883503153400 Size M7 W9,10126-100M7W9 CrocsBaya Clog CLR- White/883503153400 Size M7 W9,Default Ridgefield,0,0,0,0,0,35
,10126-100M7W9 CrocsBaya Clog CLR- White/883503153400 Size M7 W9,10126-100M7W9 CrocsBaya Clog CLR- White/883503153400 Size M7 W9,FBALYB Amazon,-1,-1,0,0,0,0
,10126-100M8W10 CrocsBaya Clog CLR- White/883503153417 Size M8 W10,10126-100M8W10 CrocsBaya Clog CLR- White/883503153417 Size M8 W10,Default Ridgefield,1,1,0,0,0,23
,10126-100M8W10 CrocsBaya Clog CLR- White/883503153417 Size M8 W10,10126-100M8W10 CrocsBaya Clog CLR- White/883503153417 Size M8 W10,FBALYB Amazon,-4,-4,0,0,0,0
,10126-100M9W11 CrocsBaya Clog CLR- White/883503153424 Size M9 W11,10126-100M9W11 CrocsBaya Clog CLR- White/883503153424 Size M9 W11,Default Ridgefield,0,0,0,0,0,23
,10126-100M9W11 CrocsBaya Clog CLR- White/883503153424 Size M9 W11,10126-100M9W11 CrocsBaya Clog CLR- White/883503153424 Size M9 W11,FBALYB Amazon,-2,-2,0,0,0,0
,10126-206M11 CrocsBaya Clog CLR- Espresso/887350867275 Size M11 W13,10126-206M11 CrocsBaya Clog CLR- Espresso/887350867275 Size M11 W13,FBALYB Amazon,-1,-1,0,0,0,0
,10126-206M12 CrocsBaya Clog CLR- Espresso/887350867282 Size M12 W14,10126-206M12 CrocsBaya Clog CLR- Espresso/887350867282 Size M12 W14,FBALYB Amazon,4,3,1,0,1,0
,10126-206M5W7 CrocsBaya Clog CLR- Espresso/887350867312 Size M5 W7,10126-206M5W7 CrocsBaya Clog CLR- Espresso/887350867312 Size M5 W7,FBALYB Amazon,19,19,0,0,0,0
,10126-206M6W8 CrocsBaya Clog CLR- Espresso/887350867329 Size M6 W8,10126-206M6W8 CrocsBaya Clog CLR- Espresso/887350867329 Size M6 W8,FBALYB Amazon,10,9,1,0,1,0
,10126-206M7W9 CrocsBaya Clog CLR- Espresso/887350867336 Size M7 W9,10126-206M7W9 CrocsBaya Clog CLR- Espresso/887350867336 Size M7 W9,FBALYB Amazon,10,10,0,0,0,0
,10126-206M8W10 CrocsBaya Clog CLR- Espresso/887350867343 Size M8 W10,10126-206M8W10 CrocsBaya Clog CLR- Espresso/887350867343 Size M8 W10,FBALYB Amazon,10,10,0,0,0,0
,10126-206M9W11 CrocsBaya Clog CLR- Espresso/887350867350 Size M9 W11,10126-206M9W11 CrocsBaya Clog CLR- Espresso/887350867350 Size M9 W11,FBALYB Amazon,-3,-3,0,0,0,0
,10126-410M10W12 CrocsBaya Clog CLR- Navy/883503153837 Size M10 W12,10126-410M10W12 CrocsBaya Clog CLR- Navy/883503153837 Size M10 W12,Default Ridgefield,31,31,0,0,0,72
,10126-410M11 CrocsBaya Clog CLR- Navy/883503153844 Size M11 W13,10126-410M11 CrocsBaya Clog CLR- Navy/883503153844 Size M11 W13,Default Ridgefield,0,0,0,0,0,24
,10126-410M12 CrocsBaya Clog CLR- Navy/883503153851 Size M12 W14,10126-410M12 CrocsBaya Clog CLR- Navy/883503153851 Size M12 W14,FBALYB Amazon,-1,-1,0,0,0,0
,10126-410M4W6 CrocsBaya Clog CLR- Navy/883503153776 Size M4 W6,10126-410M4W6 CrocsBaya Clog CLR- Navy/883503153776 Size M4 W6,Default Ridgefield,0,0,0,0,0,71
,10126-410M4W6 CrocsBaya Clog CLR- Navy/883503153776 Size M4 W6,10126-410M4W6 CrocsBaya Clog CLR- Navy/883503153776 Size M4 W6,FBALYB Amazon,-2,-2,0,0,0,0
,10126-410M5W7 CrocsBaya Clog CLR- Navy/883503153783 Size M5 W7,10126-410M5W7 CrocsBaya Clog CLR- Navy/883503153783 Size M5 W7,Default Ridgefield,0,0,0,0,0,131
,10126-410M5W7 CrocsBaya Clog CLR- Navy/883503153783 Size M5 W7,10126-410M5W7 CrocsBaya Clog CLR- Navy/883503153783 Size M5 W7,FBALYB Amazon,-3,-3,0,0,0,0
,10126-410M6W8 CrocsBaya Clog CLR- Navy/883503153790 Size M6 W8,10126-410M6W8 CrocsBaya Clog CLR- Navy/883503153790 Size M6 W8,Default Ridgefield,0,0,0,0,0,95
,10126-410M6W8 CrocsBaya Clog CLR- Navy/883503153790 Size M6 W8,10126-410M6W8 CrocsBaya Clog CLR- Navy/883503153790 Size M6 W8,FBALYB Amazon,-4,-4,0,0,0,0
,10126-410M7W9 CrocsBaya Clog CLR- Navy/883503153806 Size M7 W9,10126-410M7W9 CrocsBaya Clog CLR- Navy/883503153806 Size M7 W9,Default Ridgefield,0,0,0,0,0,95
,10126-410M7W9 CrocsBaya Clog CLR- Navy/883503153806 Size M7 W9,10126-410M7W9 CrocsBaya Clog CLR- Navy/883503153806 Size M7 W9,FBALYB Amazon,5,5,0,0,0,0
,10126-410M8W10 CrocsBaya Clog CLR- Navy/883503153813 Size M8 W10,10126-410M8W10 CrocsBaya Clog CLR- Navy/883503153813 Size M8 W10,Default Ridgefield,0,0,0,0,0,83
,10126-410M8W10 CrocsBaya Clog CLR- Navy/883503153813 Size M8 W10,10126-410M8W10 CrocsBaya Clog CLR- Navy/883503153813 Size M8 W10,FBALYB Amazon,30,30,0,0,0,0
,10126-410M9W11 CrocsBaya Clog CLR- Navy/883503153820 Size M9 W11,10126-410M9W11 CrocsBaya Clog CLR- Navy/883503153820 Size M9 W11,Default Ridgefield,0,0,0,0,0,107
,10126-410M9W11 CrocsBaya Clog CLR- Navy/883503153820 Size M9 W11,10126-410M9W11 CrocsBaya Clog CLR- Navy/883503153820 Size M9 W11,FBALYB Amazon,-1,-1,0,0,0,0
,10126-530 Crocs Baya Clog Lavender US Size M5/ W7,10126-530 Crocs Baya Clog Lavender US Size M5/ W7,Default Ridgefield,0,0,0,0,0,107
,10126-530 Crocs Baya Clog Lavender US Size M5/ W7,10126-530 Crocs Baya Clog Lavender US Size M5/ W7,FBALYB Amazon,0,0,0,9,0,0
,10126-530 Crocs Baya Clog Lavender US Size M6/ W8,10126-530 Crocs Baya Clog Lavender US Size M6/ W8,Default Ridgefield,0,0,0,0,0,47
,10126-530 Crocs Baya Clog Lavender US Size M6/ W8,10126-530 Crocs Baya Clog Lavender US Size M6/ W8,FBALYB Amazon,5,4,1,0,1,0
,10126-530 Crocs Baya Clog Lavender US Size M7/ W9,10126-530 Crocs Baya Clog Lavender US Size M7/ W9,Default Ridgefield,1,1,0,0,0,11
,10126-530 Crocs Baya Clog Lavender US Size M7/ W9,10126-530 Crocs Baya Clog Lavender US Size M7/ W9,FBALYB Amazon,6,3,3,0,3,0
,10126-530 Crocs Baya Clog Lavender US Size M8/ W10,10126-530 Crocs Baya Clog Lavender US Size M8/ W10,FBALYB Amazon,10,8,2,0,2,0
,10126-530 Crocs Baya Clog Lavender US Size M9/ W11,10126-530 Crocs Baya Clog Lavender US Size M9/ W11,FBALYB Amazon,10,10,0,0,0,0
,10126-6ENM10W12 CrocsBaya Clog CLR- Pepper/887350867664 Size M10 W12,10126-6ENM10W12 CrocsBaya Clog CLR- Pepper/887350867664 Size M10 W12,FBALYB Amazon,-1,-1,0,0,0,0
,10126-6ENM11 CrocsBaya Clog CLR- Pepper/887350867671 Size M11 W13,10126-6ENM11 CrocsBaya Clog CLR- Pepper/887350867671 Size M11 W13,FBALYB Amazon,-1,-1,0,0,0,0
,10126-6ENM4W6 CrocsBaya Clog CLR- Pepper/887350867701 Size M4 W6,10126-6ENM4W6 CrocsBaya Clog CLR- Pepper/887350867701 Size M4 W6,FBALYB Amazon,-1,-1,0,0,0,0
,10126-6ENM5W7 CrocsBaya Clog CLR- Pepper/887350867718 Size M5 W7,10126-6ENM5W7 CrocsBaya Clog CLR- Pepper/887350867718 Size M5 W7,FBALYB Amazon,-1,-1,0,0,0,0
,10126-6ENM6W8 CrocsBaya Clog CLR- Pepper/887350867725 Size M6 W8,10126-6ENM6W8 CrocsBaya Clog CLR- Pepper/887350867725 Size M6 W8,FBALYB Amazon,-1,-1,0,0,0,0
,10126-6ENM7W9 CrocsBaya Clog CLR- Pepper/887350867732 Size M7 W9,10126-6ENM7W9 CrocsBaya Clog CLR- Pepper/887350867732 Size M7 W9,FBALYB Amazon,-5,-5,0,0,0,0
,10126-6ENM8W10 CrocsBaya Clog CLR- Pepper/887350867749 Size M8 W10,10126-6ENM8W10 CrocsBaya Clog CLR- Pepper/887350867749 Size M8 W10,FBALYB Amazon,-4,-4,0,0,0,0
,10126-6ENM9W11 CrocsBaya Clog CLR- Pepper/887350867756 Size M9 W11,10126-6ENM9W11 CrocsBaya Clog CLR- Pepper/887350867756 Size M9 W11,FBALYB Amazon,-2,-2,0,0,0,0
,10126-7C1M10W12 CrocsBaya Clog CLR- Lemon/191448441781 Size M10 W12,10126-7C1M10W12 CrocsBaya Clog CLR- Lemon/191448441781 Size M10 W12,FBALYB Amazon,-3,-3,0,0,0,0
,10126-7C1M5W7 CrocsBaya Clog CLR- Lemon/191448441835 Size M5 W7,10126-7C1M5W7 CrocsBaya Clog CLR- Lemon/191448441835 Size M5 W7,FBALYB Amazon,-3,-3,0,0,0,0
,10126-7C1M6W8 CrocsBaya Clog CLR- Lemon/191448441842 Size M6 W8,10126-7C1M6W8 CrocsBaya Clog CLR- Lemon/191448441842 Size M6 W8,FBALYB Amazon,1,1,0,0,0,0
,10126-7C1M7W9 CrocsBaya Clog CLR- Lemon/191448441859 Size M7 W9,10126-7C1M7W9 CrocsBaya Clog CLR- Lemon/191448441859 Size M7 W9,FBALYB Amazon,-2,-2,0,0,0,0
,10126-7C1M8W10 CrocsBaya Clog CLR- Lemon/191448441866 Size M8 W10,10126-7C1M8W10 CrocsBaya Clog CLR- Lemon/191448441866 Size M8 W10,FBALYB Amazon,0,-1,1,0,1,0
,10126-7C1M9W11 CrocsBaya Clog CLR- Lemon/191448441873 Size M9 W11,10126-7C1M9W11 CrocsBaya Clog CLR- Lemon/191448441873 Size M9 W11,FBALYB Amazon,-1,-1,0,0,0,0
,10128-261M12 CrocsMen’s Santa Cruz Slip-On CLR- Khaki/Khaki/883503149861 Size 12,10128-261M12 CrocsMen’s Santa Cruz Slip-On CLR- Khaki/Khaki/883503149861 Size 12,FBALYB Amazon,1,1,0,0,0,0
,"101 MP 2000 0,7 Rondo  4014519270652","101 MP 2000 0,7 Rondo  4014519270652",FBALYB Amazon,-7,-7,0,0,0,0
,1027 Vetericyn + Ear Rinse 3oz,1027 Vetericyn + Ear Rinse 3oz,FBALYB Amazon,2,-1,3,0,3,0
,1027 Vetericyn + Ear Rinse 3oz,1027 Vetericyn + Ear Rinse 3oz,FBALYB Canada,2,2,0,0,0,0
,1037 Vetericyn + Eye Wash 3oz,1037 Vetericyn + Eye Wash 3oz,FBALYB Amazon,1554,1495,59,2,59,0
,1037 Vetericyn + Eye Wash 3oz,1037 Vetericyn + Eye Wash 3oz,FBALYB Canada,-4,-4,0,150,0,0
,1037 Vetericyn + Eye Wash 3oz 3pk,1037 Vetericyn + Eye Wash 3oz 3pk,FBALYB Amazon,66,64,2,0,2,0
,1037 Vetericyn + Eye Wash 3oz 3pk,1037 Vetericyn + Eye Wash 3oz 3pk,FBALYB Canada,0,0,0,15,0,0
,10386-060 CrocsWomen’s Patricia Sandal CLR- Black/Black  Size 11,10386-060 CrocsWomen’s Patricia Sandal CLR- Black/Black  Size 11,FBALYB Amazon,6,6,0,2,0,0
,10386-060W6 CrocsWomen’s Patricia Sandal CLR- Black/Black/883503381223 Size 6,10386-060W6 CrocsWomen’s Patricia Sandal CLR- Black/Black/883503381223 Size 6,Default Ridgefield,15,15,0,0,0,0
,10386-060W6 CrocsWomen’s Patricia Sandal CLR- Black/Black/883503381223 Size 6,10386-060W6 CrocsWomen’s Patricia Sandal CLR- Black/Black/883503381223 Size 6,FBALYB Amazon,-1,-1,0,0,0,0
,10386-060W7 CrocsWomen’s Patricia Sandal CLR- Black/Black/883503381230 Size 7,10386-060W7 CrocsWomen’s Patricia Sandal CLR- Black/Black/883503381230 Size 7,Default Ridgefield,42,42,0,0,0,0
,10386-060W8 CrocsWomen’s Patricia Sandal CLR- Black/Black/883503381247 Size 8,10386-060W8 CrocsWomen’s Patricia Sandal CLR- Black/Black/883503381247 Size 8,Default Ridgefield,138,138,0,0,0,0
,10386-060W8 CrocsWomen’s Patricia Sandal CLR- Black/Black/883503381247 Size 8,10386-060W8 CrocsWomen’s Patricia Sandal CLR- Black/Black/883503381247 Size 8,FBALYB Amazon,-2,-2,0,0,0,0
,10386-060W9 CrocsWomen’s Patricia Sandal CLR- Black/Black/883503381254 Size 9,10386-060W9 CrocsWomen’s Patricia Sandal CLR- Black/Black/883503381254 Size 9,Default Ridgefield,102,102,0,0,0,0
,10386-060W9 CrocsWomen’s Patricia Sandal CLR- Black/Black/883503381254 Size 9,10386-060W9 CrocsWomen’s Patricia Sandal CLR- Black/Black/883503381254 Size 9,FBALYB Amazon,-2,-2,0,0,0,0
,10386-13S CrocsWomen’s Patricia Sandal CLR- Oyster/Gold Size 11,10386-13S CrocsWomen’s Patricia Sandal CLR- Oyster/Gold Size 11,FBALYB Amazon,10,10,0,0,0,0
,10386-13SW10 CrocsWomen’s Patricia Sandal CLR- Oyster/Gold/887350453843 Size 10,10386-13SW10 CrocsWomen’s Patricia Sandal CLR- Oyster/Gold/887350453843 Size 10,Default Ridgefield,10,10,0,0,0,0
,10386-13SW6 CrocsWomen’s Patricia Sandal CLR- Oyster/Gold/887350453805 Size 6,10386-13SW6 CrocsWomen’s Patricia Sandal CLR- Oyster/Gold/887350453805 Size 6,Default Ridgefield,10,10,0,0,0,0
,10386-13SW6 CrocsWomen’s Patricia Sandal CLR- Oyster/Gold/887350453805 Size 6,10386-13SW6 CrocsWomen’s Patricia Sandal CLR- Oyster/Gold/887350453805 Size 6,FBALYB Amazon,-1,-1,0,0,0,0
,10386-13SW7 CrocsWomen’s Patricia Sandal CLR- Oyster/Gold/887350453812 Size 7,10386-13SW7 CrocsWomen’s Patricia Sandal CLR- Oyster/Gold/887350453812 Size 7,Default Ridgefield,10,10,0,0,0,0
,10386-13SW8 CrocsWomen’s Patricia Sandal CLR- Oyster/Gold/887350453829 Size 8,10386-13SW8 CrocsWomen’s Patricia Sandal CLR- Oyster/Gold/887350453829 Size 8,Default Ridgefield,50,50,0,0,0,0
,10386-13SW8 CrocsWomen’s Patricia Sandal CLR- Oyster/Gold/887350453829 Size 8,10386-13SW8 CrocsWomen’s Patricia Sandal CLR- Oyster/Gold/887350453829 Size 8,FBALYB Amazon,-1,-1,0,0,0,0
,10386-13SW9 CrocsWomen’s Patricia Sandal CLR- Oyster/Gold/887350453836 Size 9,10386-13SW9 CrocsWomen’s Patricia Sandal CLR- Oyster/Gold/887350453836 Size 9,Default Ridgefield,20,20,0,0,0,0
,10386-13SW9 CrocsWomen’s Patricia Sandal CLR- Oyster/Gold/887350453836 Size 9,10386-13SW9 CrocsWomen’s Patricia Sandal CLR- Oyster/Gold/887350453836 Size 9,FBALYB Amazon,-2,-2,0,0,0,0
,10386-46U CrocsWomen’s Patricia Sandal CLR- Navy/Smoke Size 11,10386-46U CrocsWomen’s Patricia Sandal CLR- Navy/Smoke Size 11,FBALYB Amazon,10,9,1,0,1,0
,10386-46UW10 CrocsWomen’s Patricia Sandal CLR- Navy/Smoke/191448205970 Size 10,10386-46UW10 CrocsWomen’s Patricia Sandal CLR- Navy/Smoke/191448205970 Size 10,Default Ridgefield,12,12,0,0,0,0
,10386-46UW10 CrocsWomen’s Patricia Sandal CLR- Navy/Smoke/191448205970 Size 10,10386-46UW10 CrocsWomen’s Patricia Sandal CLR- Navy/Smoke/191448205970 Size 10,FBALYB Amazon,1,1,0,0,0,0
,10386-46UW6 CrocsWomen’s Patricia Sandal CLR- Navy/Smoke/191448206014 Size 6,10386-46UW6 CrocsWomen’s Patricia Sandal CLR- Navy/Smoke/191448206014 Size 6,Default Ridgefield,10,10,0,0,0,0
,10386-46UW7 CrocsWomen’s Patricia Sandal CLR- Navy/Smoke/191448206021 Size 7,10386-46UW7 CrocsWomen’s Patricia Sandal CLR- Navy/Smoke/191448206021 Size 7,Default Ridgefield,21,21,0,0,0,0
,10386-46UW7 CrocsWomen’s Patricia Sandal CLR- Navy/Smoke/191448206021 Size 7,10386-46UW7 CrocsWomen’s Patricia Sandal CLR- Navy/Smoke/191448206021 Size 7,FBALYB Amazon,-2,-2,0,0,0,0
,10386-46UW8 CrocsWomen’s Patricia Sandal CLR- Navy/Smoke/191448206038 Size 8,10386-46UW8 CrocsWomen’s Patricia Sandal CLR- Navy/Smoke/191448206038 Size 8,Default Ridgefield,70,70,0,0,0,0
,10386-46UW8 CrocsWomen’s Patricia Sandal CLR- Navy/Smoke/191448206038 Size 8,10386-46UW8 CrocsWomen’s Patricia Sandal CLR- Navy/Smoke/191448206038 Size 8,FBALYB Amazon,-2,-2,0,0,0,0
,10386-46UW9 CrocsWomen’s Patricia Sandal CLR- Navy/Smoke/191448206045 Size 9,10386-46UW9 CrocsWomen’s Patricia Sandal CLR- Navy/Smoke/191448206045 Size 9,Default Ridgefield,50,50,0,0,0,0
,10386-46UW9 CrocsWomen’s Patricia Sandal CLR- Navy/Smoke/191448206045 Size 9,10386-46UW9 CrocsWomen’s Patricia Sandal CLR- Navy/Smoke/191448206045 Size 9,FBALYB Amazon,-1,-1,0,0,0,0
,1042 Vetericyn + Hydrogel Wound / Skin Care 8oz,1042 Vetericyn + Hydrogel Wound / Skin Care 8oz,Default Ridgefield,29,29,0,0,0,0
,1042 Vetericyn + Hydrogel Wound / Skin Care 8oz,1042 Vetericyn + Hydrogel Wound / Skin Care 8oz,FBALYB Amazon,-16,-17,1,0,1,0
,1042 Vetericyn + Hydrogel Wound / Skin Care 8oz,1042 Vetericyn + Hydrogel Wound / Skin Care 8oz,FBALYB Canada,9,9,0,6,0,0
,1047 Vetericyn + Antimicrobial Hydrogel 3oz,1047 Vetericyn + Antimicrobial Hydrogel 3oz,FBALYB Amazon,-6,-6,0,0,0,0
,1047 Vetericyn + Antimicrobial Hydrogel 3oz,1047 Vetericyn + Antimicrobial Hydrogel 3oz,FBALYB Canada,-1,-1,0,0,0,0
,1048 Vetericyn + Hot Spot Antimicrobial Gel 3oz,1048 Vetericyn + Hot Spot Antimicrobial Gel 3oz,Default Ridgefield,12,12,0,0,0,0
,1048 Vetericyn + Hot Spot Antimicrobial Gel 3oz,1048 Vetericyn + Hot Spot Antimicrobial Gel 3oz,FBALYB Canada,-1,-1,0,0,0,0
,1067 Vetericyn + Ophthalmic Gel 3 oz,1067 Vetericyn + Ophthalmic Gel 3 oz,Default,0,-69,69,0,0,0
,1067 Vetericyn + Ophthalmic Gel 3 oz,1067 Vetericyn + Ophthalmic Gel 3 oz,Default Ridgefield,13,13,0,0,0,0
,1067 Vetericyn + Ophthalmic Gel 3 oz,1067 Vetericyn + Ophthalmic Gel 3 oz,FBALYB Amazon,-16,-19,3,0,3,0
,1067 Vetericyn + Ophthalmic Gel 3 oz,1067 Vetericyn + Ophthalmic Gel 3 oz,FBALYB Canada,-1,-1,0,0,0,0
,1100 Vetericyn + Pink Eye Spray 16 oz,1100 Vetericyn + Pink Eye Spray 16 oz,FBALYB Amazon,-8,-8,0,0,0,0
,1100 Vetericyn + Pink Eye Spray 16 oz,1100 Vetericyn + Pink Eye Spray 16 oz,FBALYB Canada,10,10,0,0,0,0
,11016-001M10W12 CrocsCRObandTM Clog CLR- Black/883503475984 Size M10 W12,11016-001M10W12 CrocsCRObandTM Clog CLR- Black/883503475984 Size M10 W12,Default Ridgefield,13,13,0,0,0,0
,11016-001M10W12 CrocsCRObandTM Clog CLR- Black/883503475984 Size M10 W12,11016-001M10W12 CrocsCRObandTM Clog CLR- Black/883503475984 Size M10 W12,FBALYB Amazon,-19,-20,1,18,1,0
,11016-001M11 CrocsCRObandTM Clog CLR- Black/883503475991 Size M11 W13,11016-001M11 CrocsCRObandTM Clog CLR- Black/883503475991 Size M11 W13,Default Ridgefield,1,1,0,0,0,0
,11016-001M11 CrocsCRObandTM Clog CLR- Black/883503475991 Size M11 W13,11016-001M11 CrocsCRObandTM Clog CLR- Black/883503475991 Size M11 W13,FBALYB Amazon,-1,-1,0,0,0,0
,11016-001M12 CrocsCRObandTM Clog CLR- Black/883503476004 Size M12 W14,11016-001M12 CrocsCRObandTM Clog CLR- Black/883503476004 Size M12 W14,FBALYB Amazon,22,22,0,0,0,0
,11016-001M4W6 CrocsCRObandTM Clog CLR- Black/883503475922 Size M4 W6,11016-001M4W6 CrocsCRObandTM Clog CLR- Black/883503475922 Size M4 W6,Default Ridgefield,1,1,0,0,0,0
,11016-001M4W6 CrocsCRObandTM Clog CLR- Black/883503475922 Size M4 W6,11016-001M4W6 CrocsCRObandTM Clog CLR- Black/883503475922 Size M4 W6,FBALYB Amazon,13,12,1,0,1,0
,11016-001M5W7 CrocsCRObandTM Clog CLR- Black/883503475939 Size M5 W7,11016-001M5W7 CrocsCRObandTM Clog CLR- Black/883503475939 Size M5 W7,FBALYB Amazon,54,53,1,0,1,0
,11016-001M6W8 CrocsCRObandTM Clog CLR- Black/883503475946 Size M6 W8,11016-001M6W8 CrocsCRObandTM Clog CLR- Black/883503475946 Size M6 W8,Default Ridgefield,71,71,0,0,0,0
,11016-001M6W8 CrocsCRObandTM Clog CLR- Black/883503475946 Size M6 W8,11016-001M6W8 CrocsCRObandTM Clog CLR- Black/883503475946 Size M6 W8,FBALYB Amazon,-42,-42,0,36,0,0
,11016-001M7W9 CrocsCRObandTM Clog CLR- Black/883503475953 Size M7 W9,11016-001M7W9 CrocsCRObandTM Clog CLR- Black/883503475953 Size M7 W9,FBALYB Amazon,87,83,4,1,4,0
,11016-001M8W10 CrocsCRObandTM Clog CLR- Black/883503475960 Size M8 W10,11016-001M8W10 CrocsCRObandTM Clog CLR- Black/883503475960 Size M8 W10,Default Ridgefield,80,80,0,0,0,0
,11016-001M8W10 CrocsCRObandTM Clog CLR- Black/883503475960 Size M8 W10,11016-001M8W10 CrocsCRObandTM Clog CLR- Black/883503475960 Size M8 W10,FBALYB Amazon,-8,-8,0,0,0,0
,11016-001M9W11 CrocsCRObandTM Clog CLR- Black/883503475977 Size M9 W11,11016-001M9W11 CrocsCRObandTM Clog CLR- Black/883503475977 Size M9 W11,Default Ridgefield,3,3,0,0,0,0
,11016-001M9W11 CrocsCRObandTM Clog CLR- Black/883503475977 Size M9 W11,11016-001M9W11 CrocsCRObandTM Clog CLR- Black/883503475977 Size M9 W11,FBALYB Amazon,46,44,2,36,2,0
,11016-01UM10W12 CrocsCRObandTM Clog CLR- Light Grey/Navy/887350868951 Size M10 W12,11016-01UM10W12 CrocsCRObandTM Clog CLR- Light Grey/Navy/887350868951 Size M10 W12,FBALYB Amazon,-4,-4,0,0,0,0
,11016-01UM11 CrocsCRObandTM Clog CLR- Light Grey/Navy/887350868968 Size M11 W13,11016-01UM11 CrocsCRObandTM Clog CLR- Light Grey/Navy/887350868968 Size M11 W13,FBALYB Amazon,-2,-2,0,0,0,0
,11016-01UM5W7 CrocsCRObandTM Clog CLR- Light Grey/Navy/887350869002 Size M5 W7,11016-01UM5W7 CrocsCRObandTM Clog CLR- Light Grey/Navy/887350869002 Size M5 W7,FBALYB Amazon,-2,-2,0,0,0,0
,11016-01UM6W8 CrocsCRObandTM Clog CLR- Light Grey/Navy/887350869019 Size M6 W8,11016-01UM6W8 CrocsCRObandTM Clog CLR- Light Grey/Navy/887350869019 Size M6 W8,FBALYB Amazon,-4,-4,0,0,0,0
,11016-01UM7W9 CrocsCRObandTM Clog CLR- Light Grey/Navy/887350869026 Size M7 W9,11016-01UM7W9 CrocsCRObandTM Clog CLR- Light Grey/Navy/887350869026 Size M7 W9,FBALYB Amazon,4,4,0,0,0,0
,11016-01UM8W10 CrocsCRObandTM Clog CLR- Light Grey/Navy/887350869033 Size M8 W10,11016-01UM8W10 CrocsCRObandTM Clog CLR- Light Grey/Navy/887350869033 Size M8 W10,FBALYB Amazon,-2,-2,0,0,0,0
,11016-01UM9W11 CrocsCRObandTM Clog CLR- Light Grey/Navy/887350869040 Size M9 W11,11016-01UM9W11 CrocsCRObandTM Clog CLR- Light Grey/Navy/887350869040 Size M9 W11,FBALYB Amazon,-2,-2,0,0,0,0
,11016-07WM10W12 CrocsCRObandTM Clog CLR- Charcoal/Ocean/883503836877 Size M10 W12,11016-07WM10W12 CrocsCRObandTM Clog CLR- Charcoal/Ocean/883503836877 Size M10 W12,Default Ridgefield,1,1,0,0,0,0
,11016-07WM10W12 CrocsCRObandTM Clog CLR- Charcoal/Ocean/883503836877 Size M10 W12,11016-07WM10W12 CrocsCRObandTM Clog CLR- Charcoal/Ocean/883503836877 Size M10 W12,FBALYB Amazon,15,15,0,0,0,0
,11016-07WM11 CrocsCRObandTM Clog CLR- Charcoal/Ocean/883503836884 Size M11 W13,11016-07WM11 CrocsCRObandTM Clog CLR- Charcoal/Ocean/883503836884 Size M11 W13,FBALYB Amazon,3,-1,4,0,4,0
,11016-07WM12 CrocsCRObandTM Clog CLR- Charcoal/Ocean/883503836891 Size M12 W14,11016-07WM12 CrocsCRObandTM Clog CLR- Charcoal/Ocean/883503836891 Size M12 W14,FBALYB Amazon,1,1,0,0,0,0
,11016-07WM4W6 CrocsCRObandTM Clog CLR- Charcoal/Ocean/883503836815 Size M4 W6,11016-07WM4W6 CrocsCRObandTM Clog CLR- Charcoal/Ocean/883503836815 Size M4 W6,FBALYB Amazon,14,13,1,0,1,0
,11016-07WM5W7 CrocsCRObandTM Clog CLR- Charcoal/Ocean/883503836822 Size M5 W7,11016-07WM5W7 CrocsCRObandTM Clog CLR- Charcoal/Ocean/883503836822 Size M5 W7,FBALYB Amazon,31,31,0,0,0,0
,11016-07WM6W8 CrocsCRObandTM Clog CLR- Charcoal/Ocean/883503836839 Size M6 W8,11016-07WM6W8 CrocsCRObandTM Clog CLR- Charcoal/Ocean/883503836839 Size M6 W8,FBALYB Amazon,2,1,1,0,1,0
,11016-07WM7W9 CrocsCRObandTM Clog CLR- Charcoal/Ocean/883503836846 Size M7 W9,11016-07WM7W9 CrocsCRObandTM Clog CLR- Charcoal/Ocean/883503836846 Size M7 W9,Default Ridgefield,36,36,0,0,0,0
,11016-07WM7W9 CrocsCRObandTM Clog CLR- Charcoal/Ocean/883503836846 Size M7 W9,11016-07WM7W9 CrocsCRObandTM Clog CLR- Charcoal/Ocean/883503836846 Size M7 W9,FBALYB Amazon,18,18,0,0,0,0
,11016-07WM9W11 CrocsCRObandTM Clog CLR- Charcoal/Ocean/883503836860 Size M9 W11,11016-07WM9W11 CrocsCRObandTM Clog CLR- Charcoal/Ocean/883503836860 Size M9 W11,Default Ridgefield,1,1,0,0,0,0
,11016-07WM9W11 CrocsCRObandTM Clog CLR- Charcoal/Ocean/883503836860 Size M9 W11,11016-07WM9W11 CrocsCRObandTM Clog CLR- Charcoal/Ocean/883503836860 Size M9 W11,FBALYB Amazon,7,7,0,0,0,0
,11016-100M10W12 CrocsCRObandTM Clog CLR- White/883503476073 Size M10 W12,11016-100M10W12 CrocsCRObandTM Clog CLR- White/883503476073 Size M10 W12,FBALYB Amazon,36,36,0,0,0,0
,11016-100M11 CrocsCRObandTM Clog CLR- White/883503476080 Size M11 W13,11016-100M11 CrocsCRObandTM Clog CLR- White/883503476080 Size M11 W13,FBALYB Amazon,26,25,1,0,1,0
,11016-100M12 CrocsCRObandTM Clog CLR- White/883503476097 Size M12 W14,11016-100M12 CrocsCRObandTM Clog CLR- White/883503476097 Size M12 W14,FBALYB Amazon,22,20,2,0,2,0
,11016-100M4W6 CrocsCRObandTM Clog CLR- White/883503476011 Size M4 W6,11016-100M4W6 CrocsCRObandTM Clog CLR- White/883503476011 Size M4 W6,Default Ridgefield,0,0,0,0,0,131
,11016-100M4W6 CrocsCRObandTM Clog CLR- White/883503476011 Size M4 W6,11016-100M4W6 CrocsCRObandTM Clog CLR- White/883503476011 Size M4 W6,FBALYB Amazon,33,33,0,0,0,0
,11016-100M5W7 CrocsCRObandTM Clog CLR- White/883503476028 Size M5 W7,11016-100M5W7 CrocsCRObandTM Clog CLR- White/883503476028 Size M5 W7,Default Ridgefield,0,0,0,0,0,191
,11016-100M5W7 CrocsCRObandTM Clog CLR- White/883503476028 Size M5 W7,11016-100M5W7 CrocsCRObandTM Clog CLR- White/883503476028 Size M5 W7,FBALYB Amazon,58,58,0,0,0,0
,11016-100M6W8 CrocsCRObandTM Clog CLR- White/883503476035 Size M6 W8,11016-100M6W8 CrocsCRObandTM Clog CLR- White/883503476035 Size M6 W8,Default Ridgefield,13,13,0,0,0,95
,11016-100M6W8 CrocsCRObandTM Clog CLR- White/883503476035 Size M6 W8,11016-100M6W8 CrocsCRObandTM Clog CLR- White/883503476035 Size M6 W8,FBALYB Amazon,24,24,0,1,0,0
,11016-100M7W9 CrocsCRObandTM Clog CLR- White/883503476042 Size M7 W9,11016-100M7W9 CrocsCRObandTM Clog CLR- White/883503476042 Size M7 W9,Default Ridgefield,1,1,0,0,0,12
,11016-100M7W9 CrocsCRObandTM Clog CLR- White/883503476042 Size M7 W9,11016-100M7W9 CrocsCRObandTM Clog CLR- White/883503476042 Size M7 W9,FBALYB Amazon,46,44,2,0,2,0
,11016-100M8W10 CrocsCRObandTM Clog CLR- White/883503476059 SIze M8 W10,11016-100M8W10 CrocsCRObandTM Clog CLR- White/883503476059 SIze M8 W10,Default Ridgefield,0,0,0,0,0,12
,11016-100M8W10 CrocsCRObandTM Clog CLR- White/883503476059 SIze M8 W10,11016-100M8W10 CrocsCRObandTM Clog CLR- White/883503476059 SIze M8 W10,FBALYB Amazon,47,44,3,0,3,0
,11016-100M9W11 CrocsCRObandTM Clog CLR- White/883503476066 Size M9 W11,11016-100M9W11 CrocsCRObandTM Clog CLR- White/883503476066 Size M9 W11,Default Ridgefield,0,0,0,0,0,24
,11016-100M9W11 CrocsCRObandTM Clog CLR- White/883503476066 Size M9 W11,11016-100M9W11 CrocsCRObandTM Clog CLR- White/883503476066 Size M9 W11,FBALYB Amazon,58,57,1,0,1,0
,11016-11IM10W12 CrocsCRObandTM Clog CLR- White/Blue Jean/191448103061 Size M10 W12,11016-11IM10W12 CrocsCRObandTM Clog CLR- White/Blue Jean/191448103061 Size M10 W12,FBALYB Amazon,-1,-1,0,0,0,0
,11016-11IM11 CrocsCRObandTM Clog CLR- White/Blue Jean/191448103078 Size M11 W13,11016-11IM11 CrocsCRObandTM Clog CLR- White/Blue Jean/191448103078 Size M11 W13,FBALYB Amazon,-1,-1,0,0,0,0
,11016-11IM12 CrocsCRObandTM Clog CLR- White/Blue Jean/191448103085 Size M12 W14,11016-11IM12 CrocsCRObandTM Clog CLR- White/Blue Jean/191448103085 Size M12 W14,FBALYB Amazon,-1,-1,0,0,0,0
,11016-11IM4W6 CrocsCRObandTM Clog CLR- White/Blue Jean/191448103108 Size M4 W6,11016-11IM4W6 CrocsCRObandTM Clog CLR- White/Blue Jean/191448103108 Size M4 W6,FBALYB Amazon,0,-1,1,0,1,0
,11016-11IM5W7 CrocsCRObandTM Clog CLR- White/Blue Jean/191448103115 Size M5 W7,11016-11IM5W7 CrocsCRObandTM Clog CLR- White/Blue Jean/191448103115 Size M5 W7,FBALYB Amazon,-2,-2,0,0,0,0
,11016-11IM6W8 CrocsCRObandTM Clog CLR- White/Blue Jean/191448103122 Size M6 W8,11016-11IM6W8 CrocsCRObandTM Clog CLR- White/Blue Jean/191448103122 Size M6 W8,FBALYB Amazon,-2,-3,1,0,1,0
,11016-11IM7W9 CrocsCRObandTM Clog CLR- White/Blue Jean/191448103139 Size M7 W9,11016-11IM7W9 CrocsCRObandTM Clog CLR- White/Blue Jean/191448103139 Size M7 W9,FBALYB Amazon,3,1,2,0,2,0
,11016-11IM8W10 CrocsCRObandTM Clog CLR- White/Blue Jean/191448103146 Size M8 W10,11016-11IM8W10 CrocsCRObandTM Clog CLR- White/Blue Jean/191448103146 Size M8 W10,FBALYB Amazon,1,1,0,0,0,0
,11016-11IM9W11 CrocsCRObandTM Clog CLR- White/Blue Jean/191448103153 Size M9 W11,11016-11IM9W11 CrocsCRObandTM Clog CLR- White/Blue Jean/191448103153 Size M9 W11,FBALYB Amazon,-3,-3,0,0,0,0
,11016-1ASM10W12 CrocsCRObandTM Clog CLR- Stucco/Melon/887350869354 Size M10 W12,11016-1ASM10W12 CrocsCRObandTM Clog CLR- Stucco/Melon/887350869354 Size M10 W12,FBALYB Amazon,-1,-1,0,0,0,0
,11016-1ASM12 CrocsCRObandTM Clog CLR- Stucco/Melon/887350869378 Size M12 W14,11016-1ASM12 CrocsCRObandTM Clog CLR- Stucco/Melon/887350869378 Size M12 W14,FBALYB Amazon,4,4,0,0,0,0
,11016-1ASM4W6 CrocsCRObandTM Clog CLR- Stucco/Melon/887350869392 Size M4 W6,11016-1ASM4W6 CrocsCRObandTM Clog CLR- Stucco/Melon/887350869392 Size M4 W6,Default Ridgefield,0,0,0,0,0,803
,11016-1ASM5W7 CrocsCRObandTM Clog CLR- Stucco/Melon/887350869408 Size M5 W7,11016-1ASM5W7 CrocsCRObandTM Clog CLR- Stucco/Melon/887350869408 Size M5 W7,Default,0,0,0,0,0,7
,11016-1ASM5W7 CrocsCRObandTM Clog CLR- Stucco/Melon/887350869408 Size M5 W7,11016-1ASM5W7 CrocsCRObandTM Clog CLR- Stucco/Melon/887350869408 Size M5 W7,Default Ridgefield,0,0,0,0,0,1535
,11016-1ASM5W7 CrocsCRObandTM Clog CLR- Stucco/Melon/887350869408 Size M5 W7,11016-1ASM5W7 CrocsCRObandTM Clog CLR- Stucco/Melon/887350869408 Size M5 W7,FBALYB Amazon,-2,-2,0,0,0,0
,11016-1ASM6W8 CrocsCRObandTM Clog CLR- Stucco/Melon/887350869415 Size M6 W8,11016-1ASM6W8 CrocsCRObandTM Clog CLR- Stucco/Melon/887350869415 Size M6 W8,Default Ridgefield,0,0,0,0,0,923
,11016-1ASM6W8 CrocsCRObandTM Clog CLR- Stucco/Melon/887350869415 Size M6 W8,11016-1ASM6W8 CrocsCRObandTM Clog CLR- Stucco/Melon/887350869415 Size M6 W8,FBALYB Amazon,2,2,0,0,0,0
,11016-1ASM7W9 CrocsCRObandTM Clog CLR- Stucco/Melon/887350869422 Size M7 W9,11016-1ASM7W9 CrocsCRObandTM Clog CLR- Stucco/Melon/887350869422 Size M7 W9,Default Ridgefield,0,0,0,0,0,191
,11016-1ASM7W9 CrocsCRObandTM Clog CLR- Stucco/Melon/887350869422 Size M7 W9,11016-1ASM7W9 CrocsCRObandTM Clog CLR- Stucco/Melon/887350869422 Size M7 W9,FBALYB Amazon,-4,-4,0,0,0,0
,11016-1ASM8W10 CrocsCRObandTM Clog CLR- Stucco/Melon/887350869439 Size M8 W10,11016-1ASM8W10 CrocsCRObandTM Clog CLR- Stucco/Melon/887350869439 Size M8 W10,Default Ridgefield,0,0,0,0,0,35
,11016-1ASM8W10 CrocsCRObandTM Clog CLR- Stucco/Melon/887350869439 Size M8 W10,11016-1ASM8W10 CrocsCRObandTM Clog CLR- Stucco/Melon/887350869439 Size M8 W10,FBALYB Amazon,-3,-3,0,0,0,0
,11016-1ASM9W11 CrocsCRObandTM Clog CLR- Stucco/Melon/887350869446 Size M9 W11,11016-1ASM9W11 CrocsCRObandTM Clog CLR- Stucco/Melon/887350869446 Size M9 W11,Default Ridgefield,0,0,0,0,0,23
,11016-1ASM9W11 CrocsCRObandTM Clog CLR- Stucco/Melon/887350869446 Size M9 W11,11016-1ASM9W11 CrocsCRObandTM Clog CLR- Stucco/Melon/887350869446 Size M9 W11,FBALYB Amazon,18,18,0,0,0,0
,11016-40IM10W12 CrocsCRObandTM Clog CLR- Navy/Volt Green/Lemon/887350935202 Size M10 W12,11016-40IM10W12 CrocsCRObandTM Clog CLR- Navy/Volt Green/Lemon/887350935202 Size M10 W12,FBALYB Amazon,-19,-19,0,18,0,0
,11016-40IM11 CrocsCRObandTM Clog CLR- Navy/Volt Green/Lemon/887350935219 Size M11 W13,11016-40IM11 CrocsCRObandTM Clog CLR- Navy/Volt Green/Lemon/887350935219 Size M11 W13,Default Ridgefield,1,1,0,0,0,0
,11016-40IM11 CrocsCRObandTM Clog CLR- Navy/Volt Green/Lemon/887350935219 Size M11 W13,11016-40IM11 CrocsCRObandTM Clog CLR- Navy/Volt Green/Lemon/887350935219 Size M11 W13,FBALYB Amazon,0,0,0,17,0,0
,11016-40IM12 CrocsCRObandTM Clog CLR- Navy/Volt Green/Lemon/887350935226 Size M12 W14,11016-40IM12 CrocsCRObandTM Clog CLR- Navy/Volt Green/Lemon/887350935226 Size M12 W14,FBALYB Amazon,1,-1,2,0,2,0
,11016-40IM4W6 CrocsCRObandTM Clog CLR- Navy/Volt Green/Lemon/887350935240 Size M4 W6,11016-40IM4W6 CrocsCRObandTM Clog CLR- Navy/Volt Green/Lemon/887350935240 Size M4 W6,FBALYB Amazon,6,6,0,12,0,0
,11016-40IM5W7 CrocsCRObandTM Clog CLR- Navy/Volt Green/Lemon/887350935257 Size M5 W7,11016-40IM5W7 CrocsCRObandTM Clog CLR- Navy/Volt Green/Lemon/887350935257 Size M5 W7,FBALYB Amazon,16,15,1,0,1,0
,11016-40IM6W8 CrocsCRObandTM Clog CLR- Navy/Volt Green/Lemon/887350935264 Size M6 W8,11016-40IM6W8 CrocsCRObandTM Clog CLR- Navy/Volt Green/Lemon/887350935264 Size M6 W8,FBALYB Amazon,-27,-31,4,36,4,0
,11016-40IM7W9 CrocsCRObandTM Clog CLR- Navy/Volt Green/Lemon/887350935271 Size M7 W9,11016-40IM7W9 CrocsCRObandTM Clog CLR- Navy/Volt Green/Lemon/887350935271 Size M7 W9,Default,0,0,0,0,0,6
,11016-40IM7W9 CrocsCRObandTM Clog CLR- Navy/Volt Green/Lemon/887350935271 Size M7 W9,11016-40IM7W9 CrocsCRObandTM Clog CLR- Navy/Volt Green/Lemon/887350935271 Size M7 W9,FBALYB Amazon,9,6,3,0,3,0
,11016-40IM8W10 CrocsCRObandTM Clog CLR- Navy/Volt Green/Lemon/887350935288 Size M8 W10,11016-40IM8W10 CrocsCRObandTM Clog CLR- Navy/Volt Green/Lemon/887350935288 Size M8 W10,FBALYB Amazon,6,6,0,0,0,0
,11016-40IM9W11 CrocsCRObandTM Clog CLR- Navy/Volt Green/Lemon/887350935295 Size M9 W11,11016-40IM9W11 CrocsCRObandTM Clog CLR- Navy/Volt Green/Lemon/887350935295 Size M9 W11,FBALYB Amazon,23,21,2,0,2,0
,11016-410M10W12 CrocsCRObandTM Clog CLR- Navy/883503476257 Size M10 W12,11016-410M10W12 CrocsCRObandTM Clog CLR- Navy/883503476257 Size M10 W12,Default Ridgefield,2,2,0,0,0,0
,11016-410M10W12 CrocsCRObandTM Clog CLR- Navy/883503476257 Size M10 W12,11016-410M10W12 CrocsCRObandTM Clog CLR- Navy/883503476257 Size M10 W12,FBALYB Amazon,78,76,2,0,2,0
,11016-410M11 CrocsCRObandTM Clog CLR- Navy/883503476264 Size M11 W13,11016-410M11 CrocsCRObandTM Clog CLR- Navy/883503476264 Size M11 W13,Default Ridgefield,1,1,0,0,0,0
,11016-410M11 CrocsCRObandTM Clog CLR- Navy/883503476264 Size M11 W13,11016-410M11 CrocsCRObandTM Clog CLR- Navy/883503476264 Size M11 W13,FBALYB Amazon,70,69,1,0,1,0
,11016-410M12 CrocsCRObandTM Clog CLR- Navy/883503476271 Size M12 W14,11016-410M12 CrocsCRObandTM Clog CLR- Navy/883503476271 Size M12 W14,FBALYB Amazon,26,26,0,0,0,0
,11016-410M4W6 CrocsCRObandTM Clog CLR- Navy/883503476196 Size M4 W6,11016-410M4W6 CrocsCRObandTM Clog CLR- Navy/883503476196 Size M4 W6,FBALYB Amazon,51,51,0,0,0,0
,11016-410M5W7 CrocsCRObandTM Clog CLR- Navy/883503476202 Size M5 W7,11016-410M5W7 CrocsCRObandTM Clog CLR- Navy/883503476202 Size M5 W7,FBALYB Amazon,131,130,1,0,1,0
,11016-410M6W8 CrocsCRObandTM Clog CLR- Navy/883503476219 Size M6 W8,11016-410M6W8 CrocsCRObandTM Clog CLR- Navy/883503476219 Size M6 W8,FBALYB Amazon,41,34,7,0,7,0
,11016-410M7W9 CrocsCRObandTM Clog CLR- Navy/883503476226 Size M7 W9,11016-410M7W9 CrocsCRObandTM Clog CLR- Navy/883503476226 Size M7 W9,Default Ridgefield,32,32,0,0,0,0
,11016-410M7W9 CrocsCRObandTM Clog CLR- Navy/883503476226 Size M7 W9,11016-410M7W9 CrocsCRObandTM Clog CLR- Navy/883503476226 Size M7 W9,FBALYB Amazon,88,84,4,0,4,0
,11016-410M8W10 CrocsCRObandTM Clog CLR- Navy/883503476233 Size M8 W10,11016-410M8W10 CrocsCRObandTM Clog CLR- Navy/883503476233 Size M8 W10,FBALYB Amazon,120,118,2,0,2,0
,11016-410M9W11 CrocsCRObandTM Clog CLR- Navy/883503476240 Size M9 W11,11016-410M9W11 CrocsCRObandTM Clog CLR- Navy/883503476240 Size M9 W11,Default Ridgefield,4,4,0,0,0,0
,11016-410M9W11 CrocsCRObandTM Clog CLR- Navy/883503476240 Size M9 W11,11016-410M9W11 CrocsCRObandTM Clog CLR- Navy/883503476240 Size M9 W11,FBALYB Amazon,154,154,0,0,0,0
,11016-4JNM10W12 CrocsCRObandTM Clog CLR- Bright Cobalt/Charcoal/191448384262 Size M10 W12,11016-4JNM10W12 CrocsCRObandTM Clog CLR- Bright Cobalt/Charcoal/191448384262 Size M10 W12,Default,0,0,0,0,0,1
,11016-4JNM10W12 CrocsCRObandTM Clog CLR- Bright Cobalt/Charcoal/191448384262 Size M10 W12,11016-4JNM10W12 CrocsCRObandTM Clog CLR- Bright Cobalt/Charcoal/191448384262 Size M10 W12,Default Ridgefield,-1,-1,0,0,0,0
,11016-4JNM10W12 CrocsCRObandTM Clog CLR- Bright Cobalt/Charcoal/191448384262 Size M10 W12,11016-4JNM10W12 CrocsCRObandTM Clog CLR- Bright Cobalt/Charcoal/191448384262 Size M10 W12,FBALYB Amazon,-1,-1,0,0,0,0
,11016-4JNM11 CrocsCRObandTM Clog CLR- Bright Cobalt/Charcoal/191448384279 Size M11 W13,11016-4JNM11 CrocsCRObandTM Clog CLR- Bright Cobalt/Charcoal/191448384279 Size M11 W13,Default Ridgefield,1,1,0,0,0,0
,11016-4JNM11 CrocsCRObandTM Clog CLR- Bright Cobalt/Charcoal/191448384279 Size M11 W13,11016-4JNM11 CrocsCRObandTM Clog CLR- Bright Cobalt/Charcoal/191448384279 Size M11 W13,FBALYB Amazon,2,1,1,0,1,0
,11016-4JNM4W6 CrocsCRObandTM Clog CLR- Bright Cobalt/Charcoal/191448384309 Size M4 W6,11016-4JNM4W6 CrocsCRObandTM Clog CLR- Bright Cobalt/Charcoal/191448384309 Size M4 W6,FBALYB Amazon,-1,-1,0,0,0,0
,11016-4JNM5W7 CrocsCRObandTM Clog CLR- Bright Cobalt/Charcoal/191448384316 Size M5 W7,11016-4JNM5W7 CrocsCRObandTM Clog CLR- Bright Cobalt/Charcoal/191448384316 Size M5 W7,FBALYB Amazon,-3,-4,1,0,1,0
,11016-4JNM6W8 CrocsCRObandTM Clog CLR- Bright Cobalt/Charcoal/191448384323 Size M6 W8,11016-4JNM6W8 CrocsCRObandTM Clog CLR- Bright Cobalt/Charcoal/191448384323 Size M6 W8,FBALYB Amazon,-3,-4,1,0,1,0
,11016-4JNM7W9 CrocsCRObandTM Clog CLR- Bright Cobalt/Charcoal/191448384330 Size M7 W9,11016-4JNM7W9 CrocsCRObandTM Clog CLR- Bright Cobalt/Charcoal/191448384330 Size M7 W9,FBALYB Amazon,-7,-7,0,0,0,0
,11016-4JNM8W10 CrocsCRObandTM Clog CLR- Bright Cobalt/Charcoal/191448384347 Size M8 W10,11016-4JNM8W10 CrocsCRObandTM Clog CLR- Bright Cobalt/Charcoal/191448384347 Size M8 W10,FBALYB Amazon,-2,-2,0,0,0,0
,11016-4JNM9W11 CrocsCRObandTM Clog CLR- Bright Cobalt/Charcoal/191448384354 Size M9 W11,11016-4JNM9W11 CrocsCRObandTM Clog CLR- Bright Cobalt/Charcoal/191448384354 Size M9 W11,FBALYB Amazon,-1,-1,0,0,0,0
,11016-4SLM10W12 CrocsCRObandTM Clog CLR- Digital Aqua/191448653252 Size M10 W12,11016-4SLM10W12 CrocsCRObandTM Clog CLR- Digital Aqua/191448653252 Size M10 W12,FBALYB Amazon,3,3,0,0,0,0
,11016-4SLM11 CrocsCRObandTM Clog CLR- Digital Aqua/191448653269 Size M11 W13,11016-4SLM11 CrocsCRObandTM Clog CLR- Digital Aqua/191448653269 Size M11 W13,FBALYB Amazon,5,5,0,0,0,0
,11016-4SLM12 CrocsCRObandTM Clog CLR- Digital Aqua/191448653276 Size M12 W14,11016-4SLM12 CrocsCRObandTM Clog CLR- Digital Aqua/191448653276 Size M12 W14,FBALYB Amazon,3,3,0,0,0,0
,11016-4SLM5W7 CrocsCRObandTM Clog CLR- Digital Aqua/191448653306 Size M5 W7,11016-4SLM5W7 CrocsCRObandTM Clog CLR- Digital Aqua/191448653306 Size M5 W7,FBALYB Amazon,-1,-1,0,0,0,0
,11016-4SLM6W8 CrocsCRObandTM Clog CLR- Digital Aqua/191448653313 Size M6 W8,11016-4SLM6W8 CrocsCRObandTM Clog CLR- Digital Aqua/191448653313 Size M6 W8,Default Ridgefield,1,1,0,0,0,0
,11016-4SLM6W8 CrocsCRObandTM Clog CLR- Digital Aqua/191448653313 Size M6 W8,11016-4SLM6W8 CrocsCRObandTM Clog CLR- Digital Aqua/191448653313 Size M6 W8,FBALYB Amazon,-5,-5,0,0,0,0
,11016-4SLM7W9 CrocsCRObandTM Clog CLR- Digital Aqua/191448653320 Size M7 W9,11016-4SLM7W9 CrocsCRObandTM Clog CLR- Digital Aqua/191448653320 Size M7 W9,FBALYB Amazon,-3,-3,0,0,0,0
,11016-4SLM8W10 CrocsCRObandTM Clog CLR- Digital Aqua/191448653337 Size M8 W10,11016-4SLM8W10 CrocsCRObandTM Clog CLR- Digital Aqua/191448653337 Size M8 W10,FBALYB Amazon,7,5,2,0,2,0
,11016-4SLM9W11 CrocsCRObandTM Clog CLR- Digital Aqua/191448653344 Size M9 W11,11016-4SLM9W11 CrocsCRObandTM Clog CLR- Digital Aqua/191448653344 Size M9 W11,FBALYB Amazon,8,6,2,0,2,0
,11016-50Q Crocs Crocband™ Clog Lavender/Purple US Size M5/ W7,11016-50Q Crocs Crocband™ Clog Lavender/Purple US Size M5/ W7,FBALYB Amazon,0,0,0,10,0,0
,11016-50Q Crocs Crocband™ Clog Lavender/Purple US Size M6/ W8,11016-50Q Crocs Crocband™ Clog Lavender/Purple US Size M6/ W8,FBALYB Amazon,0,0,0,10,0,0
,11016-50Q Crocs Crocband™ Clog Lavender/Purple US Size M7/ W9,11016-50Q Crocs Crocband™ Clog Lavender/Purple US Size M7/ W9,FBALYB Amazon,0,0,0,10,0,0
,11016-50Q Crocs Crocband™ Clog Lavender/Purple US Size M8/ W10,11016-50Q Crocs Crocband™ Clog Lavender/Purple US Size M8/ W10,Default Ridgefield,2,2,0,0,0,0
,11016-50Q Crocs Crocband™ Clog Lavender/Purple US Size M8/ W10,11016-50Q Crocs Crocband™ Clog Lavender/Purple US Size M8/ W10,FBALYB Amazon,8,8,0,0,0,0
,11016-50Q Crocs Crocband™ Clog Lavender/Purple US Size M9/ W11,11016-50Q Crocs Crocband™ Clog Lavender/Purple US Size M9/ W11,FBALYB Amazon,10,9,1,0,1,0
,11016-54RM4W6 CrocsCRObandTM Clog CLR- Viola/191448653450 Size M4 W6,11016-54RM4W6 CrocsCRObandTM Clog CLR- Viola/191448653450 Size M4 W6,Default Ridgefield,0,-6,6,0,0,0
,11016-54RM4W6 CrocsCRObandTM Clog CLR- Viola/191448653450 Size M4 W6,11016-54RM4W6 CrocsCRObandTM Clog CLR- Viola/191448653450 Size M4 W6,FBALYB Amazon,-1,-1,0,0,0,0
,11016-54RM5W7 CrocsCRObandTM Clog CLR- Viola/191448653467 Size M5 W7,11016-54RM5W7 CrocsCRObandTM Clog CLR- Viola/191448653467 Size M5 W7,FBALYB Amazon,1,1,0,0,0,0
,11016-54RM6W8 CrocsCRObandTM Clog CLR- Viola/191448653474 Size M6 W8,11016-54RM6W8 CrocsCRObandTM Clog CLR- Viola/191448653474 Size M6 W8,FBALYB Amazon,-3,-3,0,0,0,0
,11016-54RM7W9 CrocsCRObandTM Clog CLR- Viola/191448653481 Size M7 W9,11016-54RM7W9 CrocsCRObandTM Clog CLR- Viola/191448653481 Size M7 W9,Default Ridgefield,0,-18,18,0,0,0
,11016-54RM7W9 CrocsCRObandTM Clog CLR- Viola/191448653481 Size M7 W9,11016-54RM7W9 CrocsCRObandTM Clog CLR- Viola/191448653481 Size M7 W9,FBALYB Amazon,-1,-1,0,0,0,0
,11016-54RM8W10 CrocsCRObandTM Clog CLR- Viola/191448653498 Size M8 W10,11016-54RM8W10 CrocsCRObandTM Clog CLR- Viola/191448653498 Size M8 W10,Default Ridgefield,0,-18,18,0,0,0
,11016-54RM8W10 CrocsCRObandTM Clog CLR- Viola/191448653498 Size M8 W10,11016-54RM8W10 CrocsCRObandTM Clog CLR- Viola/191448653498 Size M8 W10,FBALYB Amazon,-1,-1,0,0,0,0
,11016-54RM9W11 CrocsCRObandTM Clog CLR- Viola/191448653504 Size M9 W11,11016-54RM9W11 CrocsCRObandTM Clog CLR- Viola/191448653504 Size M9 W11,FBALYB Amazon,6,6,0,0,0,0
,11016-62PM5W7 CrocsCRObandTM Clog CLR- Pink Lemonade/White/191448384798 Size M5 W7,11016-62PM5W7 CrocsCRObandTM Clog CLR- Pink Lemonade/White/191448384798 Size M5 W7,FBALYB Amazon,0,-1,1,0,1,0
,11016-62PM6W8 CrocsCRObandTM Clog CLR- Pink Lemonade/White/191448384804 Size M6 W8,11016-62PM6W8 CrocsCRObandTM Clog CLR- Pink Lemonade/White/191448384804 Size M6 W8,Default Ridgefield,1,1,0,0,0,0
,11016-62PM6W8 CrocsCRObandTM Clog CLR- Pink Lemonade/White/191448384804 Size M6 W8,11016-62PM6W8 CrocsCRObandTM Clog CLR- Pink Lemonade/White/191448384804 Size M6 W8,FBALYB Amazon,-2,-2,0,0,0,0
,11016-62PM7W9 CrocsCRObandTM Clog CLR- Pink Lemonade/White/191448384811 Size M7 W9,11016-62PM7W9 CrocsCRObandTM Clog CLR- Pink Lemonade/White/191448384811 Size M7 W9,FBALYB Amazon,-3,-3,0,0,0,0
,11016-62PM8W10 CrocsCRObandTM Clog CLR- Pink Lemonade/White/191448384828 Size M8 W10,11016-62PM8W10 CrocsCRObandTM Clog CLR- Pink Lemonade/White/191448384828 Size M8 W10,FBALYB Amazon,-1,-1,0,0,0,0
,11016-62PM9W11 CrocsCRObandTM Clog CLR- Pink Lemonade/White/191448384835 Size M9 W11,11016-62PM9W11 CrocsCRObandTM Clog CLR- Pink Lemonade/White/191448384835 Size M9 W11,FBALYB Amazon,-3,-3,0,0,0,0
,11016-6ENM10W12 CrocsCRObandTM Clog CLR- Pepper/887350870152 Size M10 W12,11016-6ENM10W12 CrocsCRObandTM Clog CLR- Pepper/887350870152 Size M10 W12,FBALYB Amazon,1,1,0,0,0,0
,11016-6ENM11 CrocsCRObandTM Clog CLR- Pepper/887350870169 Size M11 W13,11016-6ENM11 CrocsCRObandTM Clog CLR- Pepper/887350870169 Size M11 W13,FBALYB Amazon,0,0,0,1,0,0
,11016-6ENM4W6 CrocsCRObandTM Clog CLR- Pepper/887350870190 Size M4 W6,11016-6ENM4W6 CrocsCRObandTM Clog CLR- Pepper/887350870190 Size M4 W6,FBALYB Amazon,-1,-1,0,0,0,0
,11016-6ENM5W7 CrocsCRObandTM Clog CLR- Pepper/887350870206 Size M5 W7,11016-6ENM5W7 CrocsCRObandTM Clog CLR- Pepper/887350870206 Size M5 W7,FBALYB Amazon,8,7,1,0,1,0
,11016-6ENM6W8 CrocsCRObandTM Clog CLR- Pepper/887350870213 Size M6 W8,11016-6ENM6W8 CrocsCRObandTM Clog CLR- Pepper/887350870213 Size M6 W8,FBALYB Amazon,1,1,0,0,0,0
,11016-6ENM7W9 CrocsCRObandTM Clog CLR- Pepper/887350870220 Size M7 W9,11016-6ENM7W9 CrocsCRObandTM Clog CLR- Pepper/887350870220 Size M7 W9,FBALYB Amazon,12,12,0,0,0,0
,11016-6ENM8W10 CrocsCRObandTM Clog CLR- Pepper/887350870237 Size M8 W10,11016-6ENM8W10 CrocsCRObandTM Clog CLR- Pepper/887350870237 Size M8 W10,FBALYB Amazon,7,7,0,0,0,0
,11016-6ENM9W11 CrocsCRObandTM Clog CLR- Pepper/887350870244 Size M9 W11,11016-6ENM9W11 CrocsCRObandTM Clog CLR- Pepper/887350870244 Size M9 W11,Default Ridgefield,12,12,0,0,0,0
,11016-6ENM9W11 CrocsCRObandTM Clog CLR- Pepper/887350870244 Size M9 W11,11016-6ENM9W11 CrocsCRObandTM Clog CLR- Pepper/887350870244 Size M9 W11,FBALYB Amazon,-3,-3,0,0,0,0
,12803-3E8 Crocs Kids’ Handle It Rain Boot Grass Green US Size: C10,12803-3E8 Crocs Kids’ Handle It Rain Boot Grass Green US Size: C10,FBALYB Amazon,0,0,0,10,0,0
,12803-3E8 Crocs Kids’ Handle It Rain Boot Grass Green US Size: C9,12803-3E8 Crocs Kids’ Handle It Rain Boot Grass Green US Size: C9,FBALYB Amazon,0,0,0,10,0,0
,12803-3E8 Crocs Kids’ Handle It Rain Boot Grass Green US Size: J1,12803-3E8 Crocs Kids’ Handle It Rain Boot Grass Green US Size: J1,FBALYB Amazon,0,0,0,9,0,0
,12803-3E8 Crocs Kids’ Handle It Rain Boot Grass Green US Size: J2,12803-3E8 Crocs Kids’ Handle It Rain Boot Grass Green US Size: J2,FBALYB Amazon,0,0,0,10,0,0
,12803-3E8 Crocs Kids’ Handle It Rain Boot Grass Green US Size: J3,12803-3E8 Crocs Kids’ Handle It Rain Boot Grass Green US Size: J3,FBALYB Amazon,0,0,0,10,0,0
,12803-410 Crocs Kids’ Handle It Rain Boot Navy US Size C10,12803-410 Crocs Kids’ Handle It Rain Boot Navy US Size C10,FBALYB Amazon,0,0,0,10,0,0
,12803-410 Crocs Kids’ Handle It Rain Boot Navy US Size C9,12803-410 Crocs Kids’ Handle It Rain Boot Navy US Size C9,FBALYB Amazon,0,0,0,10,0,0
,12803-410 Crocs Kids’ Handle It Rain Boot Navy US Size J1,12803-410 Crocs Kids’ Handle It Rain Boot Navy US Size J1,FBALYB Amazon,0,0,0,10,0,0
,12803-410 Crocs Kids’ Handle It Rain Boot Navy US Size J2,12803-410 Crocs Kids’ Handle It Rain Boot Navy US Size J2,FBALYB Amazon,0,0,0,10,0,0
,12803-410 Crocs Kids’ Handle It Rain Boot Navy US Size J3,12803-410 Crocs Kids’ Handle It Rain Boot Navy US Size J3,FBALYB Amazon,0,0,0,10,0,0
,12803-4O5 Crocs Kids’ Handle It Rain Boot Cerulean Blue US Size C10,12803-4O5 Crocs Kids’ Handle It Rain Boot Cerulean Blue US Size C10,Default Ridgefield,35,35,0,0,0,0
,12803-4O5 Crocs Kids’ Handle It Rain Boot Cerulean Blue US Size C11,12803-4O5 Crocs Kids’ Handle It Rain Boot Cerulean Blue US Size C11,FBALYB Amazon,0,0,0,21,0,0
,12803-4O5 Crocs Kids’ Handle It Rain Boot Cerulean Blue US Size C12,12803-4O5 Crocs Kids’ Handle It Rain Boot Cerulean Blue US Size C12,Default Ridgefield,26,26,0,0,0,0
,12803-4O5 Crocs Kids’ Handle It Rain Boot Cerulean Blue US Size C13,12803-4O5 Crocs Kids’ Handle It Rain Boot Cerulean Blue US Size C13,FBALYB Amazon,0,0,0,21,0,0
,12803-4O5 Crocs Kids’ Handle It Rain Boot Cerulean Blue US Size C6,12803-4O5 Crocs Kids’ Handle It Rain Boot Cerulean Blue US Size C6,FBALYB Amazon,0,0,0,31,0,0
,12803-4O5 Crocs Kids’ Handle It Rain Boot Cerulean Blue US Size C7,12803-4O5 Crocs Kids’ Handle It Rain Boot Cerulean Blue US Size C7,Default Ridgefield,10,10,0,0,0,0
,12803-4O5 Crocs Kids’ Handle It Rain Boot Cerulean Blue US Size C8,12803-4O5 Crocs Kids’ Handle It Rain Boot Cerulean Blue US Size C8,Default Ridgefield,10,10,0,0,0,0
,12803-4O5 Crocs Kids’ Handle It Rain Boot Cerulean Blue US Size C9,12803-4O5 Crocs Kids’ Handle It Rain Boot Cerulean Blue US Size C9,Default Ridgefield,30,30,0,0,0,0
,12803-4O5 Crocs Kids’ Handle It Rain Boot Cerulean Blue US Size J1,12803-4O5 Crocs Kids’ Handle It Rain Boot Cerulean Blue US Size J1,FBALYB Amazon,0,0,0,16,0,0
,12803-4O5 Crocs Kids’ Handle It Rain Boot Cerulean Blue US Size J2,12803-4O5 Crocs Kids’ Handle It Rain Boot Cerulean Blue US Size J2,Default Ridgefield,10,10,0,0,0,0
,12803-4O5 Crocs Kids’ Handle It Rain Boot Cerulean Blue US Size J3,12803-4O5 Crocs Kids’ Handle It Rain Boot Cerulean Blue US Size J3,FBALYB Amazon,9,8,1,0,1,0
,12803-6X0 Crocs Kids’ Handle It Rain Boot Candy Pink US Size C10,12803-6X0 Crocs Kids’ Handle It Rain Boot Candy Pink US Size C10,FBALYB Amazon,21,10,11,0,11,0
,12803-6X0 Crocs Kids’ Handle It Rain Boot Candy Pink US Size C11,12803-6X0 Crocs Kids’ Handle It Rain Boot Candy Pink US Size C11,FBALYB Amazon,0,0,0,20,0,0
,12803-6X0 Crocs Kids’ Handle It Rain Boot Candy Pink US Size C12,12803-6X0 Crocs Kids’ Handle It Rain Boot Candy Pink US Size C12,FBALYB Amazon,0,0,0,26,0,0
,12803-6X0 Crocs Kids’ Handle It Rain Boot Candy Pink US Size C13,12803-6X0 Crocs Kids’ Handle It Rain Boot Candy Pink US Size C13,Default Ridgefield,21,21,0,0,0,0
,12803-6X0 Crocs Kids’ Handle It Rain Boot Candy Pink US Size C6,12803-6X0 Crocs Kids’ Handle It Rain Boot Candy Pink US Size C6,FBALYB Amazon,0,0,0,31,0,0
,12803-6X0 Crocs Kids’ Handle It Rain Boot Candy Pink US Size C7,12803-6X0 Crocs Kids’ Handle It Rain Boot Candy Pink US Size C7,FBALYB Amazon,0,0,0,10,0,0
,12803-6X0 Crocs Kids’ Handle It Rain Boot Candy Pink US Size C8,12803-6X0 Crocs Kids’ Handle It Rain Boot Candy Pink US Size C8,Default Ridgefield,2,2,0,0,0,0
,12803-6X0 Crocs Kids’ Handle It Rain Boot Candy Pink US Size C8,12803-6X0 Crocs Kids’ Handle It Rain Boot Candy Pink US Size C8,FBALYB Amazon,0,0,0,8,0,0
,12803-6X0 Crocs Kids’ Handle It Rain Boot Candy Pink US Size C9,12803-6X0 Crocs Kids’ Handle It Rain Boot Candy Pink US Size C9,FBALYB Amazon,0,0,0,30,0,0
,12803-6X0 Crocs Kids’ Handle It Rain Boot Candy Pink US Size J1,12803-6X0 Crocs Kids’ Handle It Rain Boot Candy Pink US Size J1,FBALYB Amazon,7,0,7,0,7,0
,12803-6X0 Crocs Kids’ Handle It Rain Boot Candy Pink US Size J2,12803-6X0 Crocs Kids’ Handle It Rain Boot Candy Pink US Size J2,FBALYB Amazon,5,3,2,0,2,0
,12803-6X0 Crocs Kids’ Handle It Rain Boot Candy Pink US Size J3,12803-6X0 Crocs Kids’ Handle It Rain Boot Candy Pink US Size J3,FBALYB Amazon,7,6,1,0,1,0
,12803-730 Crocs Kids’ Handle It Rain Boot Yellow US Size C10,12803-730 Crocs Kids’ Handle It Rain Boot Yellow US Size C10,FBALYB Amazon,0,0,0,21,0,0
,12803-730 Crocs Kids’ Handle It Rain Boot Yellow US Size C11,12803-730 Crocs Kids’ Handle It Rain Boot Yellow US Size C11,FBALYB Amazon,0,0,0,10,0,0
,12803-730 Crocs Kids’ Handle It Rain Boot Yellow US Size C12,12803-730 Crocs Kids’ Handle It Rain Boot Yellow US Size C12,FBALYB Amazon,0,0,0,10,0,0
,12803-730 Crocs Kids’ Handle It Rain Boot Yellow US Size C13,12803-730 Crocs Kids’ Handle It Rain Boot Yellow US Size C13,FBALYB Amazon,1,0,1,0,1,0
,12803-730 Crocs Kids’ Handle It Rain Boot Yellow US Size C6,12803-730 Crocs Kids’ Handle It Rain Boot Yellow US Size C6,FBALYB Amazon,0,0,0,20,0,0
,12803-730 Crocs Kids’ Handle It Rain Boot Yellow US Size C7,12803-730 Crocs Kids’ Handle It Rain Boot Yellow US Size C7,FBALYB Amazon,0,0,0,10,0,0
,12803-730 Crocs Kids’ Handle It Rain Boot Yellow US Size C8,12803-730 Crocs Kids’ Handle It Rain Boot Yellow US Size C8,Default Ridgefield,10,10,0,0,0,0
,12803-730 Crocs Kids’ Handle It Rain Boot Yellow US Size C9,12803-730 Crocs Kids’ Handle It Rain Boot Yellow US Size C9,Default Ridgefield,19,19,0,0,0,0
,12803-730 Crocs Kids’ Handle It Rain Boot Yellow US Size J1,12803-730 Crocs Kids’ Handle It Rain Boot Yellow US Size J1,FBALYB Amazon,0,0,0,10,0,0
,12803-730 Crocs Kids’ Handle It Rain Boot Yellow US Size J2,12803-730 Crocs Kids’ Handle It Rain Boot Yellow US Size J2,FBALYB Amazon,0,0,0,10,0,0
,12803-730 Crocs Kids’ Handle It Rain Boot Yellow US Size J3,12803-730 Crocs Kids’ Handle It Rain Boot Yellow US Size J3,Default Ridgefield,10,10,0,0,0,0
,1L-27EK-7W86,Shopkins 20 Mega Pack New Series Season Two 2,Default Ridgefield,133,133,0,0,0,0
,1L-27EK-7W86,Shopkins 20 Mega Pack New Series Season Two 2,FBALYB Amazon,17,11,6,0,6,0
,1L-W209-5U5A,Crock-Pot 7-Qt. Cook n' Carry Programmable Countdown Slow Cooker,Default,0,0,0,0,0,5
,1L-W209-5U5A,Crock-Pot 7-Qt. Cook n' Carry Programmable Countdown Slow Cooker,FBALYB Amazon,-5,-5,0,4,0,0
,1Y-GDFB-KKV7,"NuWave 36001 Brio Air Fryer, Black",FBAAP Amazon,11,11,0,0,0,0
,1Y-GDFB-KKV7,"NuWave 36001 Brio Air Fryer, Black",FBALYB Amazon,51,51,0,0,0,0
,200ct Wellsley Farms K Cups,200ct Wellsley Farms Colombian Coffee K Cups,Default,1,0,1,0,0,0
,200ct Wellsley Farms K Cups,200ct Wellsley Farms Colombian Coffee K Cups,FBALYB Amazon,-2,-2,0,0,0,0
,201 BP 2000 M M16bk Rondo  4014519270546,201 BP 2000 M M16bk Rondo  4014519270546,FBALYB Amazon,59,58,1,0,1,0
,202492-001W10 CrocsWomen’s Kadee II Flip CLR- Black/887350725995 Size 10,202492-001W10 CrocsWomen’s Kadee II Flip CLR- Black/887350725995 Size 10,FBALYB Amazon,-1,-1,0,0,0,0
,202492-001W7 CrocsWomen’s Kadee II Flip CLR- Black/887350726046 Size 7,202492-001W7 CrocsWomen’s Kadee II Flip CLR- Black/887350726046 Size 7,FBALYB Amazon,-3,-3,0,0,0,0
,202492-001W8 CrocsWomen’s Kadee II Flip CLR- Black/887350726053 Size 8,202492-001W8 CrocsWomen’s Kadee II Flip CLR- Black/887350726053 Size 8,FBALYB Amazon,-4,-4,0,0,0,0
,202492-100W10 CrocsWomen’s Kadee II Flip CLR- White/191448116757 Size 10,202492-100W10 CrocsWomen’s Kadee II Flip CLR- White/191448116757 Size 10,FBALYB Amazon,-1,-1,0,0,0,0
,202492-100W6 CrocsWomen’s Kadee II Flip CLR- White/191448116795 Size 6,202492-100W6 CrocsWomen’s Kadee II Flip CLR- White/191448116795 Size 6,FBALYB Amazon,-2,-2,0,0,0,0
,202492-100W7 CrocsWomen’s Kadee II Flip CLR- White/191448116801 Size 7,202492-100W7 CrocsWomen’s Kadee II Flip CLR- White/191448116801 Size 7,FBALYB Amazon,-3,-3,0,0,0,0
,202492-100W8 CrocsWomen’s Kadee II Flip CLR- White/191448116818 Size 8,202492-100W8 CrocsWomen’s Kadee II Flip CLR- White/191448116818 Size 8,FBALYB Amazon,-2,-2,0,0,0,0
,202492-100W9 CrocsWomen’s Kadee II Flip CLR- White/191448116825 Size 9,202492-100W9 CrocsWomen’s Kadee II Flip CLR- White/191448116825 Size 9,FBALYB Amazon,-3,-3,0,0,0,0
,202492-410W10 CrocsWomen’s Kadee II Flip CLR- Navy/887350726152 Size 10,202492-410W10 CrocsWomen’s Kadee II Flip CLR- Navy/887350726152 Size 10,FBALYB Amazon,-4,-4,0,0,0,0
,202492-410W6 CrocsWomen’s Kadee II Flip CLR- Navy/887350726190 Size 6,202492-410W6 CrocsWomen’s Kadee II Flip CLR- Navy/887350726190 Size 6,FBALYB Amazon,-1,-1,0,0,0,0
,202492-410W8 CrocsWomen’s Kadee II Flip CLR- Navy/887350726213 Size 8,202492-410W8 CrocsWomen’s Kadee II Flip CLR- Navy/887350726213 Size 8,FBALYB Amazon,-5,-5,0,0,0,0
,202492-410W9 CrocsWomen’s Kadee II Flip CLR- Navy/887350726220 Size 9,202492-410W9 CrocsWomen’s Kadee II Flip CLR- Navy/887350726220 Size 9,FBALYB Amazon,-3,-3,0,0,0,0
,202502-02SW10 CrocsWomen’s Capri V Flip CLR- Black/Graphite/887350705294 Size 10,202502-02SW10 CrocsWomen’s Capri V Flip CLR- Black/Graphite/887350705294 Size 10,FBALYB Amazon,-2,-2,0,0,0,0
,202502-02SW6 CrocsWomen’s Capri V Flip CLR- Black/Graphite/887350705331 Size 6,202502-02SW6 CrocsWomen’s Capri V Flip CLR- Black/Graphite/887350705331 Size 6,FBALYB Amazon,-1,-1,0,0,0,0
,202502-02SW7 CrocsWomen’s Capri V Flip CLR- Black/Graphite/887350705348 Size 7,202502-02SW7 CrocsWomen’s Capri V Flip CLR- Black/Graphite/887350705348 Size 7,FBALYB Amazon,-1,-1,0,0,0,0
,202502-02SW8 CrocsWomen’s Capri V Flip CLR- Black/Graphite/887350705355 Size 8,202502-02SW8 CrocsWomen’s Capri V Flip CLR- Black/Graphite/887350705355 Size 8,FBALYB Amazon,-3,-3,0,0,0,0
,202502-02SW9 CrocsWomen’s Capri V Flip CLR- Black/Graphite/887350705362 Size 9,202502-02SW9 CrocsWomen’s Capri V Flip CLR- Black/Graphite/887350705362 Size 9,FBALYB Amazon,-2,-2,0,0,0,0
,202502-27LW10 CrocsWomen’s Capri V Flip CLR- Chai/Walnut/887350705454 Size 10,202502-27LW10 CrocsWomen’s Capri V Flip CLR- Chai/Walnut/887350705454 Size 10,FBALYB Amazon,-3,-3,0,0,0,0
,202502-27LW6 CrocsWomen’s Capri V Flip CLR- Chai/Walnut/887350705492 Size 6,202502-27LW6 CrocsWomen’s Capri V Flip CLR- Chai/Walnut/887350705492 Size 6,FBALYB Amazon,-2,-2,0,0,0,0
,202502-27LW7 CrocsWomen’s Capri V Flip CLR- Chai/Walnut/887350705508 Size 7,202502-27LW7 CrocsWomen’s Capri V Flip CLR- Chai/Walnut/887350705508 Size 7,FBALYB Amazon,-5,-5,0,0,0,0
,202502-27LW8 CrocsWomen’s Capri V Flip CLR- Chai/Walnut/887350705515 Size 8,202502-27LW8 CrocsWomen’s Capri V Flip CLR- Chai/Walnut/887350705515 Size 8,FBALYB Amazon,-3,-3,0,0,0,0
,202502-27LW9 CrocsWomen’s Capri V Flip CLR- Chai/Walnut/887350705522 Size 9,202502-27LW9 CrocsWomen’s Capri V Flip CLR- Chai/Walnut/887350705522 Size 9,FBALYB Amazon,-2,-2,0,0,0,0
,203998-060W10 CrocsWomen’s SwiftwaterTM Sandal CLR- Black/Black/887350888447 Size 10,203998-060W10 CrocsWomen’s SwiftwaterTM Sandal CLR- Black/Black/887350888447 Size 10,Default Ridgefield,6,6,0,0,0,0
,203998-060W9 CrocsWomen’s SwiftwaterTM Sandal CLR- Black/Black/887350888515 Size 9,203998-060W9 CrocsWomen’s SwiftwaterTM Sandal CLR- Black/Black/887350888515 Size 9,FBALYB Amazon,18,18,0,12,0,0
,204311-001W10 CrocsWomen’s Capri V Sequin Flip CLR- Black/887350917024 Size 10,204311-001W10 CrocsWomen’s Capri V Sequin Flip CLR- Black/887350917024 Size 10,FBALYB Amazon,-1,-1,0,0,0,0
,204311-001W6 CrocsWomen’s Capri V Sequin Flip CLR- Black/887350917062 Size 6,204311-001W6 CrocsWomen’s Capri V Sequin Flip CLR- Black/887350917062 Size 6,FBALYB Amazon,6,6,0,0,0,0
,204311-001W7 CrocsWomen’s Capri V Sequin Flip CLR- Black/887350917079 Size 7,204311-001W7 CrocsWomen’s Capri V Sequin Flip CLR- Black/887350917079 Size 7,FBALYB Amazon,-3,-3,0,0,0,0
,204311-001W8 CrocsWomen’s Capri V Sequin Flip CLR- Black/887350917086 Size 8,204311-001W8 CrocsWomen’s Capri V Sequin Flip CLR- Black/887350917086 Size 8,Default Ridgefield,2,2,0,0,0,0
,204311-001W8 CrocsWomen’s Capri V Sequin Flip CLR- Black/887350917086 Size 8,204311-001W8 CrocsWomen’s Capri V Sequin Flip CLR- Black/887350917086 Size 8,FBALYB Amazon,-2,-2,0,0,0,0
,204311-001W9 CrocsWomen’s Capri V Sequin Flip CLR- Black/887350917093 Size 9,204311-001W9 CrocsWomen’s Capri V Sequin Flip CLR- Black/887350917093 Size 9,Default Ridgefield,3,3,0,0,0,0
,204311-040W10 CrocsWomen’s Capri V Sequin Flip CLR- Silver/887350917109 Size 10,204311-040W10 CrocsWomen’s Capri V Sequin Flip CLR- Silver/887350917109 Size 10,Default Ridgefield,6,6,0,0,0,0
,204311-040W7 CrocsWomen’s Capri V Sequin Flip CLR- Silver/887350917154 Size 7,204311-040W7 CrocsWomen’s Capri V Sequin Flip CLR- Silver/887350917154 Size 7,FBALYB Amazon,-3,-3,0,0,0,0
,204311-040W9 CrocsWomen’s Capri V Sequin Flip CLR- Silver/887350917178 Size 9,204311-040W9 CrocsWomen’s Capri V Sequin Flip CLR- Silver/887350917178 Size 9,FBALYB Amazon,-3,-3,0,0,0,0
,204536-001C10 CrocsKids’ Classic Clog CLR- Black/887350922264 Size 10,204536-001C10 CrocsKids’ Classic Clog CLR- Black/887350922264 Size 10,FBALYB Amazon,-1,-1,0,0,0,0
,204536-001C11 CrocsKids’ Classic Clog CLR- Black/887350922271 Size 11,204536-001C11 CrocsKids’ Classic Clog CLR- Black/887350922271 Size 11,FBALYB Amazon,-4,-4,0,0,0,0
,204536-001C12 CrocsKids’ Classic Clog CLR- Black/887350922288 Size 12,204536-001C12 CrocsKids’ Classic Clog CLR- Black/887350922288 Size 12,FBALYB Amazon,-1,-1,0,0,0,0
,204536-001C13 CrocsKids’ Classic Clog CLR- Black/887350922295 Size 13,204536-001C13 CrocsKids’ Classic Clog CLR- Black/887350922295 Size 13,FBALYB Amazon,-4,-4,0,0,0,0
,204536-001C4 CrocsKids’ Classic Clog CLR- Black/887350922301 Size 4,204536-001C4 CrocsKids’ Classic Clog CLR- Black/887350922301 Size 4,FBALYB Amazon,-9,-9,0,0,0,0
,204536-001C5 CrocsKids’ Classic Clog CLR- Black/887350922318 Size 5,204536-001C5 CrocsKids’ Classic Clog CLR- Black/887350922318 Size 5,FBALYB Amazon,-5,-5,0,0,0,0
,204536-001C6 CrocsKids’ Classic Clog CLR- Black/887350922325 Size 6,204536-001C6 CrocsKids’ Classic Clog CLR- Black/887350922325 Size 6,FBALYB Amazon,-6,-6,0,0,0,0
,204536-001C7 CrocsKids’ Classic Clog CLR- Black/887350922332 Size 7,204536-001C7 CrocsKids’ Classic Clog CLR- Black/887350922332 Size 7,Default Ridgefield,5,5,0,0,0,0
,204536-001C7 CrocsKids’ Classic Clog CLR- Black/887350922332 Size 7,204536-001C7 CrocsKids’ Classic Clog CLR- Black/887350922332 Size 7,FBALYB Amazon,-2,-2,0,0,0,0
,204536-001C8 CrocsKids’ Classic Clog CLR- Black/887350922349 Size 8,204536-001C8 CrocsKids’ Classic Clog CLR- Black/887350922349 Size 8,FBALYB Amazon,-1,-1,0,0,0,0
,204536-001C9 CrocsKids’ Classic Clog CLR- Black/887350922356 SIze 9,204536-001C9 CrocsKids’ Classic Clog CLR- Black/887350922356 SIze 9,FBALYB Amazon,-2,-2,0,0,0,0
,204536-001J1 CrocsKids’ Classic Clog CLR- Black/887350922363 Size 1,204536-001J1 CrocsKids’ Classic Clog CLR- Black/887350922363 Size 1,FBALYB Amazon,-50,-51,1,0,1,0
,204536-001J2 CrocsKids’ Classic Clog CLR- Black/887350922370 Size 2,204536-001J2 CrocsKids’ Classic Clog CLR- Black/887350922370 Size 2,FBALYB Amazon,-12,-12,0,0,0,0
,204536-001J3 CrocsKids’ Classic Clog CLR- Black/887350922387 Size 3,204536-001J3 CrocsKids’ Classic Clog CLR- Black/887350922387 Size 3,FBALYB Amazon,-24,-25,1,0,1,0
,204536-001J4 CrocsKids’ Classic Clog CLR- Black/191448428409 Size 4,204536-001J4 CrocsKids’ Classic Clog CLR- Black/191448428409 Size 4,FBALYB Amazon,-11,-11,0,0,0,0
,204536-001J5 CrocsKids’ Classic Clog CLR- Black/191448428416 Size 5,204536-001J5 CrocsKids’ Classic Clog CLR- Black/191448428416 Size 5,FBALYB Amazon,-34,-34,0,0,0,0
,204536-001J6 CrocsKids’ Classic Clog CLR- Black/191448428423 Size 6,204536-001J6 CrocsKids’ Classic Clog CLR- Black/191448428423 Size 6,Default Ridgefield,1,1,0,0,0,0
,204536-001J6 CrocsKids’ Classic Clog CLR- Black/191448428423 Size 6,204536-001J6 CrocsKids’ Classic Clog CLR- Black/191448428423 Size 6,FBALYB Amazon,-15,-15,0,0,0,0
,204536-0DAC11 CrocsKids’ Classic Clog CLR- Slate Grey/887350977868 Size 11,204536-0DAC11 CrocsKids’ Classic Clog CLR- Slate Grey/887350977868 Size 11,FBALYB Amazon,-1,-1,0,0,0,0
,204536-0DAC12 CrocsKids’ Classic Clog CLR- Slate Grey/887350977875 Size 12,204536-0DAC12 CrocsKids’ Classic Clog CLR- Slate Grey/887350977875 Size 12,FBALYB Amazon,-4,-4,0,0,0,0
,204536-0DAC13 CrocsKids’ Classic Clog CLR- Slate Grey/887350977882 Size 13,204536-0DAC13 CrocsKids’ Classic Clog CLR- Slate Grey/887350977882 Size 13,FBALYB Amazon,1,1,0,0,0,0
,204536-0DAC4 CrocsKids’ Classic Clog CLR- Slate Grey/887350977899 Size 4,204536-0DAC4 CrocsKids’ Classic Clog CLR- Slate Grey/887350977899 Size 4,FBALYB Amazon,1,-1,2,0,2,0
,204536-0DAC5 CrocsKids’ Classic Clog CLR- Slate Grey/887350977905 Size 5,204536-0DAC5 CrocsKids’ Classic Clog CLR- Slate Grey/887350977905 Size 5,FBALYB Amazon,-6,-6,0,0,0,0
,204536-0DAC6 CrocsKids’ Classic Clog CLR- Slate Grey/887350977912 Size 6,204536-0DAC6 CrocsKids’ Classic Clog CLR- Slate Grey/887350977912 Size 6,FBALYB Amazon,-2,-2,0,0,0,0
,204536-0DAC7 CrocsKids’ Classic Clog CLR- Slate Grey/887350977929 Size 7,204536-0DAC7 CrocsKids’ Classic Clog CLR- Slate Grey/887350977929 Size 7,FBALYB Amazon,-3,-3,0,0,0,0
,204536-0DAC9 CrocsKids’ Classic Clog CLR- Slate Grey/887350977943 Size 9,204536-0DAC9 CrocsKids’ Classic Clog CLR- Slate Grey/887350977943 Size 9,FBALYB Amazon,-5,-5,0,0,0,0
,204536-0DAJ1 CrocsKids’ Classic Clog CLR- Slate Grey/887350977950 Size 1,204536-0DAJ1 CrocsKids’ Classic Clog CLR- Slate Grey/887350977950 Size 1,FBALYB Amazon,247,247,0,0,0,0
,204536-0DAJ2 CrocsKids’ Classic Clog CLR- Slate Grey/887350977967 Size 2,204536-0DAJ2 CrocsKids’ Classic Clog CLR- Slate Grey/887350977967 Size 2,FBALYB Amazon,-9,-9,0,0,0,0
,204536-0DAJ3 CrocsKids’ Classic Clog CLR- Slate Grey/887350977974 Size 3,204536-0DAJ3 CrocsKids’ Classic Clog CLR- Slate Grey/887350977974 Size 3,FBALYB Amazon,-7,-7,0,0,0,0
,204536-0DAJ4 CrocsKids’ Classic Clog CLR- Slate Grey/191448428522 Size 4,204536-0DAJ4 CrocsKids’ Classic Clog CLR- Slate Grey/191448428522 Size 4,Default Ridgefield,5,5,0,0,0,0
,204536-0DAJ4 CrocsKids’ Classic Clog CLR- Slate Grey/191448428522 Size 4,204536-0DAJ4 CrocsKids’ Classic Clog CLR- Slate Grey/191448428522 Size 4,FBALYB Amazon,-24,-24,0,0,0,0
,204536-0DAJ5 CrocsKids’ Classic Clog CLR- Slate Grey/191448428539 Size 5,204536-0DAJ5 CrocsKids’ Classic Clog CLR- Slate Grey/191448428539 Size 5,FBALYB Amazon,-30,-30,0,0,0,0
,204536-0DAJ6 CrocsKids’ Classic Clog CLR- Slate Grey/191448428546 Size 6,204536-0DAJ6 CrocsKids’ Classic Clog CLR- Slate Grey/191448428546 Size 6,FBALYB Amazon,-26,-26,0,0,0,0
,204536-100C10 CrocsKids’ Classic Clog CLR- White/887350977981 Size 10,204536-100C10 CrocsKids’ Classic Clog CLR- White/887350977981 Size 10,FBALYB Amazon,-3,-3,0,0,0,0
,204536-100C11 CrocsKids’ Classic Clog CLR- White/887350977998 Size 11,204536-100C11 CrocsKids’ Classic Clog CLR- White/887350977998 Size 11,FBALYB Amazon,-3,-3,0,0,0,0
,204536-100C12 CrocsKids’ Classic Clog CLR- White/887350978001 Size 12,204536-100C12 CrocsKids’ Classic Clog CLR- White/887350978001 Size 12,FBALYB Amazon,-3,-3,0,0,0,0
,204536-100C13 CrocsKids’ Classic Clog CLR- White/887350978018 Size 13,204536-100C13 CrocsKids’ Classic Clog CLR- White/887350978018 Size 13,FBALYB Amazon,-2,-3,1,0,1,0
,204536-100C4 CrocsKids’ Classic Clog CLR- White/887350978025 Size 4,204536-100C4 CrocsKids’ Classic Clog CLR- White/887350978025 Size 4,FBALYB Amazon,3,3,0,0,0,0
,204536-100C5 CrocsKids’ Classic Clog CLR- White/887350978032 Size 5,204536-100C5 CrocsKids’ Classic Clog CLR- White/887350978032 Size 5,FBALYB Amazon,-3,-3,0,0,0,0
,204536-100C6 CrocsKids’ Classic Clog CLR- White/887350978049 Size 6,204536-100C6 CrocsKids’ Classic Clog CLR- White/887350978049 Size 6,Default Ridgefield,14,14,0,0,0,0
,204536-100C7 CrocsKids’ Classic Clog CLR- White/887350978056 Size 7,204536-100C7 CrocsKids’ Classic Clog CLR- White/887350978056 Size 7,Default Ridgefield,9,9,0,0,0,0
,204536-100C7 CrocsKids’ Classic Clog CLR- White/887350978056 Size 7,204536-100C7 CrocsKids’ Classic Clog CLR- White/887350978056 Size 7,FBALYB Amazon,-4,-4,0,0,0,0
,204536-100C8 CrocsKids’ Classic Clog CLR- White/887350978063 Size 8,204536-100C8 CrocsKids’ Classic Clog CLR- White/887350978063 Size 8,Default Ridgefield,9,9,0,0,0,0
,204536-100C9 CrocsKids’ Classic Clog CLR- White/887350978070 Size 9,204536-100C9 CrocsKids’ Classic Clog CLR- White/887350978070 Size 9,Default Ridgefield,6,6,0,0,0,0
,204536-100C9 CrocsKids’ Classic Clog CLR- White/887350978070 Size 9,204536-100C9 CrocsKids’ Classic Clog CLR- White/887350978070 Size 9,FBALYB Amazon,-7,-7,0,0,0,0
,204536-100J1 CrocsKids’ Classic Clog CLR- White/887350978087 Size 1,204536-100J1 CrocsKids’ Classic Clog CLR- White/887350978087 Size 1,Default Ridgefield,0,0,0,0,0,12
,204536-100J1 CrocsKids’ Classic Clog CLR- White/887350978087 Size 1,204536-100J1 CrocsKids’ Classic Clog CLR- White/887350978087 Size 1,FBALYB Amazon,178,174,4,1,4,0
,204536-100J2 CrocsKids’ Classic Clog CLR- White/887350978094 Size 2,204536-100J2 CrocsKids’ Classic Clog CLR- White/887350978094 Size 2,Default Ridgefield,0,0,0,0,0,12
,204536-100J2 CrocsKids’ Classic Clog CLR- White/887350978094 Size 2,204536-100J2 CrocsKids’ Classic Clog CLR- White/887350978094 Size 2,FBALYB Amazon,-11,-11,0,1,0,0
,204536-100J3 CrocsKids’ Classic Clog CLR- White/887350978100 Size 3,204536-100J3 CrocsKids’ Classic Clog CLR- White/887350978100 Size 3,Default Ridgefield,0,0,0,0,0,24
,204536-100J3 CrocsKids’ Classic Clog CLR- White/887350978100 Size 3,204536-100J3 CrocsKids’ Classic Clog CLR- White/887350978100 Size 3,FBALYB Amazon,-14,-15,1,0,1,0
,204536-100J4 CrocsKids’ Classic Clog CLR- White/191448428102 Size 4,204536-100J4 CrocsKids’ Classic Clog CLR- White/191448428102 Size 4,Default Ridgefield,95,95,0,0,0,0
,204536-100J4 CrocsKids’ Classic Clog CLR- White/191448428102 Size 4,204536-100J4 CrocsKids’ Classic Clog CLR- White/191448428102 Size 4,FBALYB Amazon,-5,-6,1,0,1,0
,204536-100J5 CrocsKids’ Classic Clog CLR- White/191448428119 Size 5,204536-100J5 CrocsKids’ Classic Clog CLR- White/191448428119 Size 5,FBALYB Amazon,-27,-28,1,0,1,0
,204536-100J6 CrocsKids’ Classic Clog CLR- White/191448428126 Size 6,204536-100J6 CrocsKids’ Classic Clog CLR- White/191448428126 Size 6,FBALYB Amazon,-37,-39,2,0,2,0
,204536-410C10 CrocsKids’ Classic Clog CLR- Navy/887350922783 Size 10,204536-410C10 CrocsKids’ Classic Clog CLR- Navy/887350922783 Size 10,FBALYB Amazon,-1,-2,1,0,1,0
,204536-410C11 CrocsKids’ Classic Clog CLR- Navy/887350922790 Size 11,204536-410C11 CrocsKids’ Classic Clog CLR- Navy/887350922790 Size 11,Default Ridgefield,0,-18,18,0,0,0
,204536-410C11 CrocsKids’ Classic Clog CLR- Navy/887350922790 Size 11,204536-410C11 CrocsKids’ Classic Clog CLR- Navy/887350922790 Size 11,FBALYB Amazon,-2,-2,0,0,0,0
,204536-410C13 CrocsKids’ Classic Clog CLR- Navy/887350922813 Size 13,204536-410C13 CrocsKids’ Classic Clog CLR- Navy/887350922813 Size 13,FBALYB Amazon,-3,-3,0,0,0,0
,204536-410C4 CrocsKids’ Classic Clog CLR- Navy/887350922820 Size 4,204536-410C4 CrocsKids’ Classic Clog CLR- Navy/887350922820 Size 4,FBALYB Amazon,-2,-2,0,0,0,0
,204536-410C6 CrocsKids’ Classic Clog CLR- Navy/887350922844 Size 6,204536-410C6 CrocsKids’ Classic Clog CLR- Navy/887350922844 Size 6,Default Ridgefield,0,-18,18,0,0,0
,204536-410C7 CrocsKids’ Classic Clog CLR- Navy/887350922851 Size 7,204536-410C7 CrocsKids’ Classic Clog CLR- Navy/887350922851 Size 7,Default Ridgefield,0,-18,18,0,0,0
,204536-410C7 CrocsKids’ Classic Clog CLR- Navy/887350922851 Size 7,204536-410C7 CrocsKids’ Classic Clog CLR- Navy/887350922851 Size 7,FBALYB Amazon,2,2,0,0,0,0
,204536-410C8 CrocsKids’ Classic Clog CLR- Navy/887350922868 Size 8,204536-410C8 CrocsKids’ Classic Clog CLR- Navy/887350922868 Size 8,Default Ridgefield,0,-18,18,0,0,0
,204536-410C8 CrocsKids’ Classic Clog CLR- Navy/887350922868 Size 8,204536-410C8 CrocsKids’ Classic Clog CLR- Navy/887350922868 Size 8,FBALYB Amazon,-3,-3,0,0,0,0
,204536-410C9 CrocsKids’ Classic Clog CLR- Navy/887350922875 Size 9,204536-410C9 CrocsKids’ Classic Clog CLR- Navy/887350922875 Size 9,Default Ridgefield,0,-18,18,0,0,0
,204536-410J1 CrocsKids’ Classic Clog CLR- Navy/887350922882 Size 1,204536-410J1 CrocsKids’ Classic Clog CLR- Navy/887350922882 Size 1,Default Ridgefield,40,40,0,0,0,0
,204536-410J1 CrocsKids’ Classic Clog CLR- Navy/887350922882 Size 1,204536-410J1 CrocsKids’ Classic Clog CLR- Navy/887350922882 Size 1,FBALYB Amazon,-8,-8,0,0,0,0
,204536-410J2 CrocsKids’ Classic Clog CLR- Navy/887350922899 Size 2,204536-410J2 CrocsKids’ Classic Clog CLR- Navy/887350922899 Size 2,FBALYB Amazon,-2,-2,0,0,0,0
,204536-410J3 CrocsKids’ Classic Clog CLR- Navy/887350922905 Size 3,204536-410J3 CrocsKids’ Classic Clog CLR- Navy/887350922905 Size 3,FBALYB Amazon,-8,-8,0,0,0,0
,204536-410J4 CrocsKids’ Classic Clog CLR- Navy/191448428461 Size 4,204536-410J4 CrocsKids’ Classic Clog CLR- Navy/191448428461 Size 4,Default Ridgefield,0,0,0,0,0,36
,204536-410J4 CrocsKids’ Classic Clog CLR- Navy/191448428461 Size 4,204536-410J4 CrocsKids’ Classic Clog CLR- Navy/191448428461 Size 4,FBALYB Amazon,-6,-6,0,0,0,0
,204536-410J5 CrocsKids’ Classic Clog CLR- Navy/191448428478 Size 5,204536-410J5 CrocsKids’ Classic Clog CLR- Navy/191448428478 Size 5,Default Ridgefield,0,0,0,0,0,48
,204536-410J5 CrocsKids’ Classic Clog CLR- Navy/191448428478 Size 5,204536-410J5 CrocsKids’ Classic Clog CLR- Navy/191448428478 Size 5,FBALYB Amazon,-2,-2,0,0,0,0
,204536-410J6 CrocsKids’ Classic Clog CLR- Navy/191448428485 SIze 6,204536-410J6 CrocsKids’ Classic Clog CLR- Navy/191448428485 SIze 6,Default Ridgefield,24,24,0,0,0,24
,204536-410J6 CrocsKids’ Classic Clog CLR- Navy/191448428485 SIze 6,204536-410J6 CrocsKids’ Classic Clog CLR- Navy/191448428485 SIze 6,FBALYB Amazon,-5,-5,0,0,0,0
,204536-456C10 CrocsKids’ Classic Clog CLR- Ocean/887350923049 Size 10,204536-456C10 CrocsKids’ Classic Clog CLR- Ocean/887350923049 Size 10,FBALYB Amazon,-2,-2,0,0,0,0
,204536-456C11 CrocsKids’ Classic Clog CLR- Ocean/887350923056 Size 11,204536-456C11 CrocsKids’ Classic Clog CLR- Ocean/887350923056 Size 11,Default Ridgefield,10,10,0,0,0,0
,204536-456C11 CrocsKids’ Classic Clog CLR- Ocean/887350923056 Size 11,204536-456C11 CrocsKids’ Classic Clog CLR- Ocean/887350923056 Size 11,FBALYB Amazon,-2,-2,0,0,0,0
,204536-456C12 CrocsKids’ Classic Clog CLR- Ocean/887350923063 Size 12,204536-456C12 CrocsKids’ Classic Clog CLR- Ocean/887350923063 Size 12,Default Ridgefield,10,10,0,0,0,0
,204536-456C12 CrocsKids’ Classic Clog CLR- Ocean/887350923063 Size 12,204536-456C12 CrocsKids’ Classic Clog CLR- Ocean/887350923063 Size 12,FBALYB Amazon,-2,-2,0,0,0,0
,204536-456C13 CrocsKids’ Classic Clog CLR- Ocean/887350923070 Size 13,204536-456C13 CrocsKids’ Classic Clog CLR- Ocean/887350923070 Size 13,Default Ridgefield,10,10,0,0,0,0
,204536-456C13 CrocsKids’ Classic Clog CLR- Ocean/887350923070 Size 13,204536-456C13 CrocsKids’ Classic Clog CLR- Ocean/887350923070 Size 13,FBALYB Amazon,1,1,0,0,0,0
,204536-456C4 CrocsKids’ Classic Clog CLR- Ocean/887350923087 Size 4,204536-456C4 CrocsKids’ Classic Clog CLR- Ocean/887350923087 Size 4,FBALYB Amazon,-4,-4,0,0,0,0
,204536-456C5 CrocsKids’ Classic Clog CLR- Ocean/887350923094 Size 5,204536-456C5 CrocsKids’ Classic Clog CLR- Ocean/887350923094 Size 5,FBALYB Amazon,-4,-4,0,0,0,0
,204536-456C6 CrocsKids’ Classic Clog CLR- Ocean/887350923100 Size 6,204536-456C6 CrocsKids’ Classic Clog CLR- Ocean/887350923100 Size 6,FBALYB Amazon,-2,-2,0,0,0,0
,204536-456C8 CrocsKids’ Classic Clog CLR- Ocean/887350923124 Size 8,204536-456C8 CrocsKids’ Classic Clog CLR- Ocean/887350923124 Size 8,FBALYB Amazon,-2,-2,0,0,0,0
,204536-456C9 CrocsKids’ Classic Clog CLR- Ocean/887350923131 Size 9,204536-456C9 CrocsKids’ Classic Clog CLR- Ocean/887350923131 Size 9,FBALYB Amazon,-1,-1,0,0,0,0
,204536-456J1 CrocsKids’ Classic Clog CLR- Ocean/887350923148 Size 1,204536-456J1 CrocsKids’ Classic Clog CLR- Ocean/887350923148 Size 1,Default Ridgefield,53,53,0,0,0,0
,204536-456J2 CrocsKids’ Classic Clog CLR- Ocean/887350923155 Size 2,204536-456J2 CrocsKids’ Classic Clog CLR- Ocean/887350923155 Size 2,Default Ridgefield,18,18,0,0,0,0
,204536-456J2 CrocsKids’ Classic Clog CLR- Ocean/887350923155 Size 2,204536-456J2 CrocsKids’ Classic Clog CLR- Ocean/887350923155 Size 2,FBALYB Amazon,1,1,0,0,0,0
,204536-456J3 CrocsKids’ Classic Clog CLR- Ocean/887350923162 Size 3,204536-456J3 CrocsKids’ Classic Clog CLR- Ocean/887350923162 Size 3,FBALYB Amazon,30,28,2,0,2,0
,204536-456J4 CrocsKids’ Classic Clog CLR- Ocean/191448428287 Size 4,204536-456J4 CrocsKids’ Classic Clog CLR- Ocean/191448428287 Size 4,Default Ridgefield,25,25,0,0,0,0
,204536-456J4 CrocsKids’ Classic Clog CLR- Ocean/191448428287 Size 4,204536-456J4 CrocsKids’ Classic Clog CLR- Ocean/191448428287 Size 4,FBALYB Amazon,-5,-5,0,0,0,0
,204536-456J5 CrocsKids’ Classic Clog CLR- Ocean/191448428294 Size 5,204536-456J5 CrocsKids’ Classic Clog CLR- Ocean/191448428294 Size 5,FBALYB Amazon,54,54,0,0,0,0
,204536-456J6 CrocsKids’ Classic Clog CLR- Ocean/191448428300 Size 6,204536-456J6 CrocsKids’ Classic Clog CLR- Ocean/191448428300 Size 6,Default Ridgefield,44,44,0,0,0,0
,204536-4O9C12 CrocsKids’ Classic Clog CLR- Ice Blue/887350978261 Size 12,204536-4O9C12 CrocsKids’ Classic Clog CLR- Ice Blue/887350978261 Size 12,FBALYB Amazon,-4,-4,0,0,0,0
,204536-4O9C13 CrocsKids’ Classic Clog CLR- Ice Blue/887350978278 Size 13,204536-4O9C13 CrocsKids’ Classic Clog CLR- Ice Blue/887350978278 Size 13,FBALYB Amazon,-1,-1,0,0,0,0
,204536-4O9C4 CrocsKids’ Classic Clog CLR- Ice Blue/887350978285 Size 4,204536-4O9C4 CrocsKids’ Classic Clog CLR- Ice Blue/887350978285 Size 4,FBALYB Amazon,17,17,0,0,0,0
,204536-4O9C5 CrocsKids’ Classic Clog CLR- Ice Blue/887350978292 Size 5,204536-4O9C5 CrocsKids’ Classic Clog CLR- Ice Blue/887350978292 Size 5,FBALYB Amazon,-2,-2,0,0,0,0
,204536-4O9C6 CrocsKids’ Classic Clog CLR- Ice Blue/887350978308 Size 6,204536-4O9C6 CrocsKids’ Classic Clog CLR- Ice Blue/887350978308 Size 6,FBALYB Amazon,-2,-2,0,0,0,0
,204536-4O9C8 CrocsKids’ Classic Clog CLR- Ice Blue/887350978322 Size 8,204536-4O9C8 CrocsKids’ Classic Clog CLR- Ice Blue/887350978322 Size 8,FBALYB Amazon,-2,-2,0,0,0,0
,204536-4O9J1 CROCS-Kids’ Classic Clog CLR- Ice Blue/887350978346 Size 1,204536-4O9J1 CROCS-Kids’ Classic Clog CLR- Ice Blue/887350978346 Size 1,FBALYB Amazon,-1,-1,0,0,0,0
,204536-4O9J3 CROCS-Kids’ Classic Clog CLR- Ice Blue/887350978360 Size 3,204536-4O9J3 CROCS-Kids’ Classic Clog CLR- Ice Blue/887350978360 Size 3,FBALYB Amazon,-2,-2,0,0,0,0
,204536-4O9J4 CROCS-Kids’ Classic Clog CLR- Ice Blue/191448462694 Size 4,204536-4O9J4 CROCS-Kids’ Classic Clog CLR- Ice Blue/191448462694 Size 4,Default Ridgefield,6,6,0,0,0,0
,204536-4O9J4 CROCS-Kids’ Classic Clog CLR- Ice Blue/191448462694 Size 4,204536-4O9J4 CROCS-Kids’ Classic Clog CLR- Ice Blue/191448462694 Size 4,FBALYB Amazon,-8,-8,0,0,0,0
,204536-4O9J5 CROCS-Kids’ Classic Clog CLR- Ice Blue/191448462700 Size 5,204536-4O9J5 CROCS-Kids’ Classic Clog CLR- Ice Blue/191448462700 Size 5,FBALYB Amazon,-1,-1,0,0,0,0
,204536-4O9J6 CROCS-Kids’ Classic Clog CLR- Ice Blue/191448462717 Size 6,204536-4O9J6 CROCS-Kids’ Classic Clog CLR- Ice Blue/191448462717 Size 6,FBALYB Amazon,-4,-4,0,0,0,0
,204536-530C11 CROCS-Kids’ Classic Clog CLR- Lavender/191448191211 Size 11,204536-530C11 CROCS-Kids’ Classic Clog CLR- Lavender/191448191211 Size 11,Default Ridgefield,10,10,0,0,0,0
,204536-530C11 CROCS-Kids’ Classic Clog CLR- Lavender/191448191211 Size 11,204536-530C11 CROCS-Kids’ Classic Clog CLR- Lavender/191448191211 Size 11,FBALYB Amazon,-2,-2,0,0,0,0
,204536-530C12 CROCS-Kids’ Classic Clog CLR- Lavender/191448191228 Size 12,204536-530C12 CROCS-Kids’ Classic Clog CLR- Lavender/191448191228 Size 12,Default Ridgefield,10,10,0,0,0,0
,204536-530C12 CROCS-Kids’ Classic Clog CLR- Lavender/191448191228 Size 12,204536-530C12 CROCS-Kids’ Classic Clog CLR- Lavender/191448191228 Size 12,FBALYB Amazon,-1,-1,0,0,0,0
,204536-530C13 CROCS-Kids’ Classic Clog CLR- Lavender/191448191235 Size 13,204536-530C13 CROCS-Kids’ Classic Clog CLR- Lavender/191448191235 Size 13,Default Ridgefield,20,20,0,0,0,0
,204536-530C4 CROCS-Kids’ Classic Clog CLR- Lavender/191448191242 Size 4,204536-530C4 CROCS-Kids’ Classic Clog CLR- Lavender/191448191242 Size 4,FBALYB Amazon,-1,-1,0,0,0,0
,204536-530C5 CROCS-Kids’ Classic Clog CLR- Lavender/191448191259 Size 5,204536-530C5 CROCS-Kids’ Classic Clog CLR- Lavender/191448191259 Size 5,FBALYB Amazon,-1,-2,1,0,1,0
,204536-530C7 CROCS-Kids’ Classic Clog CLR- Lavender/191448191273 Size 7,204536-530C7 CROCS-Kids’ Classic Clog CLR- Lavender/191448191273 Size 7,FBALYB Amazon,0,0,0,1,0,0
,204536-530J1 CROCS-Kids’ Classic Clog CLR- Lavender/191448191303 Size 1,204536-530J1 CROCS-Kids’ Classic Clog CLR- Lavender/191448191303 Size 1,Default Ridgefield,209,209,0,0,0,0
,204536-530J1 CROCS-Kids’ Classic Clog CLR- Lavender/191448191303 Size 1,204536-530J1 CROCS-Kids’ Classic Clog CLR- Lavender/191448191303 Size 1,FBALYB Amazon,-2,-2,0,0,0,0
,204536-530J2 CROCS-Kids’ Classic Clog CLR- Lavender/191448191310 Size 2,204536-530J2 CROCS-Kids’ Classic Clog CLR- Lavender/191448191310 Size 2,Default Ridgefield,35,35,0,0,0,0
,204536-530J2 CROCS-Kids’ Classic Clog CLR- Lavender/191448191310 Size 2,204536-530J2 CROCS-Kids’ Classic Clog CLR- Lavender/191448191310 Size 2,FBALYB Amazon,1,0,1,0,1,0
,204536-530J3 CROCS-Kids’ Classic Clog CLR- Lavender/191448191327 Size 3,204536-530J3 CROCS-Kids’ Classic Clog CLR- Lavender/191448191327 Size 3,Default Ridgefield,170,170,0,0,0,0
,204536-530J3 CROCS-Kids’ Classic Clog CLR- Lavender/191448191327 Size 3,204536-530J3 CROCS-Kids’ Classic Clog CLR- Lavender/191448191327 Size 3,FBALYB Amazon,-3,-3,0,0,0,0
,204536-530J4 CROCS-Kids’ Classic Clog CLR- Lavender/191448428225 Size 4,204536-530J4 CROCS-Kids’ Classic Clog CLR- Lavender/191448428225 Size 4,Default Ridgefield,50,50,0,0,0,0
,204536-530J4 CROCS-Kids’ Classic Clog CLR- Lavender/191448428225 Size 4,204536-530J4 CROCS-Kids’ Classic Clog CLR- Lavender/191448428225 Size 4,FBALYB Amazon,-7,-7,0,0,0,0
,204536-530J5 CROCS-Kids’ Classic Clog CLR- Lavender/191448428232 Size 5,204536-530J5 CROCS-Kids’ Classic Clog CLR- Lavender/191448428232 Size 5,Default Ridgefield,112,112,0,0,0,0
,204536-530J5 CROCS-Kids’ Classic Clog CLR- Lavender/191448428232 Size 5,204536-530J5 CROCS-Kids’ Classic Clog CLR- Lavender/191448428232 Size 5,FBALYB Amazon,2,-2,4,0,4,0
,204536-530J6 CROCS-Kids’ Classic Clog CLR- Lavender/191448428249 Size 6,204536-530J6 CROCS-Kids’ Classic Clog CLR- Lavender/191448428249 Size 6,Default Ridgefield,85,85,0,0,0,0
,204536-530J6 CROCS-Kids’ Classic Clog CLR- Lavender/191448428249 Size 6,204536-530J6 CROCS-Kids’ Classic Clog CLR- Lavender/191448428249 Size 6,FBALYB Amazon,-8,-8,0,0,0,0
,204536-6ENC10 CROCS-Kids’ Classic Clog CLR- Pepper/887350923308 Size 10,204536-6ENC10 CROCS-Kids’ Classic Clog CLR- Pepper/887350923308 Size 10,FBALYB Amazon,-3,-3,0,0,0,0
,204536-6ENC11 CROCS-Kids’ Classic Clog CLR- Pepper/887350923315 Size 11,204536-6ENC11 CROCS-Kids’ Classic Clog CLR- Pepper/887350923315 Size 11,Default Ridgefield,18,18,0,0,0,0
,204536-6ENC11 CROCS-Kids’ Classic Clog CLR- Pepper/887350923315 Size 11,204536-6ENC11 CROCS-Kids’ Classic Clog CLR- Pepper/887350923315 Size 11,FBALYB Amazon,-2,-2,0,0,0,0
,204536-6ENC12 CROCS-Kids’ Classic Clog CLR- Pepper/887350923322 Size 12,204536-6ENC12 CROCS-Kids’ Classic Clog CLR- Pepper/887350923322 Size 12,Default Ridgefield,19,19,0,0,0,0
,204536-6ENC12 CROCS-Kids’ Classic Clog CLR- Pepper/887350923322 Size 12,204536-6ENC12 CROCS-Kids’ Classic Clog CLR- Pepper/887350923322 Size 12,FBALYB Amazon,-1,-1,0,0,0,0
,204536-6ENC13 CROCS-Kids’ Classic Clog CLR- Pepper/887350923339 Size 13,204536-6ENC13 CROCS-Kids’ Classic Clog CLR- Pepper/887350923339 Size 13,Default Ridgefield,18,18,0,0,0,0
,204536-6ENC4 CROCS-Kids’ Classic Clog CLR- Pepper/887350923346 Size 4,204536-6ENC4 CROCS-Kids’ Classic Clog CLR- Pepper/887350923346 Size 4,FBALYB Amazon,-2,-2,0,0,0,0
,204536-6ENC5 CROCS-Kids’ Classic Clog CLR- Pepper/887350923353 Size 5,204536-6ENC5 CROCS-Kids’ Classic Clog CLR- Pepper/887350923353 Size 5,Default Ridgefield,18,18,0,0,0,0
,204536-6ENC6 CROCS-Kids’ Classic Clog CLR- Pepper/887350923360 Size 6,204536-6ENC6 CROCS-Kids’ Classic Clog CLR- Pepper/887350923360 Size 6,FBALYB Amazon,16,16,0,0,0,0
,204536-6ENC7 CROCS-Kids’ Classic Clog CLR- Pepper/887350923377 Size 7,204536-6ENC7 CROCS-Kids’ Classic Clog CLR- Pepper/887350923377 Size 7,FBALYB Amazon,-4,-4,0,0,0,0
,204536-6ENC8 CROCS-Kids’ Classic Clog CLR- Pepper/887350923384 Size 8,204536-6ENC8 CROCS-Kids’ Classic Clog CLR- Pepper/887350923384 Size 8,FBALYB Amazon,-1,-1,0,0,0,0
,204536-6ENJ1 CROCS-Kids’ Classic Clog CLR- Pepper/887350923407 Size 1,204536-6ENJ1 CROCS-Kids’ Classic Clog CLR- Pepper/887350923407 Size 1,Default Ridgefield,94,94,0,0,0,0
,204536-6ENJ1 CROCS-Kids’ Classic Clog CLR- Pepper/887350923407 Size 1,204536-6ENJ1 CROCS-Kids’ Classic Clog CLR- Pepper/887350923407 Size 1,FBALYB Amazon,47,47,0,0,0,0
,204536-6ENJ2 CROCS-Kids’ Classic Clog CLR- Pepper/887350923414 Size 2,204536-6ENJ2 CROCS-Kids’ Classic Clog CLR- Pepper/887350923414 Size 2,Default Ridgefield,32,32,0,0,0,0
,204536-6ENJ2 CROCS-Kids’ Classic Clog CLR- Pepper/887350923414 Size 2,204536-6ENJ2 CROCS-Kids’ Classic Clog CLR- Pepper/887350923414 Size 2,FBALYB Amazon,-1,-1,0,0,0,0
,204536-6ENJ3 CROCS-Kids’ Classic Clog CLR- Pepper/887350923421 Size 3,204536-6ENJ3 CROCS-Kids’ Classic Clog CLR- Pepper/887350923421 Size 3,Default Ridgefield,78,78,0,0,0,0
,204536-6ENJ3 CROCS-Kids’ Classic Clog CLR- Pepper/887350923421 Size 3,204536-6ENJ3 CROCS-Kids’ Classic Clog CLR- Pepper/887350923421 Size 3,FBALYB Amazon,36,34,2,0,2,0
,204536-6ENJ4 CROCS-Kids’ Classic Clog CLR- Pepper/191448428256 Size 4,204536-6ENJ4 CROCS-Kids’ Classic Clog CLR- Pepper/191448428256 Size 4,Default Ridgefield,45,45,0,0,0,0
,204536-6ENJ4 CROCS-Kids’ Classic Clog CLR- Pepper/191448428256 Size 4,204536-6ENJ4 CROCS-Kids’ Classic Clog CLR- Pepper/191448428256 Size 4,FBALYB Amazon,-5,-5,0,0,0,0
,204536-6ENJ5 CROCS-Kids’ Classic Clog CLR- Pepper/191448428263 Size 5,204536-6ENJ5 CROCS-Kids’ Classic Clog CLR- Pepper/191448428263 Size 5,Default Ridgefield,101,101,0,0,0,0
,204536-6ENJ5 CROCS-Kids’ Classic Clog CLR- Pepper/191448428263 Size 5,204536-6ENJ5 CROCS-Kids’ Classic Clog CLR- Pepper/191448428263 Size 5,FBALYB Amazon,48,48,0,0,0,0
,204536-6ENJ6 CROCS-Kids’ Classic Clog CLR- Pepper/191448428270 Size 6,204536-6ENJ6 CROCS-Kids’ Classic Clog CLR- Pepper/191448428270 Size 6,Default Ridgefield,154,154,0,0,0,0
,204536-6QQC10 CROCS-Kids’ Classic Clog CLR- Electric Pink/191448543713 Size 10,204536-6QQC10 CROCS-Kids’ Classic Clog CLR- Electric Pink/191448543713 Size 10,FBALYB Amazon,-2,-2,0,0,0,0
,204536-6QQC11 CROCS-Kids’ Classic Clog CLR- Electric Pink/191448543720 Size 11,204536-6QQC11 CROCS-Kids’ Classic Clog CLR- Electric Pink/191448543720 Size 11,Default Ridgefield,11,11,0,0,0,0
,204536-6QQC11 CROCS-Kids’ Classic Clog CLR- Electric Pink/191448543720 Size 11,204536-6QQC11 CROCS-Kids’ Classic Clog CLR- Electric Pink/191448543720 Size 11,FBALYB Amazon,-1,-1,0,0,0,0
,204536-6QQC12 CROCS-Kids’ Classic Clog CLR- Electric Pink/191448543737 Size 12,204536-6QQC12 CROCS-Kids’ Classic Clog CLR- Electric Pink/191448543737 Size 12,Default Ridgefield,3,3,0,0,0,0
,204536-6QQC13 CROCS-Kids’ Classic Clog CLR- Electric Pink/191448543744 Size 13,204536-6QQC13 CROCS-Kids’ Classic Clog CLR- Electric Pink/191448543744 Size 13,Default Ridgefield,3,3,0,0,0,0
,204536-6QQC13 CROCS-Kids’ Classic Clog CLR- Electric Pink/191448543744 Size 13,204536-6QQC13 CROCS-Kids’ Classic Clog CLR- Electric Pink/191448543744 Size 13,FBALYB Amazon,-2,-2,0,0,0,0
,204536-6QQC4 CROCS-Kids’ Classic Clog CLR- Electric Pink/191448543751 Size 4,204536-6QQC4 CROCS-Kids’ Classic Clog CLR- Electric Pink/191448543751 Size 4,FBALYB Amazon,-4,-4,0,0,0,0
,204536-6QQC5 CROCS-Kids’ Classic Clog CLR- Electric Pink/191448543768 Size 5,204536-6QQC5 CROCS-Kids’ Classic Clog CLR- Electric Pink/191448543768 Size 5,FBALYB Amazon,-2,-2,0,0,0,0
,204536-6QQC6 CROCS-Kids’ Classic Clog CLR- Electric Pink/191448543775 Size 6,204536-6QQC6 CROCS-Kids’ Classic Clog CLR- Electric Pink/191448543775 Size 6,FBALYB Amazon,-2,-2,0,0,0,0
,204536-6QQC7 CROCS-Kids’ Classic Clog CLR- Electric Pink/191448543782 Size 7,204536-6QQC7 CROCS-Kids’ Classic Clog CLR- Electric Pink/191448543782 Size 7,FBALYB Amazon,-1,-1,0,0,0,0
,204536-6QQC8 CROCS-Kids’ Classic Clog CLR- Electric Pink/191448543799 Size 8,204536-6QQC8 CROCS-Kids’ Classic Clog CLR- Electric Pink/191448543799 Size 8,FBALYB Amazon,-2,-2,0,0,0,0
,204536-6QQJ1 CROCS-Kids’ Classic Clog CLR- Electric Pink/191448543812 Size 1,204536-6QQJ1 CROCS-Kids’ Classic Clog CLR- Electric Pink/191448543812 Size 1,FBALYB Amazon,239,239,0,0,0,0
,204536-6QQJ2 CROCS-Kids’ Classic Clog CLR- Electric Pink/191448543829 Size 2,204536-6QQJ2 CROCS-Kids’ Classic Clog CLR- Electric Pink/191448543829 Size 2,Default Ridgefield,1,1,0,0,0,0
,204536-6QQJ2 CROCS-Kids’ Classic Clog CLR- Electric Pink/191448543829 Size 2,204536-6QQJ2 CROCS-Kids’ Classic Clog CLR- Electric Pink/191448543829 Size 2,FBALYB Amazon,47,47,0,0,0,0
,204536-6QQJ3 CROCS-Kids’ Classic Clog CLR- Electric Pink/191448543836 Size 3,204536-6QQJ3 CROCS-Kids’ Classic Clog CLR- Electric Pink/191448543836 Size 3,Default Ridgefield,152,152,0,0,0,0
,204536-6QQJ3 CROCS-Kids’ Classic Clog CLR- Electric Pink/191448543836 Size 3,204536-6QQJ3 CROCS-Kids’ Classic Clog CLR- Electric Pink/191448543836 Size 3,FBALYB Amazon,25,25,0,0,0,0
,204536-6QQJ4 CROCS-Kids’ Classic Clog CLR- Electric Pink/191448543843 Size 4,204536-6QQJ4 CROCS-Kids’ Classic Clog CLR- Electric Pink/191448543843 Size 4,Default Ridgefield,1,1,0,0,0,0
,204536-6QQJ4 CROCS-Kids’ Classic Clog CLR- Electric Pink/191448543843 Size 4,204536-6QQJ4 CROCS-Kids’ Classic Clog CLR- Electric Pink/191448543843 Size 4,FBALYB Amazon,41,41,0,0,0,0
,204536-6QQJ5 CROCS-Kids’ Classic Clog CLR- Electric Pink/191448543850 Size 5,204536-6QQJ5 CROCS-Kids’ Classic Clog CLR- Electric Pink/191448543850 Size 5,FBALYB Amazon,171,170,1,20,1,0
,204536-6QQJ6 CROCS-Kids’ Classic Clog CLR- Electric Pink/191448543867 Size 6,204536-6QQJ6 CROCS-Kids’ Classic Clog CLR- Electric Pink/191448543867 Size 6,FBALYB Amazon,38,38,0,0,0,0
,204536-7C1C10 CROCS-Kids’ Classic Clog CLR- Lemon/887350923698 Size 10,204536-7C1C10 CROCS-Kids’ Classic Clog CLR- Lemon/887350923698 Size 10,FBALYB Amazon,-2,-2,0,0,0,0
,204536-7C1C11 CROCS-Kids’ Classic Clog CLR- Lemon/887350923704 Size 11,204536-7C1C11 CROCS-Kids’ Classic Clog CLR- Lemon/887350923704 Size 11,FBALYB Amazon,-1,-1,0,0,0,0
,204536-7C1C12 CROCS-Kids’ Classic Clog CLR- Lemon/887350923711 Size 12,204536-7C1C12 CROCS-Kids’ Classic Clog CLR- Lemon/887350923711 Size 12,FBALYB Amazon,-2,-2,0,0,0,0
,204536-7C1C13 CROCS-Kids’ Classic Clog CLR- Lemon/887350923728 Size 13,204536-7C1C13 CROCS-Kids’ Classic Clog CLR- Lemon/887350923728 Size 13,FBALYB Amazon,-3,-3,0,0,0,0
,204536-7C1C4 CROCS-Kids’ Classic Clog CLR- Lemon/887350923735 Size 4,204536-7C1C4 CROCS-Kids’ Classic Clog CLR- Lemon/887350923735 Size 4,FBALYB Amazon,-6,-6,0,0,0,0
,204536-7C1C5 CROCS-Kids’ Classic Clog CLR- Lemon/887350923742 Size 5,204536-7C1C5 CROCS-Kids’ Classic Clog CLR- Lemon/887350923742 Size 5,FBALYB Amazon,0,-1,1,0,1,0
,204536-7C1C6 CROCS-Kids’ Classic Clog CLR- Lemon/887350923759 Size 6,204536-7C1C6 CROCS-Kids’ Classic Clog CLR- Lemon/887350923759 Size 6,FBALYB Amazon,-4,-4,0,0,0,0
,204536-7C1C7 CROCS-Kids’ Classic Clog CLR- Lemon/887350923766 Size 7,204536-7C1C7 CROCS-Kids’ Classic Clog CLR- Lemon/887350923766 Size 7,FBALYB Amazon,-6,-6,0,0,0,0
,204536-7C1C8 CROCS-Kids’ Classic Clog CLR- Lemon/887350923773 Size 8,204536-7C1C8 CROCS-Kids’ Classic Clog CLR- Lemon/887350923773 Size 8,FBALYB Amazon,-1,-1,0,0,0,0
,204536-7C1C9 CROCS-Kids’ Classic Clog CLR- Lemon/887350923780 Size 9,204536-7C1C9 CROCS-Kids’ Classic Clog CLR- Lemon/887350923780 Size 9,FBALYB Amazon,-1,-1,0,0,0,0
,204536-7C1J1 CROCS-Kids’ Classic Clog CLR- Lemon/887350923797 Size 1,204536-7C1J1 CROCS-Kids’ Classic Clog CLR- Lemon/887350923797 Size 1,Default Ridgefield,0,-18,18,0,0,0
,204536-7C1J1 CROCS-Kids’ Classic Clog CLR- Lemon/887350923797 Size 1,204536-7C1J1 CROCS-Kids’ Classic Clog CLR- Lemon/887350923797 Size 1,FBALYB Amazon,169,168,1,0,1,0
,204536-7C1J2 CROCS-Kids’ Classic Clog CLR- Lemon/887350923803 Size 2,204536-7C1J2 CROCS-Kids’ Classic Clog CLR- Lemon/887350923803 Size 2,FBALYB Amazon,-9,-9,0,0,0,0
,204536-7C1J3 CROCS-Kids’ Classic Clog CLR- Lemon/887350923810 Size 3,204536-7C1J3 CROCS-Kids’ Classic Clog CLR- Lemon/887350923810 Size 3,FBALYB Amazon,113,113,0,0,0,0
,204536-7C1J4 CROCS-Kids’ Classic Clog CLR- Lemon/191448428614 Size 4,204536-7C1J4 CROCS-Kids’ Classic Clog CLR- Lemon/191448428614 Size 4,FBALYB Amazon,-6,-6,0,0,0,0
,204536-7C1J5 CROCS-Kids’ Classic Clog CLR- Lemon/191448428621 Size 5,204536-7C1J5 CROCS-Kids’ Classic Clog CLR- Lemon/191448428621 Size 5,Default Ridgefield,1,1,0,0,0,0
,204536-7C1J5 CROCS-Kids’ Classic Clog CLR- Lemon/191448428621 Size 5,204536-7C1J5 CROCS-Kids’ Classic Clog CLR- Lemon/191448428621 Size 5,FBALYB Amazon,44,41,3,0,3,0
,204536-7C1J6 CROCS-Kids’ Classic Clog CLR- Lemon/191448428638 Size 6,204536-7C1J6 CROCS-Kids’ Classic Clog CLR- Lemon/191448428638 Size 6,FBALYB Amazon,9,7,2,1,2,0
,204537-05HC10 CROCS-Kids’ CRObandTM Clog CLR- Smoke/Navy/887350943863 Size 10,204537-05HC10 CROCS-Kids’ CRObandTM Clog CLR- Smoke/Navy/887350943863 Size 10,Default Ridgefield,94,94,0,0,0,24
,204537-05HC10 CROCS-Kids’ CRObandTM Clog CLR- Smoke/Navy/887350943863 Size 10,204537-05HC10 CROCS-Kids’ CRObandTM Clog CLR- Smoke/Navy/887350943863 Size 10,FBALYB Amazon,-16,-17,1,0,1,0
,204537-05HC11 CROCS-Kids’ CRObandTM Clog CLR- Smoke/Navy/887350943870 Size 11,204537-05HC11 CROCS-Kids’ CRObandTM Clog CLR- Smoke/Navy/887350943870 Size 11,Default Ridgefield,95,95,0,0,0,12
,204537-05HC11 CROCS-Kids’ CRObandTM Clog CLR- Smoke/Navy/887350943870 Size 11,204537-05HC11 CROCS-Kids’ CRObandTM Clog CLR- Smoke/Navy/887350943870 Size 11,FBALYB Amazon,-11,-13,2,0,2,0
,204537-05HC12 CROCS-Kids’ CRObandTM Clog CLR- Smoke/Navy/887350943887 Size 12,204537-05HC12 CROCS-Kids’ CRObandTM Clog CLR- Smoke/Navy/887350943887 Size 12,Default Ridgefield,144,144,0,0,0,12
,204537-05HC12 CROCS-Kids’ CRObandTM Clog CLR- Smoke/Navy/887350943887 Size 12,204537-05HC12 CROCS-Kids’ CRObandTM Clog CLR- Smoke/Navy/887350943887 Size 12,FBALYB Amazon,-4,-4,0,0,0,0
,204537-05HC13 CROCS-Kids’ CRObandTM Clog CLR- Smoke/Navy/887350943894 Size 13,204537-05HC13 CROCS-Kids’ CRObandTM Clog CLR- Smoke/Navy/887350943894 Size 13,Default Ridgefield,95,95,0,0,0,24
,204537-05HC13 CROCS-Kids’ CRObandTM Clog CLR- Smoke/Navy/887350943894 Size 13,204537-05HC13 CROCS-Kids’ CRObandTM Clog CLR- Smoke/Navy/887350943894 Size 13,FBALYB Amazon,-8,-10,2,0,2,0
,204537-05HC4 CROCS-Kids’ CRObandTM Clog CLR- Smoke/Navy/887350943900 Size 4,204537-05HC4 CROCS-Kids’ CRObandTM Clog CLR- Smoke/Navy/887350943900 Size 4,FBALYB Amazon,-9,-9,0,0,0,0
,204537-05HC5 CROCS-Kids’ CRObandTM Clog CLR- Smoke/Navy/887350943917 Size 5,204537-05HC5 CROCS-Kids’ CRObandTM Clog CLR- Smoke/Navy/887350943917 Size 5,FBALYB Amazon,9,9,0,0,0,0
,204537-05HC6 CROCS-Kids’ CRObandTM Clog CLR- Smoke/Navy/887350943924 Size 6,204537-05HC6 CROCS-Kids’ CRObandTM Clog CLR- Smoke/Navy/887350943924 Size 6,Default Ridgefield,48,48,0,0,0,0
,204537-05HC6 CROCS-Kids’ CRObandTM Clog CLR- Smoke/Navy/887350943924 Size 6,204537-05HC6 CROCS-Kids’ CRObandTM Clog CLR- Smoke/Navy/887350943924 Size 6,FBALYB Amazon,-12,-12,0,0,0,0
,204537-05HC7 CROCS-Kids’ CRObandTM Clog CLR- Smoke/Navy/887350943931 Size 7,204537-05HC7 CROCS-Kids’ CRObandTM Clog CLR- Smoke/Navy/887350943931 Size 7,Default Ridgefield,53,53,0,0,0,0
,204537-05HC7 CROCS-Kids’ CRObandTM Clog CLR- Smoke/Navy/887350943931 Size 7,204537-05HC7 CROCS-Kids’ CRObandTM Clog CLR- Smoke/Navy/887350943931 Size 7,FBALYB Amazon,3,3,0,0,0,0
,204537-05HC8 CROCS-Kids’ CRObandTM Clog CLR- Smoke/Navy/887350943948 Size 8,204537-05HC8 CROCS-Kids’ CRObandTM Clog CLR- Smoke/Navy/887350943948 Size 8,Default Ridgefield,96,96,0,0,0,0
,204537-05HC8 CROCS-Kids’ CRObandTM Clog CLR- Smoke/Navy/887350943948 Size 8,204537-05HC8 CROCS-Kids’ CRObandTM Clog CLR- Smoke/Navy/887350943948 Size 8,FBALYB Amazon,106,106,0,0,0,0
,204537-05HC9 CROCS-Kids’ CRObandTM Clog CLR- Smoke/Navy/887350943955 Size 9,204537-05HC9 CROCS-Kids’ CRObandTM Clog CLR- Smoke/Navy/887350943955 Size 9,Default Ridgefield,1,1,0,0,0,0
,204537-05HC9 CROCS-Kids’ CRObandTM Clog CLR- Smoke/Navy/887350943955 Size 9,204537-05HC9 CROCS-Kids’ CRObandTM Clog CLR- Smoke/Navy/887350943955 Size 9,FBALYB Amazon,100,99,1,0,1,0
,204537-05HJ1 CROCS-Kids’ CRObandTM Clog CLR- Smoke/Navy/887350943962 Size 1,204537-05HJ1 CROCS-Kids’ CRObandTM Clog CLR- Smoke/Navy/887350943962 Size 1,Default Ridgefield,1,1,0,0,0,12
,204537-05HJ1 CROCS-Kids’ CRObandTM Clog CLR- Smoke/Navy/887350943962 Size 1,204537-05HJ1 CROCS-Kids’ CRObandTM Clog CLR- Smoke/Navy/887350943962 Size 1,FBALYB Amazon,-2,-6,4,0,4,0
,204537-05HJ2 CROCS-Kids’ CRObandTM Clog CLR- Smoke/Navy/887350943979 Size 2,204537-05HJ2 CROCS-Kids’ CRObandTM Clog CLR- Smoke/Navy/887350943979 Size 2,Default Ridgefield,48,48,0,0,0,0
,204537-05HJ2 CROCS-Kids’ CRObandTM Clog CLR- Smoke/Navy/887350943979 Size 2,204537-05HJ2 CROCS-Kids’ CRObandTM Clog CLR- Smoke/Navy/887350943979 Size 2,FBALYB Amazon,-5,-5,0,0,0,0
,204537-05HJ3 CROCS-Kids’ CRObandTM Clog CLR- Smoke/Navy/887350943986 Size 3,204537-05HJ3 CROCS-Kids’ CRObandTM Clog CLR- Smoke/Navy/887350943986 Size 3,Default Ridgefield,33,33,0,0,0,12
,204537-05HJ3 CROCS-Kids’ CRObandTM Clog CLR- Smoke/Navy/887350943986 Size 3,204537-05HJ3 CROCS-Kids’ CRObandTM Clog CLR- Smoke/Navy/887350943986 Size 3,FBALYB Amazon,16,16,0,0,0,0
,204537-05HJ4 CROCS-Kids’ CRObandTM Clog CLR- Smoke/Navy/191448427433 Size 4,204537-05HJ4 CROCS-Kids’ CRObandTM Clog CLR- Smoke/Navy/191448427433 Size 4,Default Ridgefield,0,0,0,0,0,71
,204537-05HJ4 CROCS-Kids’ CRObandTM Clog CLR- Smoke/Navy/191448427433 Size 4,204537-05HJ4 CROCS-Kids’ CRObandTM Clog CLR- Smoke/Navy/191448427433 Size 4,FBALYB Amazon,2,1,1,0,1,0
,204537-05HJ5 CROCS-Kids’ CRObandTM Clog CLR- Smoke/Navy/191448427457 Size 5,204537-05HJ5 CROCS-Kids’ CRObandTM Clog CLR- Smoke/Navy/191448427457 Size 5,Default Ridgefield,0,0,0,0,0,143
,204537-05HJ5 CROCS-Kids’ CRObandTM Clog CLR- Smoke/Navy/191448427457 Size 5,204537-05HJ5 CROCS-Kids’ CRObandTM Clog CLR- Smoke/Navy/191448427457 Size 5,FBALYB Amazon,-5,-9,4,0,4,0
,204537-05HJ6 CROCS-Kids’ CRObandTM Clog CLR- Smoke/Navy/191448427471 Size 6,204537-05HJ6 CROCS-Kids’ CRObandTM Clog CLR- Smoke/Navy/191448427471 Size 6,Default Ridgefield,0,0,0,0,0,95
,204537-05HJ6 CROCS-Kids’ CRObandTM Clog CLR- Smoke/Navy/191448427471 Size 6,204537-05HJ6 CROCS-Kids’ CRObandTM Clog CLR- Smoke/Navy/191448427471 Size 6,FBALYB Amazon,8,-1,9,0,9,0
,204537-3TVC10 CROCS-Kids’ CRObandTM Clog CLR- Deep Green/Prep Blue/191448445673 Size 10,204537-3TVC10 CROCS-Kids’ CRObandTM Clog CLR- Deep Green/Prep Blue/191448445673 Size 10,Default Ridgefield,72,72,0,0,0,0
,204537-3TVC10 CROCS-Kids’ CRObandTM Clog CLR- Deep Green/Prep Blue/191448445673 Size 10,204537-3TVC10 CROCS-Kids’ CRObandTM Clog CLR- Deep Green/Prep Blue/191448445673 Size 10,FBALYB Amazon,2,-1,3,0,3,0
,204537-3TVC11 CROCS-Kids’ CRObandTM Clog CLR- Deep Green/Prep Blue/191448445680 Size 11,204537-3TVC11 CROCS-Kids’ CRObandTM Clog CLR- Deep Green/Prep Blue/191448445680 Size 11,Default Ridgefield,72,72,0,0,0,0
,204537-3TVC11 CROCS-Kids’ CRObandTM Clog CLR- Deep Green/Prep Blue/191448445680 Size 11,204537-3TVC11 CROCS-Kids’ CRObandTM Clog CLR- Deep Green/Prep Blue/191448445680 Size 11,FBALYB Amazon,-3,-3,0,0,0,0
,204537-3TVC12 CROCS-Kids’ CRObandTM Clog CLR- Deep Green/Prep Blue/191448445697 Size 12,204537-3TVC12 CROCS-Kids’ CRObandTM Clog CLR- Deep Green/Prep Blue/191448445697 Size 12,Default Ridgefield,72,72,0,0,0,0
,204537-3TVC12 CROCS-Kids’ CRObandTM Clog CLR- Deep Green/Prep Blue/191448445697 Size 12,204537-3TVC12 CROCS-Kids’ CRObandTM Clog CLR- Deep Green/Prep Blue/191448445697 Size 12,FBALYB Amazon,-4,-4,0,0,0,0
,204537-3TVC13 CROCS-Kids’ CRObandTM Clog CLR- Deep Green/Prep Blue/191448445703 Size 13,204537-3TVC13 CROCS-Kids’ CRObandTM Clog CLR- Deep Green/Prep Blue/191448445703 Size 13,Default Ridgefield,48,48,0,0,0,0
,204537-3TVC13 CROCS-Kids’ CRObandTM Clog CLR- Deep Green/Prep Blue/191448445703 Size 13,204537-3TVC13 CROCS-Kids’ CRObandTM Clog CLR- Deep Green/Prep Blue/191448445703 Size 13,FBALYB Amazon,-1,-1,0,0,0,0
,204537-3TVC4 CROCS-Kids’ CRObandTM Clog CLR- Deep Green/Prep Blue/191448445710 Size 4,204537-3TVC4 CROCS-Kids’ CRObandTM Clog CLR- Deep Green/Prep Blue/191448445710 Size 4,FBALYB Amazon,-2,-2,0,0,0,0
,204537-3TVC5 CROCS-Kids’ CRObandTM Clog CLR- Deep Green/Prep Blue/191448445727 Size 5,204537-3TVC5 CROCS-Kids’ CRObandTM Clog CLR- Deep Green/Prep Blue/191448445727 Size 5,FBALYB Amazon,4,3,1,0,1,0
,204537-3TVC6 CROCS-Kids’ CRObandTM Clog CLR- Deep Green/Prep Blue/191448445734 Size 6,204537-3TVC6 CROCS-Kids’ CRObandTM Clog CLR- Deep Green/Prep Blue/191448445734 Size 6,Default Ridgefield,24,24,0,0,0,0
,204537-3TVC6 CROCS-Kids’ CRObandTM Clog CLR- Deep Green/Prep Blue/191448445734 Size 6,204537-3TVC6 CROCS-Kids’ CRObandTM Clog CLR- Deep Green/Prep Blue/191448445734 Size 6,FBALYB Amazon,16,16,0,0,0,0
,204537-3TVC7 CROCS-Kids’ CRObandTM Clog CLR- Deep Green/Prep Blue/191448445741 Size 7,204537-3TVC7 CROCS-Kids’ CRObandTM Clog CLR- Deep Green/Prep Blue/191448445741 Size 7,Default Ridgefield,48,48,0,0,0,0
,204537-3TVC8 CROCS-Kids’ CRObandTM Clog CLR- Deep Green/Prep Blue/191448445758 Size 8,204537-3TVC8 CROCS-Kids’ CRObandTM Clog CLR- Deep Green/Prep Blue/191448445758 Size 8,Default Ridgefield,48,48,0,0,0,0
,204537-3TVC8 CROCS-Kids’ CRObandTM Clog CLR- Deep Green/Prep Blue/191448445758 Size 8,204537-3TVC8 CROCS-Kids’ CRObandTM Clog CLR- Deep Green/Prep Blue/191448445758 Size 8,FBALYB Amazon,-3,-4,1,0,1,0
,204537-3TVC9 CROCS-Kids’ CRObandTM Clog CLR- Deep Green/Prep Blue/191448445765 Size 9,204537-3TVC9 CROCS-Kids’ CRObandTM Clog CLR- Deep Green/Prep Blue/191448445765 Size 9,Default Ridgefield,90,90,0,0,0,0
,204537-3TVC9 CROCS-Kids’ CRObandTM Clog CLR- Deep Green/Prep Blue/191448445765 Size 9,204537-3TVC9 CROCS-Kids’ CRObandTM Clog CLR- Deep Green/Prep Blue/191448445765 Size 9,FBALYB Amazon,-1,-1,0,0,0,0
,204537-3TVJ1 CROCS-Kids’ CRObandTM Clog CLR- Deep Green/Prep Blue/191448445772 Size 1,204537-3TVJ1 CROCS-Kids’ CRObandTM Clog CLR- Deep Green/Prep Blue/191448445772 Size 1,Default Ridgefield,24,24,0,0,0,0
,204537-3TVJ1 CROCS-Kids’ CRObandTM Clog CLR- Deep Green/Prep Blue/191448445772 Size 1,204537-3TVJ1 CROCS-Kids’ CRObandTM Clog CLR- Deep Green/Prep Blue/191448445772 Size 1,FBALYB Amazon,-5,-5,0,0,0,0
,204537-3TVJ2 CROCS-Kids’ CRObandTM Clog CLR- Deep Green/Prep Blue/191448445789 Size 2,204537-3TVJ2 CROCS-Kids’ CRObandTM Clog CLR- Deep Green/Prep Blue/191448445789 Size 2,Default Ridgefield,24,24,0,0,0,0
,204537-3TVJ2 CROCS-Kids’ CRObandTM Clog CLR- Deep Green/Prep Blue/191448445789 Size 2,204537-3TVJ2 CROCS-Kids’ CRObandTM Clog CLR- Deep Green/Prep Blue/191448445789 Size 2,FBALYB Amazon,-8,-8,0,0,0,0
,204537-3TVJ3 CROCS-Kids’ CRObandTM Clog CLR- Deep Green/Prep Blue/191448445796 Size 3,204537-3TVJ3 CROCS-Kids’ CRObandTM Clog CLR- Deep Green/Prep Blue/191448445796 Size 3,Default Ridgefield,24,24,0,0,0,0
,204537-3TVJ3 CROCS-Kids’ CRObandTM Clog CLR- Deep Green/Prep Blue/191448445796 Size 3,204537-3TVJ3 CROCS-Kids’ CRObandTM Clog CLR- Deep Green/Prep Blue/191448445796 Size 3,FBALYB Amazon,-4,-4,0,0,0,0
,204537-3TVJ4 CROCS-Kids’ CRObandTM Clog CLR- Deep Green/Prep Blue/191448445802 Size 4,204537-3TVJ4 CROCS-Kids’ CRObandTM Clog CLR- Deep Green/Prep Blue/191448445802 Size 4,Default Ridgefield,24,24,0,0,0,0
,204537-3TVJ4 CROCS-Kids’ CRObandTM Clog CLR- Deep Green/Prep Blue/191448445802 Size 4,204537-3TVJ4 CROCS-Kids’ CRObandTM Clog CLR- Deep Green/Prep Blue/191448445802 Size 4,FBALYB Amazon,0,-1,1,0,1,0
,204537-3TVJ5 CROCS-Kids’ CRObandTM Clog CLR- Deep Green/Prep Blue/191448445819 Size 5,204537-3TVJ5 CROCS-Kids’ CRObandTM Clog CLR- Deep Green/Prep Blue/191448445819 Size 5,Default Ridgefield,24,24,0,0,0,0
,204537-3TVJ6 CROCS-Kids’ CRObandTM Clog CLR- Deep Green/Prep Blue/191448445826 Size 6,204537-3TVJ6 CROCS-Kids’ CRObandTM Clog CLR- Deep Green/Prep Blue/191448445826 Size 6,Default Ridgefield,24,24,0,0,0,0
,204537-3TVJ6 CROCS-Kids’ CRObandTM Clog CLR- Deep Green/Prep Blue/191448445826 Size 6,204537-3TVJ6 CROCS-Kids’ CRObandTM Clog CLR- Deep Green/Prep Blue/191448445826 Size 6,FBALYB Amazon,10,7,3,0,3,0
,204537-485C10 CROCS-Kids’ CRObandTM Clog CLR- Navy/Red/887350924473 Size 10,204537-485C10 CROCS-Kids’ CRObandTM Clog CLR- Navy/Red/887350924473 Size 10,Default Ridgefield,0,0,0,0,0,46
,204537-485C10 CROCS-Kids’ CRObandTM Clog CLR- Navy/Red/887350924473 Size 10,204537-485C10 CROCS-Kids’ CRObandTM Clog CLR- Navy/Red/887350924473 Size 10,FBALYB Amazon,113,97,16,0,16,0
,204537-485C11 CROCS-Kids’ CRObandTM Clog CLR- Navy/Red/887350924480 Size 11,204537-485C11 CROCS-Kids’ CRObandTM Clog CLR- Navy/Red/887350924480 Size 11,Default Ridgefield,0,0,0,0,0,34
,204537-485C11 CROCS-Kids’ CRObandTM Clog CLR- Navy/Red/887350924480 Size 11,204537-485C11 CROCS-Kids’ CRObandTM Clog CLR- Navy/Red/887350924480 Size 11,FBALYB Amazon,252,247,5,0,5,0
,204537-485C12 CROCS-Kids’ CRObandTM Clog CLR- Navy/Red/887350924497 Size 12,204537-485C12 CROCS-Kids’ CRObandTM Clog CLR- Navy/Red/887350924497 Size 12,Default Ridgefield,118,118,0,0,0,46
,204537-485C12 CROCS-Kids’ CRObandTM Clog CLR- Navy/Red/887350924497 Size 12,204537-485C12 CROCS-Kids’ CRObandTM Clog CLR- Navy/Red/887350924497 Size 12,FBALYB Amazon,-19,-25,6,1,6,0
,204537-485C13 CROCS-Kids’ CRObandTM Clog CLR- Navy/Red/887350924503 Size 13,204537-485C13 CROCS-Kids’ CRObandTM Clog CLR- Navy/Red/887350924503 Size 13,Default Ridgefield,156,156,0,0,0,70
,204537-485C13 CROCS-Kids’ CRObandTM Clog CLR- Navy/Red/887350924503 Size 13,204537-485C13 CROCS-Kids’ CRObandTM Clog CLR- Navy/Red/887350924503 Size 13,FBALYB Amazon,-4,-8,4,0,4,0
,204537-485C4 CROCS-Kids’ CRObandTM Clog CLR- Navy/Red/887350924510 Size 4,204537-485C4 CROCS-Kids’ CRObandTM Clog CLR- Navy/Red/887350924510 Size 4,FBALYB Amazon,-8,-8,0,0,0,0
,204537-485C5 CROCS-Kids’ CRObandTM Clog CLR- Navy/Red/887350924527 Size 5,204537-485C5 CROCS-Kids’ CRObandTM Clog CLR- Navy/Red/887350924527 Size 5,Default Ridgefield,1,1,0,0,0,0
,204537-485C5 CROCS-Kids’ CRObandTM Clog CLR- Navy/Red/887350924527 Size 5,204537-485C5 CROCS-Kids’ CRObandTM Clog CLR- Navy/Red/887350924527 Size 5,FBALYB Amazon,125,122,3,0,3,0
,204537-485C6 CROCS-Kids’ CRObandTM Clog CLR- Navy/Red/887350924534 Size 6,204537-485C6 CROCS-Kids’ CRObandTM Clog CLR- Navy/Red/887350924534 Size 6,Default Ridgefield,60,60,0,0,0,0
,204537-485C6 CROCS-Kids’ CRObandTM Clog CLR- Navy/Red/887350924534 Size 6,204537-485C6 CROCS-Kids’ CRObandTM Clog CLR- Navy/Red/887350924534 Size 6,FBALYB Amazon,14,6,8,0,8,0
,204537-485C7 CROCS-Kids’ CRObandTM Clog CLR- Navy/Red/887350924541 Size 7,204537-485C7 CROCS-Kids’ CRObandTM Clog CLR- Navy/Red/887350924541 Size 7,Default Ridgefield,0,0,0,0,0,30
,204537-485C7 CROCS-Kids’ CRObandTM Clog CLR- Navy/Red/887350924541 Size 7,204537-485C7 CROCS-Kids’ CRObandTM Clog CLR- Navy/Red/887350924541 Size 7,FBALYB Amazon,28,14,14,0,14,0
,204537-485C8 CROCS-Kids’ CRObandTM Clog CLR- Navy/Red/887350924558 Size 8,204537-485C8 CROCS-Kids’ CRObandTM Clog CLR- Navy/Red/887350924558 Size 8,Default Ridgefield,52,52,0,0,0,36
,204537-485C8 CROCS-Kids’ CRObandTM Clog CLR- Navy/Red/887350924558 Size 8,204537-485C8 CROCS-Kids’ CRObandTM Clog CLR- Navy/Red/887350924558 Size 8,FBALYB Amazon,485,471,14,1,14,0
,204537-485C9 CROCS-Kids’ CRObandTM Clog CLR- Navy/Red/887350924565 Size 9,204537-485C9 CROCS-Kids’ CRObandTM Clog CLR- Navy/Red/887350924565 Size 9,Default Ridgefield,0,0,0,0,0,48
,204537-485C9 CROCS-Kids’ CRObandTM Clog CLR- Navy/Red/887350924565 Size 9,204537-485C9 CROCS-Kids’ CRObandTM Clog CLR- Navy/Red/887350924565 Size 9,FBALYB Amazon,181,174,7,0,7,0
,204537-485J1 CROCS-Kids’ CRObandTM Clog CLR- Navy/Red/887350924572 Size 1,204537-485J1 CROCS-Kids’ CRObandTM Clog CLR- Navy/Red/887350924572 Size 1,Default Ridgefield,96,96,0,0,0,70
,204537-485J1 CROCS-Kids’ CRObandTM Clog CLR- Navy/Red/887350924572 Size 1,204537-485J1 CROCS-Kids’ CRObandTM Clog CLR- Navy/Red/887350924572 Size 1,FBALYB Amazon,-70,-76,6,0,6,0
,204537-485J2 CROCS-Kids’ CRObandTM Clog CLR- Navy/Red/887350924589 Size 2,204537-485J2 CROCS-Kids’ CRObandTM Clog CLR- Navy/Red/887350924589 Size 2,Default Ridgefield,0,0,0,0,0,80
,204537-485J2 CROCS-Kids’ CRObandTM Clog CLR- Navy/Red/887350924589 Size 2,204537-485J2 CROCS-Kids’ CRObandTM Clog CLR- Navy/Red/887350924589 Size 2,FBALYB Amazon,34,30,4,0,4,0
,204537-485J3 CROCS-Kids’ CRObandTM Clog CLR- Navy/Red/887350924596 Size 3,204537-485J3 CROCS-Kids’ CRObandTM Clog CLR- Navy/Red/887350924596 Size 3,Default Ridgefield,49,49,0,0,0,80
,204537-485J3 CROCS-Kids’ CRObandTM Clog CLR- Navy/Red/887350924596 Size 3,204537-485J3 CROCS-Kids’ CRObandTM Clog CLR- Navy/Red/887350924596 Size 3,FBALYB Amazon,7,5,2,0,2,0
,204537-485J4 CROCS-Kids’ CRObandTM Clog CLR- Navy/Red/191448427648 Size 4,204537-485J4 CROCS-Kids’ CRObandTM Clog CLR- Navy/Red/191448427648 Size 4,Default Ridgefield,3,3,0,0,0,140
,204537-485J4 CROCS-Kids’ CRObandTM Clog CLR- Navy/Red/191448427648 Size 4,204537-485J4 CROCS-Kids’ CRObandTM Clog CLR- Navy/Red/191448427648 Size 4,FBALYB Amazon,-14,-19,5,0,5,0
,204537-485J5 CROCS-Kids’ CRObandTM Clog CLR- Navy/Red/191448427655 Size 5,204537-485J5 CROCS-Kids’ CRObandTM Clog CLR- Navy/Red/191448427655 Size 5,Default Ridgefield,0,0,0,0,0,296
,204537-485J5 CROCS-Kids’ CRObandTM Clog CLR- Navy/Red/191448427655 Size 5,204537-485J5 CROCS-Kids’ CRObandTM Clog CLR- Navy/Red/191448427655 Size 5,FBALYB Amazon,7,3,4,0,4,0
,204537-485J6 CROCS-Kids’ CRObandTM Clog CLR- Navy/Red/191448427662 Size 6,204537-485J6 CROCS-Kids’ CRObandTM Clog CLR- Navy/Red/191448427662 Size 6,Default Ridgefield,48,47,1,0,0,164
,204537-485J6 CROCS-Kids’ CRObandTM Clog CLR- Navy/Red/191448427662 Size 6,204537-485J6 CROCS-Kids’ CRObandTM Clog CLR- Navy/Red/191448427662 Size 6,FBALYB Amazon,-29,-31,2,0,2,0
,204537-4JNC10 CROCS-Kids’ CRObandTM Clog CLR- Bright Cobalt/Charcoal/191448408135 Size 10,204537-4JNC10 CROCS-Kids’ CRObandTM Clog CLR- Bright Cobalt/Charcoal/191448408135 Size 10,Default Ridgefield,96,96,0,0,0,0
,204537-4JNC10 CROCS-Kids’ CRObandTM Clog CLR- Bright Cobalt/Charcoal/191448408135 Size 10,204537-4JNC10 CROCS-Kids’ CRObandTM Clog CLR- Bright Cobalt/Charcoal/191448408135 Size 10,FBALYB Amazon,34,32,2,0,2,0
,204537-4JNC11 CROCS-Kids’ CRObandTM Clog CLR- Bright Cobalt/Charcoal/191448408142 Size 11,204537-4JNC11 CROCS-Kids’ CRObandTM Clog CLR- Bright Cobalt/Charcoal/191448408142 Size 11,Default Ridgefield,88,88,0,0,0,0
,204537-4JNC11 CROCS-Kids’ CRObandTM Clog CLR- Bright Cobalt/Charcoal/191448408142 Size 11,204537-4JNC11 CROCS-Kids’ CRObandTM Clog CLR- Bright Cobalt/Charcoal/191448408142 Size 11,FBALYB Amazon,61,57,4,0,4,0
,204537-4JNC12 CROCS-Kids’ CRObandTM Clog CLR- Bright Cobalt/Charcoal/191448408159 Size 12,204537-4JNC12 CROCS-Kids’ CRObandTM Clog CLR- Bright Cobalt/Charcoal/191448408159 Size 12,Default Ridgefield,82,82,0,0,0,0
,204537-4JNC12 CROCS-Kids’ CRObandTM Clog CLR- Bright Cobalt/Charcoal/191448408159 Size 12,204537-4JNC12 CROCS-Kids’ CRObandTM Clog CLR- Bright Cobalt/Charcoal/191448408159 Size 12,FBALYB Amazon,1,-2,3,0,3,0
,204537-4JNC13 CROCS-Kids’ CRObandTM Clog CLR- Bright Cobalt/Charcoal/191448408166 Size 13,204537-4JNC13 CROCS-Kids’ CRObandTM Clog CLR- Bright Cobalt/Charcoal/191448408166 Size 13,Default Ridgefield,112,112,0,0,0,0
,204537-4JNC13 CROCS-Kids’ CRObandTM Clog CLR- Bright Cobalt/Charcoal/191448408166 Size 13,204537-4JNC13 CROCS-Kids’ CRObandTM Clog CLR- Bright Cobalt/Charcoal/191448408166 Size 13,FBALYB Amazon,-4,-4,0,0,0,0
,204537-4JNC4 CROCS-Kids’ CRObandTM Clog CLR- Bright Cobalt/Charcoal/191448408173 Size 4,204537-4JNC4 CROCS-Kids’ CRObandTM Clog CLR- Bright Cobalt/Charcoal/191448408173 Size 4,FBALYB Amazon,17,17,0,0,0,0
,204537-4JNC5 CROCS-Kids’ CRObandTM Clog CLR- Bright Cobalt/Charcoal/191448408180 Size 5,204537-4JNC5 CROCS-Kids’ CRObandTM Clog CLR- Bright Cobalt/Charcoal/191448408180 Size 5,Default Ridgefield,20,20,0,0,0,0
,204537-4JNC5 CROCS-Kids’ CRObandTM Clog CLR- Bright Cobalt/Charcoal/191448408180 Size 5,204537-4JNC5 CROCS-Kids’ CRObandTM Clog CLR- Bright Cobalt/Charcoal/191448408180 Size 5,FBALYB Amazon,-6,-6,0,0,0,0
,204537-4JNC6 CROCS-Kids’ CRObandTM Clog CLR- Bright Cobalt/Charcoal/191448408197 Size 6,204537-4JNC6 CROCS-Kids’ CRObandTM Clog CLR- Bright Cobalt/Charcoal/191448408197 Size 6,Default Ridgefield,39,39,0,0,0,0
,204537-4JNC6 CROCS-Kids’ CRObandTM Clog CLR- Bright Cobalt/Charcoal/191448408197 Size 6,204537-4JNC6 CROCS-Kids’ CRObandTM Clog CLR- Bright Cobalt/Charcoal/191448408197 Size 6,FBALYB Amazon,13,13,0,0,0,0
,204537-4JNC7 CROCS-Kids’ CRObandTM Clog CLR- Bright Cobalt/Charcoal/191448408203 Size 7,204537-4JNC7 CROCS-Kids’ CRObandTM Clog CLR- Bright Cobalt/Charcoal/191448408203 Size 7,Default Ridgefield,88,88,0,0,0,0
,204537-4JNC7 CROCS-Kids’ CRObandTM Clog CLR- Bright Cobalt/Charcoal/191448408203 Size 7,204537-4JNC7 CROCS-Kids’ CRObandTM Clog CLR- Bright Cobalt/Charcoal/191448408203 Size 7,FBALYB Amazon,-3,-3,0,0,0,0
,204537-4JNC8 CROCS-Kids’ CRObandTM Clog CLR- Bright Cobalt/Charcoal/191448408210 Size 8,204537-4JNC8 CROCS-Kids’ CRObandTM Clog CLR- Bright Cobalt/Charcoal/191448408210 Size 8,Default Ridgefield,81,81,0,0,0,0
,204537-4JNC8 CROCS-Kids’ CRObandTM Clog CLR- Bright Cobalt/Charcoal/191448408210 Size 8,204537-4JNC8 CROCS-Kids’ CRObandTM Clog CLR- Bright Cobalt/Charcoal/191448408210 Size 8,FBALYB Amazon,35,35,0,0,0,0
,204537-4JNC9 CROCS-Kids’ CRObandTM Clog CLR- Bright Cobalt/Charcoal/191448408227 Size 9,204537-4JNC9 CROCS-Kids’ CRObandTM Clog CLR- Bright Cobalt/Charcoal/191448408227 Size 9,Default Ridgefield,99,99,0,0,0,0
,204537-4JNC9 CROCS-Kids’ CRObandTM Clog CLR- Bright Cobalt/Charcoal/191448408227 Size 9,204537-4JNC9 CROCS-Kids’ CRObandTM Clog CLR- Bright Cobalt/Charcoal/191448408227 Size 9,FBALYB Amazon,87,85,2,0,2,0
,204537-4JNJ1 CROCS-Kids’ CRObandTM Clog CLR- Bright Cobalt/Charcoal/191448408234 Size 1,204537-4JNJ1 CROCS-Kids’ CRObandTM Clog CLR- Bright Cobalt/Charcoal/191448408234 Size 1,Default Ridgefield,82,82,0,0,0,0
,204537-4JNJ1 CROCS-Kids’ CRObandTM Clog CLR- Bright Cobalt/Charcoal/191448408234 Size 1,204537-4JNJ1 CROCS-Kids’ CRObandTM Clog CLR- Bright Cobalt/Charcoal/191448408234 Size 1,FBALYB Amazon,-1,-1,0,0,0,0
,204537-4JNJ2 CROCS-Kids’ CRObandTM Clog CLR- Bright Cobalt/Charcoal/191448408241 Size 2,204537-4JNJ2 CROCS-Kids’ CRObandTM Clog CLR- Bright Cobalt/Charcoal/191448408241 Size 2,Default Ridgefield,58,58,0,0,0,0
,204537-4JNJ2 CROCS-Kids’ CRObandTM Clog CLR- Bright Cobalt/Charcoal/191448408241 Size 2,204537-4JNJ2 CROCS-Kids’ CRObandTM Clog CLR- Bright Cobalt/Charcoal/191448408241 Size 2,FBALYB Amazon,-3,-3,0,0,0,0
,204537-4JNJ3 CROCS-Kids’ CRObandTM Clog CLR- Bright Cobalt/Charcoal/191448408258 Size 3,204537-4JNJ3 CROCS-Kids’ CRObandTM Clog CLR- Bright Cobalt/Charcoal/191448408258 Size 3,Default Ridgefield,58,58,0,0,0,0
,204537-4JNJ3 CROCS-Kids’ CRObandTM Clog CLR- Bright Cobalt/Charcoal/191448408258 Size 3,204537-4JNJ3 CROCS-Kids’ CRObandTM Clog CLR- Bright Cobalt/Charcoal/191448408258 Size 3,FBALYB Amazon,0,-1,1,0,1,0
,204537-4JNJ4 CROCS-Kids’ CRObandTM Clog CLR- Bright Cobalt/Charcoal/191448427679 Size 4,204537-4JNJ4 CROCS-Kids’ CRObandTM Clog CLR- Bright Cobalt/Charcoal/191448427679 Size 4,Default Ridgefield,48,48,0,0,0,0
,204537-4JNJ4 CROCS-Kids’ CRObandTM Clog CLR- Bright Cobalt/Charcoal/191448427679 Size 4,204537-4JNJ4 CROCS-Kids’ CRObandTM Clog CLR- Bright Cobalt/Charcoal/191448427679 Size 4,FBALYB Amazon,3,3,0,0,0,0
,204537-4JNJ5 CROCS-Kids’ CRObandTM Clog CLR- Bright Cobalt/Charcoal/191448427686 Size 5,204537-4JNJ5 CROCS-Kids’ CRObandTM Clog CLR- Bright Cobalt/Charcoal/191448427686 Size 5,Default Ridgefield,64,64,0,0,0,0
,204537-4JNJ5 CROCS-Kids’ CRObandTM Clog CLR- Bright Cobalt/Charcoal/191448427686 Size 5,204537-4JNJ5 CROCS-Kids’ CRObandTM Clog CLR- Bright Cobalt/Charcoal/191448427686 Size 5,FBALYB Amazon,-4,-4,0,0,0,0
,204537-4JNJ6 CROCS-Kids’ CRObandTM Clog CLR- Bright Cobalt/Charcoal/191448427693 Size 6,204537-4JNJ6 CROCS-Kids’ CRObandTM Clog CLR- Bright Cobalt/Charcoal/191448427693 Size 6,Default Ridgefield,47,47,0,0,0,0
,204537-4JNJ6 CROCS-Kids’ CRObandTM Clog CLR- Bright Cobalt/Charcoal/191448427693 Size 6,204537-4JNJ6 CROCS-Kids’ CRObandTM Clog CLR- Bright Cobalt/Charcoal/191448427693 Size 6,FBALYB Amazon,15,11,4,0,4,0
,204537-4O5C10 CROCS-Kids’ CRObandTM Clog CLR- Cerulean Blue/887350924732 Size 10,204537-4O5C10 CROCS-Kids’ CRObandTM Clog CLR- Cerulean Blue/887350924732 Size 10,Default Ridgefield,46,46,0,0,0,0
,204537-4O5C10 CROCS-Kids’ CRObandTM Clog CLR- Cerulean Blue/887350924732 Size 10,204537-4O5C10 CROCS-Kids’ CRObandTM Clog CLR- Cerulean Blue/887350924732 Size 10,FBALYB Amazon,45,45,0,0,0,0
,204537-4O5C11 CROCS-Kids’ CRObandTM Clog CLR- Cerulean Blue/887350924749 Size 11,204537-4O5C11 CROCS-Kids’ CRObandTM Clog CLR- Cerulean Blue/887350924749 Size 11,Default Ridgefield,96,96,0,0,0,0
,204537-4O5C11 CROCS-Kids’ CRObandTM Clog CLR- Cerulean Blue/887350924749 Size 11,204537-4O5C11 CROCS-Kids’ CRObandTM Clog CLR- Cerulean Blue/887350924749 Size 11,FBALYB Amazon,-1,-1,0,0,0,0
,204537-4O5C12 CROCS-Kids’ CRObandTM Clog CLR- Cerulean Blue/887350924756 Size 12,204537-4O5C12 CROCS-Kids’ CRObandTM Clog CLR- Cerulean Blue/887350924756 Size 12,Default Ridgefield,95,95,0,0,0,0
,204537-4O5C12 CROCS-Kids’ CRObandTM Clog CLR- Cerulean Blue/887350924756 Size 12,204537-4O5C12 CROCS-Kids’ CRObandTM Clog CLR- Cerulean Blue/887350924756 Size 12,FBALYB Amazon,-4,-5,1,0,1,0
,204537-4O5C13 CROCS-Kids’ CRObandTM Clog CLR- Cerulean Blue/887350924763 Size 13,204537-4O5C13 CROCS-Kids’ CRObandTM Clog CLR- Cerulean Blue/887350924763 Size 13,Default Ridgefield,71,71,0,0,0,0
,204537-4O5C13 CROCS-Kids’ CRObandTM Clog CLR- Cerulean Blue/887350924763 Size 13,204537-4O5C13 CROCS-Kids’ CRObandTM Clog CLR- Cerulean Blue/887350924763 Size 13,FBALYB Amazon,10,9,1,0,1,0
,204537-4O5C4 CROCS-Kids’ CRObandTM Clog CLR- Cerulean Blue/887350924770 Size 4,204537-4O5C4 CROCS-Kids’ CRObandTM Clog CLR- Cerulean Blue/887350924770 Size 4,Default Ridgefield,0,-18,18,0,0,0
,204537-4O5C4 CROCS-Kids’ CRObandTM Clog CLR- Cerulean Blue/887350924770 Size 4,204537-4O5C4 CROCS-Kids’ CRObandTM Clog CLR- Cerulean Blue/887350924770 Size 4,FBALYB Amazon,-1,-2,1,0,1,0
,204537-4O5C5 CROCS-Kids’ CRObandTM Clog CLR- Cerulean Blue/887350924787 Size 5,204537-4O5C5 CROCS-Kids’ CRObandTM Clog CLR- Cerulean Blue/887350924787 Size 5,Default Ridgefield,0,-18,18,0,0,0
,204537-4O5C5 CROCS-Kids’ CRObandTM Clog CLR- Cerulean Blue/887350924787 Size 5,204537-4O5C5 CROCS-Kids’ CRObandTM Clog CLR- Cerulean Blue/887350924787 Size 5,FBALYB Amazon,5,4,1,0,1,0
,204537-4O5C6 CROCS-Kids’ CRObandTM Clog CLR- Cerulean Blue/887350924794 Size 6,204537-4O5C6 CROCS-Kids’ CRObandTM Clog CLR- Cerulean Blue/887350924794 Size 6,Default Ridgefield,12,12,0,0,0,0
,204537-4O5C6 CROCS-Kids’ CRObandTM Clog CLR- Cerulean Blue/887350924794 Size 6,204537-4O5C6 CROCS-Kids’ CRObandTM Clog CLR- Cerulean Blue/887350924794 Size 6,FBALYB Amazon,1,1,0,0,0,0
,204537-4O5C7 CROCS-Kids’ CRObandTM Clog CLR- Cerulean Blue/887350924800 Size 7,204537-4O5C7 CROCS-Kids’ CRObandTM Clog CLR- Cerulean Blue/887350924800 Size 7,Default Ridgefield,72,72,0,0,0,0
,204537-4O5C7 CROCS-Kids’ CRObandTM Clog CLR- Cerulean Blue/887350924800 Size 7,204537-4O5C7 CROCS-Kids’ CRObandTM Clog CLR- Cerulean Blue/887350924800 Size 7,FBALYB Amazon,-3,-4,1,0,1,0
,204537-4O5C8 CROCS-Kids’ CRObandTM Clog CLR- Cerulean Blue/887350924817 Size 8,204537-4O5C8 CROCS-Kids’ CRObandTM Clog CLR- Cerulean Blue/887350924817 Size 8,Default Ridgefield,72,54,18,0,0,0
,204537-4O5C8 CROCS-Kids’ CRObandTM Clog CLR- Cerulean Blue/887350924817 Size 8,204537-4O5C8 CROCS-Kids’ CRObandTM Clog CLR- Cerulean Blue/887350924817 Size 8,FBALYB Amazon,18,18,0,0,0,0
,204537-4O5C9 CROCS-Kids’ CRObandTM Clog CLR- Cerulean Blue/887350924824 Size 9,204537-4O5C9 CROCS-Kids’ CRObandTM Clog CLR- Cerulean Blue/887350924824 Size 9,Default Ridgefield,46,28,18,0,0,0
,204537-4O5C9 CROCS-Kids’ CRObandTM Clog CLR- Cerulean Blue/887350924824 Size 9,204537-4O5C9 CROCS-Kids’ CRObandTM Clog CLR- Cerulean Blue/887350924824 Size 9,FBALYB Amazon,36,35,1,0,1,0
,204537-4O5J1 CROCS-Kids’ CRObandTM Clog CLR- Cerulean Blue/887350924831 Size 1,204537-4O5J1 CROCS-Kids’ CRObandTM Clog CLR- Cerulean Blue/887350924831 Size 1,Default Ridgefield,89,89,0,0,0,0
,204537-4O5J1 CROCS-Kids’ CRObandTM Clog CLR- Cerulean Blue/887350924831 Size 1,204537-4O5J1 CROCS-Kids’ CRObandTM Clog CLR- Cerulean Blue/887350924831 Size 1,FBALYB Amazon,-4,-4,0,0,0,0
,204537-4O5J2 CROCS-Kids’ CRObandTM Clog CLR- Cerulean Blue/887350924848 Size 2,204537-4O5J2 CROCS-Kids’ CRObandTM Clog CLR- Cerulean Blue/887350924848 Size 2,Default Ridgefield,36,36,0,0,0,0
,204537-4O5J2 CROCS-Kids’ CRObandTM Clog CLR- Cerulean Blue/887350924848 Size 2,204537-4O5J2 CROCS-Kids’ CRObandTM Clog CLR- Cerulean Blue/887350924848 Size 2,FBALYB Amazon,32,31,1,0,1,0
,204537-4O5J3 CROCS-Kids’ CRObandTM Clog CLR- Cerulean Blue/887350924855 Size 3,204537-4O5J3 CROCS-Kids’ CRObandTM Clog CLR- Cerulean Blue/887350924855 Size 3,Default Ridgefield,48,48,0,0,0,0
,204537-4O5J3 CROCS-Kids’ CRObandTM Clog CLR- Cerulean Blue/887350924855 Size 3,204537-4O5J3 CROCS-Kids’ CRObandTM Clog CLR- Cerulean Blue/887350924855 Size 3,FBALYB Amazon,19,19,0,0,0,0
,204537-4O5J4 CROCS-Kids’ CRObandTM Clog CLR- Cerulean Blue/191448427730 Size 4,204537-4O5J4 CROCS-Kids’ CRObandTM Clog CLR- Cerulean Blue/191448427730 Size 4,Default Ridgefield,24,24,0,0,0,0
,204537-4O5J4 CROCS-Kids’ CRObandTM Clog CLR- Cerulean Blue/191448427730 Size 4,204537-4O5J4 CROCS-Kids’ CRObandTM Clog CLR- Cerulean Blue/191448427730 Size 4,FBALYB Amazon,-4,-4,0,0,0,0
,204537-4O5J5 CROCS-Kids’ CRObandTM Clog CLR- Cerulean Blue/191448427747 Size 5,204537-4O5J5 CROCS-Kids’ CRObandTM Clog CLR- Cerulean Blue/191448427747 Size 5,Default Ridgefield,42,42,0,0,0,0
,204537-4O5J6 CROCS-Kids’ CRObandTM Clog CLR- Cerulean Blue/191448427754 Size 6,204537-4O5J6 CROCS-Kids’ CRObandTM Clog CLR- Cerulean Blue/191448427754 Size 6,Default Ridgefield,23,23,0,0,0,0
,204537-4O5J6 CROCS-Kids’ CRObandTM Clog CLR- Cerulean Blue/191448427754 Size 6,204537-4O5J6 CROCS-Kids’ CRObandTM Clog CLR- Cerulean Blue/191448427754 Size 6,FBALYB Amazon,-2,-2,0,0,0,0
,204537-4S3C10 CROCS-Kids’ CRObandTM Clog CLR- Ice Blue/White/887350984149 Size 10,204537-4S3C10 CROCS-Kids’ CRObandTM Clog CLR- Ice Blue/White/887350984149 Size 10,Default Ridgefield,7,7,0,0,0,0
,204537-4S3C10 CROCS-Kids’ CRObandTM Clog CLR- Ice Blue/White/887350984149 Size 10,204537-4S3C10 CROCS-Kids’ CRObandTM Clog CLR- Ice Blue/White/887350984149 Size 10,FBALYB Amazon,-14,-16,2,0,2,0
,204537-4S3C11 CROCS-Kids’ CRObandTM Clog CLR- Ice Blue/White/887350984156 Size 11,204537-4S3C11 CROCS-Kids’ CRObandTM Clog CLR- Ice Blue/White/887350984156 Size 11,Default Ridgefield,1,1,0,0,0,0
,204537-4S3C11 CROCS-Kids’ CRObandTM Clog CLR- Ice Blue/White/887350984156 Size 11,204537-4S3C11 CROCS-Kids’ CRObandTM Clog CLR- Ice Blue/White/887350984156 Size 11,FBALYB Amazon,39,37,2,0,2,0
,204537-4S3C12 CROCS-Kids’ CRObandTM Clog CLR- Ice Blue/White/887350984163 Size 12,204537-4S3C12 CROCS-Kids’ CRObandTM Clog CLR- Ice Blue/White/887350984163 Size 12,Default Ridgefield,1,1,0,0,0,0
,204537-4S3C12 CROCS-Kids’ CRObandTM Clog CLR- Ice Blue/White/887350984163 Size 12,204537-4S3C12 CROCS-Kids’ CRObandTM Clog CLR- Ice Blue/White/887350984163 Size 12,FBALYB Amazon,-3,-3,0,0,0,0
,204537-4S3C13 CROCS-Kids’ CRObandTM Clog CLR- Ice Blue/White/887350984170 Size 13,204537-4S3C13 CROCS-Kids’ CRObandTM Clog CLR- Ice Blue/White/887350984170 Size 13,FBALYB Amazon,-6,-8,2,0,2,0
,204537-4S3C4 CROCS-Kids’ CRObandTM Clog CLR- Ice Blue/White/887350984187 Size 4,204537-4S3C4 CROCS-Kids’ CRObandTM Clog CLR- Ice Blue/White/887350984187 Size 4,FBALYB Amazon,-2,-2,0,0,0,0
,204537-4S3C5 CROCS-Kids’ CRObandTM Clog CLR- Ice Blue/White/887350984194 Size 5,204537-4S3C5 CROCS-Kids’ CRObandTM Clog CLR- Ice Blue/White/887350984194 Size 5,Default Ridgefield,1,1,0,0,0,0
,204537-4S3C5 CROCS-Kids’ CRObandTM Clog CLR- Ice Blue/White/887350984194 Size 5,204537-4S3C5 CROCS-Kids’ CRObandTM Clog CLR- Ice Blue/White/887350984194 Size 5,FBALYB Amazon,16,15,1,0,1,0
,204537-4S3C6 CROCS-Kids’ CRObandTM Clog CLR- Ice Blue/White/887350984200 Size 6,204537-4S3C6 CROCS-Kids’ CRObandTM Clog CLR- Ice Blue/White/887350984200 Size 6,Default Ridgefield,66,66,0,0,0,0
,204537-4S3C6 CROCS-Kids’ CRObandTM Clog CLR- Ice Blue/White/887350984200 Size 6,204537-4S3C6 CROCS-Kids’ CRObandTM Clog CLR- Ice Blue/White/887350984200 Size 6,FBALYB Amazon,0,0,0,45,0,0
,204537-4S3C7 CROCS-Kids’ CRObandTM Clog CLR- Ice Blue/White/887350984217 Size 7,204537-4S3C7 CROCS-Kids’ CRObandTM Clog CLR- Ice Blue/White/887350984217 Size 7,Default Ridgefield,1,1,0,0,0,0
,204537-4S3C7 CROCS-Kids’ CRObandTM Clog CLR- Ice Blue/White/887350984217 Size 7,204537-4S3C7 CROCS-Kids’ CRObandTM Clog CLR- Ice Blue/White/887350984217 Size 7,FBALYB Amazon,-2,-3,1,0,1,0
,204537-4S3C8 CROCS-Kids’ CRObandTM Clog CLR- Ice Blue/White/887350984224 Size 8,204537-4S3C8 CROCS-Kids’ CRObandTM Clog CLR- Ice Blue/White/887350984224 Size 8,FBALYB Amazon,164,161,3,0,3,0
,204537-4S3C9 CROCS-Kids’ CRObandTM Clog CLR- Ice Blue/White/887350984231 Size 9,204537-4S3C9 CROCS-Kids’ CRObandTM Clog CLR- Ice Blue/White/887350984231 Size 9,Default Ridgefield,1,1,0,0,0,0
,204537-4S3C9 CROCS-Kids’ CRObandTM Clog CLR- Ice Blue/White/887350984231 Size 9,204537-4S3C9 CROCS-Kids’ CRObandTM Clog CLR- Ice Blue/White/887350984231 Size 9,FBALYB Amazon,39,34,5,0,5,0
,204537-4S3J1 CROCS-Kids’ CRObandTM Clog CLR- Ice Blue/White/887350984248 Size 1,204537-4S3J1 CROCS-Kids’ CRObandTM Clog CLR- Ice Blue/White/887350984248 Size 1,FBALYB Amazon,-23,-24,1,0,1,0
,204537-4S3J2 CROCS-Kids’ CRObandTM Clog CLR- Ice Blue/White/887350984255 Size 2,204537-4S3J2 CROCS-Kids’ CRObandTM Clog CLR- Ice Blue/White/887350984255 Size 2,FBALYB Amazon,-3,-3,0,0,0,0
,204537-4S3J3 CROCS-Kids’ CRObandTM Clog CLR- Ice Blue/White/887350984262 Size 3,204537-4S3J3 CROCS-Kids’ CRObandTM Clog CLR- Ice Blue/White/887350984262 Size 3,FBALYB Amazon,-1,-4,3,0,3,0
,204537-4S3J4 CROCS-Kids’ CRObandTM Clog CLR- Ice Blue/White/191448427761 Size 4,204537-4S3J4 CROCS-Kids’ CRObandTM Clog CLR- Ice Blue/White/191448427761 Size 4,FBALYB Amazon,-13,-14,1,1,1,0
,204537-4S3J5 CROCS-Kids’ CRObandTM Clog CLR- Ice Blue/White/191448427778 Size 5,204537-4S3J5 CROCS-Kids’ CRObandTM Clog CLR- Ice Blue/White/191448427778 Size 5,FBALYB Amazon,-12,-12,0,0,0,0
,204537-4S3J6 CROCS-Kids’ CRObandTM Clog CLR- Ice Blue/White/191448427785 Size 6,204537-4S3J6 CROCS-Kids’ CRObandTM Clog CLR- Ice Blue/White/191448427785 Size 6,Default Ridgefield,3,3,0,0,0,0
,204537-4S3J6 CROCS-Kids’ CRObandTM Clog CLR- Ice Blue/White/191448427785 Size 6,204537-4S3J6 CROCS-Kids’ CRObandTM Clog CLR- Ice Blue/White/191448427785 Size 6,FBALYB Amazon,3,3,0,0,0,0
,204537-5P8C10 CROCS-Kids’ CRObandTM Clog CLR- Lavender/Neon Purple/191448268739 Size 10,204537-5P8C10 CROCS-Kids’ CRObandTM Clog CLR- Lavender/Neon Purple/191448268739 Size 10,Default Ridgefield,72,72,0,0,0,24
,204537-5P8C10 CROCS-Kids’ CRObandTM Clog CLR- Lavender/Neon Purple/191448268739 Size 10,204537-5P8C10 CROCS-Kids’ CRObandTM Clog CLR- Lavender/Neon Purple/191448268739 Size 10,FBALYB Amazon,-11,-12,1,0,1,0
,204537-5P8C11 CROCS-Kids’ CRObandTM Clog CLR- Lavender/Neon Purple/191448268746 Size 11,204537-5P8C11 CROCS-Kids’ CRObandTM Clog CLR- Lavender/Neon Purple/191448268746 Size 11,Default Ridgefield,111,111,0,0,0,24
,204537-5P8C11 CROCS-Kids’ CRObandTM Clog CLR- Lavender/Neon Purple/191448268746 Size 11,204537-5P8C11 CROCS-Kids’ CRObandTM Clog CLR- Lavender/Neon Purple/191448268746 Size 11,FBALYB Amazon,-2,-2,0,0,0,0
,204537-5P8C12 CROCS-Kids’ CRObandTM Clog CLR- Lavender/Neon Purple/191448268753 Size 12,204537-5P8C12 CROCS-Kids’ CRObandTM Clog CLR- Lavender/Neon Purple/191448268753 Size 12,Default Ridgefield,72,72,0,0,0,24
,204537-5P8C12 CROCS-Kids’ CRObandTM Clog CLR- Lavender/Neon Purple/191448268753 Size 12,204537-5P8C12 CROCS-Kids’ CRObandTM Clog CLR- Lavender/Neon Purple/191448268753 Size 12,FBALYB Amazon,-2,-2,0,0,0,0
,204537-5P8C13 CROCS-Kids’ CRObandTM Clog CLR- Lavender/Neon Purple/191448268760 Size 13,204537-5P8C13 CROCS-Kids’ CRObandTM Clog CLR- Lavender/Neon Purple/191448268760 Size 13,Default Ridgefield,50,50,0,0,0,47
,204537-5P8C13 CROCS-Kids’ CRObandTM Clog CLR- Lavender/Neon Purple/191448268760 Size 13,204537-5P8C13 CROCS-Kids’ CRObandTM Clog CLR- Lavender/Neon Purple/191448268760 Size 13,FBALYB Amazon,2,2,0,0,0,0
,204537-5P8C4 CROCS-Kids’ CRObandTM Clog CLR- Lavender/Neon Purple/191448268777 Size 4,204537-5P8C4 CROCS-Kids’ CRObandTM Clog CLR- Lavender/Neon Purple/191448268777 Size 4,FBALYB Amazon,-2,-2,0,0,0,0
,204537-5P8C5 CROCS-Kids’ CRObandTM Clog CLR- Lavender/Neon Purple/191448268784 Size 5,204537-5P8C5 CROCS-Kids’ CRObandTM Clog CLR- Lavender/Neon Purple/191448268784 Size 5,Default Ridgefield,25,25,0,0,0,0
,204537-5P8C5 CROCS-Kids’ CRObandTM Clog CLR- Lavender/Neon Purple/191448268784 Size 5,204537-5P8C5 CROCS-Kids’ CRObandTM Clog CLR- Lavender/Neon Purple/191448268784 Size 5,FBALYB Amazon,-2,-2,0,0,0,0
,204537-5P8C6 CROCS-Kids’ CRObandTM Clog CLR- Lavender/Neon Purple/191448268791 Size 6,204537-5P8C6 CROCS-Kids’ CRObandTM Clog CLR- Lavender/Neon Purple/191448268791 Size 6,Default Ridgefield,30,30,0,0,0,0
,204537-5P8C6 CROCS-Kids’ CRObandTM Clog CLR- Lavender/Neon Purple/191448268791 Size 6,204537-5P8C6 CROCS-Kids’ CRObandTM Clog CLR- Lavender/Neon Purple/191448268791 Size 6,FBALYB Amazon,-1,-1,0,0,0,0
,204537-5P8C7 CROCS-Kids’ CRObandTM Clog CLR- Lavender/Neon Purple/191448268807 Size 7,204537-5P8C7 CROCS-Kids’ CRObandTM Clog CLR- Lavender/Neon Purple/191448268807 Size 7,Default Ridgefield,85,85,0,0,0,0
,204537-5P8C7 CROCS-Kids’ CRObandTM Clog CLR- Lavender/Neon Purple/191448268807 Size 7,204537-5P8C7 CROCS-Kids’ CRObandTM Clog CLR- Lavender/Neon Purple/191448268807 Size 7,FBALYB Amazon,-5,-5,0,0,0,0
,204537-5P8C8 CROCS-Kids’ CRObandTM Clog CLR- Lavender/Neon Purple/191448268814 Size 8,204537-5P8C8 CROCS-Kids’ CRObandTM Clog CLR- Lavender/Neon Purple/191448268814 Size 8,Default Ridgefield,158,158,0,0,0,24
,204537-5P8C8 CROCS-Kids’ CRObandTM Clog CLR- Lavender/Neon Purple/191448268814 Size 8,204537-5P8C8 CROCS-Kids’ CRObandTM Clog CLR- Lavender/Neon Purple/191448268814 Size 8,FBALYB Amazon,4,3,1,0,1,0
,204537-5P8C9 CROCS-Kids’ CRObandTM Clog CLR- Lavender/Neon Purple/191448268821 Size 9,204537-5P8C9 CROCS-Kids’ CRObandTM Clog CLR- Lavender/Neon Purple/191448268821 Size 9,Default Ridgefield,142,142,0,0,0,24
,204537-5P8C9 CROCS-Kids’ CRObandTM Clog CLR- Lavender/Neon Purple/191448268821 Size 9,204537-5P8C9 CROCS-Kids’ CRObandTM Clog CLR- Lavender/Neon Purple/191448268821 Size 9,FBALYB Amazon,-2,-2,0,0,0,0
,204537-5P8J1 CROCS-Kids’ CRObandTM Clog CLR- Lavender/Neon Purple/191448268838 Size 1,204537-5P8J1 CROCS-Kids’ CRObandTM Clog CLR- Lavender/Neon Purple/191448268838 Size 1,Default Ridgefield,33,33,0,0,0,47
,204537-5P8J1 CROCS-Kids’ CRObandTM Clog CLR- Lavender/Neon Purple/191448268838 Size 1,204537-5P8J1 CROCS-Kids’ CRObandTM Clog CLR- Lavender/Neon Purple/191448268838 Size 1,FBALYB Amazon,10,9,1,0,1,0
,204537-5P8J2 CROCS-Kids’ CRObandTM Clog CLR- Lavender/Neon Purple/191448268845 Size 2,204537-5P8J2 CROCS-Kids’ CRObandTM Clog CLR- Lavender/Neon Purple/191448268845 Size 2,Default Ridgefield,30,30,0,0,0,47
,204537-5P8J2 CROCS-Kids’ CRObandTM Clog CLR- Lavender/Neon Purple/191448268845 Size 2,204537-5P8J2 CROCS-Kids’ CRObandTM Clog CLR- Lavender/Neon Purple/191448268845 Size 2,FBALYB Amazon,-7,-7,0,0,0,0
,204537-5P8J3 CROCS-Kids’ CRObandTM Clog CLR- Lavender/Neon Purple/191448268852 Size 3,204537-5P8J3 CROCS-Kids’ CRObandTM Clog CLR- Lavender/Neon Purple/191448268852 Size 3,Default Ridgefield,33,33,0,0,0,71
,204537-5P8J3 CROCS-Kids’ CRObandTM Clog CLR- Lavender/Neon Purple/191448268852 Size 3,204537-5P8J3 CROCS-Kids’ CRObandTM Clog CLR- Lavender/Neon Purple/191448268852 Size 3,FBALYB Amazon,-2,-2,0,0,0,0
,204537-5P8J4 CROCS-Kids’ CRObandTM Clog CLR- Lavender/Neon Purple/191448427792 Size 4,204537-5P8J4 CROCS-Kids’ CRObandTM Clog CLR- Lavender/Neon Purple/191448427792 Size 4,Default Ridgefield,18,18,0,0,0,0
,204537-5P8J4 CROCS-Kids’ CRObandTM Clog CLR- Lavender/Neon Purple/191448427792 Size 4,204537-5P8J4 CROCS-Kids’ CRObandTM Clog CLR- Lavender/Neon Purple/191448427792 Size 4,FBALYB Amazon,4,3,1,0,1,0
,204537-5P8J5 CROCS-Kids’ CRObandTM Clog CLR- Lavender/Neon Purple/191448427808 Size 5,204537-5P8J5 CROCS-Kids’ CRObandTM Clog CLR- Lavender/Neon Purple/191448427808 Size 5,Default Ridgefield,44,44,0,0,0,0
,204537-5P8J5 CROCS-Kids’ CRObandTM Clog CLR- Lavender/Neon Purple/191448427808 Size 5,204537-5P8J5 CROCS-Kids’ CRObandTM Clog CLR- Lavender/Neon Purple/191448427808 Size 5,FBALYB Amazon,-2,-2,0,0,0,0
,204537-5P8J6 CROCS-Kids’ CRObandTM Clog CLR- Lavender/Neon Purple/191448427815 Size 6,204537-5P8J6 CROCS-Kids’ CRObandTM Clog CLR- Lavender/Neon Purple/191448427815 Size 6,Default Ridgefield,65,65,0,0,0,0
,204537-5P8J6 CROCS-Kids’ CRObandTM Clog CLR- Lavender/Neon Purple/191448427815 Size 6,204537-5P8J6 CROCS-Kids’ CRObandTM Clog CLR- Lavender/Neon Purple/191448427815 Size 6,FBALYB Amazon,-1,-1,0,0,0,0
,204537-6IBC10 CROCS-Kids’ CRObandTM Clog CLR- Pepper/Graphite/887350925258 Size 10,204537-6IBC10 CROCS-Kids’ CRObandTM Clog CLR- Pepper/Graphite/887350925258 Size 10,Default Ridgefield,16,16,0,0,0,0
,204537-6IBC10 CROCS-Kids’ CRObandTM Clog CLR- Pepper/Graphite/887350925258 Size 10,204537-6IBC10 CROCS-Kids’ CRObandTM Clog CLR- Pepper/Graphite/887350925258 Size 10,FBALYB Amazon,-1,-1,0,0,0,0
,204537-6IBC11 CROCS-Kids’ CRObandTM Clog CLR- Pepper/Graphite/887350925265 Size 11,204537-6IBC11 CROCS-Kids’ CRObandTM Clog CLR- Pepper/Graphite/887350925265 Size 11,Default Ridgefield,11,11,0,0,0,0
,204537-6IBC11 CROCS-Kids’ CRObandTM Clog CLR- Pepper/Graphite/887350925265 Size 11,204537-6IBC11 CROCS-Kids’ CRObandTM Clog CLR- Pepper/Graphite/887350925265 Size 11,FBALYB Amazon,-1,-1,0,0,0,0
,204537-6IBC12 CROCS-Kids’ CRObandTM Clog CLR- Pepper/Graphite/887350925272 Size 12,204537-6IBC12 CROCS-Kids’ CRObandTM Clog CLR- Pepper/Graphite/887350925272 Size 12,Default Ridgefield,10,10,0,0,0,0
,204537-6IBC13 CROCS-Kids’ CRObandTM Clog CLR- Pepper/Graphite/887350925289 Size 13,204537-6IBC13 CROCS-Kids’ CRObandTM Clog CLR- Pepper/Graphite/887350925289 Size 13,Default Ridgefield,10,10,0,0,0,0
,204537-6IBC13 CROCS-Kids’ CRObandTM Clog CLR- Pepper/Graphite/887350925289 Size 13,204537-6IBC13 CROCS-Kids’ CRObandTM Clog CLR- Pepper/Graphite/887350925289 Size 13,FBALYB Amazon,-4,-4,0,0,0,0
,204537-6IBC4 CROCS-Kids’ CRObandTM Clog CLR- Pepper/Graphite/887350925296 Size 4,204537-6IBC4 CROCS-Kids’ CRObandTM Clog CLR- Pepper/Graphite/887350925296 Size 4,FBALYB Amazon,11,11,0,0,0,0
,204537-6IBC5 CROCS-Kids’ CRObandTM Clog CLR- Pepper/Graphite/887350925302 Size 5,204537-6IBC5 CROCS-Kids’ CRObandTM Clog CLR- Pepper/Graphite/887350925302 Size 5,Default Ridgefield,10,10,0,0,0,0
,204537-6IBC5 CROCS-Kids’ CRObandTM Clog CLR- Pepper/Graphite/887350925302 Size 5,204537-6IBC5 CROCS-Kids’ CRObandTM Clog CLR- Pepper/Graphite/887350925302 Size 5,FBALYB Amazon,12,12,0,0,0,0
,204537-6IBC6 CROCS-Kids’ CRObandTM Clog CLR- Pepper/Graphite/887350925319 Size 6,204537-6IBC6 CROCS-Kids’ CRObandTM Clog CLR- Pepper/Graphite/887350925319 Size 6,Default Ridgefield,10,10,0,0,0,0
,204537-6IBC6 CROCS-Kids’ CRObandTM Clog CLR- Pepper/Graphite/887350925319 Size 6,204537-6IBC6 CROCS-Kids’ CRObandTM Clog CLR- Pepper/Graphite/887350925319 Size 6,FBALYB Amazon,3,2,1,0,1,0
,204537-6IBC7 CROCS-Kids’ CRObandTM Clog CLR- Pepper/Graphite/887350925326 Size 7,204537-6IBC7 CROCS-Kids’ CRObandTM Clog CLR- Pepper/Graphite/887350925326 Size 7,Default Ridgefield,10,10,0,0,0,0
,204537-6IBC8 CROCS-Kids’ CRObandTM Clog CLR- Pepper/Graphite/887350925333 Size 8,204537-6IBC8 CROCS-Kids’ CRObandTM Clog CLR- Pepper/Graphite/887350925333 Size 8,Default Ridgefield,28,28,0,0,0,0
,204537-6IBC8 CROCS-Kids’ CRObandTM Clog CLR- Pepper/Graphite/887350925333 Size 8,204537-6IBC8 CROCS-Kids’ CRObandTM Clog CLR- Pepper/Graphite/887350925333 Size 8,FBALYB Amazon,-1,-1,0,0,0,0
,204537-6IBC9 CROCS-Kids’ CRObandTM Clog CLR- Pepper/Graphite/887350925340 Size 9,204537-6IBC9 CROCS-Kids’ CRObandTM Clog CLR- Pepper/Graphite/887350925340 Size 9,Default Ridgefield,16,16,0,0,0,0
,204537-6IBC9 CROCS-Kids’ CRObandTM Clog CLR- Pepper/Graphite/887350925340 Size 9,204537-6IBC9 CROCS-Kids’ CRObandTM Clog CLR- Pepper/Graphite/887350925340 Size 9,FBALYB Amazon,-1,-1,0,0,0,0
,204537-6IBJ1 CROCS-Kids’ CRObandTM Clog CLR- Pepper/Graphite/887350925357 Size 1,204537-6IBJ1 CROCS-Kids’ CRObandTM Clog CLR- Pepper/Graphite/887350925357 Size 1,Default Ridgefield,10,10,0,0,0,0
,204537-6IBJ1 CROCS-Kids’ CRObandTM Clog CLR- Pepper/Graphite/887350925357 Size 1,204537-6IBJ1 CROCS-Kids’ CRObandTM Clog CLR- Pepper/Graphite/887350925357 Size 1,FBALYB Amazon,-4,-4,0,0,0,0
,204537-6IBJ2 CROCS-Kids’ CRObandTM Clog CLR- Pepper/Graphite/887350925364 Size 2,204537-6IBJ2 CROCS-Kids’ CRObandTM Clog CLR- Pepper/Graphite/887350925364 Size 2,Default Ridgefield,10,10,0,0,0,0
,204537-6IBJ2 CROCS-Kids’ CRObandTM Clog CLR- Pepper/Graphite/887350925364 Size 2,204537-6IBJ2 CROCS-Kids’ CRObandTM Clog CLR- Pepper/Graphite/887350925364 Size 2,FBALYB Amazon,-1,-1,0,0,0,0
,204537-6IBJ3 CROCS-Kids’ CRObandTM Clog CLR- Pepper/Graphite/887350925371 Size 3,204537-6IBJ3 CROCS-Kids’ CRObandTM Clog CLR- Pepper/Graphite/887350925371 Size 3,Default Ridgefield,10,10,0,0,0,0
,204537-6IBJ4 CROCS-Kids’ CRObandTM Clog CLR- Pepper/Graphite/191448427884 Size 4,204537-6IBJ4 CROCS-Kids’ CRObandTM Clog CLR- Pepper/Graphite/191448427884 Size 4,Default Ridgefield,12,12,0,0,0,0
,204537-6IBJ5 CROCS-Kids’ CRObandTM Clog CLR- Pepper/Graphite/191448427891 Size 5,204537-6IBJ5 CROCS-Kids’ CRObandTM Clog CLR- Pepper/Graphite/191448427891 Size 5,Default Ridgefield,38,38,0,0,0,0
,204537-6IBJ6 CROCS-Kids’ CRObandTM Clog CLR- Pepper/Graphite/191448427907 Size 6,204537-6IBJ6 CROCS-Kids’ CRObandTM Clog CLR- Pepper/Graphite/191448427907 Size 6,Default Ridgefield,18,18,0,0,0,0
,204537-6QZC10 CROCS-Kids’ CRObandTM Clog CLR- Electric Pink/Cantaloupe/191448445833 Size 10,204537-6QZC10 CROCS-Kids’ CRObandTM Clog CLR- Electric Pink/Cantaloupe/191448445833 Size 10,Default Ridgefield,82,82,0,0,0,0
,204537-6QZC10 CROCS-Kids’ CRObandTM Clog CLR- Electric Pink/Cantaloupe/191448445833 Size 10,204537-6QZC10 CROCS-Kids’ CRObandTM Clog CLR- Electric Pink/Cantaloupe/191448445833 Size 10,FBALYB Amazon,-4,-4,0,0,0,0
,204537-6QZC11 CROCS-Kids’ CRObandTM Clog CLR- Electric Pink/Cantaloupe/191448445840 Size 11,204537-6QZC11 CROCS-Kids’ CRObandTM Clog CLR- Electric Pink/Cantaloupe/191448445840 Size 11,Default Ridgefield,82,82,0,0,0,0
,204537-6QZC12 CROCS-Kids’ CRObandTM Clog CLR- Electric Pink/Cantaloupe/191448445857 Size 12,204537-6QZC12 CROCS-Kids’ CRObandTM Clog CLR- Electric Pink/Cantaloupe/191448445857 Size 12,Default Ridgefield,82,82,0,0,0,0
,204537-6QZC12 CROCS-Kids’ CRObandTM Clog CLR- Electric Pink/Cantaloupe/191448445857 Size 12,204537-6QZC12 CROCS-Kids’ CRObandTM Clog CLR- Electric Pink/Cantaloupe/191448445857 Size 12,FBALYB Amazon,-1,-2,1,0,1,0
,204537-6QZC13 CROCS-Kids’ CRObandTM Clog CLR- Electric Pink/Cantaloupe/191448445864 Size 13,204537-6QZC13 CROCS-Kids’ CRObandTM Clog CLR- Electric Pink/Cantaloupe/191448445864 Size 13,Default Ridgefield,48,48,0,0,0,0
,204537-6QZC13 CROCS-Kids’ CRObandTM Clog CLR- Electric Pink/Cantaloupe/191448445864 Size 13,204537-6QZC13 CROCS-Kids’ CRObandTM Clog CLR- Electric Pink/Cantaloupe/191448445864 Size 13,FBALYB Amazon,-2,-2,0,0,0,0
,204537-6QZC4 CROCS-Kids’ CRObandTM Clog CLR- Electric Pink/Cantaloupe/191448445871 Size 4,204537-6QZC4 CROCS-Kids’ CRObandTM Clog CLR- Electric Pink/Cantaloupe/191448445871 Size 4,FBALYB Amazon,-3,-3,0,0,0,0
,204537-6QZC6 CROCS-Kids’ CRObandTM Clog CLR- Electric Pink/Cantaloupe/191448445895 Size 6,204537-6QZC6 CROCS-Kids’ CRObandTM Clog CLR- Electric Pink/Cantaloupe/191448445895 Size 6,Default Ridgefield,22,22,0,0,0,0
,204537-6QZC6 CROCS-Kids’ CRObandTM Clog CLR- Electric Pink/Cantaloupe/191448445895 Size 6,204537-6QZC6 CROCS-Kids’ CRObandTM Clog CLR- Electric Pink/Cantaloupe/191448445895 Size 6,FBALYB Amazon,4,3,1,0,1,0
,204537-6QZC7 CROCS-Kids’ CRObandTM Clog CLR- Electric Pink/Cantaloupe/191448445901 Size 7,204537-6QZC7 CROCS-Kids’ CRObandTM Clog CLR- Electric Pink/Cantaloupe/191448445901 Size 7,Default Ridgefield,62,62,0,0,0,0
,204537-6QZC8 CROCS-Kids’ CRObandTM Clog CLR- Electric Pink/Cantaloupe/191448445918 Size 8,204537-6QZC8 CROCS-Kids’ CRObandTM Clog CLR- Electric Pink/Cantaloupe/191448445918 Size 8,Default Ridgefield,58,58,0,0,0,0
,204537-6QZC8 CROCS-Kids’ CRObandTM Clog CLR- Electric Pink/Cantaloupe/191448445918 Size 8,204537-6QZC8 CROCS-Kids’ CRObandTM Clog CLR- Electric Pink/Cantaloupe/191448445918 Size 8,FBALYB Amazon,-1,-1,0,0,0,0
,204537-6QZC9 CROCS-Kids’ CRObandTM Clog CLR- Electric Pink/Cantaloupe/191448445925 Size 9,204537-6QZC9 CROCS-Kids’ CRObandTM Clog CLR- Electric Pink/Cantaloupe/191448445925 Size 9,Default Ridgefield,98,98,0,0,0,0
,204537-6QZJ1 CROCS-Kids’ CRObandTM Clog CLR- Electric Pink/Cantaloupe/191448445932 Size 1,204537-6QZJ1 CROCS-Kids’ CRObandTM Clog CLR- Electric Pink/Cantaloupe/191448445932 Size 1,Default Ridgefield,34,34,0,0,0,0
,204537-6QZJ1 CROCS-Kids’ CRObandTM Clog CLR- Electric Pink/Cantaloupe/191448445932 Size 1,204537-6QZJ1 CROCS-Kids’ CRObandTM Clog CLR- Electric Pink/Cantaloupe/191448445932 Size 1,FBALYB Amazon,-6,-6,0,0,0,0
,204537-6QZJ2 CROCS-Kids’ CRObandTM Clog CLR- Electric Pink/Cantaloupe/191448445949 Size 2,204537-6QZJ2 CROCS-Kids’ CRObandTM Clog CLR- Electric Pink/Cantaloupe/191448445949 Size 2,Default Ridgefield,34,34,0,0,0,0
,204537-6QZJ2 CROCS-Kids’ CRObandTM Clog CLR- Electric Pink/Cantaloupe/191448445949 Size 2,204537-6QZJ2 CROCS-Kids’ CRObandTM Clog CLR- Electric Pink/Cantaloupe/191448445949 Size 2,FBALYB Amazon,-6,-6,0,0,0,0
,204537-6QZJ3 CROCS-Kids’ CRObandTM Clog CLR- Electric Pink/Cantaloupe/191448445956 Size 3,204537-6QZJ3 CROCS-Kids’ CRObandTM Clog CLR- Electric Pink/Cantaloupe/191448445956 Size 3,Default Ridgefield,34,34,0,0,0,0
,204537-6QZJ3 CROCS-Kids’ CRObandTM Clog CLR- Electric Pink/Cantaloupe/191448445956 Size 3,204537-6QZJ3 CROCS-Kids’ CRObandTM Clog CLR- Electric Pink/Cantaloupe/191448445956 Size 3,FBALYB Amazon,-1,-1,0,0,0,0
,204537-6QZJ4 CROCS-Kids’ CRObandTM Clog CLR- Electric Pink/Cantaloupe/191448445963 Size 4,204537-6QZJ4 CROCS-Kids’ CRObandTM Clog CLR- Electric Pink/Cantaloupe/191448445963 Size 4,Default Ridgefield,24,24,0,0,0,0
,204537-6QZJ4 CROCS-Kids’ CRObandTM Clog CLR- Electric Pink/Cantaloupe/191448445963 Size 4,204537-6QZJ4 CROCS-Kids’ CRObandTM Clog CLR- Electric Pink/Cantaloupe/191448445963 Size 4,FBALYB Amazon,-4,-4,0,0,0,0
,204537-6QZJ5 CROCS-Kids’ CRObandTM Clog CLR- Electric Pink/Cantaloupe/191448445970 Size 5,204537-6QZJ5 CROCS-Kids’ CRObandTM Clog CLR- Electric Pink/Cantaloupe/191448445970 Size 5,Default Ridgefield,23,23,0,0,0,0
,204537-6QZJ5 CROCS-Kids’ CRObandTM Clog CLR- Electric Pink/Cantaloupe/191448445970 Size 5,204537-6QZJ5 CROCS-Kids’ CRObandTM Clog CLR- Electric Pink/Cantaloupe/191448445970 Size 5,FBALYB Amazon,-3,-3,0,0,0,0
,204537-6QZJ6 CROCS-Kids’ CRObandTM Clog CLR- Electric Pink/Cantaloupe/191448445987 Size 6,204537-6QZJ6 CROCS-Kids’ CRObandTM Clog CLR- Electric Pink/Cantaloupe/191448445987 Size 6,Default Ridgefield,24,24,0,0,0,0
,204537-6QZJ6 CROCS-Kids’ CRObandTM Clog CLR- Electric Pink/Cantaloupe/191448445987 Size 6,204537-6QZJ6 CROCS-Kids’ CRObandTM Clog CLR- Electric Pink/Cantaloupe/191448445987 Size 6,FBALYB Amazon,17,17,0,0,0,0
,204592-05MM12 CrocsLiteRideTM Clog CLR- Black/Smoke/191448300279 Size M12 W14,204592-05MM12 CrocsLiteRideTM Clog CLR- Black/Smoke/191448300279 Size M12 W14,FBALYB Amazon,-1,-1,0,0,0,0
,204592-05MM4W6 CrocsLiteRideTM Clog CLR- Black/Smoke/191448300293 Size M4 W6,204592-05MM4W6 CrocsLiteRideTM Clog CLR- Black/Smoke/191448300293 Size M4 W6,FBALYB Amazon,-1,-1,0,0,0,0
,204592-05MM5W7 CrocsLiteRideTM Clog CLR- Black/Smoke/191448300309 Size M5 W7,204592-05MM5W7 CrocsLiteRideTM Clog CLR- Black/Smoke/191448300309 Size M5 W7,FBALYB Amazon,-2,-2,0,0,0,0
,204592-05MM6W8 CrocsLiteRideTM Clog CLR- Black/Smoke/191448300316 Size M6 W8,204592-05MM6W8 CrocsLiteRideTM Clog CLR- Black/Smoke/191448300316 Size M6 W8,FBALYB Amazon,-1,-1,0,0,0,0
,204592-05MM7W9 CrocsLiteRideTM Clog CLR- Black/Smoke/191448300323 Size M7 W9,204592-05MM7W9 CrocsLiteRideTM Clog CLR- Black/Smoke/191448300323 Size M7 W9,FBALYB Amazon,-3,-3,0,0,0,0
,204592-05MM8W10 CrocsLiteRideTM Clog CLR- Black/Smoke/191448300330 Size M8 W10,204592-05MM8W10 CrocsLiteRideTM Clog CLR- Black/Smoke/191448300330 Size M8 W10,FBALYB Amazon,3,3,0,0,0,0
,204592-05MM9W11 CrocsLiteRideTM Clog CLR- Black/Smoke/191448300347 Size M9 W11,204592-05MM9W11 CrocsLiteRideTM Clog CLR- Black/Smoke/191448300347 Size M9 W11,FBALYB Amazon,-1,-1,0,0,0,0
,204592-06JM10W12 CrocsLiteRideTM Clog CLR- Smoke/Pearl White/191448300453 Size M10 W12,204592-06JM10W12 CrocsLiteRideTM Clog CLR- Smoke/Pearl White/191448300453 Size M10 W12,FBALYB Amazon,-3,-3,0,0,0,0
,204592-06JM4W6 CrocsLiteRideTM Clog CLR- Smoke/Pearl White/191448300491 Size M4 W6,204592-06JM4W6 CrocsLiteRideTM Clog CLR- Smoke/Pearl White/191448300491 Size M4 W6,FBALYB Amazon,-1,-1,0,0,0,0
,204592-06JM6W8 CrocsLiteRideTM Clog CLR- Smoke/Pearl White/191448300514 Size M6 W8,204592-06JM6W8 CrocsLiteRideTM Clog CLR- Smoke/Pearl White/191448300514 Size M6 W8,FBALYB Amazon,-1,-1,0,0,0,0
,204592-06JM7W9 CrocsLiteRideTM Clog CLR- Smoke/Pearl White/191448300521 Size M7 W9,204592-06JM7W9 CrocsLiteRideTM Clog CLR- Smoke/Pearl White/191448300521 Size M7 W9,FBALYB Amazon,-3,-3,0,0,0,0
,204592-06JM8W10 CrocsLiteRideTM Clog CLR- Smoke/Pearl White/191448300538 Size M8 W10,204592-06JM8W10 CrocsLiteRideTM Clog CLR- Smoke/Pearl White/191448300538 Size M8 W10,FBALYB Amazon,-2,-2,0,0,0,0
,204592-06JM9W11 CrocsLiteRideTM Clog CLR- Smoke/Pearl White/191448300545 Size M9 W11,204592-06JM9W11 CrocsLiteRideTM Clog CLR- Smoke/Pearl White/191448300545 Size M9 W11,FBALYB Amazon,9,9,0,0,0,0
,204592-0DDM10W12 CrocsLiteRideTM Clog CLR- Black/Slate Grey/191448208094 Size M10 W12,204592-0DDM10W12 CrocsLiteRideTM Clog CLR- Black/Slate Grey/191448208094 Size M10 W12,Default Ridgefield,1,1,0,0,0,0
,204592-0DDM10W12 CrocsLiteRideTM Clog CLR- Black/Slate Grey/191448208094 Size M10 W12,204592-0DDM10W12 CrocsLiteRideTM Clog CLR- Black/Slate Grey/191448208094 Size M10 W12,FBALYB Amazon,-2,-2,0,0,0,0
,204592-0DDM4W6 CrocsLiteRideTM Clog CLR- Black/Slate Grey/191448208131 Size M4 W6,204592-0DDM4W6 CrocsLiteRideTM Clog CLR- Black/Slate Grey/191448208131 Size M4 W6,FBALYB Amazon,-1,-1,0,0,0,0
,204592-0DDM6W8 CrocsLiteRideTM Clog CLR- Black/Slate Grey/191448208155 Size M6 W8,204592-0DDM6W8 CrocsLiteRideTM Clog CLR- Black/Slate Grey/191448208155 Size M6 W8,FBALYB Amazon,-1,-1,0,0,0,0
,204592-0DDM7W9 CrocsLiteRideTM Clog CLR- Black/Slate Grey/191448208162 Size M7 W9,204592-0DDM7W9 CrocsLiteRideTM Clog CLR- Black/Slate Grey/191448208162 Size M7 W9,FBALYB Amazon,-6,-6,0,0,0,0
,204592-0DDM8W10 CrocsLiteRideTM Clog CLR- Black/Slate Grey/191448208179 Size M8 W10,204592-0DDM8W10 CrocsLiteRideTM Clog CLR- Black/Slate Grey/191448208179 Size M8 W10,FBALYB Amazon,-1,-1,0,0,0,0
,204592-0DDM9W11 CrocsLiteRideTM Clog CLR- Black/Slate Grey/191448208186 Size M9 W11,204592-0DDM9W11 CrocsLiteRideTM Clog CLR- Black/Slate Grey/191448208186 Size M9 W11,FBALYB Amazon,-2,-2,0,0,0,0
,204592-1CVM10W12 CrocsLiteRideTM Clog CLR- Almost White/Almost White/191448498563 Size M10 W12,204592-1CVM10W12 CrocsLiteRideTM Clog CLR- Almost White/Almost White/191448498563 Size M10 W12,FBALYB Amazon,-2,-3,1,0,1,0
,204592-1CVM11 CrocsLiteRideTM Clog CLR- Almost White/Almost White/191448498570 Size M11 W13,204592-1CVM11 CrocsLiteRideTM Clog CLR- Almost White/Almost White/191448498570 Size M11 W13,FBALYB Amazon,1,1,0,0,0,0
,204592-1CVM12 CrocsLiteRideTM Clog CLR- Almost White/Almost White/191448498587 Size M12 W14,204592-1CVM12 CrocsLiteRideTM Clog CLR- Almost White/Almost White/191448498587 Size M12 W14,FBALYB Amazon,10,10,0,0,0,0
,204592-1CVM4W6 CrocsLiteRideTM Clog CLR- Almost White/Almost White/191448498600 Size M4 W6,204592-1CVM4W6 CrocsLiteRideTM Clog CLR- Almost White/Almost White/191448498600 Size M4 W6,FBALYB Amazon,2,2,0,0,0,0
,204592-1CVM6W8 CrocsLiteRideTM Clog CLR- Almost White/Almost White/191448498624 Size M6 W8,204592-1CVM6W8 CrocsLiteRideTM Clog CLR- Almost White/Almost White/191448498624 Size M6 W8,FBALYB Amazon,8,6,2,0,2,0
,204592-1CVM7W9 CrocsLiteRideTM Clog CLR- Almost White/Almost White/191448498631 Size M7 W9,204592-1CVM7W9 CrocsLiteRideTM Clog CLR- Almost White/Almost White/191448498631 Size M7 W9,FBALYB Amazon,-1,-1,0,0,0,0
,204592-1CVM8W10 CrocsLiteRideTM Clog CLR- Almost White/Almost White/191448498648 Size M8 W10,204592-1CVM8W10 CrocsLiteRideTM Clog CLR- Almost White/Almost White/191448498648 Size M8 W10,FBALYB Amazon,4,4,0,0,0,0
,204592-1CVM9W11 CrocsLiteRideTM Clog CLR- Almost White/Almost White/191448498655 Size M9 W11,204592-1CVM9W11 CrocsLiteRideTM Clog CLR- Almost White/Almost White/191448498655 Size M9 W11,FBALYB Amazon,23,23,0,0,0,0
,204592-4CCM11 CrocsLiteRideTM Clog CLR- Navy/Pepper/191448405622 Size M11 W13,204592-4CCM11 CrocsLiteRideTM Clog CLR- Navy/Pepper/191448405622 Size M11 W13,FBALYB Amazon,-3,-3,0,0,0,0
,204592-4CCM12 CrocsLiteRideTM Clog CLR- Navy/Pepper/191448405639 Size M12 W14,204592-4CCM12 CrocsLiteRideTM Clog CLR- Navy/Pepper/191448405639 Size M12 W14,FBALYB Amazon,-1,-1,0,0,0,0
,204592-4CCM4W6 CrocsLiteRideTM Clog CLR- Navy/Pepper/191448405653 Size M4 W6,204592-4CCM4W6 CrocsLiteRideTM Clog CLR- Navy/Pepper/191448405653 Size M4 W6,FBALYB Amazon,1,0,1,0,1,0
,204592-4CCM5W7 CrocsLiteRideTM Clog CLR- Navy/Pepper/191448405660 Size M5 W7,204592-4CCM5W7 CrocsLiteRideTM Clog CLR- Navy/Pepper/191448405660 Size M5 W7,FBALYB Amazon,-1,-1,0,0,0,0
,204592-4CCM6W8 CrocsLiteRideTM Clog CLR- Navy/Pepper/191448405677 Size M6 W8,204592-4CCM6W8 CrocsLiteRideTM Clog CLR- Navy/Pepper/191448405677 Size M6 W8,FBALYB Amazon,-1,-1,0,0,0,0
,204592-4CCM7W9 CrocsLiteRideTM Clog CLR- Navy/Pepper/191448405684 Size M7 W9,204592-4CCM7W9 CrocsLiteRideTM Clog CLR- Navy/Pepper/191448405684 Size M7 W9,FBALYB Amazon,-2,-2,0,0,0,0
,204592-4CCM8W10 CrocsLiteRideTM Clog CLR- Navy/Pepper/191448405691 Size M8 W10,204592-4CCM8W10 CrocsLiteRideTM Clog CLR- Navy/Pepper/191448405691 Size M8 W10,FBALYB Amazon,-4,-5,1,0,1,0
,204592-4CCM9W11 CrocsLiteRideTM Clog CLR- Navy/Pepper/191448405707 Size M9 W11,204592-4CCM9W11 CrocsLiteRideTM Clog CLR- Navy/Pepper/191448405707 Size M9 W11,FBALYB Amazon,-2,-2,0,0,0,0
,204592-4RWM10W12 CrocsLiteRideTM Clog CLR- Lapis/Black/191448563810 Size M10 W12,204592-4RWM10W12 CrocsLiteRideTM Clog CLR- Lapis/Black/191448563810 Size M10 W12,FBALYB Amazon,-2,-2,0,0,0,0
,204592-4RWM11 CrocsLiteRideTM Clog CLR- Lapis/Black/191448563827 Size M11 W13,204592-4RWM11 CrocsLiteRideTM Clog CLR- Lapis/Black/191448563827 Size M11 W13,FBALYB Amazon,2,2,0,0,0,0
,204592-4RWM12 CrocsLiteRideTM Clog CLR- Lapis/Black/191448563834 Size M12 W14,204592-4RWM12 CrocsLiteRideTM Clog CLR- Lapis/Black/191448563834 Size M12 W14,FBALYB Amazon,1,1,0,0,0,0
,204592-4RWM6W8 CrocsLiteRideTM Clog CLR- Lapis/Black/191448563872 Size M6 W8,204592-4RWM6W8 CrocsLiteRideTM Clog CLR- Lapis/Black/191448563872 Size M6 W8,FBALYB Amazon,9,9,0,0,0,0
,204592-4RWM7W9 CrocsLiteRideTM Clog CLR- Lapis/Black/191448563889 Size M7 W9,204592-4RWM7W9 CrocsLiteRideTM Clog CLR- Lapis/Black/191448563889 Size M7 W9,FBALYB Amazon,-3,-3,0,0,0,0
,204592-4RWM8W10 CrocsLiteRideTM Clog CLR- Lapis/Black/191448563896 Size M8 W10,204592-4RWM8W10 CrocsLiteRideTM Clog CLR- Lapis/Black/191448563896 Size M8 W10,FBALYB Amazon,5,5,0,0,0,0
,204592-4RWM9W11 CrocsLiteRideTM Clog CLR- Lapis/Black/191448563902 Size M9 W11,204592-4RWM9W11 CrocsLiteRideTM Clog CLR- Lapis/Black/191448563902 Size M9 W11,FBALYB Amazon,7,7,0,0,0,0
,204592-4SBM10W12 CrocsLiteRideTM Clog CLR- Vivid Blue/Almost White/191448564015 Size M10 W12,204592-4SBM10W12 CrocsLiteRideTM Clog CLR- Vivid Blue/Almost White/191448564015 Size M10 W12,Default Ridgefield,6,6,0,0,0,0
,204592-4SBM11 CrocsLiteRideTM Clog CLR- Vivid Blue/Almost White/191448564022 Size M11 W13,204592-4SBM11 CrocsLiteRideTM Clog CLR- Vivid Blue/Almost White/191448564022 Size M11 W13,FBALYB Amazon,0,0,0,6,0,0
,204592-4SBM12 CrocsLiteRideTM Clog CLR- Vivid Blue/Almost White/191448564039 Size M12 W14,204592-4SBM12 CrocsLiteRideTM Clog CLR- Vivid Blue/Almost White/191448564039 Size M12 W14,Default Ridgefield,6,6,0,0,0,0
,204592-4SBM4W6 CrocsLiteRideTM Clog CLR- Vivid Blue/Almost White/191448564053 Size M4 W6,204592-4SBM4W6 CrocsLiteRideTM Clog CLR- Vivid Blue/Almost White/191448564053 Size M4 W6,FBALYB Amazon,0,0,0,6,0,0
,204592-4SBM5W7 CrocsLiteRideTM Clog CLR- Vivid Blue/Almost White/191448564060 Size M5 W7,204592-4SBM5W7 CrocsLiteRideTM Clog CLR- Vivid Blue/Almost White/191448564060 Size M5 W7,Default Ridgefield,6,6,0,0,0,0
,204592-4SBM6W8 CrocsLiteRideTM Clog CLR- Vivid Blue/Almost White/191448564077 Size M6 W8,204592-4SBM6W8 CrocsLiteRideTM Clog CLR- Vivid Blue/Almost White/191448564077 Size M6 W8,FBALYB Amazon,0,0,0,12,0,0
,204592-4SBM7W9 CrocsLiteRideTM Clog CLR- Vivid Blue/Almost White/191448564084 Size M7 W9,204592-4SBM7W9 CrocsLiteRideTM Clog CLR- Vivid Blue/Almost White/191448564084 Size M7 W9,Default Ridgefield,1,1,0,0,0,0
,204592-4SBM7W9 CrocsLiteRideTM Clog CLR- Vivid Blue/Almost White/191448564084 Size M7 W9,204592-4SBM7W9 CrocsLiteRideTM Clog CLR- Vivid Blue/Almost White/191448564084 Size M7 W9,FBALYB Amazon,0,0,0,11,0,0
,204592-4SBM8W10 CrocsLiteRideTM Clog CLR- Vivid Blue/Almost White/191448564091 Size M8 W10,204592-4SBM8W10 CrocsLiteRideTM Clog CLR- Vivid Blue/Almost White/191448564091 Size M8 W10,FBALYB Amazon,0,0,0,18,0,0
,204592-4SBM9W11 CrocsLiteRideTM Clog CLR- Vivid Blue/Almost White/191448564107 Size M9 W11,204592-4SBM9W11 CrocsLiteRideTM Clog CLR- Vivid Blue/Almost White/191448564107 Size M9 W11,FBALYB Amazon,0,0,0,18,0,0
,204967-060M10 CrocsMen’s LiteRideTM Pacer CLR- Black/Black/191448338463 Size 10,204967-060M10 CrocsMen’s LiteRideTM Pacer CLR- Black/Black/191448338463 Size 10,FBALYB Amazon,-1,-1,0,0,0,0
,204967-060M11 CrocsMen’s LiteRideTM Pacer CLR- Black/Black/191448338470 Size 11,204967-060M11 CrocsMen’s LiteRideTM Pacer CLR- Black/Black/191448338470 Size 11,FBALYB Amazon,-1,-1,0,0,0,0
,204967-060M12 CrocsMen’s LiteRideTM Pacer CLR- Black/Black/191448338487 Size 12,204967-060M12 CrocsMen’s LiteRideTM Pacer CLR- Black/Black/191448338487 Size 12,FBALYB Amazon,-1,-1,0,0,0,0
,204967-060M7 CrocsMen’s LiteRideTM Pacer CLR- Black/Black/191448338531 Size 7,204967-060M7 CrocsMen’s LiteRideTM Pacer CLR- Black/Black/191448338531 Size 7,FBALYB Amazon,-1,-1,0,0,0,0
,204967-060M8 CrocsMen’s LiteRideTM Pacer CLR- Black/Black/191448338548 Size 8,204967-060M8 CrocsMen’s LiteRideTM Pacer CLR- Black/Black/191448338548 Size 8,FBALYB Amazon,-4,-4,0,0,0,0
,204967-060M9 CrocsMen’s LiteRideTM Pacer CLR- Black/Black/191448338555 Size 9,204967-060M9 CrocsMen’s LiteRideTM Pacer CLR- Black/Black/191448338555 Size 9,FBALYB Amazon,-5,-5,0,0,0,0
,204967-066M10 CrocsMen’s LiteRideTM Pacer CLR- Black/White/191448151406 Size 10,204967-066M10 CrocsMen’s LiteRideTM Pacer CLR- Black/White/191448151406 Size 10,FBALYB Amazon,-2,-2,0,0,0,0
,204967-066M11 CrocsMen’s LiteRideTM Pacer CLR- Black/White/191448151413 Size 11,204967-066M11 CrocsMen’s LiteRideTM Pacer CLR- Black/White/191448151413 Size 11,FBALYB Amazon,-2,-2,0,0,0,0
,204967-066M8 CrocsMen’s LiteRideTM Pacer CLR- Black/White/191448151482 Size 8,204967-066M8 CrocsMen’s LiteRideTM Pacer CLR- Black/White/191448151482 Size 8,FBALYB Amazon,-2,-2,0,0,0,0
,204967-462M10 CrocsMen’s LiteRideTM Pacer CLR- Navy/White/191448151604 Size 10,204967-462M10 CrocsMen’s LiteRideTM Pacer CLR- Navy/White/191448151604 Size 10,FBALYB Amazon,-1,-1,0,0,0,0
,204967-462M11 CrocsMen’s LiteRideTM Pacer CLR- Navy/White/191448151611 Size 11,204967-462M11 CrocsMen’s LiteRideTM Pacer CLR- Navy/White/191448151611 Size 11,FBALYB Amazon,-2,-2,0,0,0,0
,204967-462M7 CrocsMen’s LiteRideTM Pacer CLR- Navy/White/191448151673 Size 7,204967-462M7 CrocsMen’s LiteRideTM Pacer CLR- Navy/White/191448151673 Size 7,FBALYB Amazon,-1,-1,0,0,0,0
,204967-462M8 CrocsMen’s LiteRideTM Pacer CLR- Navy/White/191448151680 Size 8,204967-462M8 CrocsMen’s LiteRideTM Pacer CLR- Navy/White/191448151680 Size 8,FBALYB Amazon,-3,-3,0,0,0,0
,204967-462M9 CrocsMen’s LiteRideTM Pacer CLR- Navy/White/191448151697 Size 9,204967-462M9 CrocsMen’s LiteRideTM Pacer CLR- Navy/White/191448151697 Size 9,FBALYB Amazon,-2,-2,0,0,0,0
,204974-060W10 CrocsWomen’s SwiftwaterTM Flip CLR- Black/Black/191448208957 Size 10,204974-060W10 CrocsWomen’s SwiftwaterTM Flip CLR- Black/Black/191448208957 Size 10,FBALYB Amazon,-2,-2,0,0,0,0
,204974-060W6 CrocsWomen’s SwiftwaterTM Flip CLR- Black/Black/191448208995 Size 6,204974-060W6 CrocsWomen’s SwiftwaterTM Flip CLR- Black/Black/191448208995 Size 6,FBALYB Amazon,-1,-1,0,0,0,0
,204974-060W7 CrocsWomen’s SwiftwaterTM Flip CLR- Black/Black/191448209008 Size 7,204974-060W7 CrocsWomen’s SwiftwaterTM Flip CLR- Black/Black/191448209008 Size 7,FBALYB Amazon,-2,-2,0,0,0,0
,204974-060W8 CrocsWomen’s SwiftwaterTM Flip CLR- Black/Black/191448209015 Size 8,204974-060W8 CrocsWomen’s SwiftwaterTM Flip CLR- Black/Black/191448209015 Size 8,FBALYB Amazon,-7,-7,0,0,0,0
,204974-066W6 CrocsWomen’s SwiftwaterTM Flip CLR- Black/White/191448148239 Size 6,204974-066W6 CrocsWomen’s SwiftwaterTM Flip CLR- Black/White/191448148239 Size 6,FBALYB Amazon,-4,-4,0,0,0,0
,204974-066W7 CrocsWomen’s SwiftwaterTM Flip CLR- Black/White/191448148246 Size 7,204974-066W7 CrocsWomen’s SwiftwaterTM Flip CLR- Black/White/191448148246 Size 7,FBALYB Amazon,-2,-2,0,0,0,0
,204974-066W8 CrocsWomen’s SwiftwaterTM Flip CLR- Black/White/191448148253 Size 8,204974-066W8 CrocsWomen’s SwiftwaterTM Flip CLR- Black/White/191448148253 Size 8,FBALYB Amazon,-8,-8,0,0,0,0
,204974-066W9 CrocsWomen’s SwiftwaterTM Flip CLR- Black/White/191448148260 Size 9,204974-066W9 CrocsWomen’s SwiftwaterTM Flip CLR- Black/White/191448148260 Size 9,FBALYB Amazon,-6,-6,0,0,0,0
,204974-462W6 CrocsWomen’s SwiftwaterTM Flip CLR- Navy/White/191448232044 Size 6,204974-462W6 CrocsWomen’s SwiftwaterTM Flip CLR- Navy/White/191448232044 Size 6,FBALYB Amazon,6,6,0,0,0,0
,204974-462W9 CrocsWomen’s SwiftwaterTM Flip CLR- Navy/White/191448232075 Size 9,204974-462W9 CrocsWomen’s SwiftwaterTM Flip CLR- Navy/White/191448232075 Size 9,FBALYB Amazon,-6,-6,0,0,0,0
,205077-001W9 CrocsWomen’s Kadee Slingback CLR- Black/191448149489 Size 9,205077-001W9 CrocsWomen’s Kadee Slingback CLR- Black/191448149489 Size 9,FBALYB Amazon,-6,-6,0,0,0,0
,205182-0DDM10W12 CrocsLiteRideTM Flip CLR- Black/Slate Grey/191448209350 Size M10 W12,205182-0DDM10W12 CrocsLiteRideTM Flip CLR- Black/Slate Grey/191448209350 Size M10 W12,Default Ridgefield,10,10,0,0,0,0
,205182-0DDM10W12 CrocsLiteRideTM Flip CLR- Black/Slate Grey/191448209350 Size M10 W12,205182-0DDM10W12 CrocsLiteRideTM Flip CLR- Black/Slate Grey/191448209350 Size M10 W12,FBALYB Amazon,-7,-7,0,0,0,0
,205182-0DDM11 CrocsLiteRideTM Flip CLR- Black/Slate Grey/191448209367 Size M11 W13,205182-0DDM11 CrocsLiteRideTM Flip CLR- Black/Slate Grey/191448209367 Size M11 W13,Default Ridgefield,10,10,0,0,0,0
,205182-0DDM11 CrocsLiteRideTM Flip CLR- Black/Slate Grey/191448209367 Size M11 W13,205182-0DDM11 CrocsLiteRideTM Flip CLR- Black/Slate Grey/191448209367 Size M11 W13,FBALYB Amazon,-2,-2,0,0,0,0
,205182-0DDM12 CrocsLiteRideTM Flip CLR- Black/Slate Grey/191448209374 Size M12 W14,205182-0DDM12 CrocsLiteRideTM Flip CLR- Black/Slate Grey/191448209374 Size M12 W14,Default Ridgefield,10,10,0,0,0,0
,205182-0DDM4W6 CrocsLiteRideTM Flip CLR- Black/Slate Grey/191448209398 Size M4 W6,205182-0DDM4W6 CrocsLiteRideTM Flip CLR- Black/Slate Grey/191448209398 Size M4 W6,Default Ridgefield,6,6,0,0,0,0
,205182-0DDM4W6 CrocsLiteRideTM Flip CLR- Black/Slate Grey/191448209398 Size M4 W6,205182-0DDM4W6 CrocsLiteRideTM Flip CLR- Black/Slate Grey/191448209398 Size M4 W6,FBALYB Amazon,-3,-3,0,0,0,0
,205182-0DDM5W7 CrocsLiteRideTM Flip CLR- Black/Slate Grey/191448209404 Size M5 W7,205182-0DDM5W7 CrocsLiteRideTM Flip CLR- Black/Slate Grey/191448209404 Size M5 W7,FBALYB Amazon,9,9,0,0,0,0
,205182-0DDM6W8 CrocsLiteRideTM Flip CLR- Black/Slate Grey/191448209411 Size M6 W8,205182-0DDM6W8 CrocsLiteRideTM Flip CLR- Black/Slate Grey/191448209411 Size M6 W8,Default Ridgefield,10,10,0,0,0,0
,205182-0DDM6W8 CrocsLiteRideTM Flip CLR- Black/Slate Grey/191448209411 Size M6 W8,205182-0DDM6W8 CrocsLiteRideTM Flip CLR- Black/Slate Grey/191448209411 Size M6 W8,FBALYB Amazon,-7,-7,0,0,0,0
,205182-0DDM7W9 CrocsLiteRideTM Flip CLR- Black/Slate Grey/191448209428 Size M7 W9,205182-0DDM7W9 CrocsLiteRideTM Flip CLR- Black/Slate Grey/191448209428 Size M7 W9,Default Ridgefield,10,10,0,0,0,0
,205182-0DDM7W9 CrocsLiteRideTM Flip CLR- Black/Slate Grey/191448209428 Size M7 W9,205182-0DDM7W9 CrocsLiteRideTM Flip CLR- Black/Slate Grey/191448209428 Size M7 W9,FBALYB Amazon,-10,-10,0,0,0,0
,205182-0DDM8W10 CrocsLiteRideTM Flip CLR- Black/Slate Grey/191448209435 Size M8 W10,205182-0DDM8W10 CrocsLiteRideTM Flip CLR- Black/Slate Grey/191448209435 Size M8 W10,Default Ridgefield,10,10,0,0,0,0
,205182-0DDM8W10 CrocsLiteRideTM Flip CLR- Black/Slate Grey/191448209435 Size M8 W10,205182-0DDM8W10 CrocsLiteRideTM Flip CLR- Black/Slate Grey/191448209435 Size M8 W10,FBALYB Amazon,-7,-7,0,0,0,0
,205182-0DDM9W11 CrocsLiteRideTM Flip CLR- Black/Slate Grey/191448209442 Size M9 W11,205182-0DDM9W11 CrocsLiteRideTM Flip CLR- Black/Slate Grey/191448209442 Size M9 W11,Default Ridgefield,10,10,0,0,0,0
,205182-0DDM9W11 CrocsLiteRideTM Flip CLR- Black/Slate Grey/191448209442 Size M9 W11,205182-0DDM9W11 CrocsLiteRideTM Flip CLR- Black/Slate Grey/191448209442 Size M9 W11,FBALYB Amazon,-10,-10,0,0,0,0
,205182-462M10W12 CrocsLiteRideTM Flip CLR- Navy/White/191448142176 Size M10 W12,205182-462M10W12 CrocsLiteRideTM Flip CLR- Navy/White/191448142176 Size M10 W12,FBALYB Amazon,-2,-2,0,0,0,0
,205182-462M11 CrocsLiteRideTM Flip CLR- Navy/White/191448142183 Size M11 W13,205182-462M11 CrocsLiteRideTM Flip CLR- Navy/White/191448142183 Size M11 W13,Default Ridgefield,1,1,0,0,0,0
,205182-462M11 CrocsLiteRideTM Flip CLR- Navy/White/191448142183 Size M11 W13,205182-462M11 CrocsLiteRideTM Flip CLR- Navy/White/191448142183 Size M11 W13,FBALYB Amazon,0,0,0,5,0,0
,205182-462M12 CrocsLiteRideTM Flip CLR- Navy/White/191448142190 Size M12 W14,205182-462M12 CrocsLiteRideTM Flip CLR- Navy/White/191448142190 Size M12 W14,FBALYB Amazon,-1,-1,0,0,0,0
,205182-462M4W6 CrocsLiteRideTM Flip CLR- Navy/White/191448142213 Size M4 W6,205182-462M4W6 CrocsLiteRideTM Flip CLR- Navy/White/191448142213 Size M4 W6,FBALYB Amazon,-1,-1,0,0,0,0
,205182-462M5W7 CrocsLiteRideTM Flip CLR- Navy/White/191448142220 Size M5 W7,205182-462M5W7 CrocsLiteRideTM Flip CLR- Navy/White/191448142220 Size M5 W7,FBALYB Amazon,-2,-2,0,0,0,0
,205182-462M6W8 CrocsLiteRideTM Flip CLR- Navy/White/191448142237 Size M6 W8,205182-462M6W8 CrocsLiteRideTM Flip CLR- Navy/White/191448142237 Size M6 W8,Default Ridgefield,6,6,0,0,0,0
,205182-462M6W8 CrocsLiteRideTM Flip CLR- Navy/White/191448142237 Size M6 W8,205182-462M6W8 CrocsLiteRideTM Flip CLR- Navy/White/191448142237 Size M6 W8,FBALYB Amazon,-6,-6,0,0,0,0
,205182-462M7W9 CrocsLiteRideTM Flip CLR- Navy/White/191448142244 Size M7 W9,205182-462M7W9 CrocsLiteRideTM Flip CLR- Navy/White/191448142244 Size M7 W9,Default Ridgefield,10,10,0,0,0,0
,205182-462M7W9 CrocsLiteRideTM Flip CLR- Navy/White/191448142244 Size M7 W9,205182-462M7W9 CrocsLiteRideTM Flip CLR- Navy/White/191448142244 Size M7 W9,FBALYB Amazon,12,12,0,0,0,0
,205182-462M8W10 CrocsLiteRideTM Flip CLR- Navy/White/191448142251 Size M8 W10,205182-462M8W10 CrocsLiteRideTM Flip CLR- Navy/White/191448142251 Size M8 W10,Default Ridgefield,10,10,0,0,0,0
,205182-462M8W10 CrocsLiteRideTM Flip CLR- Navy/White/191448142251 Size M8 W10,205182-462M8W10 CrocsLiteRideTM Flip CLR- Navy/White/191448142251 Size M8 W10,FBALYB Amazon,-5,-6,1,0,1,0
,205182-462M9W11 CrocsLiteRideTM Flip CLR- Navy/White/191448142268 SIze M9 W11,205182-462M9W11 CrocsLiteRideTM Flip CLR- Navy/White/191448142268 SIze M9 W11,Default Ridgefield,5,5,0,0,0,0
,205182-462M9W11 CrocsLiteRideTM Flip CLR- Navy/White/191448142268 SIze M9 W11,205182-462M9W11 CrocsLiteRideTM Flip CLR- Navy/White/191448142268 SIze M9 W11,FBALYB Amazon,-10,-10,0,0,0,0
,205234-001W8 CrocsWomen’s LiteRideTM Pacer CLR- Black/191448166448 Size 8,205234-001W8 CrocsWomen’s LiteRideTM Pacer CLR- Black/191448166448 Size 8,FBALYB Amazon,-2,-2,0,0,0,0
,205234-001W9 CrocsWomen’s LiteRideTM Pacer CLR- Black/191448166455 Size 9,205234-001W9 CrocsWomen’s LiteRideTM Pacer CLR- Black/191448166455 Size 9,FBALYB Amazon,-1,-1,0,0,0,0
,205234-1CNW8 CrocsWomen’s LiteRideTM Pacer CLR- Almost White/191448500341 Size 8,205234-1CNW8 CrocsWomen’s LiteRideTM Pacer CLR- Almost White/191448500341 Size 8,FBALYB Amazon,-3,-3,0,0,0,0
,205234-4GTW10 CrocsWomen’s LiteRideTM Pacer CLR- Navy/Ice Blue/191448500440 Size 10,205234-4GTW10 CrocsWomen’s LiteRideTM Pacer CLR- Navy/Ice Blue/191448500440 Size 10,FBALYB Amazon,-2,-2,0,0,0,0
,205234-4GTW8 CrocsWomen’s LiteRideTM Pacer CLR- Navy/Ice Blue/191448500501 Size 8,205234-4GTW8 CrocsWomen’s LiteRideTM Pacer CLR- Navy/Ice Blue/191448500501 Size 8,FBALYB Amazon,-6,-6,0,0,0,0
,205234-4GTW9 CrocsWomen’s LiteRideTM Pacer CLR- Navy/Ice Blue/191448500518 Size 9,205234-4GTW9 CrocsWomen’s LiteRideTM Pacer CLR- Navy/Ice Blue/191448500518 Size 9,FBALYB Amazon,-2,-2,0,0,0,0
,205289-001M10 CrocsMen’s SwiftwaterTM Mesh Deck Sandal CLR- Black/191448223165 Size 10,205289-001M10 CrocsMen’s SwiftwaterTM Mesh Deck Sandal CLR- Black/191448223165 Size 10,FBALYB Amazon,-5,-5,0,0,0,0
,205289-001M11 CrocsMen’s SwiftwaterTM Mesh Deck Sandal CLR- Black/191448223172 Size 11,205289-001M11 CrocsMen’s SwiftwaterTM Mesh Deck Sandal CLR- Black/191448223172 Size 11,FBALYB Amazon,-1,-1,0,0,0,0
,205289-001M12 CrocsMen’s SwiftwaterTM Mesh Deck Sandal CLR- Black/191448223189 Size 12,205289-001M12 CrocsMen’s SwiftwaterTM Mesh Deck Sandal CLR- Black/191448223189 Size 12,FBALYB Amazon,-1,-1,0,0,0,0
,205289-001M7 CrocsMen’s SwiftwaterTM Mesh Deck Sandal CLR- Black/191448223202 Size 7,205289-001M7 CrocsMen’s SwiftwaterTM Mesh Deck Sandal CLR- Black/191448223202 Size 7,FBALYB Amazon,-1,-1,0,0,0,0
,205289-001M8 CrocsMen’s SwiftwaterTM Mesh Deck Sandal CLR- Black/191448223219 Size 8,205289-001M8 CrocsMen’s SwiftwaterTM Mesh Deck Sandal CLR- Black/191448223219 Size 8,FBALYB Amazon,-2,-2,0,0,0,0
,205289-001M9 CrocsMen’s SwiftwaterTM Mesh Deck Sandal CLR- Black/191448223226 Size 9,205289-001M9 CrocsMen’s SwiftwaterTM Mesh Deck Sandal CLR- Black/191448223226 Size 9,FBALYB Amazon,-1,-1,0,0,0,0
,205289-206M10 CrocsMen’s SwiftwaterTM Mesh Deck Sandal CLR- Espresso/191448223301 Size 10,205289-206M10 CrocsMen’s SwiftwaterTM Mesh Deck Sandal CLR- Espresso/191448223301 Size 10,FBALYB Amazon,-1,-1,0,0,0,0
,205289-206M11 CrocsMen’s SwiftwaterTM Mesh Deck Sandal CLR- Espresso/191448223318 Size 11,205289-206M11 CrocsMen’s SwiftwaterTM Mesh Deck Sandal CLR- Espresso/191448223318 Size 11,FBALYB Amazon,-1,-1,0,0,0,0
,205289-206M7 CrocsMen’s SwiftwaterTM Mesh Deck Sandal CLR- Espresso/191448223349 Size 7,205289-206M7 CrocsMen’s SwiftwaterTM Mesh Deck Sandal CLR- Espresso/191448223349 Size 7,FBALYB Amazon,4,4,0,0,0,0
,205289-206M8 CrocsMen’s SwiftwaterTM Mesh Deck Sandal CLR- Espresso/191448223356 Size 8,205289-206M8 CrocsMen’s SwiftwaterTM Mesh Deck Sandal CLR- Espresso/191448223356 Size 8,FBALYB Amazon,-3,-3,0,0,0,0
,205289-206M9 CrocsMen’s SwiftwaterTM Mesh Deck Sandal CLR- Espresso/191448223363 Size 9,205289-206M9 CrocsMen’s SwiftwaterTM Mesh Deck Sandal CLR- Espresso/191448223363 Size 9,FBALYB Amazon,-2,-2,0,0,0,0
,205441-669 Crocs Kids’ Classic Glitter Clog Pink Lemonade US Size C11,205441-669 Crocs Kids’ Classic Glitter Clog Pink Lemonade US Size C11,FBALYB Amazon,13,13,0,2,0,0
,205441-669 Crocs Kids’ Classic Glitter Clog Pink Lemonade US Size C12,205441-669 Crocs Kids’ Classic Glitter Clog Pink Lemonade US Size C12,FBALYB Amazon,0,0,0,10,0,0
,205441-669 Crocs Kids’ Classic Glitter Clog Pink Lemonade US Size C13,205441-669 Crocs Kids’ Classic Glitter Clog Pink Lemonade US Size C13,Default Ridgefield,3,3,0,0,0,0
,205441-669 Crocs Kids’ Classic Glitter Clog Pink Lemonade US Size C13,205441-669 Crocs Kids’ Classic Glitter Clog Pink Lemonade US Size C13,FBALYB Amazon,0,0,0,98,0,0
,205441-669 Crocs Kids’ Classic Glitter Clog Pink Lemonade US Size J1,205441-669 Crocs Kids’ Classic Glitter Clog Pink Lemonade US Size J1,FBALYB Amazon,0,0,0,30,0,0
,205441-669 Crocs Kids’ Classic Glitter Clog Pink Lemonade US Size J2,205441-669 Crocs Kids’ Classic Glitter Clog Pink Lemonade US Size J2,FBALYB Amazon,17,17,0,0,0,0
,205441-669 Crocs Kids’ Classic Glitter Clog Pink Lemonade US Size J3,205441-669 Crocs Kids’ Classic Glitter Clog Pink Lemonade US Size J3,FBALYB Amazon,40,40,0,0,0,0
,205451-90H Crocs Kids’ Classic Tie-Dye Graphic Clog Multi US Size C10,205451-90H Crocs Kids’ Classic Tie-Dye Graphic Clog Multi US Size C10,FBALYB Amazon,0,0,0,84,0,0
,205451-90H Crocs Kids’ Classic Tie-Dye Graphic Clog Multi US Size C11,205451-90H Crocs Kids’ Classic Tie-Dye Graphic Clog Multi US Size C11,FBALYB Amazon,0,0,0,32,0,0
,205451-90H Crocs Kids’ Classic Tie-Dye Graphic Clog Multi US Size C12,205451-90H Crocs Kids’ Classic Tie-Dye Graphic Clog Multi US Size C12,FBALYB Amazon,0,0,0,43,0,0
,205451-90H Crocs Kids’ Classic Tie-Dye Graphic Clog Multi US Size C13,205451-90H Crocs Kids’ Classic Tie-Dye Graphic Clog Multi US Size C13,FBALYB Amazon,85,85,0,0,0,0
,205451-90H Crocs Kids’ Classic Tie-Dye Graphic Clog Multi US Size C5,205451-90H Crocs Kids’ Classic Tie-Dye Graphic Clog Multi US Size C5,Default Ridgefield,1,1,0,0,0,0
,205451-90H Crocs Kids’ Classic Tie-Dye Graphic Clog Multi US Size C5,205451-90H Crocs Kids’ Classic Tie-Dye Graphic Clog Multi US Size C5,FBALYB Amazon,0,0,0,8,0,0
,205451-90H Crocs Kids’ Classic Tie-Dye Graphic Clog Multi US Size C6,205451-90H Crocs Kids’ Classic Tie-Dye Graphic Clog Multi US Size C6,FBALYB Amazon,0,0,0,21,0,0
,205451-90H Crocs Kids’ Classic Tie-Dye Graphic Clog Multi US Size C7,205451-90H Crocs Kids’ Classic Tie-Dye Graphic Clog Multi US Size C7,FBALYB Amazon,0,0,0,21,0,0
,205451-90H Crocs Kids’ Classic Tie-Dye Graphic Clog Multi US Size C8,205451-90H Crocs Kids’ Classic Tie-Dye Graphic Clog Multi US Size C8,Default Ridgefield,3,3,0,0,0,0
,205451-90H Crocs Kids’ Classic Tie-Dye Graphic Clog Multi US Size C8,205451-90H Crocs Kids’ Classic Tie-Dye Graphic Clog Multi US Size C8,FBALYB Amazon,0,0,0,72,0,0
,205451-90H Crocs Kids’ Classic Tie-Dye Graphic Clog Multi US Size C9,205451-90H Crocs Kids’ Classic Tie-Dye Graphic Clog Multi US Size C9,FBALYB Amazon,0,0,0,54,0,0
,205451-90H Crocs Kids’ Classic Tie-Dye Graphic Clog Multi US Size J1,205451-90H Crocs Kids’ Classic Tie-Dye Graphic Clog Multi US Size J1,Default Ridgefield,1,1,0,0,0,0
,205451-90H Crocs Kids’ Classic Tie-Dye Graphic Clog Multi US Size J1,205451-90H Crocs Kids’ Classic Tie-Dye Graphic Clog Multi US Size J1,FBALYB Amazon,0,0,0,159,0,0
,205451-90H Crocs Kids’ Classic Tie-Dye Graphic Clog Multi US Size J2,205451-90H Crocs Kids’ Classic Tie-Dye Graphic Clog Multi US Size J2,FBALYB Amazon,154,154,0,16,0,0
,205451-90H Crocs Kids’ Classic Tie-Dye Graphic Clog Multi US Size J3,205451-90H Crocs Kids’ Classic Tie-Dye Graphic Clog Multi US Size J3,FBALYB Amazon,203,203,0,0,0,0
,205451-90H Crocs Kids’ Classic Tie-Dye Graphic Clog Multi US Size J4,205451-90H Crocs Kids’ Classic Tie-Dye Graphic Clog Multi US Size J4,FBALYB Amazon,159,159,0,0,0,0
,205451-90H Crocs Kids’ Classic Tie-Dye Graphic Clog Multi US Size J5,205451-90H Crocs Kids’ Classic Tie-Dye Graphic Clog Multi US Size J5,Default Ridgefield,1,1,0,0,0,0
,205451-90H Crocs Kids’ Classic Tie-Dye Graphic Clog Multi US Size J5,205451-90H Crocs Kids’ Classic Tie-Dye Graphic Clog Multi US Size J5,FBALYB Amazon,146,143,3,24,3,0
,205451-90H Crocs Kids’ Classic Tie-Dye Graphic Clog Multi US Size J6,205451-90H Crocs Kids’ Classic Tie-Dye Graphic Clog Multi US Size J6,Default Ridgefield,2,2,0,0,0,0
,205451-90H Crocs Kids’ Classic Tie-Dye Graphic Clog Multi US Size J6,205451-90H Crocs Kids’ Classic Tie-Dye Graphic Clog Multi US Size J6,FBALYB Amazon,126,126,0,1,0,0
,205453-90HM10W12 CrocsClassic Tie-Dye Graphic Clog CLR- Multi/191448236745 M10 W12,205453-90HM10W12 CrocsClassic Tie-Dye Graphic Clog CLR- Multi/191448236745 M10 W12,FBALYB Amazon,-1,-1,0,0,0,0
,205453-90HM11 CrocsClassic Tie-Dye Graphic Clog CLR- Multi/191448236752 Size M11 W13,205453-90HM11 CrocsClassic Tie-Dye Graphic Clog CLR- Multi/191448236752 Size M11 W13,FBALYB Amazon,-1,-1,0,0,0,0
,205453-90HM6W8 CrocsClassic Tie-Dye Graphic Clog CLR- Multi/191448236806 Size M6 W8,205453-90HM6W8 CrocsClassic Tie-Dye Graphic Clog CLR- Multi/191448236806 Size M6 W8,FBALYB Amazon,-2,-2,0,0,0,0
,205453-90HM7W9 CrocsClassic Tie-Dye Graphic Clog CLR- Multi/191448236813 Size M7 W9,205453-90HM7W9 CrocsClassic Tie-Dye Graphic Clog CLR- Multi/191448236813 Size M7 W9,FBALYB Amazon,-3,-3,0,0,0,0
,205453-90HM8W10 CrocsClassic Tie-Dye Graphic Clog CLR- Multi/191448236820 Size M8 W10,205453-90HM8W10 CrocsClassic Tie-Dye Graphic Clog CLR- Multi/191448236820 Size M8 W10,FBALYB Amazon,1,0,1,0,1,0
,205453-90HM9W11 CrocsClassic Tie-Dye Graphic Clog CLR- Multi/191448236837 Size M9 W11,205453-90HM9W11 CrocsClassic Tie-Dye Graphic Clog CLR- Multi/191448236837 Size M9 W11,FBALYB Amazon,9,9,0,0,0,0
,205453-94SM10W12 CrocsClassic Tie-Dye Graphic Clog CLR- White/Multi/191448412781 Size M10 W12,205453-94SM10W12 CrocsClassic Tie-Dye Graphic Clog CLR- White/Multi/191448412781 Size M10 W12,Default Ridgefield,11,11,0,0,0,0
,205453-94SM11 CrocsClassic Tie-Dye Graphic Clog CLR- White/Multi/191448412798 Size M11 W13,205453-94SM11 CrocsClassic Tie-Dye Graphic Clog CLR- White/Multi/191448412798 Size M11 W13,Default Ridgefield,6,6,0,0,0,0
,205453-94SM12 CrocsClassic Tie-Dye Graphic Clog CLR- White/Multi/191448412804 M12 W14,205453-94SM12 CrocsClassic Tie-Dye Graphic Clog CLR- White/Multi/191448412804 M12 W14,Default Ridgefield,1,1,0,0,0,0
,205453-94SM12 CrocsClassic Tie-Dye Graphic Clog CLR- White/Multi/191448412804 M12 W14,205453-94SM12 CrocsClassic Tie-Dye Graphic Clog CLR- White/Multi/191448412804 M12 W14,FBALYB Amazon,0,0,0,4,0,0
,205453-94SM4W6 CrocsClassic Tie-Dye Graphic Clog CLR- White/Multi/191448412828 Size M4 W6,205453-94SM4W6 CrocsClassic Tie-Dye Graphic Clog CLR- White/Multi/191448412828 Size M4 W6,Default Ridgefield,4,4,0,0,0,0
,205453-94SM5W7 CrocsClassic Tie-Dye Graphic Clog CLR- White/Multi/191448412835 Size M5 W7,205453-94SM5W7 CrocsClassic Tie-Dye Graphic Clog CLR- White/Multi/191448412835 Size M5 W7,Default Ridgefield,4,4,0,0,0,0
,205453-94SM6W8 CrocsClassic Tie-Dye Graphic Clog CLR- White/Multi/191448412842 Size M6 W8,205453-94SM6W8 CrocsClassic Tie-Dye Graphic Clog CLR- White/Multi/191448412842 Size M6 W8,Default Ridgefield,11,11,0,0,0,0
,205453-94SM7W9 CrocsClassic Tie-Dye Graphic Clog CLR- White/Multi/191448412859 Size M7 W9,205453-94SM7W9 CrocsClassic Tie-Dye Graphic Clog CLR- White/Multi/191448412859 Size M7 W9,Default Ridgefield,18,18,0,0,0,0
,205453-94SM8W10 CrocsClassic Tie-Dye Graphic Clog CLR- White/Multi/191448412866 Size M8 W10,205453-94SM8W10 CrocsClassic Tie-Dye Graphic Clog CLR- White/Multi/191448412866 Size M8 W10,Default Ridgefield,8,8,0,0,0,0
,205453-94SM9W11 CrocsClassic Tie-Dye Graphic Clog CLR- White/Multi/191448412873 Size M9 W11,205453-94SM9W11 CrocsClassic Tie-Dye Graphic Clog CLR- White/Multi/191448412873 Size M9 W11,Default Ridgefield,17,17,0,0,0,0
,205468-060W10 CrocsWomen’s CRO Serena Flip CLR- Black/Black/191448321199 Size 10,205468-060W10 CrocsWomen’s CRO Serena Flip CLR- Black/Black/191448321199 Size 10,FBALYB Amazon,-1,-1,0,0,0,0
,205468-060W6 CrocsWomen’s CRO Serena Flip CLR- Black/Black/191448321236 Size 6,205468-060W6 CrocsWomen’s CRO Serena Flip CLR- Black/Black/191448321236 Size 6,FBALYB Amazon,-1,-1,0,0,0,0
,205468-060W7 CrocsWomen’s CRO Serena Flip CLR- Black/Black/191448321243 Size 7,205468-060W7 CrocsWomen’s CRO Serena Flip CLR- Black/Black/191448321243 Size 7,FBALYB Amazon,-3,-3,0,0,0,0
,205468-060W8 CrocsWomen’s CRO Serena Flip CLR- Black/Black/191448321250 Size 8,205468-060W8 CrocsWomen’s CRO Serena Flip CLR- Black/Black/191448321250 Size 8,FBALYB Amazon,-5,-5,0,0,0,0
,205468-060W9 CrocsWomen’s CRO Serena Flip CLR- Black/Black/191448321267 Size 9,205468-060W9 CrocsWomen’s CRO Serena Flip CLR- Black/Black/191448321267 Size 9,FBALYB Amazon,-1,-1,0,0,0,0
,205468-611W6 CrocsWomen’s CRO Serena Flip CLR- Poppy/191448361058 Size 6,205468-611W6 CrocsWomen’s CRO Serena Flip CLR- Poppy/191448361058 Size 6,FBALYB Amazon,-3,-3,0,0,0,0
,205468-611W7 CrocsWomen’s CRO Serena Flip CLR- Poppy/191448361065 Size 7,205468-611W7 CrocsWomen’s CRO Serena Flip CLR- Poppy/191448361065 Size 7,FBALYB Amazon,-1,-1,0,0,0,0
,205468-611W8 CrocsWomen’s CRO Serena Flip CLR- Poppy/191448361072 Size 8,205468-611W8 CrocsWomen’s CRO Serena Flip CLR- Poppy/191448361072 Size 8,Default,0,0,0,0,0,1
,205468-611W8 CrocsWomen’s CRO Serena Flip CLR- Poppy/191448361072 Size 8,205468-611W8 CrocsWomen’s CRO Serena Flip CLR- Poppy/191448361072 Size 8,Default Ridgefield,17,17,0,0,0,0
,205468-611W9 CrocsWomen’s CRO Serena Flip CLR- Poppy/191448361089 Size 9,205468-611W9 CrocsWomen’s CRO Serena Flip CLR- Poppy/191448361089 Size 9,FBALYB Amazon,-6,-6,0,0,0,0
,205469-060W10 CrocsWomen’s CRO Serena Sandal CLR- Black/Black/191448321519 Size 10,205469-060W10 CrocsWomen’s CRO Serena Sandal CLR- Black/Black/191448321519 Size 10,FBALYB Amazon,-1,-1,0,0,0,0
,205469-060W6 CrocsWomen’s CRO Serena Sandal CLR- Black/Black/191448321557 Size 6,205469-060W6 CrocsWomen’s CRO Serena Sandal CLR- Black/Black/191448321557 Size 6,FBALYB Amazon,0,0,0,6,0,0
,205469-060W7 CrocsWomen’s CRO Serena Sandal CLR- Black/Black/191448321564 Size 7,205469-060W7 CrocsWomen’s CRO Serena Sandal CLR- Black/Black/191448321564 Size 7,FBALYB Amazon,0,0,0,12,0,0
,205469-060W8 CrocsWomen’s CRO Serena Sandal CLR- Black/Black/191448321571 Size 8,205469-060W8 CrocsWomen’s CRO Serena Sandal CLR- Black/Black/191448321571 Size 8,Default Ridgefield,17,17,0,0,0,0
,205469-060W8 CrocsWomen’s CRO Serena Sandal CLR- Black/Black/191448321571 Size 8,205469-060W8 CrocsWomen’s CRO Serena Sandal CLR- Black/Black/191448321571 Size 8,FBALYB Amazon,0,0,0,1,0,0
,205469-060W9 CrocsWomen’s CRO Serena Sandal CLR- Black/Black/191448321588 Size 9,205469-060W9 CrocsWomen’s CRO Serena Sandal CLR- Black/Black/191448321588 Size 9,FBALYB Amazon,0,0,0,18,0,0
,205469-611W10 CrocsWomen’s CRO Serena Sandal CLR- Poppy/191448361096 Size 10,205469-611W10 CrocsWomen’s CRO Serena Sandal CLR- Poppy/191448361096 Size 10,FBALYB Amazon,0,0,0,6,0,0
,205469-611W6 CrocsWomen’s CRO Serena Sandal CLR- Poppy/191448361133 Size 6,205469-611W6 CrocsWomen’s CRO Serena Sandal CLR- Poppy/191448361133 Size 6,FBALYB Amazon,0,0,0,6,0,0
,205469-611W7 CrocsWomen’s CRO Serena Sandal CLR- Poppy/191448361140 Size 7,205469-611W7 CrocsWomen’s CRO Serena Sandal CLR- Poppy/191448361140 Size 7,FBALYB Amazon,0,0,0,12,0,0
,205469-611W8 CrocsWomen’s CRO Serena Sandal CLR- Poppy/191448361157 Size 8,205469-611W8 CrocsWomen’s CRO Serena Sandal CLR- Poppy/191448361157 Size 8,FBALYB Amazon,0,0,0,18,0,0
,205469-611W9 CrocsWomen’s CRO Serena Sandal CLR- Poppy/191448361164 Size 9,205469-611W9 CrocsWomen’s CRO Serena Sandal CLR- Poppy/191448361164 Size 9,FBALYB Amazon,0,0,0,18,0,0
,205619-001 Crocs Specialist II Vent Clog Black US Size M10/ W12,205619-001 Crocs Specialist II Vent Clog Black US Size M10/ W12,Default Ridgefield,12,12,0,0,0,0
,205619-001 Crocs Specialist II Vent Clog Black US Size M10/ W12,205619-001 Crocs Specialist II Vent Clog Black US Size M10/ W12,FBALYB Amazon,0,0,0,11,0,0
,205619-001 Crocs Specialist II Vent Clog Black US Size M11/ W13,205619-001 Crocs Specialist II Vent Clog Black US Size M11/ W13,Default Ridgefield,1,1,0,0,0,0
,205619-001 Crocs Specialist II Vent Clog Black US Size M11/ W13,205619-001 Crocs Specialist II Vent Clog Black US Size M11/ W13,FBALYB Amazon,20,20,0,0,0,0
,205619-001 Crocs Specialist II Vent Clog Black US Size M12/ W14,205619-001 Crocs Specialist II Vent Clog Black US Size M12/ W14,FBALYB Amazon,18,18,0,0,0,0
,205619-001 Crocs Specialist II Vent Clog Black US Size M13/ W15,205619-001 Crocs Specialist II Vent Clog Black US Size M13/ W15,FBALYB Amazon,13,13,0,0,0,0
,205619-001 Crocs Specialist II Vent Clog Black US Size M4/ W6,205619-001 Crocs Specialist II Vent Clog Black US Size M4/ W6,FBALYB Amazon,15,11,4,0,4,0
,205619-001 Crocs Specialist II Vent Clog Black US Size M5/ W7,205619-001 Crocs Specialist II Vent Clog Black US Size M5/ W7,FBALYB Amazon,0,0,0,36,0,0
,205619-001 Crocs Specialist II Vent Clog Black US Size M6/ W8,205619-001 Crocs Specialist II Vent Clog Black US Size M6/ W8,FBALYB Amazon,0,0,0,31,0,0
,205619-001 Crocs Specialist II Vent Clog Black US Size M7/ W9,205619-001 Crocs Specialist II Vent Clog Black US Size M7/ W9,FBALYB Amazon,27,23,4,0,4,0
,205619-001 Crocs Specialist II Vent Clog Black US Size M8/ W10,205619-001 Crocs Specialist II Vent Clog Black US Size M8/ W10,FBALYB Amazon,0,0,0,18,0,0
,205619-001 Crocs Specialist II Vent Clog Black US Size M9/ W11,205619-001 Crocs Specialist II Vent Clog Black US Size M9/ W11,FBALYB Amazon,0,0,0,31,0,0
,206081-00JW8 CrocsWomen's LiteRideTM Stretch Sandal CLR- Light Grey/White/191448503922 Size 8,206081-00JW8 CrocsWomen's LiteRideTM Stretch Sandal CLR- Light Grey/White/191448503922 Size 8,FBALYB Amazon,-6,-6,0,0,0,0
,206081-00JW9 CrocsWomen's LiteRideTM Stretch Sandal CLR- Light Grey/White/191448503939 Size 9,206081-00JW9 CrocsWomen's LiteRideTM Stretch Sandal CLR- Light Grey/White/191448503939 Size 9,FBALYB Amazon,-4,-4,0,0,0,0
,206081-060W10 CrocsWomen's LiteRideTM Stretch Sandal CLR- Black/Black/191448503946 Size 10,206081-060W10 CrocsWomen's LiteRideTM Stretch Sandal CLR- Black/Black/191448503946 Size 10,FBALYB Amazon,-8,-8,0,0,0,0
,206081-060W6 CrocsWomen's LiteRideTM Stretch Sandal CLR- Black/Black/191448503984 Size 6,206081-060W6 CrocsWomen's LiteRideTM Stretch Sandal CLR- Black/Black/191448503984 Size 6,FBALYB Amazon,-4,-4,0,0,0,0
,206081-060W8 CrocsWomen's LiteRideTM Stretch Sandal CLR- Black/Black/191448504004 Size 8,206081-060W8 CrocsWomen's LiteRideTM Stretch Sandal CLR- Black/Black/191448504004 Size 8,FBALYB Amazon,-18,-21,3,0,3,0
,206081-060W9 CrocsWomen's LiteRideTM Stretch Sandal CLR- Black/Black/191448504011 Size 9,206081-060W9 CrocsWomen's LiteRideTM Stretch Sandal CLR- Black/Black/191448504011 Size 9,FBALYB Amazon,-21,-25,4,0,4,0
,206081-066W10 CrocsWomen's LiteRideTM Stretch Sandal CLR- Black/White/191448504028 Size 10,206081-066W10 CrocsWomen's LiteRideTM Stretch Sandal CLR- Black/White/191448504028 Size 10,FBALYB Amazon,-1,-1,0,0,0,0
,206081-066W6 CrocsWomen's LiteRideTM Stretch Sandal CLR- Black/White/191448504066 Size 6,206081-066W6 CrocsWomen's LiteRideTM Stretch Sandal CLR- Black/White/191448504066 Size 6,FBALYB Amazon,-1,-1,0,0,0,0
,206081-066W7 CrocsWomen's LiteRideTM Stretch Sandal CLR- Black/White/191448504073 Size 7,206081-066W7 CrocsWomen's LiteRideTM Stretch Sandal CLR- Black/White/191448504073 Size 7,FBALYB Amazon,-3,-5,2,0,2,0
,206081-066W8 CrocsWomen's LiteRideTM Stretch Sandal CLR- Black/White/191448504080 Size 8,206081-066W8 CrocsWomen's LiteRideTM Stretch Sandal CLR- Black/White/191448504080 Size 8,FBALYB Amazon,-3,-4,1,0,1,0
,206081-066W9 CrocsWomen's LiteRideTM Stretch Sandal CLR- Black/White/191448504097 Size 9,206081-066W9 CrocsWomen's LiteRideTM Stretch Sandal CLR- Black/White/191448504097 Size 9,FBALYB Amazon,-2,-2,0,0,0,0
,206100-001W6 CrocsWomen's CRObandTM Flip CLR- Black/191448483453 Size 6,206100-001W6 CrocsWomen's CRObandTM Flip CLR- Black/191448483453 Size 6,FBALYB Amazon,-1,-1,0,0,0,0
,206100-001W7 CrocsWomen's CRObandTM Flip CLR- Black/191448483460 Size 7,206100-001W7 CrocsWomen's CRObandTM Flip CLR- Black/191448483460 Size 7,FBALYB Amazon,-1,-1,0,0,0,0
,206100-001W8 CrocsWomen's CRObandTM Flip CLR- Black/191448483477 Size 8,206100-001W8 CrocsWomen's CRObandTM Flip CLR- Black/191448483477 Size 8,FBALYB Amazon,-2,-2,0,0,0,0
,206100-001W9 CrocsWomen's CRObandTM Flip CLR- Black/191448483484 Size 9,206100-001W9 CrocsWomen's CRObandTM Flip CLR- Black/191448483484 Size 9,FBALYB Amazon,-6,-7,1,0,1,0
,206100-100W10 CrocsWomen's CRObandTM Flip CLR- White/191448483491 Size 10,206100-100W10 CrocsWomen's CRObandTM Flip CLR- White/191448483491 Size 10,Default,0,0,0,0,0,6
,206100-100W10 CrocsWomen's CRObandTM Flip CLR- White/191448483491 Size 10,206100-100W10 CrocsWomen's CRObandTM Flip CLR- White/191448483491 Size 10,FBALYB Amazon,3,3,0,0,0,0
,206100-100W6 CrocsWomen's CRObandTM Flip CLR- White/191448483538 Size 6,206100-100W6 CrocsWomen's CRObandTM Flip CLR- White/191448483538 Size 6,FBALYB Amazon,-4,-4,0,0,0,0
,206100-100W7 CrocsWomen's CRObandTM Flip CLR- White/191448483545 Size 7,206100-100W7 CrocsWomen's CRObandTM Flip CLR- White/191448483545 Size 7,FBALYB Amazon,-2,-2,0,0,0,0
,206100-100W8 CrocsWomen's CRObandTM Flip CLR- White/191448483552 Size 8,206100-100W8 CrocsWomen's CRObandTM Flip CLR- White/191448483552 Size 8,FBALYB Amazon,-4,-4,0,0,0,0
,206100-100W9 CrocsWomen's CRObandTM Flip CLR- White/191448483569 Size 9,206100-100W9 CrocsWomen's CRObandTM Flip CLR- White/191448483569 Size 9,Default,0,0,0,0,0,24
,206100-100W9 CrocsWomen's CRObandTM Flip CLR- White/191448483569 Size 9,206100-100W9 CrocsWomen's CRObandTM Flip CLR- White/191448483569 Size 9,FBALYB Amazon,-1,-1,0,0,0,0
,206100-3U4W6 CrocsWomen's CRObandTM Flip CLR- Lime Zest/191448713505 Size 6,206100-3U4W6 CrocsWomen's CRObandTM Flip CLR- Lime Zest/191448713505 Size 6,FBALYB Amazon,-1,-1,0,0,0,0
,206100-3U4W7 CrocsWomen's CRObandTM Flip CLR- Lime Zest/191448713512 Size 7,206100-3U4W7 CrocsWomen's CRObandTM Flip CLR- Lime Zest/191448713512 Size 7,Default,0,0,0,0,0,18
,206100-3U4W8 CrocsWomen's CRObandTM Flip CLR- Lime Zest/191448713529 Size 8,206100-3U4W8 CrocsWomen's CRObandTM Flip CLR- Lime Zest/191448713529 Size 8,FBALYB Amazon,-2,-2,0,0,0,0
,206100-3U4W9 CrocsWomen's CRObandTM Flip CLR- Lime Zest/191448713536 Size 9,206100-3U4W9 CrocsWomen's CRObandTM Flip CLR- Lime Zest/191448713536 Size 9,FBALYB Amazon,-1,-1,0,0,0,0
,206100-410W10 CrocsWomen's CRObandTM Flip CLR- Navy/191448483736 Size 10,206100-410W10 CrocsWomen's CRObandTM Flip CLR- Navy/191448483736 Size 10,FBALYB Amazon,0,-1,1,0,1,0
,206100-410W6 CrocsWomen's CRObandTM Flip CLR- Navy/191448483774 Size 6,206100-410W6 CrocsWomen's CRObandTM Flip CLR- Navy/191448483774 Size 6,FBALYB Amazon,-2,-2,0,0,0,0
,206100-410W7 CrocsWomen's CRObandTM Flip CLR- Navy/191448483781 Size 7,206100-410W7 CrocsWomen's CRObandTM Flip CLR- Navy/191448483781 Size 7,FBALYB Amazon,-4,-4,0,0,0,0
,206100-410W8 CrocsWomen's CRObandTM Flip CLR- Navy/191448483798 Size 8,206100-410W8 CrocsWomen's CRObandTM Flip CLR- Navy/191448483798 Size 8,FBALYB Amazon,-2,-2,0,0,0,0
,206100-410W9 CrocsWomen's CRObandTM Flip CLR- Navy/191448483804 Size 9,206100-410W9 CrocsWomen's CRObandTM Flip CLR- Navy/191448483804 Size 9,Default,0,0,0,0,0,24
,206100-4O9W7 CrocsWomen's CRObandTM Flip CLR- Ice Blue/191448483866 Size 7,206100-4O9W7 CrocsWomen's CRObandTM Flip CLR- Ice Blue/191448483866 Size 7,FBALYB Amazon,-3,-3,0,0,0,0
,206100-4O9W8 CrocsWomen's CRObandTM Flip CLR- Ice Blue/191448483873 Size 8,206100-4O9W8 CrocsWomen's CRObandTM Flip CLR- Ice Blue/191448483873 Size 8,FBALYB Amazon,-1,-1,0,0,0,0
,206100-6QQW6 CrocsWomen's CRObandTM Flip CLR- Electric Pink/191448483934 Size 6,206100-6QQW6 CrocsWomen's CRObandTM Flip CLR- Electric Pink/191448483934 Size 6,FBALYB Amazon,6,6,0,0,0,0
,206100-6QQW7 CrocsWomen's CRObandTM Flip CLR- Electric Pink/191448483941 Size 7,206100-6QQW7 CrocsWomen's CRObandTM Flip CLR- Electric Pink/191448483941 Size 7,FBALYB Amazon,-3,-3,0,0,0,0
,206100-6QQW8 CrocsWomen's CRObandTM Flip CLR- Electric Pink/191448483958 Size 8,206100-6QQW8 CrocsWomen's CRObandTM Flip CLR- Electric Pink/191448483958 Size 8,FBALYB Amazon,-4,-4,0,0,0,0
,206100-6QQW9 CrocsWomen's CRObandTM Flip CLR- Electric Pink/191448483965 Size 9,206100-6QQW9 CrocsWomen's CRObandTM Flip CLR- Electric Pink/191448483965 Size 9,Default,0,0,0,0,0,24
,206100-6QQW9 CrocsWomen's CRObandTM Flip CLR- Electric Pink/191448483965 Size 9,206100-6QQW9 CrocsWomen's CRObandTM Flip CLR- Electric Pink/191448483965 Size 9,FBALYB Amazon,-2,-2,0,0,0,0
,206107-00WW6 CrocsWomen's CRO Tulum Sandal CLR- Black/Tan/191448504387 Size 6,206107-00WW6 CrocsWomen's CRO Tulum Sandal CLR- Black/Tan/191448504387 Size 6,FBALYB Amazon,-1,-1,0,0,0,0
,206107-00WW7 CrocsWomen's CRO Tulum Sandal CLR- Black/Tan/191448504394 Size 7,206107-00WW7 CrocsWomen's CRO Tulum Sandal CLR- Black/Tan/191448504394 Size 7,FBALYB Amazon,-2,-2,0,0,0,0
,206107-00WW8 CrocsWomen's CRO Tulum Sandal CLR- Black/Tan/191448504400 Size 8,206107-00WW8 CrocsWomen's CRO Tulum Sandal CLR- Black/Tan/191448504400 Size 8,FBALYB Amazon,-5,-5,0,0,0,0
,206107-00WW9 CrocsWomen's CRO Tulum Sandal CLR- Black/Tan/191448515819 Size 9,206107-00WW9 CrocsWomen's CRO Tulum Sandal CLR- Black/Tan/191448515819 Size 9,FBALYB Amazon,-4,-4,0,0,0,0
,206107-1CQW8 CrocsWomen's CRO Tulum Sandal CLR- Oyster/Tan/191448506077 Size 8,206107-1CQW8 CrocsWomen's CRO Tulum Sandal CLR- Oyster/Tan/191448506077 Size 8,FBALYB Amazon,-3,-3,0,0,0,0
,206108-00WW8 CrocsWomen's CRO Tulum Toe Post Sandal CLR- Black/Tan/191448516045 Size 8,206108-00WW8 CrocsWomen's CRO Tulum Toe Post Sandal CLR- Black/Tan/191448516045 Size 8,Default Ridgefield,12,12,0,0,0,0
,206108-00WW9 CrocsWomen's CRO Tulum Toe Post Sandal CLR- Black/Tan/191448516052 Size 9,206108-00WW9 CrocsWomen's CRO Tulum Toe Post Sandal CLR- Black/Tan/191448516052 Size 9,FBALYB Amazon,0,0,0,12,0,0
,206108-1CQW7 CrocsWomen's CRO Tulum Toe Post Sandal CLR- Oyster/Tan/191448506541 Size 7,206108-1CQW7 CrocsWomen's CRO Tulum Toe Post Sandal CLR- Oyster/Tan/191448506541 Size 7,FBALYB Amazon,-2,-2,0,0,0,0
,206108-1CQW8 CrocsWomen's CRO Tulum Toe Post Sandal CLR- Oyster/Tan/191448506558 Size 8,206108-1CQW8 CrocsWomen's CRO Tulum Toe Post Sandal CLR- Oyster/Tan/191448506558 Size 8,FBALYB Amazon,-1,-1,0,0,0,0
,206108-1CQW9 CrocsWomen's CRO Tulum Toe Post Sandal CLR- Oyster/Tan/191448506565 Size 9,206108-1CQW9 CrocsWomen's CRO Tulum Toe Post Sandal CLR- Oyster/Tan/191448506565 Size 9,Default Ridgefield,18,18,0,0,0,0
,206119-001M10W12 CrocsClassic II Flip CLR- Black/191448507395 Size M10 W12,206119-001M10W12 CrocsClassic II Flip CLR- Black/191448507395 Size M10 W12,FBALYB Amazon,6,5,1,0,1,0
,206119-001M11 CrocsClassic II Flip CLR- Black/191448507401 Size M11 W13,206119-001M11 CrocsClassic II Flip CLR- Black/191448507401 Size M11 W13,FBALYB Amazon,-1,-1,0,0,0,0
,206119-001M5W7 CrocsClassic II Flip CLR- Black/191448507449 Size M5 W7,206119-001M5W7 CrocsClassic II Flip CLR- Black/191448507449 Size M5 W7,FBALYB Amazon,9,7,2,0,2,0
,206119-001M6W8 CrocsClassic II Flip CLR- Black/191448507456 Size M6 W8,206119-001M6W8 CrocsClassic II Flip CLR- Black/191448507456 Size M6 W8,Default Ridgefield,0,-18,18,0,0,0
,206119-001M6W8 CrocsClassic II Flip CLR- Black/191448507456 Size M6 W8,206119-001M6W8 CrocsClassic II Flip CLR- Black/191448507456 Size M6 W8,FBALYB Amazon,-2,-2,0,0,0,0
,206119-001M7W9 CrocsClassic II Flip CLR- Black/191448507463 Size M7 W9,206119-001M7W9 CrocsClassic II Flip CLR- Black/191448507463 Size M7 W9,Default Ridgefield,0,-18,18,0,0,0
,206119-001M7W9 CrocsClassic II Flip CLR- Black/191448507463 Size M7 W9,206119-001M7W9 CrocsClassic II Flip CLR- Black/191448507463 Size M7 W9,FBALYB Amazon,-3,-3,0,0,0,0
,206119-001M8W10 CrocsClassic II Flip CLR- Black/191448507470 Size M8 W10,206119-001M8W10 CrocsClassic II Flip CLR- Black/191448507470 Size M8 W10,FBALYB Amazon,1,1,0,0,0,0
,206119-001M9W11 CrocsClassic II Flip CLR- Black/191448507487 Size M9 W11,206119-001M9W11 CrocsClassic II Flip CLR- Black/191448507487 Size M9 W11,Default Ridgefield,15,15,0,0,0,0
,206119-0DAM10W12 CrocsClassic II Flip CLR- Slate Grey/191448507593 Size M10 W12,206119-0DAM10W12 CrocsClassic II Flip CLR- Slate Grey/191448507593 Size M10 W12,FBALYB Amazon,6,6,0,0,0,0
,206119-0DAM11 CrocsClassic II Flip CLR- Slate Grey/191448507609 Size M11 W13,206119-0DAM11 CrocsClassic II Flip CLR- Slate Grey/191448507609 Size M11 W13,Default Ridgefield,12,12,0,0,0,0
,206119-0DAM11 CrocsClassic II Flip CLR- Slate Grey/191448507609 Size M11 W13,206119-0DAM11 CrocsClassic II Flip CLR- Slate Grey/191448507609 Size M11 W13,FBALYB Amazon,13,12,1,0,1,0
,206119-0DAM12 CrocsClassic II Flip CLR- Slate Grey/191448507616 Size M12 W14,206119-0DAM12 CrocsClassic II Flip CLR- Slate Grey/191448507616 Size M12 W14,FBALYB Amazon,8,7,1,0,1,0
,206119-0DAM4W6 CrocsClassic II Flip CLR- Slate Grey/191448507630 Size M4 W6,206119-0DAM4W6 CrocsClassic II Flip CLR- Slate Grey/191448507630 Size M4 W6,Default Ridgefield,10,10,0,0,0,0
,206119-0DAM4W6 CrocsClassic II Flip CLR- Slate Grey/191448507630 Size M4 W6,206119-0DAM4W6 CrocsClassic II Flip CLR- Slate Grey/191448507630 Size M4 W6,FBALYB Amazon,4,4,0,0,0,0
,206119-0DAM5W7 CrocsClassic II Flip CLR- Slate Grey/191448507647 Size M5 W7,206119-0DAM5W7 CrocsClassic II Flip CLR- Slate Grey/191448507647 Size M5 W7,FBALYB Amazon,17,17,0,0,0,0
,206119-0DAM6W8 CrocsClassic II Flip CLR- Slate Grey/191448507654 Size M6 W8,206119-0DAM6W8 CrocsClassic II Flip CLR- Slate Grey/191448507654 Size M6 W8,FBALYB Amazon,16,16,0,0,0,0
,206119-0DAM7W9 CrocsClassic II Flip CLR- Slate Grey/191448507661 Size M7 W9,206119-0DAM7W9 CrocsClassic II Flip CLR- Slate Grey/191448507661 Size M7 W9,FBALYB Amazon,20,19,1,0,1,0
,206119-0DAM8W10 CrocsClassic II Flip CLR- Slate Grey/191448507678 Size M8 W10,206119-0DAM8W10 CrocsClassic II Flip CLR- Slate Grey/191448507678 Size M8 W10,Default Ridgefield,30,30,0,0,0,0
,206119-0DAM8W10 CrocsClassic II Flip CLR- Slate Grey/191448507678 Size M8 W10,206119-0DAM8W10 CrocsClassic II Flip CLR- Slate Grey/191448507678 Size M8 W10,FBALYB Amazon,-4,-4,0,0,0,0
,206119-0DAM9W11 CrocsClassic II Flip CLR- Slate Grey/191448507685 Size M9 W11,206119-0DAM9W11 CrocsClassic II Flip CLR- Slate Grey/191448507685 Size M9 W11,Default Ridgefield,32,32,0,0,0,0
,206119-0DAM9W11 CrocsClassic II Flip CLR- Slate Grey/191448507685 Size M9 W11,206119-0DAM9W11 CrocsClassic II Flip CLR- Slate Grey/191448507685 Size M9 W11,FBALYB Amazon,-2,-2,0,0,0,0
,206119-100M10W12 CrocsClassic II Flip CLR- White/191448507791 Size M10 W12,206119-100M10W12 CrocsClassic II Flip CLR- White/191448507791 Size M10 W12,FBALYB Amazon,-2,-2,0,0,0,0
,206119-100M11 CrocsClassic II Flip CLR- White/191448507807 Size M11 W13,206119-100M11 CrocsClassic II Flip CLR- White/191448507807 Size M11 W13,FBALYB Amazon,-1,-1,0,0,0,0
,206119-100M12 CrocsClassic II Flip CLR- White/191448507814 Size M12 W14,206119-100M12 CrocsClassic II Flip CLR- White/191448507814 Size M12 W14,FBALYB Amazon,-2,-2,0,0,0,0
,206119-100M4W6 CrocsClassic II Flip CLR- White/191448507838 Size M4 W6,206119-100M4W6 CrocsClassic II Flip CLR- White/191448507838 Size M4 W6,FBALYB Amazon,-1,-1,0,0,0,0
,206119-100M5W7 CrocsClassic II Flip CLR- White/191448507845 Size M5 W7,206119-100M5W7 CrocsClassic II Flip CLR- White/191448507845 Size M5 W7,FBALYB Amazon,-1,-1,0,0,0,0
,206119-100M6W8 CrocsClassic II Flip CLR- White/191448507852 Size M6 W8,206119-100M6W8 CrocsClassic II Flip CLR- White/191448507852 Size M6 W8,Default Ridgefield,1,-17,18,0,0,0
,206119-100M6W8 CrocsClassic II Flip CLR- White/191448507852 Size M6 W8,206119-100M6W8 CrocsClassic II Flip CLR- White/191448507852 Size M6 W8,FBALYB Amazon,1,-3,4,0,4,0
,206119-100M7W9 CrocsClassic II Flip CLR- White/191448507869 Size M7 W9,206119-100M7W9 CrocsClassic II Flip CLR- White/191448507869 Size M7 W9,FBALYB Amazon,3,3,0,0,0,0
,206119-100M8W10 CrocsClassic II Flip CLR- White/191448507876 Size M8 W10,206119-100M8W10 CrocsClassic II Flip CLR- White/191448507876 Size M8 W10,FBALYB Amazon,2,-1,3,0,3,0
,206119-100M9W11 CrocsClassic II Flip CLR- White/191448507883 Size M9 W11,206119-100M9W11 CrocsClassic II Flip CLR- White/191448507883 Size M9 W11,FBALYB Amazon,16,14,2,0,2,0
,206119-410M10W12 CrocsClassic II Flip CLR- Navy/191448508194 Size M10 W12,206119-410M10W12 CrocsClassic II Flip CLR- Navy/191448508194 Size M10 W12,FBALYB Amazon,13,11,2,0,2,0
,206119-410M11 CrocsClassic II Flip CLR- Navy/191448508200 Size M11 W13,206119-410M11 CrocsClassic II Flip CLR- Navy/191448508200 Size M11 W13,FBALYB Amazon,8,7,1,0,1,0
,206119-410M12 CrocsClassic II Flip CLR- Navy/191448508217 Size M12 W14,206119-410M12 CrocsClassic II Flip CLR- Navy/191448508217 Size M12 W14,FBALYB Amazon,10,9,1,0,1,0
,206119-410M4W6 CrocsClassic II Flip CLR- Navy/191448508231 Size M4 W6,206119-410M4W6 CrocsClassic II Flip CLR- Navy/191448508231 Size M4 W6,FBALYB Amazon,-2,-2,0,12,0,0
,206119-410M5W7 CrocsClassic II Flip CLR- Navy/191448508248 Size M5 W7,206119-410M5W7 CrocsClassic II Flip CLR- Navy/191448508248 Size M5 W7,FBALYB Amazon,6,4,2,0,2,0
,206119-410M6W8 CrocsClassic II Flip CLR- Navy/191448508255 Size M6 W8,206119-410M6W8 CrocsClassic II Flip CLR- Navy/191448508255 Size M6 W8,FBALYB Amazon,5,5,0,0,0,0
,206119-410M7W9 CrocsClassic II Flip CLR- Navy/191448508262 Size M7 W9,206119-410M7W9 CrocsClassic II Flip CLR- Navy/191448508262 Size M7 W9,FBALYB Amazon,-13,-13,0,12,0,0
,206119-410M9W11 CrocsClassic II Flip CLR- Navy/191448508286 Size M9 W11,206119-410M9W11 CrocsClassic II Flip CLR- Navy/191448508286 Size M9 W11,FBALYB Amazon,-1,-1,0,0,0,0
,206119-4SLM11 CrocsClassic II Flip CLR- Digital Aqua/191448666658 Size M11 W13,206119-4SLM11 CrocsClassic II Flip CLR- Digital Aqua/191448666658 Size M11 W13,FBALYB Amazon,-1,-1,0,0,0,0
,206119-4SLM4W6 CrocsClassic II Flip CLR- Digital Aqua/191448666689 Size M4 W6,206119-4SLM4W6 CrocsClassic II Flip CLR- Digital Aqua/191448666689 Size M4 W6,FBALYB Amazon,-1,-1,0,0,0,0
,206119-4SLM6W8 CrocsClassic II Flip CLR- Digital Aqua/191448666702 Size M6 W8,206119-4SLM6W8 CrocsClassic II Flip CLR- Digital Aqua/191448666702 Size M6 W8,Default Ridgefield,0,-1,1,0,0,0
,206119-4SLM7W9 CrocsClassic II Flip CLR- Digital Aqua/191448666719 Size M7 W9,206119-4SLM7W9 CrocsClassic II Flip CLR- Digital Aqua/191448666719 Size M7 W9,FBALYB Amazon,-1,-1,0,0,0,0
,206119-4SLM8W10 CrocsClassic II Flip CLR- Digital Aqua/191448666726 Size M8 W10,206119-4SLM8W10 CrocsClassic II Flip CLR- Digital Aqua/191448666726 Size M8 W10,FBALYB Amazon,-1,-1,0,0,0,0
,206119-5PRM4W6 CrocsClassic II Flip CLR- Orchid/191448666887 Size M4 W6,206119-5PRM4W6 CrocsClassic II Flip CLR- Orchid/191448666887 Size M4 W6,FBALYB Amazon,-1,-1,0,0,0,0
,206119-5PRM6W8 CrocsClassic II Flip CLR- Orchid/191448666900 Size M6 W8,206119-5PRM6W8 CrocsClassic II Flip CLR- Orchid/191448666900 Size M6 W8,FBALYB Amazon,-1,-1,0,0,0,0
,206119-5PRM7W9 CrocsClassic II Flip CLR- Orchid/191448666917 Size M7 W9,206119-5PRM7W9 CrocsClassic II Flip CLR- Orchid/191448666917 Size M7 W9,FBALYB Amazon,-1,-1,0,0,0,0
,206119-5PRM8W10 CrocsClassic II Flip CLR- Orchid/191448666924 Size M8 W10,206119-5PRM8W10 CrocsClassic II Flip CLR- Orchid/191448666924 Size M8 W10,FBALYB Amazon,2,2,0,0,0,0
,206119-7C1M12 CrocsClassic II Flip CLR- Lemon/191448508736 Size M12 W14,206119-7C1M12 CrocsClassic II Flip CLR- Lemon/191448508736 Size M12 W14,FBALYB Amazon,-1,-1,0,0,0,0
,206119-7C1M5W7 CrocsClassic II Flip CLR- Lemon/191448508767 Size M5 W7,206119-7C1M5W7 CrocsClassic II Flip CLR- Lemon/191448508767 Size M5 W7,FBALYB Amazon,-3,-3,0,0,0,0
,206119-7C1M8W10 CrocsClassic II Flip CLR- Lemon/191448508798 Size M8 W10,206119-7C1M8W10 CrocsClassic II Flip CLR- Lemon/191448508798 Size M8 W10,FBALYB Amazon,4,3,1,0,1,0
,206119-7C1M9W11 CrocsClassic II Flip CLR- Lemon/191448508804 Size M9 W11,206119-7C1M9W11 CrocsClassic II Flip CLR- Lemon/191448508804 Size M9 W11,FBALYB Amazon,1,1,0,0,0,0
,206121-001M10W12 CrocsClassic CRO Slide CLR- Black/191448438316 Size M10 W12,206121-001M10W12 CrocsClassic CRO Slide CLR- Black/191448438316 Size M10 W12,FBALYB Amazon,2,1,1,0,1,0
,206121-001M11 CrocsClassic CRO Slide CLR- Black/191448438323 Size M11 W13,206121-001M11 CrocsClassic CRO Slide CLR- Black/191448438323 Size M11 W13,FBALYB Amazon,-7,-10,3,0,3,0
,206121-001M12 CrocsClassic CRO Slide CLR- Black/191448438330 Size M12 W14,206121-001M12 CrocsClassic CRO Slide CLR- Black/191448438330 Size M12 W14,Default Ridgefield,1,1,0,0,0,0
,206121-001M12 CrocsClassic CRO Slide CLR- Black/191448438330 Size M12 W14,206121-001M12 CrocsClassic CRO Slide CLR- Black/191448438330 Size M12 W14,FBALYB Amazon,-4,-4,0,0,0,0
,206121-001M4W6 CrocsClassic CRO Slide CLR- Black/191448438354 Size M4 W6,206121-001M4W6 CrocsClassic CRO Slide CLR- Black/191448438354 Size M4 W6,FBALYB Amazon,-5,-6,1,0,1,0
,206121-001M5W7 CrocsClassic CRO Slide CLR- Black/191448438361 Size M5 W7,206121-001M5W7 CrocsClassic CRO Slide CLR- Black/191448438361 Size M5 W7,FBALYB Amazon,-17,-23,6,0,6,0
,206121-001M6W8 CrocsClassic CRO Slide CLR- Black/191448438378 Size M6 W8,206121-001M6W8 CrocsClassic CRO Slide CLR- Black/191448438378 Size M6 W8,FBALYB Amazon,-13,-13,0,0,0,0
,206121-001M7W9 CrocsClassic CRO Slide CLR- Black/191448438385 Size M7 W9,206121-001M7W9 CrocsClassic CRO Slide CLR- Black/191448438385 Size M7 W9,FBALYB Amazon,-34,-35,1,0,1,0
,206121-001M8W10 CrocsClassic CRO Slide CLR- Black/191448438392 Size M8 W10,206121-001M8W10 CrocsClassic CRO Slide CLR- Black/191448438392 Size M8 W10,FBALYB Amazon,-10,-10,0,0,0,0
,206121-001M9W11 CrocsClassic CRO Slide CLR- Black/191448438408 Size M9 W11,206121-001M9W11 CrocsClassic CRO Slide CLR- Black/191448438408 Size M9 W11,FBALYB Amazon,-3,-3,0,0,0,0
,206121-100M10W12 CrocsClassic CRO Slide CLR- White/191448438514 Size M10 W12,206121-100M10W12 CrocsClassic CRO Slide CLR- White/191448438514 Size M10 W12,Default Ridgefield,8,8,0,0,0,0
,206121-100M11 CrocsClassic CRO Slide CLR- White/191448438521 Size M11 W13,206121-100M11 CrocsClassic CRO Slide CLR- White/191448438521 Size M11 W13,Default Ridgefield,32,32,0,0,0,0
,206121-100M11 CrocsClassic CRO Slide CLR- White/191448438521 Size M11 W13,206121-100M11 CrocsClassic CRO Slide CLR- White/191448438521 Size M11 W13,FBALYB Amazon,-1,-1,0,0,0,0
,206121-100M12 CrocsClassic CRO Slide CLR- White/191448438538 Size M12 W14,206121-100M12 CrocsClassic CRO Slide CLR- White/191448438538 Size M12 W14,FBALYB Amazon,1,1,0,0,0,0
,206121-100M5W7 CrocsClassic CRO Slide CLR- White/191448438569 Size M5 W7,206121-100M5W7 CrocsClassic CRO Slide CLR- White/191448438569 Size M5 W7,Default Ridgefield,1,1,0,0,0,0
,206121-100M5W7 CrocsClassic CRO Slide CLR- White/191448438569 Size M5 W7,206121-100M5W7 CrocsClassic CRO Slide CLR- White/191448438569 Size M5 W7,FBALYB Amazon,-1,-2,1,0,1,0
,206121-100M6W8 CrocsClassic CRO Slide CLR- White/191448438576 Size M6 W8,206121-100M6W8 CrocsClassic CRO Slide CLR- White/191448438576 Size M6 W8,FBALYB Amazon,3,1,2,0,2,0
,206121-100M7W9 CrocsClassic CRO Slide CLR- White/191448438583 Size M7 W9,206121-100M7W9 CrocsClassic CRO Slide CLR- White/191448438583 Size M7 W9,Default Ridgefield,56,56,0,0,0,0
,206121-100M8W10 CrocsClassic CRO Slide CLR- White/191448438590 Size M8 W10,206121-100M8W10 CrocsClassic CRO Slide CLR- White/191448438590 Size M8 W10,FBALYB Amazon,-2,-2,0,0,0,0
,206121-100M9W11 CrocsClassic CRO Slide CLR- White/191448438606 Size M9 W11,206121-100M9W11 CrocsClassic CRO Slide CLR- White/191448438606 Size M9 W11,Default Ridgefield,8,8,0,0,0,0
,206121-100M9W11 CrocsClassic CRO Slide CLR- White/191448438606 Size M9 W11,206121-100M9W11 CrocsClassic CRO Slide CLR- White/191448438606 Size M9 W11,FBALYB Amazon,-1,-1,0,0,0,0
,206121-410M10W12 CrocsClassic CRO Slide CLR- Navy/191448509511 Size M10 W12,206121-410M10W12 CrocsClassic CRO Slide CLR- Navy/191448509511 Size M10 W12,FBALYB Amazon,-2,-3,1,0,1,0
,206121-410M11 CrocsClassic CRO Slide CLR- Navy/191448509528 Size M11 W13,206121-410M11 CrocsClassic CRO Slide CLR- Navy/191448509528 Size M11 W13,FBALYB Amazon,-6,-6,0,0,0,0
,206121-410M12 CrocsClassic CRO Slide CLR- Navy/191448509535 Size M12 W14,206121-410M12 CrocsClassic CRO Slide CLR- Navy/191448509535 Size M12 W14,Default Ridgefield,0,-6,6,0,0,0
,206121-410M12 CrocsClassic CRO Slide CLR- Navy/191448509535 Size M12 W14,206121-410M12 CrocsClassic CRO Slide CLR- Navy/191448509535 Size M12 W14,FBALYB Amazon,-1,-1,0,0,0,0
,206121-410M4W6 CrocsClassic CRO Slide CLR- Navy/191448509559 Size M4 W6,206121-410M4W6 CrocsClassic CRO Slide CLR- Navy/191448509559 Size M4 W6,FBALYB Amazon,-3,-3,0,0,0,0
,206121-410M5W7 CrocsClassic CRO Slide CLR- Navy/191448509566 Size M5 W7,206121-410M5W7 CrocsClassic CRO Slide CLR- Navy/191448509566 Size M5 W7,FBALYB Amazon,-1,-1,0,0,0,0
,206121-410M6W8 CrocsClassic CRO Slide CLR- Navy/191448509573 Size M6 W8,206121-410M6W8 CrocsClassic CRO Slide CLR- Navy/191448509573 Size M6 W8,FBALYB Amazon,-2,-2,0,0,0,0
,206121-410M7W9 CrocsClassic CRO Slide CLR- Navy/191448509580 Size M7 W9,206121-410M7W9 CrocsClassic CRO Slide CLR- Navy/191448509580 Size M7 W9,FBALYB Amazon,-8,-8,0,0,0,0
,206121-410M8W10 CrocsClassic CRO Slide CLR- Navy/191448509597 Size M8 W10,206121-410M8W10 CrocsClassic CRO Slide CLR- Navy/191448509597 Size M8 W10,Default Ridgefield,1,1,0,0,0,0
,206121-410M8W10 CrocsClassic CRO Slide CLR- Navy/191448509597 Size M8 W10,206121-410M8W10 CrocsClassic CRO Slide CLR- Navy/191448509597 Size M8 W10,FBALYB Amazon,-4,-5,1,0,1,0
,206121-410M9W11 CrocsClassic CRO Slide CLR- Navy/191448509603 Size M9 W11,206121-410M9W11 CrocsClassic CRO Slide CLR- Navy/191448509603 Size M9 W11,FBALYB Amazon,-10,-10,0,0,0,0
,206121-6QQM10W12 CrocsClassic CRO Slide CLR- Electric Pink/191448438910 Size M10 W12,206121-6QQM10W12 CrocsClassic CRO Slide CLR- Electric Pink/191448438910 Size M10 W12,FBALYB Amazon,0,0,0,12,0,0
,206121-6QQM11 CrocsClassic CRO Slide CLR- Electric Pink/191448438927 Size M11 W13,206121-6QQM11 CrocsClassic CRO Slide CLR- Electric Pink/191448438927 Size M11 W13,FBALYB Amazon,-1,-1,0,0,0,0
,206121-6QQM12 CrocsClassic CRO Slide CLR- Electric Pink/191448438934 Size M12 W14,206121-6QQM12 CrocsClassic CRO Slide CLR- Electric Pink/191448438934 Size M12 W14,FBALYB Amazon,1,1,0,0,0,0
,206121-6QQM5W7 CrocsClassic CRO Slide CLR- Electric Pink/191448438965 Size M5 W7,206121-6QQM5W7 CrocsClassic CRO Slide CLR- Electric Pink/191448438965 Size M5 W7,FBALYB Amazon,-2,-2,0,0,0,0
,206121-6QQM6W8 CrocsClassic CRO Slide CLR- Electric Pink/191448438972 Size M6 W8,206121-6QQM6W8 CrocsClassic CRO Slide CLR- Electric Pink/191448438972 Size M6 W8,FBALYB Amazon,3,3,0,0,0,0
,206121-6QQM7W9 CrocsClassic CRO Slide CLR- Electric Pink/191448438989 Size M7 W9,206121-6QQM7W9 CrocsClassic CRO Slide CLR- Electric Pink/191448438989 Size M7 W9,Default Ridgefield,1,1,0,0,0,0
,206121-6QQM7W9 CrocsClassic CRO Slide CLR- Electric Pink/191448438989 Size M7 W9,206121-6QQM7W9 CrocsClassic CRO Slide CLR- Electric Pink/191448438989 Size M7 W9,FBALYB Amazon,-1,-1,0,0,0,0
,206121-6QQM8W10 CrocsClassic CRO Slide CLR- Electric Pink/191448438996 M8 W10,206121-6QQM8W10 CrocsClassic CRO Slide CLR- Electric Pink/191448438996 M8 W10,FBALYB Amazon,-1,-1,0,0,0,0
,206121-6QQM9W11 CrocsClassic CRO Slide CLR- Electric Pink/191448439009 Size M9 W11,206121-6QQM9W11 CrocsClassic CRO Slide CLR- Electric Pink/191448439009 Size M9 W11,FBALYB Amazon,-1,-1,0,0,0,0
,206121-7C1M10W12 CrocsClassic CRO Slide CLR- Lemon/191448439313 Size M10 W12,206121-7C1M10W12 CrocsClassic CRO Slide CLR- Lemon/191448439313 Size M10 W12,FBALYB Amazon,-1,-1,0,0,0,0
,206121-7C1M11 CrocsClassic CRO Slide CLR- Lemon/191448439320 Size M11 W13,206121-7C1M11 CrocsClassic CRO Slide CLR- Lemon/191448439320 Size M11 W13,FBALYB Amazon,-1,-1,0,0,0,0
,206121-7C1M4W6 CrocsClassic CRO Slide CLR- Lemon/191448439351 Size M4 W6,206121-7C1M4W6 CrocsClassic CRO Slide CLR- Lemon/191448439351 Size M4 W6,FBALYB Amazon,-1,-1,0,0,0,0
,206121-7C1M6W8 CrocsClassic CRO Slide CLR- Lemon/191448439375 Size M6 W8,206121-7C1M6W8 CrocsClassic CRO Slide CLR- Lemon/191448439375 Size M6 W8,FBALYB Amazon,-4,-4,0,0,0,0
,206121-7C1M7W9 CrocsClassic CRO Slide CLR- Lemon/191448439382 Size M7 W9,206121-7C1M7W9 CrocsClassic CRO Slide CLR- Lemon/191448439382 Size M7 W9,FBALYB Amazon,1,0,1,0,1,0
,206121-7C1M8W10 CrocsClassic CRO Slide CLR- Lemon/191448439399 Size M8 W10,206121-7C1M8W10 CrocsClassic CRO Slide CLR- Lemon/191448439399 Size M8 W10,FBALYB Amazon,-1,-1,0,0,0,0
,206121-7C1M9W11 CrocsClassic CRO Slide CLR- Lemon/191448439405 Size M9 W11,206121-7C1M9W11 CrocsClassic CRO Slide CLR- Lemon/191448439405 Size M9 W11,FBALYB Amazon,-2,-2,0,0,0,0
,206219-060W10 CrocsWomen’s CRO Brooklyn Mid Wedge CLR- Black/Black/191448488427 Size 10,206219-060W10 CrocsWomen’s CRO Brooklyn Mid Wedge CLR- Black/Black/191448488427 Size 10,FBALYB Amazon,-7,-7,0,0,0,0
,206219-060W6 CrocsWomen’s CRO Brooklyn Mid Wedge CLR- Black/Black/191448488465 Size 6,206219-060W6 CrocsWomen’s CRO Brooklyn Mid Wedge CLR- Black/Black/191448488465 Size 6,FBALYB Amazon,0,0,0,6,0,0
,206219-060W8 CrocsWomen’s CRO Brooklyn Mid Wedge CLR- Black/Black/191448488489 Size 8,206219-060W8 CrocsWomen’s CRO Brooklyn Mid Wedge CLR- Black/Black/191448488489 Size 8,FBALYB Amazon,0,-1,1,0,1,0
,206219-060W9 CrocsWomen’s CRO Brooklyn Mid Wedge CLR- Black/Black/191448488496 Size 9,206219-060W9 CrocsWomen’s CRO Brooklyn Mid Wedge CLR- Black/Black/191448488496 Size 9,Default Ridgefield,1,1,0,0,0,0
,206219-060W9 CrocsWomen’s CRO Brooklyn Mid Wedge CLR- Black/Black/191448488496 Size 9,206219-060W9 CrocsWomen’s CRO Brooklyn Mid Wedge CLR- Black/Black/191448488496 Size 9,FBALYB Amazon,-1,-1,0,0,0,0
,206219-16TW7 CrocsWomen’s CRO Brooklyn Mid Wedge CLR- Stucco/Mushroom/191448527263 Size 7,206219-16TW7 CrocsWomen’s CRO Brooklyn Mid Wedge CLR- Stucco/Mushroom/191448527263 Size 7,FBALYB Amazon,-5,-5,0,0,0,0
,206219-16TW8 CrocsWomen’s CRO Brooklyn Mid Wedge CLR- Stucco/Mushroom/191448527270 Size 8,206219-16TW8 CrocsWomen’s CRO Brooklyn Mid Wedge CLR- Stucco/Mushroom/191448527270 Size 8,Default Ridgefield,6,6,0,0,0,0
,206219-16TW8 CrocsWomen’s CRO Brooklyn Mid Wedge CLR- Stucco/Mushroom/191448527270 Size 8,206219-16TW8 CrocsWomen’s CRO Brooklyn Mid Wedge CLR- Stucco/Mushroom/191448527270 Size 8,FBALYB Amazon,10,10,0,0,0,0
,206219-16TW9 CrocsWomen’s CRO Brooklyn Mid Wedge CLR- Stucco/Mushroom/191448527287 Size 9,206219-16TW9 CrocsWomen’s CRO Brooklyn Mid Wedge CLR- Stucco/Mushroom/191448527287 Size 9,FBALYB Amazon,8,7,1,0,1,0
,206222-060W7 CrocsWomen’s CRO Brooklyn High Wedge CLR- Black/Black/191448488717 Size 7,206222-060W7 CrocsWomen’s CRO Brooklyn High Wedge CLR- Black/Black/191448488717 Size 7,Default Ridgefield,3,3,0,0,0,0
,206222-060W8 CrocsWomen’s CRO Brooklyn High Wedge CLR- Black/Black/191448488724 Size 8,206222-060W8 CrocsWomen’s CRO Brooklyn High Wedge CLR- Black/Black/191448488724 Size 8,Default Ridgefield,13,13,0,0,0,0
,206222-060W9 CrocsWomen’s CRO Brooklyn High Wedge CLR- Black/Black/191448488731 Size 9,206222-060W9 CrocsWomen’s CRO Brooklyn High Wedge CLR- Black/Black/191448488731 Size 9,Default Ridgefield,18,18,0,0,0,0
,206222-16TW7 CrocsWomen’s CRO Brooklyn High Wedge CLR- Stucco/Mushroom/191448488793 Size 7,206222-16TW7 CrocsWomen’s CRO Brooklyn High Wedge CLR- Stucco/Mushroom/191448488793 Size 7,FBALYB Amazon,1,1,0,0,0,0
,206222-16TW8 CrocsWomen’s CRO Brooklyn High Wedge CLR- Stucco/Mushroom/191448488809 Size 8,206222-16TW8 CrocsWomen’s CRO Brooklyn High Wedge CLR- Stucco/Mushroom/191448488809 Size 8,FBALYB Amazon,0,0,0,13,0,0
,206222-16TW9 CrocsWomen’s CRO Brooklyn High Wedge CLR- Stucco/Mushroom/191448488816 Size 9,206222-16TW9 CrocsWomen’s CRO Brooklyn High Wedge CLR- Stucco/Mushroom/191448488816 Size 9,FBALYB Amazon,-3,-3,0,0,0,0
,206304-001W10 CrocsWomen's CRO Monterey Strappy Wedge CLR- Black/191448517363 Size 10,206304-001W10 CrocsWomen's CRO Monterey Strappy Wedge CLR- Black/191448517363 Size 10,FBALYB Amazon,-5,-5,0,0,0,0
,206304-001W8 CrocsWomen's CRO Monterey Strappy Wedge CLR- Black/191448517424 Size 8,206304-001W8 CrocsWomen's CRO Monterey Strappy Wedge CLR- Black/191448517424 Size 8,FBALYB Amazon,-1,-1,0,0,0,0
,206304-001W9 CrocsWomen's CRO Monterey Strappy Wedge CLR- Black/191448517431 Size 9,206304-001W9 CrocsWomen's CRO Monterey Strappy Wedge CLR- Black/191448517431 Size 9,FBALYB Amazon,-11,-11,0,0,0,0
,206304-206W6 CrocsWomen's CRO Monterey Strappy Wedge CLR- Espresso/191448517561 Size 6,206304-206W6 CrocsWomen's CRO Monterey Strappy Wedge CLR- Espresso/191448517561 Size 6,FBALYB Amazon,-1,-1,0,0,0,0
,206304-206W7 CrocsWomen's CRO Monterey Strappy Wedge CLR- Espresso/191448517578 Size 7,206304-206W7 CrocsWomen's CRO Monterey Strappy Wedge CLR- Espresso/191448517578 Size 7,FBALYB Amazon,-5,-5,0,0,0,0
,206304-206W8 CrocsWomen's CRO Monterey Strappy Wedge CLR- Espresso/191448517585 Size 8,206304-206W8 CrocsWomen's CRO Monterey Strappy Wedge CLR- Espresso/191448517585 Size 8,FBALYB Amazon,-5,-5,0,0,0,0
,206304-206W9 CrocsWomen's CRO Monterey Strappy Wedge CLR- Espresso/191448517592 Size 9,206304-206W9 CrocsWomen's CRO Monterey Strappy Wedge CLR- Espresso/191448517592 Size 9,FBALYB Amazon,-11,-11,0,0,0,0
,206304-410W6 CrocsWomen's CRO Monterey Strappy Wedge CLR- Navy/191448517646 Size 6,206304-410W6 CrocsWomen's CRO Monterey Strappy Wedge CLR- Navy/191448517646 Size 6,FBALYB Amazon,-1,-1,0,0,0,0
,206304-410W7 CrocsWomen's CRO Monterey Strappy Wedge CLR- Navy/191448517653 Size 7,206304-410W7 CrocsWomen's CRO Monterey Strappy Wedge CLR- Navy/191448517653 Size 7,FBALYB Amazon,-2,-2,0,0,0,0
,206304-410W8 CrocsWomen's CRO Monterey Strappy Wedge CLR- Navy/191448517660 Size 8,206304-410W8 CrocsWomen's CRO Monterey Strappy Wedge CLR- Navy/191448517660 Size 8,FBALYB Amazon,-5,-5,0,0,0,0
,206304-410W9 CrocsWomen's CRO Monterey Strappy Wedge CLR- Navy/191448517677 Size 10,206304-410W9 CrocsWomen's CRO Monterey Strappy Wedge CLR- Navy/191448517677 Size 10,Default Ridgefield,3,3,0,0,0,0
,206304-410W9 CrocsWomen's CRO Monterey Strappy Wedge CLR- Navy/191448517677 Size 9,206304-410W9 CrocsWomen's CRO Monterey Strappy Wedge CLR- Navy/191448517677 Size 9,FBALYB Amazon,-7,-7,0,0,0,0
,206340-001M10W12 CrocsClassic All-Terrain Clog CLR- Black/191448492707 Size M10 W12,206340-001M10W12 CrocsClassic All-Terrain Clog CLR- Black/191448492707 Size M10 W12,FBALYB Amazon,-1,-1,0,0,0,0
,206340-001M6W8 CrocsClassic All-Terrain Clog CLR- Black/191448492769 Size M6 W8,206340-001M6W8 CrocsClassic All-Terrain Clog CLR- Black/191448492769 Size M6 W8,FBALYB Amazon,-2,-2,0,0,0,0
,206340-001M7W9 CrocsClassic All-Terrain Clog CLR- Black/191448492776 Size M7 W9,206340-001M7W9 CrocsClassic All-Terrain Clog CLR- Black/191448492776 Size M7 W9,FBALYB Amazon,-1,-1,0,0,0,0
,206340-001M8W10 CrocsClassic All-Terrain Clog CLR- Black/191448492783 Size M8 W10,206340-001M8W10 CrocsClassic All-Terrain Clog CLR- Black/191448492783 Size M8 W10,FBALYB Amazon,-2,-2,0,0,0,0
,206340-001M9W11 CrocsClassic All-Terrain Clog CLR- Black/191448492790 Size M9 W11,206340-001M9W11 CrocsClassic All-Terrain Clog CLR- Black/191448492790 Size M9 W11,FBALYB Amazon,-4,-4,0,0,0,0
,206340-206M10W12 CrocsClassic All-Terrain Clog CLR- Espresso/191448493100 Size M10 W12,206340-206M10W12 CrocsClassic All-Terrain Clog CLR- Espresso/191448493100 Size M10 W12,FBALYB Amazon,-1,-1,0,0,0,0
,206340-206M11 CrocsClassic All-Terrain Clog CLR- Espresso/191448493117 Size M11 W13,206340-206M11 CrocsClassic All-Terrain Clog CLR- Espresso/191448493117 Size M11 W13,FBALYB Amazon,-1,-1,0,0,0,0
,206340-206M12 CrocsClassic All-Terrain Clog CLR- Espresso/191448493124 Size M12 W14,206340-206M12 CrocsClassic All-Terrain Clog CLR- Espresso/191448493124 Size M12 W14,FBALYB Amazon,-2,-2,0,0,0,0
,206340-206M5W7 CrocsClassic All-Terrain Clog CLR- Espresso/191448493155 Size M5 W7,206340-206M5W7 CrocsClassic All-Terrain Clog CLR- Espresso/191448493155 Size M5 W7,FBALYB Amazon,-1,-1,0,0,0,0
,206340-206M6W8 CrocsClassic All-Terrain Clog CLR- Espresso/191448493162 Size M6 W8,206340-206M6W8 CrocsClassic All-Terrain Clog CLR- Espresso/191448493162 Size M6 W8,Default Ridgefield,11,11,0,0,0,0
,206340-206M7W9 CrocsClassic All-Terrain Clog CLR- Espresso/191448493179 Size M7 W9,206340-206M7W9 CrocsClassic All-Terrain Clog CLR- Espresso/191448493179 Size M7 W9,Default Ridgefield,10,10,0,0,0,0
,206340-206M8W10 CrocsClassic All-Terrain Clog CLR- Espresso/191448493186 Size M8 W10,206340-206M8W10 CrocsClassic All-Terrain Clog CLR- Espresso/191448493186 Size M8 W10,FBALYB Amazon,17,17,0,0,0,0
,206340-206M9W11 CrocsClassic All-Terrain Clog CLR- Espresso/191448493193 Size M9 W11,206340-206M9W11 CrocsClassic All-Terrain Clog CLR- Espresso/191448493193 Size M9 W11,FBALYB Amazon,-2,-2,0,0,0,0
,206453-060W10 CrocsWomen’s CRO Brooklyn Low Wedge CLR- Black/Black/191448544895 Size 10,206453-060W10 CrocsWomen’s CRO Brooklyn Low Wedge CLR- Black/Black/191448544895 Size 10,FBALYB Amazon,-1,-1,0,0,0,0
,206453-060W7 CrocsWomen’s CRO Brooklyn Low Wedge CLR- Black/Black/191448544949 Size 7,206453-060W7 CrocsWomen’s CRO Brooklyn Low Wedge CLR- Black/Black/191448544949 Size 7,FBALYB Amazon,-13,-13,0,0,0,0
,206453-060W8 CrocsWomen’s CRO Brooklyn Low Wedge CLR- Black/Black/191448544956 Size 8,206453-060W8 CrocsWomen’s CRO Brooklyn Low Wedge CLR- Black/Black/191448544956 Size 8,FBALYB Amazon,-2,-2,0,0,0,0
,206453-060W9 CrocsWomen’s CRO Brooklyn Low Wedge CLR- Black/Black/191448544963 Size 9,206453-060W9 CrocsWomen’s CRO Brooklyn Low Wedge CLR- Black/Black/191448544963 Size 9,Default Ridgefield,1,1,0,0,0,0
,206453-060W9 CrocsWomen’s CRO Brooklyn Low Wedge CLR- Black/Black/191448544963 Size 9,206453-060W9 CrocsWomen’s CRO Brooklyn Low Wedge CLR- Black/Black/191448544963 Size 9,FBALYB Amazon,-3,-3,0,0,0,0
,206453-07HW6 CrocsWomen’s CRO Brooklyn Low Wedge CLR- Black/Mushroom/191448495395 Size 6,206453-07HW6 CrocsWomen’s CRO Brooklyn Low Wedge CLR- Black/Mushroom/191448495395 Size 6,FBALYB Amazon,-1,-1,0,0,0,0
,206453-07HW7 CrocsWomen’s CRO Brooklyn Low Wedge CLR- Black/Mushroom/191448495401 Size 7,206453-07HW7 CrocsWomen’s CRO Brooklyn Low Wedge CLR- Black/Mushroom/191448495401 Size 7,FBALYB Amazon,-2,-2,0,0,0,0
,206453-07HW8 CrocsWomen’s CRO Brooklyn Low Wedge CLR- Black/Mushroom/191448495418 Size 8,206453-07HW8 CrocsWomen’s CRO Brooklyn Low Wedge CLR- Black/Mushroom/191448495418 Size 8,FBALYB Amazon,-3,-3,0,0,0,0
,206453-07HW9 CrocsWomen’s CRO Brooklyn Low Wedge CLR- Black/Mushroom/191448495425 Size 9,206453-07HW9 CrocsWomen’s CRO Brooklyn Low Wedge CLR- Black/Mushroom/191448495425 Size 9,FBALYB Amazon,-4,-4,0,0,0,0
,287 BP pico chrome matt M M22bk E113 EANpr4014519275367,287 BP pico chrome matt M M22bk E113 EANpr4014519275367,FBALYB Amazon,-4,-4,0,0,0,0
,"2chic Conditioning & Styling Elixir, Leave-In, Brazilian Keratin & Argan Oil - 4 fl oz","2chic Conditioning & Styling Elixir, Leave-In, Brazilian Keratin & Argan Oil - 4 fl oz",FBALYB Amazon,-1,-1,0,0,0,0
,2H-L4FU-4T95,Shark Rocket Ultra-Light Upright (HV301),FBALYB Amazon,-49,-49,0,23,0,0
,2 Pack Kodiak Waffle Flapjack 4.5lb,2 Pack Kodiak Waffle Flapjack 4.5lb,FBALYB Amazon,61,60,1,0,1,0
,301 RB 2000 M M63bk Rondo  4014519278580,301 RB 2000 M M63bk Rondo  4014519278580,FBALYB Amazon,230,230,0,0,0,0
,312 RB vista M M63bk Rondo  4014519278979,312 RB vista M M63bk Rondo  4014519278979,Default Ridgefield,90,90,0,0,0,0
,312 RB vista M M63bk Rondo  4014519278979,312 RB vista M M63bk Rondo  4014519278979,FBALYB Amazon,-4,-4,0,0,0,0
,316 RB safari red M M63bk Rondo  4014519272465,316 RB safari red M M63bk Rondo  4014519272465,FBALYB Amazon,-8,-8,0,1,0,0
,317 RB safari umbra M M63bk Rondo  4014519270935,317 RB safari umbra M M63bk Rondo  4014519270935,Default Ridgefield,189,189,0,0,0,0
,317 RB safari umbra M M63bk Rondo  4014519270935,317 RB safari umbra M M63bk Rondo  4014519270935,FBALYB Amazon,-22,-22,0,8,0,0
,318 RB safari yellow M M63bk Rondo  4014519273264,318 RB safari yellow M M63bk Rondo  4014519273264,Default Ridgefield,330,330,0,0,0,0
,318 RB safari yellow M M63bk Rondo  4014519273264,318 RB safari yellow M M63bk Rondo  4014519273264,FBALYB Amazon,88,87,1,1,1,0
,319 RB safari white M M63bl Rondo  4014519287162,319 RB safari white M M63bl Rondo  4014519287162,FBALYB Amazon,1,1,0,0,0,0
,328 RB AL-star oceanblue M M63bk Rondo  4014519279839,328 RB AL-star oceanblue M M63bk Rondo  4014519279839,Default Ridgefield,88,88,0,0,0,0
,328 RB AL-star oceanblue M M63bk Rondo  4014519279839,328 RB AL-star oceanblue M M63bk Rondo  4014519279839,FBALYB Amazon,42,41,1,0,1,0
,32 oz Buddy's Best Pump,32 oz Buddy's Best Pump,Default,0,-613,613,0,0,0
,32 oz Buddy's Best Pump,32 oz Buddy's Best Pump,FBALYB Amazon,149,149,0,0,0,0
,331 RB swift black M +M66bk Rondo  4014519272618,331 RB swift black M +M66bk Rondo  4014519272618,Default Ridgefield,441,441,0,0,0,0
,331 RB swift black M +M66bk Rondo  4014519272618,331 RB swift black M +M66bk Rondo  4014519272618,FBALYB Amazon,36,36,0,0,0,0
,3361 Illy Dark Espresso Ground 250G,3361 Illy Dark Espresso Ground 250G,Default Ridgefield,148,148,0,0,0,0
,3363 Illy Deca Espresso Ground 250G,3363 Illy Deca Espresso Ground 250G,Default Oxford,60,60,0,0,0,0
,3363 Illy Deca Espresso Ground 250G,3363 Illy Deca Espresso Ground 250G,Default Ridgefield,214,214,0,0,0,0
,3363 Illy Deca Espresso Ground 250G,3363 Illy Deca Espresso Ground 250G,FBALYB Amazon,24,24,0,585,0,0
,3366 Illy Medium Filter Coffee,3366 Illy Medium Filter Coffee,Default,0,-6422,6422,0,0,0
,3366 Illy Medium Filter Coffee,3366 Illy Medium Filter Coffee,Default Oxford,343,343,0,0,0,0
,3366 Illy Medium Filter Coffee,3366 Illy Medium Filter Coffee,Default Ridgefield,71,71,0,0,0,0
,3366 Illy Medium Filter Coffee,3366 Illy Medium Filter Coffee,FBALYB Amazon,318,310,8,68,8,0
,3366 Illy Medium Filter Coffee 6pk,3366 Illy Medium Filter Coffee 6pk,Default Ridgefield,163,141,22,0,0,0
,3366 Illy Medium Filter Coffee 6pk,3366 Illy Medium Filter Coffee 6pk,FBALYB Amazon,-779,-804,25,1255,25,0
,3369 Illy Moka 250G,3369 Illy Moka 250G,FBALYB Amazon,3279,3218,61,45,61,0
,3373 Illy Medium Espresso Ground 250G,3373 Illy Medium Espresso Ground 250G,Default Ridgefield,209,209,0,0,0,0
,3373 Illy Medium Espresso Ground 250G 6PK,3373 Illy Medium Espresso Ground 250G 6PK,FBALYB Amazon,1008,972,36,760,36,0
,360 Electrical Surge Protector,360 Electrical PowerCurve Surge Protector with Bonus PowerCurve Mini,FBALYB Amazon,1,1,0,0,0,0
,3M Floor Polish 21oz 2PK,3M Floor Polish 21oz 2PK,FBALYB Amazon,45,45,0,0,0,0
,3M floor polish 3PK,3M floor polish 3PK,FBALYB Amazon,150,150,0,0,0,0
,3m Lint Roller 80ct,3m Lint Roller 80ct ,Default Ridgefield,478,478,0,0,0,0
,3m Lint Roller 80ct,3m Lint Roller 80ct ,FBALYB Amazon,2149,2142,7,5,7,0
,3m Lint Roller 80ct,3m Lint Roller 80ct ,WFS,-120,-120,0,0,0,0
,3m Lint Roller 80ct 2PK,3m Lint Roller 80ct 2PK,FBALYB Amazon,220,181,39,0,39,0
,3m Lint Roller 80ct 4PK,3m Lint Roller 80ct 4PK,FBALYB Amazon,1,0,1,0,1,0
,3m Lint Roller 80ct 5PK,3m Lint Roller 80ct 5PK,FBALYB Amazon,-746,-793,47,1249,47,0
,3M Scotch Heavy Duty Packaging Tape 8pk,3M Scotch Heavy Duty Shipping‑Packaging Tape ‑ 8 pack,Default,-5,-5,0,0,0,0
,3M Scotch Lint Roller 2pk,3M Scotch Lint Roller 2pk,FBALYB Amazon,1434,1434,0,2,0,0
,3M Scotch Lint Roller 5pk,3M Scotch Lint Roller 5pk,Default Ridgefield,-2,-2,0,0,0,0
,3M Scotch Lint Roller 5pk,3M Scotch Lint Roller 5pk,FBALYB Amazon,40,40,0,15,0,0
,"3M Stainless Steel Cleaner and Polish, 600 g (21 oz)","3M Stainless Steel Cleaner and Polish, 600 g (21 oz)",Default Ridgefield,1134,1134,0,0,0,0
,3R-LEM5-142I,"Chock Full O Nuts Ground Coffee, Original Blend, 48 Ounce",Default Oxford,-1,-1,0,0,0,0
,3R-LEM5-142I,"Chock Full O Nuts Ground Coffee, Original Blend, 48 Ounce",Default Ridgefield,4,4,0,0,0,0
,3R-LEM5-142I,"Chock Full O Nuts Ground Coffee, Original Blend, 48 Ounce",FBALYB Amazon,16,3,13,21,13,0
,401 MS 2000 4-colours Rondo  4014519270454,401 MS 2000 4-colours Rondo  4014519270454,Default Ridgefield,230,230,0,0,0,0
,401 MS 2000 4-colours Rondo  4014519270454,401 MS 2000 4-colours Rondo  4014519270454,FBALYB Amazon,90,88,2,0,2,0
,4C-HURU-HJUF,"Calvin Klein Men's Cotton Stretch Boxer Brief, Black Blues, Medium",FBALYB Amazon,-2,-2,0,0,0,0
,"4C Iced Tea Mix, 92.8 oz.","4C Iced Tea Mix, 92.8 oz.",Default,0,0,0,0,0,67
,"4C Iced Tea Mix, 92.8 oz.","4C Iced Tea Mix, 92.8 oz.",FBALYB Amazon,3,3,0,0,0,0
,4 footer,FEIT Electric LED 4 ft Tubes - Replaces Fluorescent Tubes (1 pack) - Includes...,FBALYB Amazon,-2,-2,0,0,0,0
,4 pc taco holder + 1 tortilla warmer,4 pc taco holder + 1 tortilla warmer,FBALYB Amazon,-2,-2,0,0,0,0
,4pk - GILLETTE BLADES MACH3 4 CT,4pk - GILLETTE BLADES MACH3 4 CT,WFS,-7,-7,0,0,0,0
,52-81RF-Z682,IDO3D Vertical Five Pen Art Set with 3D Vertical Light,FBAAP Amazon,-3,-3,0,0,0,0
,5J-0IDQ-0TWI,Sphero Star Wars BB-8 App Controlled Robot,FBALYB Amazon,-1,-1,0,0,0,0
,5 led wax candles,"5 LED Wax Candles with Remote Control, Color Changing Mode, Multiple Timers",FBALYB Amazon,-1,-1,0,0,0,0
,63-V6JH-K3FG,"Finish Dishwasher Salt (11 Pounds) Recommended For Bosch, ",FBALYB Amazon,-170,-170,0,338,0,0
,6 flour w speedo swimsuit,"Speedo Women's Patterened One Piece Swimsuit 6, Black/White Flower",FBALYB Amazon,-1,-1,0,0,0,0
,"6'  Fold in Half Table, Grey","National Public Seating Indoor Outdoor Heavy Duty 6' Banquet Rectangular Fold in Half Table, Grey",FBALYB Amazon,-4,-4,0,0,0,0
,7385 Illy Intenso Whole Bean,7385 Illy Intenso Whole Bean,Default Ridgefield,11,11,0,0,0,0
,"746 MS st tri pen black 0,5 M21bk Rondo  4014519274704","746 MS st tri pen black 0,5 M21bk Rondo  4014519274704",FBALYB Amazon,-7,-7,0,1,0,0
,7580 Illy Classico Whole Bean,7580 Illy Classico Whole Bean,Default Ridgefield,109,109,0,0,0,0
,7580 Illy Classico Whole Bean,7580 Illy Classico Whole Bean,FBALYB Amazon,323,321,2,0,2,0
,7997 Illy E.S.E. Single Pods Decaffeinated Medium Roast 131g,7997 Illy E.S.E. Single Pods Decaffeinated Medium Roast 131g,Default,0,-4,4,0,0,0
,7997 Illy E.S.E. Single Pods Decaffeinated Medium Roast 131g,7997 Illy E.S.E. Single Pods Decaffeinated Medium Roast 131g,Default Ridgefield,672,672,0,0,0,0
,7998 Illy E.S.E. Single Pods Medium Espresso Roast 125g,7998 Illy E.S.E. Single Pods Medium Espresso Roast 125g,Default Oxford,372,372,0,0,0,0
,7H-9N8G-WWYZ,Shark Rocket DeluxePro Ultra-Light Upright (HV321),Default,0,-200,200,0,0,0
,7H-9N8G-WWYZ,Shark Rocket DeluxePro Ultra-Light Upright (HV321),FBASKCK Amazon,395,395,0,5,0,0
,7R-JT0P-9WCP,"Keurig K55 Single Serve Programmable K-Cup Pod Coffee Maker, Black",FBALYB Amazon,-6,-6,0,4,0,0
,8.08219E+11,2pk - Amarena Frutto T001398,WFS,-4,-4,0,0,0,0
,8.10039E+11,Stinger Detox - Peach Lemonade,Default Ridgefield,188,188,0,0,0,0
,8.10039E+11,Stinger Detox - Peach Lemonade,FBALYB Amazon,33,33,0,0,0,0
,85-2ASM-0DOW,"Calphalon 11 Piece Classic Ceramic Nonstick Cookware Set, Grey/White, Small",FBALYB Amazon,11,11,0,0,0,0
,8843 IperEspresso Capsules Classic Medium Roast 140.7g,8843 IperEspresso Capsules Classic Medium Roast 140.7g,Default,0,-684,684,0,0,0
,8843 IperEspresso Capsules Classic Medium Roast 140.7g,8843 IperEspresso Capsules Classic Medium Roast 140.7g,Default Oxford,436,436,0,0,0,0
,8843 IperEspresso Capsules Classic Medium Roast 140.7g,8843 IperEspresso Capsules Classic Medium Roast 140.7g,Default Ridgefield,1,1,0,0,0,0
,8843 IperEspresso Capsules Classic Medium Roast 4 pk,8843 IperEspresso Capsules Classic Medium Roast 4 pk,FBALYB Amazon,7,7,0,1,0,0
,8845 IperEspresso Capsules Lungo Medium Roast 130.2g,8845 IperEspresso Capsules Lungo Medium Roast 130.2g,Default Oxford,66,66,0,0,0,0
,8845 IperEspresso Capsules Lungo Medium Roast 130.2g,8845 IperEspresso Capsules Lungo Medium Roast 130.2g,Default Ridgefield,1,1,0,0,0,0
,8845 IperEspresso Capsules Lungo Medium Roast 130.2g,8845 IperEspresso Capsules Lungo Medium Roast 130.2g,FBALYB Amazon,4,4,0,0,0,0
,8in1 Perfect Coat Puppy Wipes 100ct,8in1 Perfect Coat Puppy Wipes 100ct,FBALYB Amazon,2,0,2,0,2,0
,8in1 Perfect Coat Puppy Wipes 100ct 2pk,8in1 Perfect Coat Puppy Wipes 100ct 2pk,FBALYB Amazon,1,1,0,0,0,0
,8n1 Perch Covers for Large Birds,8n1 Perch Covers for Large Birds,Default,0,0,0,0,0,2
,8n1 Perch Covers for Large Birds 4pk,8n1 Perch Covers for Large Birds 4pk,FBALYB Amazon,-1,-1,0,1,0,0
,90-ANAK-S69Q,"Nonni's Cioccolati & Chocolate Hazelnut Biscotti,  Net wt 1 lb 15.2 oz , 25 C...",FBALYB Amazon,0,-1,1,0,1,0
,96-85DQ-5T0W,"Crock-Pot SCCPVL400-S 4-Quart Cook and Carry Slow Cooker, Stainless Steel",FBALYB Amazon,-5,-5,0,0,0,0
,96-EDAN-6CRB,Polaroid ZIP Mobile Printer w/ZINK Zero Ink Printing Technology - Compatible ...,FBALYB Amazon,-41,-41,0,0,0,0
,9K-NBZ0-CSI6,Polaroid ZIP Mobile Printer w/ZINK Zero Ink Printing Technology - Compatible ...,FBALYB Amazon,39,39,0,53,0,0
,"A1 Original Sauce, 2 ct./15 oz.","A1 Original Sauce, 2 ct./15 oz.",FBALYB Amazon,106,106,0,25,0,0
,AA + AAA Duracell Bundle,AA + AAA Duracell Bundle,Default,0,-1,1,0,0,0
,AA + AAA Duracell Bundle,AA + AAA Duracell Bundle,FBALYB Amazon,667,654,13,2,13,0
,Act Bubble Gum 4pk,Act Bubble Gum 4pk,FBALYB Amazon,6,-1,7,8,7,0
,"Act II Butter Lovers Popcorn, 30 ct.","Act II Butter Lovers Popcorn, 30 ct.",FBALYB Amazon,141,141,0,8,0,0
,ACT II BUTTER LOVERS POPCORN 32CT,ACT II BUTTER LOVERS POPCORN 32CT,Default Ridgefield,738,738,0,0,0,0
,ACT II BUTTER LOVERS POPCORN 32CT,ACT II BUTTER LOVERS POPCORN 32CT,FBALYB Amazon,290,277,13,0,13,0
,ACT II BUTTER LOVERS POPCORN 32CT,ACT II BUTTER LOVERS POPCORN 32CT,FBALYB Canada,0,0,0,20,0,0
,Activated C-Series Rite-Size S T 2ct 2pk,Activated C-Series Rite-Size S T 2ct 2pk,FBALYB Amazon,-1,-1,0,0,0,0
,Act Kids Flouride Bubble Gum,Act Anti Cavity Kids Flouride Rinse Bubble Gum Blowout 16.9 Fluid Ounce 3 pack,Default Ridgefield,120,120,0,0,0,0
,Act Kids Flouride Bubble Gum,Act Anti Cavity Kids Flouride Rinse Bubble Gum Blowout 16.9 Fluid Ounce 3 pack,FBALYB Amazon,0,0,0,1,0,0
,Act Total Care Mint Mouthwash 33.8oz,Act Total Care Mint Mouthwash 33.8oz,Default Ridgefield,8,8,0,0,0,0
,Act Total Care Mint Mouthwash 33.8oz 2pk,Act Total Care Mint Mouthwash 33.8oz 2pk,FBALYB Amazon,263,263,0,1,0,0
,Act Total Care Mint Mouthwash 33.8oz 3pk,Act Total Care Mint Mouthwash 33.8oz 3pk,FBALYB Amazon,3,3,0,0,0,0
,Adidas Copa Mundial 015110 B/W/B 10,Adidas Copa Mundial Leather Soccer Cleats 015110 Black/Cloud White/Black US size 10,FBALYB Amazon,-8,-10,2,0,2,0
,Adidas Copa Mundial 015110 B/W/B 11,Adidas Copa Mundial Leather Soccer Cleats 015110 Black/Cloud White/Black US size 11,FBALYB Amazon,53,50,3,0,3,0
,Adidas Copa Mundial 015110 B/W/B 11.5,Adidas Copa Mundial Leather Soccer Cleats 015110 Black/Cloud White/Black US size 11.5,FBALYB Amazon,9,8,1,0,1,0
,Adidas Copa Mundial 015110 B/W/B 12,Adidas Copa Mundial Leather Soccer Cleats 015110 Black/Cloud White/Black US size 12,FBALYB Amazon,61,60,1,0,1,0
,Adidas Copa Mundial 015110 B/W/B 12.5,Adidas Copa Mundial Leather Soccer Cleats 015110 Black/Cloud White/Black US size 12.5,FBALYB Amazon,21,21,0,0,0,0
,Adidas Copa Mundial 015110 B/W/B 13,Adidas Copa Mundial Leather Soccer Cleats 015110 Black/Cloud White/Black US size 13,FBALYB Amazon,13,12,1,0,1,0
,Adidas Copa Mundial 015110 B/W/B 8,Adidas Copa Mundial Leather Soccer Cleats 015110 Black/Cloud White/Black US size 8,Default Ridgefield,1,1,0,0,0,0
,Adidas Copa Mundial 015110 B/W/B 8,Adidas Copa Mundial Leather Soccer Cleats 015110 Black/Cloud White/Black US size 8,FBALYB Amazon,-6,-6,0,0,0,0
,Adidas Copa Mundial 015110 B/W/B 8.5,Adidas Copa Mundial Leather Soccer Cleats 015110 Black/Cloud White/Black US size 8.5,FBALYB Amazon,-7,-9,2,0,2,0
,Adidas Copa Mundial 015110 B/W/B 9,Adidas Copa Mundial Leather Soccer Cleats 015110 Black/Cloud White/Black US size 9,FBALYB Amazon,2,-7,9,0,9,0
,Adidas Copa Mundial 015110 B/W/B 9.5,Adidas Copa Mundial Leather Soccer Cleats 015110 Black/Cloud White/Black US size 9.5,FBALYB Amazon,-10,-12,2,0,2,0
,Adidas CrazyFlight W/B/S FX1792 6,Adidas CrazyFlight Mid Volleyball Shoes Cloud White/Core Black/Silver Metallic FX1792 US Size 6,Default Ridgefield,10,10,0,0,0,0
,Adidas CrazyFlight W/B/S FX1792 6,Adidas CrazyFlight Mid Volleyball Shoes Cloud White/Core Black/Silver Metallic FX1792 US Size 6,FBALYB Amazon,27,26,1,0,1,0
,Adidas CrazyFlight W/B/S FX1792 7,Adidas CrazyFlight Mid Volleyball Shoes Cloud White/Core Black/Silver Metallic FX1792 US Size 7,FBALYB Amazon,95,95,0,0,0,0
,Adidas CrazyFlight W/B/S FX1792 7.5,Adidas CrazyFlight Mid Volleyball Shoes Cloud White/Core Black/Silver Metallic FX1792 US Size 7.5,Default,0,0,0,0,0,10
,Adidas CrazyFlight W/B/S FX1792 7.5,Adidas CrazyFlight Mid Volleyball Shoes Cloud White/Core Black/Silver Metallic FX1792 US Size 7.5,Default Ridgefield,50,50,0,0,0,0
,Adidas CrazyFlight W/B/S FX1792 7.5,Adidas CrazyFlight Mid Volleyball Shoes Cloud White/Core Black/Silver Metallic FX1792 US Size 7.5,FBALYB Amazon,13,12,1,0,1,0
,Adidas CrazyFlight W/B/S FX1792 8,Adidas CrazyFlight Mid Volleyball Shoes Cloud White/Core Black/Silver Metallic FX1792 US Size 8,FBALYB Amazon,67,66,1,0,1,0
,Adidas CrazyFlight W/B/S FX1792 8.5,Adidas CrazyFlight Mid Volleyball Shoes Cloud White/Core Black/Silver Metallic FX1792 US Size 8.5,FBALYB Amazon,-2,-2,0,0,0,0
,Adidas CrazyFlight W/B/S FX1792 9,Adidas CrazyFlight Mid Volleyball Shoes Cloud White/Core Black/Silver Metallic FX1792 US Size 9,Default Ridgefield,1,1,0,0,0,0
,Adidas CrazyFlight W/B/S FX1792 9,Adidas CrazyFlight Mid Volleyball Shoes Cloud White/Core Black/Silver Metallic FX1792 US Size 9,FBALYB Amazon,34,32,2,0,2,0
,Adidas Navy Blue 10,Adidas Navy Blue 10 AC8476,Default,0,-45,45,0,0,0
,Adidas Navy Blue 10,Adidas Navy Blue 10 AC8476,FBALYB Amazon,-48,-48,0,0,0,0
,Adidas Navy Blue 6,Adidas Navy Blue 6 AC8476,Default,0,-15,15,0,0,0
,Adidas Navy Blue 6,Adidas Navy Blue 6 AC8476,FBALYB Amazon,-16,-16,0,0,0,0
,Adidas Navy Blue 6.5,Adidas Navy Blue 6.5 AC8476,Default,0,-9,9,0,0,0
,Adidas Navy Blue 6.5,Adidas Navy Blue 6.5 AC8476,FBALYB Amazon,-10,-10,0,0,0,0
,Adidas Navy Blue 7,Adidas Navy Blue 7 AC8476,Default,0,-23,23,0,0,0
,Adidas Navy Blue 7,Adidas Navy Blue 7 AC8476,FBALYB Amazon,-24,-24,0,0,0,0
,Adidas Navy Blue 7.5,Adidas Navy Blue 7.5 AC8476,Default,0,-21,21,0,0,0
,Adidas Navy Blue 7.5,Adidas Navy Blue 7.5 AC8476,FBALYB Amazon,-24,-24,0,0,0,0
,Adidas Navy Blue 8,Adidas Navy Blue 8 AC8476,Default,0,-20,20,0,0,0
,Adidas Navy Blue 8,Adidas Navy Blue 8 AC8476,FBALYB Amazon,-22,-22,0,0,0,0
,Adidas Navy Blue 8.5,Adidas Navy Blue 8.5 AC8476,Default,0,-12,12,0,0,0
,Adidas Navy Blue 8.5,Adidas Navy Blue 8.5 AC8476,FBALYB Amazon,-12,-12,0,0,0,0
,Adidas Navy Blue 9,Adidas Navy Blue 9 AC8476,Default,0,-24,24,0,0,0
,Adidas Navy Blue 9,Adidas Navy Blue 9 AC8476,FBALYB Amazon,-24,-24,0,0,0,0
,Adidas Navy Blue 9.5,Adidas Navy Blue 9.5 AC8476,Default,0,-26,26,0,0,0
,Adidas Navy Blue 9.5,Adidas Navy Blue 9.5 AC8476,FBALYB Amazon,-27,-27,0,0,0,0
,Adidas SGel Team Force 250ml 3 pk,Adidas SGel Team Force 250ml 3 pk,FBALYB Amazon,80,80,0,1,0,0
,Adidas ULTRABOOST 21 B/B/G FY0378 8,Adidas ULTRABOOST 21 SHOES Core Black/Core Black/Grey Four FY0378 US SIze 8,FBALYB Amazon,24,22,2,0,2,0
,Adidas Women Black 10,Adidas Women Black 10 AC8475,Default,0,-146,146,0,0,0
,Adidas Women Black 10,Adidas Women Black 10 AC8475,FBALYB Amazon,-86,-86,0,0,0,0
,Adidas Women Black 6,Adidas Women Black 6 AC8475,Default,0,-51,51,0,0,0
,Adidas Women Black 6,Adidas Women Black 6 AC8475,FBALYB Amazon,-61,-61,0,0,0,0
,Adidas Women Black 6.5,Adidas Women Black 6.5 AC8475,Default,0,-39,39,0,0,0
,Adidas Women Black 6.5,Adidas Women Black 6.5 AC8475,FBALYB Amazon,-48,-48,0,0,0,0
,Adidas Women Black 7,Adidas Women Black 7 AC8475,Default,0,-75,75,0,0,0
,Adidas Women Black 7,Adidas Women Black 7 AC8475,FBALYB Amazon,-91,-91,0,0,0,0
,Adidas Women Black 7.5,Adidas Women Black 7.5 AC8475,Default,0,-60,60,0,0,0
,Adidas Women Black 7.5,Adidas Women Black 7.5 AC8475,FBALYB Amazon,-73,-73,0,0,0,0
,Adidas Women Black 8,Adidas Women Black 8 AC8475,Default,0,-66,66,0,0,0
,Adidas Women Black 8,Adidas Women Black 8 AC8475,FBALYB Amazon,-77,-77,0,0,0,0
,Adidas Women Black 8.5,Adidas Women Black 8.5 AC8475,Default,0,-63,63,0,0,0
,Adidas Women Black 8.5,Adidas Women Black 8.5 AC8475,FBALYB Amazon,-75,-75,0,0,0,0
,Adidas Women Black 9,Adidas Women Black 9 AC8475,Default,0,-104,104,0,0,0
,Adidas Women Black 9,Adidas Women Black 9 AC8475,FBALYB Amazon,-123,-123,0,0,0,0
,Adidas Women Black 9.5,Adidas Women Black 9.5 AC8475,Default,0,-147,147,0,0,0
,Adidas Women Black 9.5,Adidas Women Black 9.5 AC8475,FBALYB Amazon,-105,-105,0,0,0,0
,Adult Cat Food 5lbs,Chicken Soup for the Soul Adult Cat Food 5lbs,Default,0,0,0,0,0,1
,Adult Cat Food 5lbs,Chicken Soup for the Soul Adult Cat Food 5lbs,FBALYB Amazon,1,1,0,0,0,0
,A.Dürer tin of 120,A.Dürer tin of 120,FBALYB Amazon,-5,-5,0,2,0,0
,"Advil Liqui-Gels, 240 Capsules","Advil Liqui-Gels, Ibuprofen, 200 mg., 240 Capsules",FBALYB Amazon,1,1,0,0,0,0
,Advil PM Caplets 200 ct,Advil PM Caplets 200 ct,FBALYB Amazon,-1,-1,0,0,0,0
,Advil Tablets 360 ct,"Advil Tablets, 200mg - 360 ct",Default,0,0,0,0,0,15
,Advil Tablets 360 ct,"Advil Tablets, 200mg - 360 ct",FBALYB Amazon,2,2,0,0,0,0
,Ae Multi Branch Bird Sm,Ae Multi Branch Bird Sm,FBALYB Amazon,1,1,0,1,0,0
,"AeroGarden Harvest, Black","AeroGarden Harvest with Gourmet Herb Seed Pod Kit, Black",FBALYB Amazon,-3,-3,0,1,0,0
,Afrin Nasal Spray,"Afrin No Drip Severe Congestion Pump Mist Nasal Spray 12 Hr RElief 20 ml, pack of 2",FBALYB Amazon,345,344,1,187,1,0
,Afrin Nasal Spray 2pk,Afrin Nasal Spray 2pk,FBALYB Amazon,-15,-17,2,0,2,0
,After Eight Mints 300g,After Eight Mints 300g,FBALYB Amazon,319,319,0,2,0,0
,After Eight Mints 300g 2pk,After Eight Mints 300g 2pk,FBALYB Amazon,13,13,0,0,0,0
,Aim Dental Floss 4pk,Aim Dental Floss 4pk,Default,0,-61,61,0,0,0
,Aim Dental Floss 4pk,Aim Dental Floss 4pk,FBALYB Amazon,2,2,0,0,0,0
,Airborne Immune Support 75ct,Airborne Immune Support 75ct,FBALYB Amazon,60,60,0,0,0,0
,Airborne vitamin c 75ct 2pk,Airborne vitamin c 75ct 2pk,FBALYB Amazon,1,0,1,0,1,0
,Airwick 7x25,Airwick 7x25,FBALYB Amazon,104,104,0,0,0,0
,"AirWick Freshmatic Air Freshener Refill, Sparkling Citrus, 250 ml","AirWick Freshmatic Air Freshener Refill, Sparkling Citrus, 250 ml",Default Ridgefield,872,872,0,0,0,0
,Airwick Freshmatic Max Autospray,Airwick Freshmatic Max Autospray,Default Ridgefield,8,8,0,0,0,0
,Airwick Freshmatic Refill Fresh Linen 250ml,Airwick Freshmatic Refill Fresh Linen 250ml,Default Ridgefield,892,892,0,0,0,0
,"AirWick Freshmatic Refill, Fresh Water 250ml","AirWick Freshmatic Refill, Fresh Water 250ml",Default Ridgefield,728,728,0,0,0,0
,Air Wick Plug-ins Holiday Scented 7ct,Air Wick Plug-ins Holiday Scented 7ct,FBALYB Amazon,-162,-162,0,160,0,0
,Airwick Variety Bundle 3pk,Airwick Variety Bundle 3pk,Default,0,-51,51,0,0,0
,Airwick Variety Bundle 3pk,Airwick Variety Bundle 3pk,FBALYB Amazon,134,134,0,56,0,0
,Airwick Warmer + Apple Cinnamon / Woodland Pine 7ct Refill,Airwick Warmer + Apple Cinnamon / Woodland Pine 7ct Refill,Default Ridgefield,459,459,0,0,0,0
,Airwick Warmer + Apple Cinnamon / Woodland Pine 7ct Refill,Airwick Warmer + Apple Cinnamon / Woodland Pine 7ct Refill,FBALYB Amazon,291,289,2,20,2,0
,AKG N700NCM2 Noise Cancelling Wireless Headphones - Black,AKG N700NCM2 Noise Cancelling Wireless Headphones - Black,FBALYB Amazon,-19,-19,0,4,0,0
,Alba Botanica Emlnt Ltion Orig 2pk,Alba Botanica Emlnt Ltion Orig 2pk,FBALYB Amazon,78,71,7,0,7,0
,Alba Botanica Shower Gel Honey Mango 32oz,Alba Botanica Shower Gel Honey Mango 32oz,Default,0,0,0,0,0,30
,Alba Botanica Shower Gel Honey Mango 32oz,Alba Botanica Shower Gel Honey Mango 32oz,FBALYB Amazon,10,10,0,0,0,0
,Alba Organics Hawaiian Kukui Nut Organic Body Oil 2pk,Alba Organics Hawaiian Kukui Nut Organic Body Oil 2pk,FBALYB Amazon,-1,-1,0,0,0,0
,"Aleve Pain Reliever, 160 Liquid Gels","Aleve Pain Reliever, 160 Liquid Gels",FBALYB Amazon,80,80,0,0,0,0
,Aleve Pain Reliever 320 Caplets,"Aleve Pain Reliever Fever Reducer, 320 Caplets",FBALYB Amazon,5,5,0,0,0,0
,Alex Toys Marker Magic 10 Markers,ALEX Toys Artist Studio Marker Magic Air Brush Studio,FBAAP Amazon,14,14,0,0,0,0
,Align Daily Probiotic 84 ct,Align Daily Probiotic 84 ct,Default,0,0,0,0,0,52
,Alka Seltzer Antacid Tablets 116count,Alka Seltzer Antacid Tablets 116count,Default,0,0,0,0,0,5
,Alka Seltzer Antacid Tablets 116count,Alka Seltzer Antacid Tablets 116count,FBALYB Amazon,6,6,0,0,0,0
,Alkazone Balance Your pH  Booster 1.25oz,Alkazone Balance Your pH  Booster 1.25oz,FBALYB Amazon,4,4,0,18,0,0
,Alkazone Make Your Own Alkaline Water 1.25oz,Alkazone Make Your Own Alkaline Water 1.25oz,FBALYB Amazon,2,2,0,0,0,0
,Alkazone Make Your Own Alkaline Water 1.25oz 2pk,Alkazone Make Your Own Alkaline Water 1.25oz 2pk,FBALYB Amazon,54,52,2,0,2,0
,Alkazone Make Your Own Alkaline Water 1.25oz 3pk,Alkazone Make Your Own Alkaline Water 1.25oz 3pk,FBALYB Amazon,102,96,6,1,6,0
,Allergan Refresh Tears 4x15ml,Allergan Refresh Tears 4x15ml,Avrami - Ebay,77,77,0,0,0,0
,Allergan Refresh Tears 4x15ml,Allergan Refresh Tears 4x15ml,Default,0,-325,325,0,0,0
,Allergan Refresh Tears 4x15ml,Allergan Refresh Tears 4x15ml,FBALYB Amazon,206,11,195,1727,195,0
,Almased Synergy Diet 17.6 oz 3pk,Almased Synergy Diet 17.6 oz 3pk,FBALYB Amazon,2,2,0,0,0,0
,"Almay Mascara, 2‑Pk","Almay One Coat Thickening Black Mascara, 2‑Pk",FBALYB Amazon,41,41,0,0,0,0
,Almond Nuggets in Dark Chocolate 500g,Almond Nuggets in Dark Chocolate 500g,Default,0,0,0,0,0,1
,Aloha Orchid Mercury Hexagon Candle.,Aloha Orchid Mercury Hexagon Candle.,Default Ridgefield,187,187,0,0,0,0
,Aloha Orchid Mercury Hexagon Candle.,Aloha Orchid Mercury Hexagon Candle.,FBALYB Amazon,200,200,0,0,0,0
,Aloha Orchid Signature Jar Candle,Aloha Orchid Signature Jar Candle,Avrami - Ebay,16,16,0,0,0,0
,Aloha Orchid Signature Jar Candle,Aloha Orchid Signature Jar Candle,FBALYB Amazon,11,11,0,4,0,0
,Aloha Orchid Signature Jar - Capri Blue Signature Collection,Aloha Orchid Signature Jar - Capri Blue Signature Collection ,FBALYB Amazon,-1,-1,0,0,0,0
,ALTOID 6/1.76Z PEPPERMINTS,ALTOID 6/1.76Z PEPPERMINTS,FBALYB Amazon,1,1,0,0,0,0
,Altra Lone Peak 4.5 Men's Trail Running Shoes Black Size 9 #ALOA4PE5000,Altra Lone Peak 4.5 Men's Trail Running Shoes Black Size 9 #ALOA4PE5000,Default Ridgefield,12,12,0,0,0,0
,Altra Lone Peak 4.5 Men's Trail Running Shoes Black Size 9 #ALOA4PE5000,Altra Lone Peak 4.5 Men's Trail Running Shoes Black Size 9 #ALOA4PE5000,FBALYB Amazon,-1,-1,0,0,0,0
,Altra M Escalante 2.5 Black Men's US Size 10.5 AL0A4VQA000,Altra M Escalante 2.5 Black Men's US Size 10.5 AL0A4VQA000,Default,0,0,0,0,0,12
,Altra M Escalante 2.5 Black Men's US Size 10.5 AL0A4VQA000,Altra M Escalante 2.5 Black Men's US Size 10.5 AL0A4VQA000,FBALYB Amazon,-4,-4,0,1,0,0
,Altra M Escalante 2.5 Black Men's US Size 10 AL0A4VQA000,Altra M Escalante 2.5 Black Men's US Size 10 AL0A4VQA000,FBALYB Amazon,-5,-5,0,0,0,0
,Altra M Escalante 2.5 Black Men's US Size 11.5 AL0A4VQA000,Altra M Escalante 2.5 Black Men's US Size 11.5 AL0A4VQA000,FBALYB Amazon,-4,-4,0,0,0,0
,Altra M Escalante 2.5 Black Men's US Size 12.5 AL0A4VQA000,Altra M Escalante 2.5 Black Men's US Size 12.5 AL0A4VQA000,FBALYB Amazon,-5,-5,0,0,0,0
,Altra M Escalante 2.5 Black Men's US Size 12 AL0A4VQA000,Altra M Escalante 2.5 Black Men's US Size 12 AL0A4VQA000,FBALYB Amazon,-1,-1,0,0,0,0
,Altra M Escalante 2.5 Black Mens US SIze 13 AL0A4VQA000,Altra M Escalante 2.5 Black Mens US SIze 13 AL0A4VQA000,FBALYB Amazon,-4,-4,0,0,0,0
,Altra M Escalante 2.5 Black Mens US SIze 8.5 AL0A4VQA000,Altra M Escalante 2.5 Black Mens US SIze 8.5 AL0A4VQA000,FBALYB Amazon,0,-1,1,0,1,0
,Altra M Escalante 2.5 Black Mens US SIze 8 AL0A4VQA000,Altra M Escalante 2.5 Black Mens US SIze 8 AL0A4VQA000,FBALYB Amazon,-1,-1,0,0,0,0
,Altra M Escalante 2.5 Black Men's US Size 9.5 AL0A4VQA000,Altra M Escalante 2.5 Black Men's US Size 9.5 AL0A4VQA000,Default,0,0,0,0,0,6
,Altra M Escalante 2.5 Black Men's US Size 9.5 AL0A4VQA000,Altra M Escalante 2.5 Black Men's US Size 9.5 AL0A4VQA000,FBALYB Amazon,-8,-8,0,0,0,0
,Altra M Escalante 2.5 Black Men's US Size 9 AL0A4VQA000,Altra M Escalante 2.5 Black Men's US Size 9 AL0A4VQA000,Default,0,0,0,0,0,12
,Altra M Escalante 2.5 Black Men's US Size 9 AL0A4VQA000,Altra M Escalante 2.5 Black Men's US Size 9 AL0A4VQA000,FBALYB Amazon,-3,-3,0,0,0,0
,Altra M Escalante 2.5 Forest Night Men's US Size 10 AL0A4VQA309,Altra M Escalante 2.5 Forest Night Men's US Size 10 AL0A4VQA309,FBALYB Amazon,-2,-2,0,0,0,0
,Altra M Escalante 2.5 Forest Night Men's US Size 11.5 AL0A4VQA309,Altra M Escalante 2.5 Forest Night Men's US Size 11.5 AL0A4VQA309,FBALYB Amazon,1,1,0,0,0,0
,Altra M Escalante 2.5 Forest Night Men's US Size 11 AL0A4VQA309,Altra M Escalante 2.5 Forest Night Men's US Size 11 AL0A4VQA309,FBALYB Amazon,-4,-4,0,0,0,0
,Altra M Escalante 2.5 Forest Night Men's US Size 12 AL0A4VQA309,Altra M Escalante 2.5 Forest Night Men's US Size 12 AL0A4VQA309,FBALYB Amazon,-4,-4,0,0,0,0
,Altra M Escalante 2.5 Forest Night Men's US Size 8.5 AL0A4VQA309,Altra M Escalante 2.5 Forest Night Men's US Size 8.5 AL0A4VQA309,FBALYB Amazon,-1,-1,0,0,0,0
,Altra M Escalante 2.5 Forest Night Men's US Size 9.5 AL0A4VQA309,Altra M Escalante 2.5 Forest Night Men's US Size 9.5 AL0A4VQA309,FBALYB Amazon,-3,-3,0,0,0,0
,Altra M Escalante 2.5 Forest Night Men's US Size 9 AL0A4VQA309,Altra M Escalante 2.5 Forest Night Men's US Size 9 AL0A4VQA309,FBALYB Amazon,-1,-1,0,0,0,0
,Altra M Escalante 2.5 Majolica Blue Men's US Size 10.5 AL0A4VQA408,Altra M Escalante 2.5 Majolica Blue Men's US Size 10.5 AL0A4VQA408,FBALYB Amazon,-1,-1,0,0,0,0
,Altra M Escalante 2.5 Majolica Blue Men's US Size 11.5 AL0A4VQA408,Altra M Escalante 2.5 Majolica Blue Men's US Size 11.5 AL0A4VQA408,FBALYB Amazon,-3,-3,0,0,0,0
,Altra M Escalante 2.5 Majolica Blue Men's US Size 12.5 AL0A4VQA408,Altra M Escalante 2.5 Majolica Blue Men's US Size 12.5 AL0A4VQA408,FBALYB Amazon,-2,-2,0,0,0,0
,Altra M Escalante 2.5 Majolica Blue Men's US Size 9.5 AL0A4VQA408,Altra M Escalante 2.5 Majolica Blue Men's US Size 9.5 AL0A4VQA408,FBALYB Amazon,-2,-2,0,0,0,0
,Altra M Lone Peak 5 Blue/Lime Mens US SIze 10.5 AL0A4VQE431,Altra M Lone Peak 5 Blue/Lime Mens US SIze 10.5 AL0A4VQE431,Default Ridgefield,3,3,0,0,0,0
,Altra M Lone Peak 5 Blue/Lime Mens US SIze 10.5 AL0A4VQE431,Altra M Lone Peak 5 Blue/Lime Mens US SIze 10.5 AL0A4VQE431,FBALYB Amazon,68,68,0,0,0,0
,Altra M Lone Peak 5 Blue/Lime Mens US SIze 10 AL0A4VQE431,Altra M Lone Peak 5 Blue/Lime Mens US SIze 10 AL0A4VQE431,Default Ridgefield,2,2,0,0,0,0
,Altra M Lone Peak 5 Blue/Lime Mens US SIze 10 AL0A4VQE431,Altra M Lone Peak 5 Blue/Lime Mens US SIze 10 AL0A4VQE431,FBALYB Amazon,37,36,1,0,1,0
,Altra M Lone Peak 5 Blue/Lime Mens US SIze 11.5 AL0A4VQE431,Altra M Lone Peak 5 Blue/Lime Mens US SIze 11.5 AL0A4VQE431,FBALYB Amazon,46,46,0,0,0,0
,Altra M Lone Peak 5 Blue/Lime Mens US SIze 11 AL0A4VQE431,Altra M Lone Peak 5 Blue/Lime Mens US SIze 11 AL0A4VQE431,Default Ridgefield,2,2,0,0,0,0
,Altra M Lone Peak 5 Blue/Lime Mens US SIze 11 AL0A4VQE431,Altra M Lone Peak 5 Blue/Lime Mens US SIze 11 AL0A4VQE431,FBALYB Amazon,80,79,1,0,1,0
,Altra M Lone Peak 5 Blue/Lime Mens US Size 12.5 AL0A4VQE431,Altra M Lone Peak 5 Blue/Lime Mens US Size 12.5 AL0A4VQE431,FBALYB Amazon,21,21,0,0,0,0
,Altra M Lone Peak 5 Blue/Lime Mens US SIze 12 AL0A4VQE431,Altra M Lone Peak 5 Blue/Lime Mens US SIze 12 AL0A4VQE431,FBALYB Amazon,76,76,0,0,0,0
,Altra M Lone Peak 5 Blue/Lime Mens US SIze 13 AL0A4VQE431,Altra M Lone Peak 5 Blue/Lime Mens US SIze 13 AL0A4VQE431,FBALYB Amazon,-1,-1,0,0,0,0
,Altra M Lone Peak 5 Blue/Lime Mens US SIze 8.5 AL0A4VQE431,Altra M Lone Peak 5 Blue/Lime Mens US SIze 8.5 AL0A4VQE431,FBALYB Amazon,-2,-2,0,0,0,0
,Altra M Lone Peak 5 Blue/Lime Mens US SIze 8 AL0A4VQE431,Altra M Lone Peak 5 Blue/Lime Mens US SIze 8 AL0A4VQE431,FBALYB Amazon,-3,-3,0,0,0,0
,Altra M Lone Peak 5 Blue/Lime Mens US SIze 9.5 AL0A4VQE431,Altra M Lone Peak 5 Blue/Lime Mens US SIze 9.5 AL0A4VQE431,Default Ridgefield,2,2,0,0,0,0
,Altra M Lone Peak 5 Blue/Lime Mens US SIze 9.5 AL0A4VQE431,Altra M Lone Peak 5 Blue/Lime Mens US SIze 9.5 AL0A4VQE431,FBALYB Amazon,40,40,0,0,0,0
,Altra M Lone Peak 5 Blue/Lime Mens US SIze 9 AL0A4VQE431,Altra M Lone Peak 5 Blue/Lime Mens US SIze 9 AL0A4VQE431,FBALYB Amazon,25,23,2,1,2,0
,Altra M Lone Peak 5 Dark Slate/Red Mens US SIze 10.5 AL0A4VQE209,Altra M Lone Peak 5 Dark Slate/Red Mens US SIze 10.5 AL0A4VQE209,Default Ridgefield,2,2,0,0,0,0
,Altra M Lone Peak 5 Dark Slate/Red Mens US SIze 10.5 AL0A4VQE209,Altra M Lone Peak 5 Dark Slate/Red Mens US SIze 10.5 AL0A4VQE209,FBALYB Amazon,43,37,6,0,6,0
,Altra M Lone Peak 5 Dark Slate/Red Mens US SIze 10 AL0A4VQE209,Altra M Lone Peak 5 Dark Slate/Red Mens US SIze 10 AL0A4VQE209,Default Ridgefield,1,1,0,0,0,0
,Altra M Lone Peak 5 Dark Slate/Red Mens US SIze 10 AL0A4VQE209,Altra M Lone Peak 5 Dark Slate/Red Mens US SIze 10 AL0A4VQE209,FBALYB Amazon,35,32,3,0,3,0
,Altra M Lone Peak 5 Dark Slate/Red Mens US SIze 11.5 AL0A4VQE209,Altra M Lone Peak 5 Dark Slate/Red Mens US SIze 11.5 AL0A4VQE209,Default Ridgefield,2,2,0,0,0,0
,Altra M Lone Peak 5 Dark Slate/Red Mens US SIze 11.5 AL0A4VQE209,Altra M Lone Peak 5 Dark Slate/Red Mens US SIze 11.5 AL0A4VQE209,FBALYB Amazon,49,48,1,0,1,0
,Altra M Lone Peak 5 Dark Slate/Red Mens US SIze 11 AL0A4VQE209,Altra M Lone Peak 5 Dark Slate/Red Mens US SIze 11 AL0A4VQE209,Default Ridgefield,2,2,0,0,0,0
,Altra M Lone Peak 5 Dark Slate/Red Mens US SIze 11 AL0A4VQE209,Altra M Lone Peak 5 Dark Slate/Red Mens US SIze 11 AL0A4VQE209,FBALYB Amazon,48,46,2,0,2,0
,Altra M Lone Peak 5 Dark Slate/Red Mens US Size 12.5 AL0A4VQE209,Altra M Lone Peak 5 Dark Slate/Red Mens US Size 12.5 AL0A4VQE209,FBALYB Amazon,13,12,1,0,1,0
,Altra M Lone Peak 5 Dark Slate/Red Mens US SIze 12 AL0A4VQE209,Altra M Lone Peak 5 Dark Slate/Red Mens US SIze 12 AL0A4VQE209,Default Ridgefield,12,12,0,0,0,0
,Altra M Lone Peak 5 Dark Slate/Red Mens US SIze 12 AL0A4VQE209,Altra M Lone Peak 5 Dark Slate/Red Mens US SIze 12 AL0A4VQE209,FBALYB Amazon,26,24,2,0,2,0
,Altra M Lone Peak 5 Dark Slate/Red Mens US SIze 13 AL0A4VQE209,Altra M Lone Peak 5 Dark Slate/Red Mens US SIze 13 AL0A4VQE209,FBALYB Amazon,-5,-5,0,0,0,0
,Altra M Lone Peak 5 Dark Slate/Red Mens US SIze 8.5 AL0A4VQE209,Altra M Lone Peak 5 Dark Slate/Red Mens US SIze 8.5 AL0A4VQE209,FBALYB Amazon,-7,-7,0,0,0,0
,Altra M Lone Peak 5 Dark Slate/Red Mens US SIze 8 AL0A4VQE209,Altra M Lone Peak 5 Dark Slate/Red Mens US SIze 8 AL0A4VQE209,FBALYB Amazon,-1,-1,0,0,0,0
,Altra M Lone Peak 5 Dark Slate/Red Mens US SIze 9.5 AL0A4VQE209,Altra M Lone Peak 5 Dark Slate/Red Mens US SIze 9.5 AL0A4VQE209,Default Ridgefield,2,2,0,0,0,0
,Altra M Lone Peak 5 Dark Slate/Red Mens US SIze 9.5 AL0A4VQE209,Altra M Lone Peak 5 Dark Slate/Red Mens US SIze 9.5 AL0A4VQE209,FBALYB Amazon,38,38,0,0,0,0
,Altra M Lone Peak 5 Dark Slate/Red Mens US SIze 9 AL0A4VQE209,Altra M Lone Peak 5 Dark Slate/Red Mens US SIze 9 AL0A4VQE209,FBALYB Amazon,14,12,2,0,2,0
,Altra M Lone Peak 5 Gray/Orange Mens US SIze 10.5 AL0A4VQE280,Altra M Lone Peak 5 Gray/Orange Mens US SIze 10.5 AL0A4VQE280,FBALYB Amazon,-3,-3,0,0,0,0
,Altra M Lone Peak 5 Gray/Orange Mens US SIze 10 AL0A4VQE280,Altra M Lone Peak 5 Gray/Orange Mens US SIze 10 AL0A4VQE280,FBALYB Amazon,-6,-6,0,0,0,0
,Altra M Lone Peak 5 Gray/Orange Mens US SIze 11.5 AL0A4VQE280,Altra M Lone Peak 5 Gray/Orange Mens US SIze 11.5 AL0A4VQE280,FBALYB Amazon,-2,-2,0,0,0,0
,Altra M Lone Peak 5 Gray/Orange Mens US SIze 11 AL0A4VQE280,Altra M Lone Peak 5 Gray/Orange Mens US SIze 11 AL0A4VQE280,FBALYB Amazon,-1,-1,0,0,0,0
,Altra M Lone Peak 5 Gray/Orange Mens US SIze 13 AL0A4VQE280,Altra M Lone Peak 5 Gray/Orange Mens US SIze 13 AL0A4VQE280,FBALYB Amazon,-1,-1,0,0,0,0
,Altra M Lone Peak 5 Gray/Orange Mens US SIze 8.5 AL0A4VQE280,Altra M Lone Peak 5 Gray/Orange Mens US SIze 8.5 AL0A4VQE280,FBALYB Amazon,-3,-3,0,0,0,0
,Altra M Lone Peak 5 Gray/Orange Mens US SIze 8 AL0A4VQE280,Altra M Lone Peak 5 Gray/Orange Mens US SIze 8 AL0A4VQE280,FBALYB Amazon,-2,-2,0,0,0,0
,Altra M Lone Peak 5 Gray/Orange Mens US SIze 9.5 AL0A4VQE280,Altra M Lone Peak 5 Gray/Orange Mens US SIze 9.5 AL0A4VQE280,FBALYB Amazon,-1,-1,0,0,0,0
,Altra M Lone Peak 5 Gray/Orange Mens US SIze 9 AL0A4VQE280,Altra M Lone Peak 5 Gray/Orange Mens US SIze 9 AL0A4VQE280,FBALYB Amazon,-1,-1,0,0,0,0
,Altra M Lone Peak 5 Khaki Mens US SIze 10.5 AL0A4VQE017,Altra M Lone Peak 5 Khaki Mens US SIze 10.5 AL0A4VQE017,Default Ridgefield,2,2,0,0,0,0
,Altra M Lone Peak 5 Khaki Mens US SIze 10.5 AL0A4VQE017,Altra M Lone Peak 5 Khaki Mens US SIze 10.5 AL0A4VQE017,FBALYB Amazon,7,4,3,0,3,0
,Altra M Lone Peak 5 Khaki Mens US SIze 10 AL0A4VQE017,Altra M Lone Peak 5 Khaki Mens US SIze 10 AL0A4VQE017,FBALYB Amazon,-10,-10,0,0,0,0
,Altra M Lone Peak 5 Khaki Mens US SIze 11.5 AL0A4VQE017,Altra M Lone Peak 5 Khaki Mens US SIze 11.5 AL0A4VQE017,Default Ridgefield,6,6,0,0,0,0
,Altra M Lone Peak 5 Khaki Mens US SIze 11.5 AL0A4VQE017,Altra M Lone Peak 5 Khaki Mens US SIze 11.5 AL0A4VQE017,FBALYB Amazon,11,6,5,0,5,0
,Altra M Lone Peak 5 Khaki Mens US SIze 11 AL0A4VQE017,Altra M Lone Peak 5 Khaki Mens US SIze 11 AL0A4VQE017,Default Ridgefield,2,2,0,0,0,0
,Altra M Lone Peak 5 Khaki Mens US SIze 11 AL0A4VQE017,Altra M Lone Peak 5 Khaki Mens US SIze 11 AL0A4VQE017,FBALYB Amazon,25,19,6,0,6,0
,Altra M Lone Peak 5 Khaki Mens US Size 12.5 AL0A4VQE017,Altra M Lone Peak 5 Khaki Mens US Size 12.5 AL0A4VQE017,FBALYB Amazon,-1,-1,0,0,0,0
,Altra M Lone Peak 5 Khaki Mens US SIze 12 AL0A4VQE017,Altra M Lone Peak 5 Khaki Mens US SIze 12 AL0A4VQE017,Default Ridgefield,3,3,0,0,0,0
,Altra M Lone Peak 5 Khaki Mens US SIze 12 AL0A4VQE017,Altra M Lone Peak 5 Khaki Mens US SIze 12 AL0A4VQE017,FBALYB Amazon,15,13,2,0,2,0
,Altra M Lone Peak 5 Khaki Mens US SIze 8 AL0A4VQE017,Altra M Lone Peak 5 Khaki Mens US SIze 8 AL0A4VQE017,FBALYB Amazon,-2,-2,0,0,0,0
,Altra M Lone Peak 5 Khaki Mens US SIze 9.5 AL0A4VQE017,Altra M Lone Peak 5 Khaki Mens US SIze 9.5 AL0A4VQE017,Default Ridgefield,1,1,0,0,0,0
,Altra M Lone Peak 5 Khaki Mens US SIze 9.5 AL0A4VQE017,Altra M Lone Peak 5 Khaki Mens US SIze 9.5 AL0A4VQE017,FBALYB Amazon,-4,-4,0,0,0,0
,Altra M Lone Peak 5 Khaki Mens US SIze 9 AL0A4VQE017,Altra M Lone Peak 5 Khaki Mens US SIze 9 AL0A4VQE017,FBALYB Amazon,-2,-2,0,0,0,0
,Altra M Lone Peak 5 Lime/Black Mens US SIze 10.5 AL0A4VQE300,Altra M Lone Peak 5 Lime/Black Mens US SIze 10.5 AL0A4VQE300,Default Ridgefield,4,4,0,0,0,0
,Altra M Lone Peak 5 Lime/Black Mens US SIze 10.5 AL0A4VQE300,Altra M Lone Peak 5 Lime/Black Mens US SIze 10.5 AL0A4VQE300,FBALYB Amazon,7,5,2,0,2,0
,Altra M Lone Peak 5 Lime/Black Mens US SIze 10 AL0A4VQE300,Altra M Lone Peak 5 Lime/Black Mens US SIze 10 AL0A4VQE300,FBALYB Amazon,8,8,0,0,0,0
,Altra M Lone Peak 5 Lime/Black Mens US SIze 11.5 AL0A4VQE300,Altra M Lone Peak 5 Lime/Black Mens US SIze 11.5 AL0A4VQE300,FBALYB Amazon,16,16,0,0,0,0
,Altra M Lone Peak 5 Lime/Black Mens US SIze 11 AL0A4VQE300,Altra M Lone Peak 5 Lime/Black Mens US SIze 11 AL0A4VQE300,FBALYB Amazon,17,16,1,0,1,0
,Altra M Lone Peak 5 Lime/Black Mens US Size 12.5 AL0A4VQE300,Altra M Lone Peak 5 Lime/Black Mens US Size 12.5 AL0A4VQE300,FBALYB Amazon,8,8,0,0,0,0
,Altra M Lone Peak 5 Lime/Black Mens US SIze 12 AL0A4VQE300,Altra M Lone Peak 5 Lime/Black Mens US SIze 12 AL0A4VQE300,Default Ridgefield,6,6,0,0,0,0
,Altra M Lone Peak 5 Lime/Black Mens US SIze 12 AL0A4VQE300,Altra M Lone Peak 5 Lime/Black Mens US SIze 12 AL0A4VQE300,FBALYB Amazon,14,14,0,0,0,0
,Altra M Lone Peak 5 Lime/Black Mens US SIze 8 AL0A4VQE300,Altra M Lone Peak 5 Lime/Black Mens US SIze 8 AL0A4VQE300,FBALYB Amazon,-1,-1,0,0,0,0
,Altra M Lone Peak 5 Lime/Black Mens US SIze 9.5 AL0A4VQE300,Altra M Lone Peak 5 Lime/Black Mens US SIze 9.5 AL0A4VQE300,FBALYB Amazon,1,0,1,0,1,0
,Altra M Lone Peak 5 Lime/Black Mens US SIze 9 AL0A4VQE300,Altra M Lone Peak 5 Lime/Black Mens US SIze 9 AL0A4VQE300,Default Ridgefield,2,2,0,0,0,0
,Altra M Lone Peak 5 Lime/Black Mens US SIze 9 AL0A4VQE300,Altra M Lone Peak 5 Lime/Black Mens US SIze 9 AL0A4VQE300,FBALYB Amazon,4,4,0,0,0,0
,Altra M Lone Peak 5 Red Mens US SIze 10.5 AL0A4VQE660,Altra M Lone Peak 5 Red Mens US SIze 10.5 AL0A4VQE660,FBALYB Amazon,-4,-4,0,0,0,0
,Altra M Lone Peak 5 Red Mens US SIze 10 AL0A4VQE660,Altra M Lone Peak 5 Red Mens US SIze 10 AL0A4VQE660,FBALYB Amazon,-3,-3,0,0,0,0
,Altra M Lone Peak 5 Red Mens US SIze 11.5 AL0A4VQE660,Altra M Lone Peak 5 Red Mens US SIze 11.5 AL0A4VQE660,FBALYB Amazon,-1,-1,0,0,0,0
,Altra M Lone Peak 5 Red Mens US SIze 11 AL0A4VQE660,Altra M Lone Peak 5 Red Mens US SIze 11 AL0A4VQE660,FBALYB Amazon,-3,-3,0,0,0,0
,Altra M Lone Peak 5 Red Mens US SIze 13 AL0A4VQE660,Altra M Lone Peak 5 Red Mens US SIze 13 AL0A4VQE660,FBALYB Amazon,-1,-1,0,0,0,0
,Altra M Lone Peak 5 Red Mens US SIze 8.5 AL0A4VQE660,Altra M Lone Peak 5 Red Mens US SIze 8.5 AL0A4VQE660,FBALYB Amazon,-3,-3,0,0,0,0
,Altra M Lone Peak 5 Red Mens US SIze 8 AL0A4VQE660,Altra M Lone Peak 5 Red Mens US SIze 8 AL0A4VQE660,FBALYB Amazon,-2,-2,0,0,0,0
,Altra M Lone Peak 5 Red Mens US SIze 9.5 AL0A4VQE660,Altra M Lone Peak 5 Red Mens US SIze 9.5 AL0A4VQE660,FBALYB Amazon,-1,-1,0,0,0,0
,Altra M Lone Peak 5 Red Mens US SIze 9 AL0A4VQE660,Altra M Lone Peak 5 Red Mens US SIze 9 AL0A4VQE660,FBALYB Amazon,-1,-1,0,0,0,0
,Altra M Paradigm 5 Black Mens US SIze 10.5 AL0A4VQO000,Altra M Paradigm 5 Black Mens US SIze 10.5 AL0A4VQO000,FBALYB Amazon,-1,-1,0,0,0,0
,Altra M Paradigm 5 Black Mens US SIze 10 AL0A4VQO000,Altra M Paradigm 5 Black Mens US SIze 10 AL0A4VQO000,FBALYB Amazon,-2,-2,0,0,0,0
,Altra M Paradigm 5 Black Mens US SIze 11.5 AL0A4VQO000,Altra M Paradigm 5 Black Mens US SIze 11.5 AL0A4VQO000,FBALYB Amazon,-3,-3,0,0,0,0
,Altra M Paradigm 5 Black Mens US SIze 11 AL0A4VQO000,Altra M Paradigm 5 Black Mens US SIze 11 AL0A4VQO000,FBALYB Amazon,-2,-2,0,0,0,0
,Altra M Paradigm 5 Black Mens US SIze 12 AL0A4VQO000,Altra M Paradigm 5 Black Mens US SIze 12 AL0A4VQO000,FBALYB Amazon,-1,-1,0,0,0,0
,Altra M Paradigm 5 Black Mens US SIze 8.5 AL0A4VQO000,Altra M Paradigm 5 Black Mens US SIze 8.5 AL0A4VQO000,FBALYB Amazon,-3,-3,0,0,0,0
,Altra M Paradigm 5 Black Mens US SIze 9 AL0A4VQO000,Altra M Paradigm 5 Black Mens US SIze 9 AL0A4VQO000,FBALYB Amazon,-4,-5,1,0,1,0
,Altra M Paradigm 5 Dark Blue Mens US SIze 10.5 AL0A4VQO442,Altra M Paradigm 5 Dark Blue Mens US SIze 10.5 AL0A4VQO442,FBALYB Amazon,-6,-6,0,0,0,0
,Altra M Paradigm 5 Dark Blue Mens US SIze 10 AL0A4VQO442,Altra M Paradigm 5 Dark Blue Mens US SIze 10 AL0A4VQO442,FBALYB Amazon,1,0,1,0,1,0
,Altra M Paradigm 5 Dark Blue Mens US SIze 11.5 AL0A4VQO442,Altra M Paradigm 5 Dark Blue Mens US SIze 11.5 AL0A4VQO442,FBALYB Amazon,1,1,0,0,0,0
,Altra M Paradigm 5 Dark Blue Mens US SIze 11 AL0A4VQO442,Altra M Paradigm 5 Dark Blue Mens US SIze 11 AL0A4VQO442,FBALYB Amazon,-1,-1,0,0,0,0
,Altra M Paradigm 5 Dark Blue Mens US SIze 12 AL0A4VQO442,Altra M Paradigm 5 Dark Blue Mens US SIze 12 AL0A4VQO442,FBALYB Amazon,-2,-2,0,0,0,0
,Altra M Paradigm 5 Dark Blue Mens US SIze 13 AL0A4VQO442,Altra M Paradigm 5 Dark Blue Mens US SIze 13 AL0A4VQO442,FBALYB Amazon,-2,-2,0,0,0,0
,Altra M Paradigm 5 Dark Blue Mens US SIze 8.5 AL0A4VQO442,Altra M Paradigm 5 Dark Blue Mens US SIze 8.5 AL0A4VQO442,FBALYB Amazon,7,7,0,0,0,0
,Altra M Paradigm 5 Dark Blue Mens US SIze 8 AL0A4VQO442,Altra M Paradigm 5 Dark Blue Mens US SIze 8 AL0A4VQO442,FBALYB Amazon,-3,-3,0,0,0,0
,Altra M Paradigm 5 Dark Blue Mens US SIze 9 AL0A4VQO442,Altra M Paradigm 5 Dark Blue Mens US SIze 9 AL0A4VQO442,FBALYB Amazon,3,2,1,0,1,0
,Altra M Provision 4 Black/Gray/Red Men's US Size 10.5 AL0A4PEA034,Altra M Provision 4 Black/Gray/Red Men's US Size 10.5 AL0A4PEA034,FBALYB Amazon,-3,-3,0,0,0,0
,Altra M Provision 4 Black/Gray/Red Men's US Size 10 AL0A4PEA034,Altra M Provision 4 Black/Gray/Red Men's US Size 10 AL0A4PEA034,FBALYB Amazon,-2,-2,0,0,0,0
,Altra M Provision 4 Black/Gray/Red Men's US Size 11 AL0A4PEA034,Altra M Provision 4 Black/Gray/Red Men's US Size 11 AL0A4PEA034,FBALYB Amazon,-1,-1,0,0,0,0
,Altra M Provision 4 Black/Gray/Red Men's US Size 12.5 AL0A4PEA034,Altra M Provision 4 Black/Gray/Red Men's US Size 12.5 AL0A4PEA034,FBALYB Amazon,-1,-1,0,0,0,0
,Altra M Provision 4 Black/Gray/Red Men's US Size 12 AL0A4PEA034,Altra M Provision 4 Black/Gray/Red Men's US Size 12 AL0A4PEA034,FBALYB Amazon,-1,-1,0,0,0,0
,Altra M Provision 4 Black/Gray/Red Men's US Size 13 AL0A4PEA034,Altra M Provision 4 Black/Gray/Red Men's US Size 13 AL0A4PEA034,FBALYB Amazon,-2,-2,0,0,0,0
,Altra M Provision 4 Black/Gray/Red Men's US Size 9.5 AL0A4PEA034,Altra M Provision 4 Black/Gray/Red Men's US Size 9.5 AL0A4PEA034,FBALYB Amazon,-3,-3,0,0,0,0
,Altra M Provision 4 Black/Gray/Red Men's US Size 9 AL0A4PEA034,Altra M Provision 4 Black/Gray/Red Men's US Size 9 AL0A4PEA034,FBALYB Amazon,-2,-2,0,0,0,0
,Altra M Provision 4 Black Men's US Size 10.5 AL0A4PEA000,Altra M Provision 4 Black Men's US Size 10.5 AL0A4PEA000,FBALYB Amazon,-3,-3,0,0,0,0
,Altra M Provision 4 Black Men's US Size 10 AL0A4PEA000,Altra M Provision 4 Black Men's US Size 10 AL0A4PEA000,FBALYB Amazon,-1,-1,0,0,0,0
,Altra M Provision 4 Black Men's US Size 11.5 AL0A4PEA000,Altra M Provision 4 Black Men's US Size 11.5 AL0A4PEA000,FBALYB Amazon,-1,-1,0,0,0,0
,Altra M Provision 4 Black Men's US Size 11 AL0A4PEA000,Altra M Provision 4 Black Men's US Size 11 AL0A4PEA000,FBALYB Amazon,-3,-3,0,0,0,0
,Altra M Provision 4 Black Men's US Size 12.5 AL0A4PEA000,Altra M Provision 4 Black Men's US Size 12.5 AL0A4PEA000,FBALYB Amazon,-1,-1,0,0,0,0
,Altra M Provision 4 Black Men's US Size 12 AL0A4PEA000,Altra M Provision 4 Black Men's US Size 12 AL0A4PEA000,FBALYB Amazon,-1,-1,0,0,0,0
,Altra M Provision 4 Black Men's US Size 13 AL0A4PEA000,Altra M Provision 4 Black Men's US Size 13 AL0A4PEA000,FBALYB Amazon,-3,-3,0,0,0,0
,Altra M Provision 4 Black Men's US Size 8.5 AL0A4PEA000,Altra M Provision 4 Black Men's US Size 8.5 AL0A4PEA000,FBALYB Amazon,0,-1,1,0,1,0
,Altra M Provision 4 Black Men's US Size 9.5 AL0A4PEA000,Altra M Provision 4 Black Men's US Size 9.5 AL0A4PEA000,FBALYB Amazon,-3,-3,0,0,0,0
,Altra M Provision 4 Black Men's US Size 9 AL0A4PEA000,Altra M Provision 4 Black Men's US Size 9 AL0A4PEA000,FBALYB Amazon,-2,-2,0,0,0,0
,Altra M Provision 4 Blue/Lime Men's US Size 10 AL0A4PEA431,Altra M Provision 4 Blue/Lime Men's US Size 10 AL0A4PEA431,FBALYB Amazon,-3,-3,0,0,0,0
,Altra M Provision 4 Blue/Lime Men's US Size 11.5 AL0A4PEA431,Altra M Provision 4 Blue/Lime Men's US Size 11.5 AL0A4PEA431,FBALYB Amazon,-3,-3,0,0,0,0
,Altra M Provision 4 Blue/Lime Men's US Size 11 AL0A4PEA431,Altra M Provision 4 Blue/Lime Men's US Size 11 AL0A4PEA431,FBALYB Amazon,-1,-1,0,0,0,0
,Altra M Provision 4 Blue/Lime Men's US Size 12.5 AL0A4PEA431,Altra M Provision 4 Blue/Lime Men's US Size 12.5 AL0A4PEA431,FBALYB Amazon,-3,-3,0,0,0,0
,Altra M Provision 4 Blue/Lime Men's US Size 12 AL0A4PEA431,Altra M Provision 4 Blue/Lime Men's US Size 12 AL0A4PEA431,FBALYB Amazon,-4,-4,0,0,0,0
,Altra M Provision 4 Blue/Lime Men's US Size 13 AL0A4PEA431,Altra M Provision 4 Blue/Lime Men's US Size 13 AL0A4PEA431,FBALYB Amazon,-1,-1,0,0,0,0
,Altra M Provision 4 Blue/Lime Men's US Size 8.5 AL0A4PEA431,Altra M Provision 4 Blue/Lime Men's US Size 8.5 AL0A4PEA431,FBALYB Amazon,6,6,0,0,0,0
,Altra M Provision 4 Blue/Lime Men's US Size 9.5 AL0A4PEA431,Altra M Provision 4 Blue/Lime Men's US Size 9.5 AL0A4PEA431,FBALYB Amazon,-2,-2,0,0,0,0
,Altra M Provision 4 White/Navy Men's US Size 10 AL0A4PEA103,Altra M Provision 4 White/Navy Men's US Size 10 AL0A4PEA103,FBALYB Amazon,-3,-3,0,0,0,0
,Altra M Provision 4 White/Navy Men's US Size 11.5 AL0A4PEA103,Altra M Provision 4 White/Navy Men's US Size 11.5 AL0A4PEA103,FBALYB Amazon,-3,-3,0,0,0,0
,Altra M Provision 4 White/Navy Men's US Size 11 AL0A4PEA103,Altra M Provision 4 White/Navy Men's US Size 11 AL0A4PEA103,FBALYB Amazon,-2,-2,0,0,0,0
,Altra M Provision 4 White/Navy Men's US Size 12.5 AL0A4PEA103,Altra M Provision 4 White/Navy Men's US Size 12.5 AL0A4PEA103,FBALYB Amazon,3,3,0,0,0,0
,Altra M Provision 4 White/Navy Men's US Size 12 AL0A4PEA103,Altra M Provision 4 White/Navy Men's US Size 12 AL0A4PEA103,FBALYB Amazon,-5,-5,0,0,0,0
,Altra M Provision 4 White/Navy Men's US Size 8.5 AL0A4PEA103,Altra M Provision 4 White/Navy Men's US Size 8.5 AL0A4PEA103,FBALYB Amazon,-3,-3,0,0,0,0
,Altra M Provision 4 White/Navy Men's US Size 8 AL0A4PEA103,Altra M Provision 4 White/Navy Men's US Size 8 AL0A4PEA103,Default Ridgefield,6,6,0,0,0,0
,Altra M Provision 4 White/Navy Men's US Size 8 AL0A4PEA103,Altra M Provision 4 White/Navy Men's US Size 8 AL0A4PEA103,FBALYB Amazon,2,2,0,0,0,0
,Altra M Provision 4 White/Navy Men's US Size 9.5 AL0A4PEA103,Altra M Provision 4 White/Navy Men's US Size 9.5 AL0A4PEA103,FBALYB Amazon,-6,-6,0,0,0,0
,Altra M Provision 4 White/Navy Men's US Size 9 AL0A4PEA103,Altra M Provision 4 White/Navy Men's US Size 9 AL0A4PEA103,FBALYB Amazon,1,1,0,0,0,0
,Altra M Superior 4.5 Black Mens US SIze 10 AL0A4VQB000,Altra M Superior 4.5 Black Mens US SIze 10 AL0A4VQB000,FBALYB Amazon,-1,-1,0,0,0,0
,Altra M Superior 4.5 Black Mens US SIze 11.5 AL0A4VQB000,Altra M Superior 4.5 Black Mens US SIze 11.5 AL0A4VQB000,FBALYB Amazon,-2,-2,0,0,0,0
,Altra M Superior 4.5 Black Mens US SIze 11 AL0A4VQB000,Altra M Superior 4.5 Black Mens US SIze 11 AL0A4VQB000,FBALYB Amazon,-5,-5,0,0,0,0
,Altra M Superior 4.5 Black Mens US SIze 12 AL0A4VQB000,Altra M Superior 4.5 Black Mens US SIze 12 AL0A4VQB000,FBALYB Amazon,-2,-2,0,0,0,0
,Altra M Superior 4.5 Black Mens US SIze 13 AL0A4VQB000,Altra M Superior 4.5 Black Mens US SIze 13 AL0A4VQB000,FBALYB Amazon,-1,-1,0,0,0,0
,Altra M Superior 4.5 Black Mens US SIze 8 AL0A4VQB000,Altra M Superior 4.5 Black Mens US SIze 8 AL0A4VQB000,FBALYB Amazon,-3,-3,0,0,0,0
,Altra M Superior 4.5 Black Mens US SIze 9.5 AL0A4VQB000,Altra M Superior 4.5 Black Mens US SIze 9.5 AL0A4VQB000,FBALYB Amazon,-3,-3,0,0,0,0
,Altra M Superior 4.5 Black Mens US SIze 9 AL0A4VQB000,Altra M Superior 4.5 Black Mens US SIze 9 AL0A4VQB000,FBALYB Amazon,-3,-3,0,0,0,0
,Altra M Superior 4.5 Blue/Yellow Men's US Size 10.5 AL0A4VQB470,Altra M Superior 4.5 Blue/Yellow Men's US Size 10.5 AL0A4VQB470,FBALYB Amazon,9,9,0,0,0,0
,Altra M Superior 4.5 Blue/Yellow Men's US Size 10 AL0A4VQB470,Altra M Superior 4.5 Blue/Yellow Men's US Size 10 AL0A4VQB470,FBALYB Amazon,-8,-8,0,0,0,0
,Altra M Superior 4.5 Blue/Yellow Men's US Size 11.5 AL0A4VQB470,Altra M Superior 4.5 Blue/Yellow Men's US Size 11.5 AL0A4VQB470,FBALYB Amazon,4,4,0,0,0,0
,Altra M Superior 4.5 Blue/Yellow Men's US Size 11 AL0A4VQB470,Altra M Superior 4.5 Blue/Yellow Men's US Size 11 AL0A4VQB470,FBALYB Amazon,-6,-6,0,0,0,0
,Altra M Superior 4.5 Blue/Yellow Men's US Size 12.5 AL0A4VQB470,Altra M Superior 4.5 Blue/Yellow Men's US Size 12.5 AL0A4VQB470,FBALYB Amazon,-1,-1,0,0,0,0
,Altra M Superior 4.5 Blue/Yellow Men's US Size 12 AL0A4VQB470,Altra M Superior 4.5 Blue/Yellow Men's US Size 12 AL0A4VQB470,FBALYB Amazon,-8,-8,0,0,0,0
,Altra M Superior 4.5 Blue/Yellow Men's US Size 13 AL0A4VQB470,Altra M Superior 4.5 Blue/Yellow Men's US Size 13 AL0A4VQB470,FBALYB Amazon,-4,-4,0,0,0,0
,Altra M Superior 4.5 Blue/Yellow Men's US Size 8.5 AL0A4VQB470,Altra M Superior 4.5 Blue/Yellow Men's US Size 8.5 AL0A4VQB470,FBALYB Amazon,-1,-1,0,0,0,0
,Altra M Superior 4.5 Blue/Yellow Men's US Size 9.5 AL0A4VQB470,Altra M Superior 4.5 Blue/Yellow Men's US Size 9.5 AL0A4VQB470,FBALYB Amazon,-7,-8,1,0,1,0
,Altra M Superior 4.5 Blue/Yellow Men's US Size 9 AL0A4VQB470,Altra M Superior 4.5 Blue/Yellow Men's US Size 9 AL0A4VQB470,FBALYB Amazon,6,5,1,0,1,0
,Altra M Superior 4.5 Green/Lime Men's US Size 10 AL0A4VQB337,Altra M Superior 4.5 Green/Lime Men's US Size 10 AL0A4VQB337,FBALYB Amazon,-3,-3,0,0,0,0
,Altra M Superior 4.5 Green/Lime Men's US Size 11 AL0A4VQB337,Altra M Superior 4.5 Green/Lime Men's US Size 11 AL0A4VQB337,FBALYB Amazon,-4,-4,0,0,0,0
,Altra M Superior 4.5 Green/Lime Men's US Size 12.5 AL0A4VQB337,Altra M Superior 4.5 Green/Lime Men's US Size 12.5 AL0A4VQB337,FBALYB Amazon,-2,-2,0,0,0,0
,Altra M Superior 4.5 Green/Lime Men's US Size 12 AL0A4VQB337,Altra M Superior 4.5 Green/Lime Men's US Size 12 AL0A4VQB337,FBALYB Amazon,-1,-1,0,0,0,0
,Altra M Superior 4.5 Green/Lime Men's US Size 8.5 AL0A4VQB337,Altra M Superior 4.5 Green/Lime Men's US Size 8.5 AL0A4VQB337,FBALYB Amazon,-1,-1,0,0,0,0
,Altra M Superior 4.5 Green/Lime Men's US Size 9.5 AL0A4VQB337,Altra M Superior 4.5 Green/Lime Men's US Size 9.5 AL0A4VQB337,FBALYB Amazon,-5,-5,0,0,0,0
,Altra M Superior 4.5 Green/Lime Men's US Size 9 AL0A4VQB337,Altra M Superior 4.5 Green/Lime Men's US Size 9 AL0A4VQB337,FBALYB Amazon,-1,-1,0,0,0,0
,Altra M Superior 4.5 Yellow/Port Men's US Size 10.5 AL0A4VQB721,Altra M Superior 4.5 Yellow/Port Men's US Size 10.5 AL0A4VQB721,FBALYB Amazon,-2,-2,0,0,0,0
,Altra M Superior 4.5 Yellow/Port Men's US Size 10 AL0A4VQB721,Altra M Superior 4.5 Yellow/Port Men's US Size 10 AL0A4VQB721,FBALYB Amazon,-1,-1,0,0,0,0
,Altra M Superior 4.5 Yellow/Port Men's US Size 11.5 AL0A4VQB721,Altra M Superior 4.5 Yellow/Port Men's US Size 11.5 AL0A4VQB721,FBALYB Amazon,-1,-1,0,0,0,0
,Altra M Superior 4.5 Yellow/Port Men's US Size 11 AL0A4VQB721,Altra M Superior 4.5 Yellow/Port Men's US Size 11 AL0A4VQB721,FBALYB Amazon,-1,-1,0,0,0,0
,Altra M Superior 4.5 Yellow/Port Men's US Size 12.5 AL0A4VQB721,Altra M Superior 4.5 Yellow/Port Men's US Size 12.5 AL0A4VQB721,FBALYB Amazon,-2,-2,0,0,0,0
,Altra M Superior 4.5 Yellow/Port Men's US Size 12 AL0A4VQB721,Altra M Superior 4.5 Yellow/Port Men's US Size 12 AL0A4VQB721,FBALYB Amazon,-3,-3,0,0,0,0
,Altra M Superior 4.5 Yellow/Port Men's US Size 8.5 AL0A4VQB721,Altra M Superior 4.5 Yellow/Port Men's US Size 8.5 AL0A4VQB721,FBALYB Amazon,-5,-5,0,0,0,0
,Altra M Superior 4.5 Yellow/Port Men's US Size 9.5 AL0A4VQB721,Altra M Superior 4.5 Yellow/Port Men's US Size 9.5 AL0A4VQB721,FBALYB Amazon,-4,-4,0,0,0,0
,Altra M Torin 4.5 Plush Black/Lime Mens US SIze 10.5 AL0A4VQT031,Altra M Torin 4.5 Plush Black/Lime Mens US SIze 10.5 AL0A4VQT031,FBALYB Amazon,-3,-3,0,0,0,0
,Altra M Torin 4.5 Plush Black/Lime Mens US SIze 10 AL0A4VQT031,Altra M Torin 4.5 Plush Black/Lime Mens US SIze 10 AL0A4VQT031,FBALYB Amazon,-4,-4,0,0,0,0
,Altra M Torin 4.5 Plush Black/Lime Mens US SIze 11.5 AL0A4VQT031,Altra M Torin 4.5 Plush Black/Lime Mens US SIze 11.5 AL0A4VQT031,FBALYB Amazon,-3,-3,0,0,0,0
,Altra M Torin 4.5 Plush Black/Lime Mens US SIze 11 AL0A4VQT031,Altra M Torin 4.5 Plush Black/Lime Mens US SIze 11 AL0A4VQT031,FBALYB Amazon,-3,-3,0,0,0,0
,Altra M Torin 4.5 Plush Black/Lime Mens US SIze 12 AL0A4VQT031,Altra M Torin 4.5 Plush Black/Lime Mens US SIze 12 AL0A4VQT031,FBALYB Amazon,-5,-5,0,0,0,0
,Altra M Torin 4.5 Plush Black/Lime Mens US SIze 8.5 AL0A4VQT031,Altra M Torin 4.5 Plush Black/Lime Mens US SIze 8.5 AL0A4VQT031,FBALYB Amazon,-2,-2,0,0,0,0
,Altra M Torin 4.5 Plush Black/Lime Mens US SIze 8 AL0A4VQT031,Altra M Torin 4.5 Plush Black/Lime Mens US SIze 8 AL0A4VQT031,FBALYB Amazon,5,5,0,0,0,0
,Altra M Torin 4.5 Plush Black/Lime Mens US SIze 9 AL0A4VQT031,Altra M Torin 4.5 Plush Black/Lime Mens US SIze 9 AL0A4VQT031,FBALYB Amazon,-2,-2,0,0,0,0
,Altra M Torin 4.5 Plush Black Steel Men's US Size 10.5 AL0A4VQT042,Altra M Torin 4.5 Plush Black Steel Men's US Size 10.5 AL0A4VQT042,FBALYB Amazon,-8,-8,0,0,0,0
,Altra M Torin 4.5 Plush Black Steel Men's US Size 10 AL0A4VQT042,Altra M Torin 4.5 Plush Black Steel Men's US Size 10 AL0A4VQT042,FBALYB Amazon,-3,-3,0,0,0,0
,Altra M Torin 4.5 Plush Black Steel Men's US Size 11.5 AL0A4VQT042,Altra M Torin 4.5 Plush Black Steel Men's US Size 11.5 AL0A4VQT042,FBALYB Amazon,-1,-1,0,0,0,0
,Altra M Torin 4.5 Plush Black Steel Men's US Size 11 AL0A4VQT042,Altra M Torin 4.5 Plush Black Steel Men's US Size 11 AL0A4VQT042,FBALYB Amazon,-5,-5,0,0,0,0
,Altra M Torin 4.5 Plush Black Steel Men's US Size 12 AL0A4VQT042,Altra M Torin 4.5 Plush Black Steel Men's US Size 12 AL0A4VQT042,FBALYB Amazon,-2,-2,0,0,0,0
,Altra M Torin 4.5 Plush Black Steel Men's US Size 15 AL0A4VQT042,Altra M Torin 4.5 Plush Black Steel Men's US Size 15 AL0A4VQT042,FBALYB Amazon,-1,-1,0,0,0,0
,Altra M Torin 4.5 Plush Black Steel Men's US Size 8 AL0A4VQT042,Altra M Torin 4.5 Plush Black Steel Men's US Size 8 AL0A4VQT042,FBALYB Amazon,-6,-6,0,0,0,0
,Altra M Torin 4.5 Plush Black Steel Men's US Size 9.5 AL0A4VQT042,Altra M Torin 4.5 Plush Black Steel Men's US Size 9.5 AL0A4VQT042,FBALYB Amazon,-4,-4,0,0,0,0
,Altra M Torin 4.5 Plush Dark Red Men's US Size 10.5 AL0A4VQT668,Altra M Torin 4.5 Plush Dark Red Men's US Size 10.5 AL0A4VQT668,FBALYB Amazon,-1,-1,0,0,0,0
,Altra M Torin 4.5 Plush Dark Red Men's US Size 10 AL0A4VQT668,Altra M Torin 4.5 Plush Dark Red Men's US Size 10 AL0A4VQT668,FBALYB Amazon,-2,-2,0,0,0,0
,Altra M Torin 4.5 Plush Dark Red Men's US Size 11.5 AL0A4VQT668,Altra M Torin 4.5 Plush Dark Red Men's US Size 11.5 AL0A4VQT668,FBALYB Amazon,-1,-1,0,0,0,0
,Altra M Torin 4.5 Plush Dark Red Men's US Size 11 AL0A4VQT668,Altra M Torin 4.5 Plush Dark Red Men's US Size 11 AL0A4VQT668,FBALYB Amazon,-1,-1,0,0,0,0
,Altra M Torin 4.5 Plush Dark Red Men's US Size 12 AL0A4VQT668,Altra M Torin 4.5 Plush Dark Red Men's US Size 12 AL0A4VQT668,FBALYB Amazon,-3,-3,0,0,0,0
,Altra M Torin 4.5 Plush Dark Red Men's US Size 8.5 AL0A4VQT668,Altra M Torin 4.5 Plush Dark Red Men's US Size 8.5 AL0A4VQT668,FBALYB Amazon,-1,-1,0,0,0,0
,Altra M Torin 4.5 Plush Dark Red Men's US Size 9.5 AL0A4VQT668,Altra M Torin 4.5 Plush Dark Red Men's US Size 9.5 AL0A4VQT668,FBALYB Amazon,-1,-1,0,0,0,0
,Altra M Torin 4.5 Plush Dark Red Men's US Size 9 AL0A4VQT668,Altra M Torin 4.5 Plush Dark Red Men's US Size 9 AL0A4VQT668,Default Ridgefield,1,1,0,0,0,0
,Altra M Torin 4.5 Plush Light Gray Men's US Size 10.5 AL0A4VQT224,Altra M Torin 4.5 Plush Light Gray Men's US Size 10.5 AL0A4VQT224,FBALYB Amazon,-1,-1,0,0,0,0
,Altra M Torin 4.5 Plush Light Gray Men's US Size 10 AL0A4VQT224,Altra M Torin 4.5 Plush Light Gray Men's US Size 10 AL0A4VQT224,FBALYB Amazon,-2,-2,0,0,0,0
,Altra M Torin 4.5 Plush Light Gray Men's US Size 11 AL0A4VQT224,Altra M Torin 4.5 Plush Light Gray Men's US Size 11 AL0A4VQT224,FBALYB Amazon,-1,-1,0,0,0,0
,Altra M Torin 4.5 Plush Light Gray Men's US Size 12 AL0A4VQT224,Altra M Torin 4.5 Plush Light Gray Men's US Size 12 AL0A4VQT224,FBALYB Amazon,-1,-1,0,0,0,0
,Altra M Torin 4.5 Plush Light Gray Men's US Size 9.5 AL0A4VQT224,Altra M Torin 4.5 Plush Light Gray Men's US Size 9.5 AL0A4VQT224,FBALYB Amazon,-1,-1,0,0,0,0
,Altra M Torin 4.5 Plush Light Gray Men's US Size 9 AL0A4VQT224,Altra M Torin 4.5 Plush Light Gray Men's US Size 9 AL0A4VQT224,FBALYB Amazon,-3,-3,0,0,0,0
,Altra M Torin 4.5 Plush Majolica Blue Men's US Size 10.5 AL0A4VQT408,Altra M Torin 4.5 Plush Majolica Blue Men's US Size 10.5 AL0A4VQT408,FBALYB Amazon,-16,-16,0,0,0,0
,Altra M Torin 4.5 Plush Majolica Blue Men's US Size 10 AL0A4VQT408,Altra M Torin 4.5 Plush Majolica Blue Men's US Size 10 AL0A4VQT408,FBALYB Amazon,-2,-2,0,0,0,0
,Altra M Torin 4.5 Plush Majolica Blue Men's US Size 11.5 AL0A4VQT408,Altra M Torin 4.5 Plush Majolica Blue Men's US Size 11.5 AL0A4VQT408,FBALYB Amazon,-2,-2,0,0,0,0
,Altra M Torin 4.5 Plush Majolica Blue Men's US Size 11 AL0A4VQT408,Altra M Torin 4.5 Plush Majolica Blue Men's US Size 11 AL0A4VQT408,FBALYB Amazon,-5,-5,0,0,0,0
,Altra M Torin 4.5 Plush Majolica Blue Men's US Size 12.5 AL0A4VQT408,Altra M Torin 4.5 Plush Majolica Blue Men's US Size 12.5 AL0A4VQT408,FBALYB Amazon,-2,-2,0,0,0,0
,Altra M Torin 4.5 Plush Majolica Blue Men's US Size 13 AL0A4VQT408,Altra M Torin 4.5 Plush Majolica Blue Men's US Size 13 AL0A4VQT408,FBALYB Amazon,-4,-4,0,0,0,0
,Altra M Torin 4.5 Plush Majolica Blue Men's US Size 14 AL0A4VQT408,Altra M Torin 4.5 Plush Majolica Blue Men's US Size 14 AL0A4VQT408,FBALYB Amazon,-1,-1,0,0,0,0
,Altra M Torin 4.5 Plush Majolica Blue Men's US Size 15 AL0A4VQT408,Altra M Torin 4.5 Plush Majolica Blue Men's US Size 15 AL0A4VQT408,FBALYB Amazon,-1,-1,0,0,0,0
,Altra M Torin 4.5 Plush Majolica Blue Men's US Size 8.5 AL0A4VQT408,Altra M Torin 4.5 Plush Majolica Blue Men's US Size 8.5 AL0A4VQT408,FBALYB Amazon,-2,-2,0,0,0,0
,Altra M Torin 4.5 Plush Majolica Blue Men's US Size 8 AL0A4VQT408,Altra M Torin 4.5 Plush Majolica Blue Men's US Size 8 AL0A4VQT408,FBALYB Amazon,-1,-1,0,0,0,0
,Altra M Torin 4.5 Plush Majolica Blue Men's US Size 9.5 AL0A4VQT408,Altra M Torin 4.5 Plush Majolica Blue Men's US Size 9.5 AL0A4VQT408,FBALYB Amazon,-3,-3,0,0,0,0
,Altra M Torin 4.5 Plush Majolica Blue Men's US Size 9 AL0A4VQT408,Altra M Torin 4.5 Plush Majolica Blue Men's US Size 9 AL0A4VQT408,FBALYB Amazon,-1,-1,0,0,0,0
,Altra M Torin 4.5 Plush Teal/Lime Mens US SIze 10.5 AL0A4VQT016,Altra M Torin 4.5 Plush Teal/Lime Mens US SIze 10.5 AL0A4VQT016,FBALYB Amazon,7,7,0,0,0,0
,Altra M Torin 4.5 Plush Teal/Lime Mens US SIze 10 AL0A4VQT016,Altra M Torin 4.5 Plush Teal/Lime Mens US SIze 10 AL0A4VQT016,FBALYB Amazon,16,16,0,0,0,0
,Altra M Torin 4.5 Plush Teal/Lime Mens US SIze 11.5 AL0A4VQT016,Altra M Torin 4.5 Plush Teal/Lime Mens US SIze 11.5 AL0A4VQT016,FBALYB Amazon,6,6,0,0,0,0
,Altra M Torin 4.5 Plush Teal/Lime Mens US SIze 12 AL0A4VQT016,Altra M Torin 4.5 Plush Teal/Lime Mens US SIze 12 AL0A4VQT016,FBALYB Amazon,5,5,0,0,0,0
,Altra M Torin 4.5 Plush Teal/Lime Mens US SIze 13 AL0A4VQT016,Altra M Torin 4.5 Plush Teal/Lime Mens US SIze 13 AL0A4VQT016,FBALYB Amazon,2,2,0,0,0,0
,Altra M Torin 4.5 Plush Teal/Lime Mens US SIze 8.5 AL0A4VQT016,Altra M Torin 4.5 Plush Teal/Lime Mens US SIze 8.5 AL0A4VQT016,FBALYB Amazon,5,5,0,0,0,0
,Altra M Torin 4.5 Plush Teal/Lime Mens US SIze 8 AL0A4VQT016,Altra M Torin 4.5 Plush Teal/Lime Mens US SIze 8 AL0A4VQT016,FBALYB Amazon,10,10,0,0,0,0
,Altra M Torin 4.5 Plush Teal/Lime Mens US SIze 9.5 AL0A4VQT016,Altra M Torin 4.5 Plush Teal/Lime Mens US SIze 9.5 AL0A4VQT016,FBALYB Amazon,0,-1,1,0,1,0
,Altra M Torin 4.5 Plush Teal/Lime Mens US SIze 9 AL0A4VQT016,Altra M Torin 4.5 Plush Teal/Lime Mens US SIze 9 AL0A4VQT016,FBALYB Amazon,22,22,0,0,0,0
,Altra W Escalante 2.5 Black Women's US Size 10.5 AL0A4VR3000,Altra W Escalante 2.5 Black Women's US Size 10.5 AL0A4VR3000,FBALYB Amazon,-4,-4,0,0,0,0
,Altra W Escalante 2.5 Black Women's US Size 10 AL0A4VR3000,Altra W Escalante 2.5 Black Women's US Size 10 AL0A4VR3000,FBALYB Amazon,-3,-3,0,1,0,0
,Altra W Escalante 2.5 Black Women's US Size 6.5 AL0A4VR3000,Altra W Escalante 2.5 Black Women's US Size 6.5 AL0A4VR3000,FBALYB Amazon,-2,-2,0,1,0,0
,Altra W Escalante 2.5 Black Women's US Size 6 AL0A4VR3000,Altra W Escalante 2.5 Black Women's US Size 6 AL0A4VR3000,FBALYB Amazon,7,7,0,0,0,0
,Altra W Escalante 2.5 Black Women's US Size 7.5 AL0A4VR3000,Altra W Escalante 2.5 Black Women's US Size 7.5 AL0A4VR3000,FBALYB Amazon,-12,-12,0,0,0,0
,Altra W Escalante 2.5 Black Women's US Size 7 AL0A4VR3000,Altra W Escalante 2.5 Black Women's US Size 7 AL0A4VR3000,FBALYB Amazon,-4,-4,0,0,0,0
,Altra W Escalante 2.5 Black Women's US Size 8.5 AL0A4VR3000,Altra W Escalante 2.5 Black Women's US Size 8.5 AL0A4VR3000,FBALYB Amazon,-17,-17,0,0,0,0
,Altra W Escalante 2.5 Black Women's US Size 8 AL0A4VR3000,Altra W Escalante 2.5 Black Women's US Size 8 AL0A4VR3000,FBALYB Amazon,-3,-3,0,0,0,0
,Altra W Escalante 2.5 Black Women's US Size 9.5 AL0A4VR3000,Altra W Escalante 2.5 Black Women's US Size 9.5 AL0A4VR3000,FBALYB Amazon,-4,-4,0,0,0,0
,Altra W Escalante 2.5 Black Women's US Size 9 AL0A4VR3000,Altra W Escalante 2.5 Black Women's US Size 9 AL0A4VR3000,FBALYB Amazon,-2,-2,0,0,0,0
,Altra W Escalante 2.5 Light Green Women's US Size 10.5 AL0A4VR3333,Altra W Escalante 2.5 Light Green Women's US Size 10.5 AL0A4VR3333,FBALYB Amazon,-1,-1,0,0,0,0
,Altra W Escalante 2.5 Light Green Women's US Size 10 AL0A4VR3333,Altra W Escalante 2.5 Light Green Women's US Size 10 AL0A4VR3333,FBALYB Amazon,-2,-2,0,0,0,0
,Altra W Escalante 2.5 Light Green Women's US Size 6.5 AL0A4VR3333,Altra W Escalante 2.5 Light Green Women's US Size 6.5 AL0A4VR3333,FBALYB Amazon,-5,-5,0,0,0,0
,Altra W Escalante 2.5 Light Green Women's US Size 6 AL0A4VR3333,Altra W Escalante 2.5 Light Green Women's US Size 6 AL0A4VR3333,FBALYB Amazon,-1,-1,0,0,0,0
,Altra W Escalante 2.5 Light Green Women's US Size 7.5 AL0A4VR3333,Altra W Escalante 2.5 Light Green Women's US Size 7.5 AL0A4VR3333,FBALYB Amazon,-1,-1,0,0,0,0
,Altra W Escalante 2.5 Light Green Women's US Size 8.5 AL0A4VR3333,Altra W Escalante 2.5 Light Green Women's US Size 8.5 AL0A4VR3333,FBALYB Amazon,-1,-1,0,0,0,0
,Altra W Escalante 2.5 Light Green Women's US Size 8 AL0A4VR3333,Altra W Escalante 2.5 Light Green Women's US Size 8 AL0A4VR3333,FBALYB Amazon,-3,-3,0,1,0,0
,Altra W Escalante 2.5 Light Green Women's US Size 9.5 AL0A4VR3333,Altra W Escalante 2.5 Light Green Women's US Size 9.5 AL0A4VR3333,FBALYB Amazon,-2,-2,0,0,0,0
,Altra W Escalante 2.5 Light Green Women's US Size 9 AL0A4VR3333,Altra W Escalante 2.5 Light Green Women's US Size 9 AL0A4VR3333,Default Ridgefield,1,1,0,0,0,0
,Altra W Lone Peak 5 Black Womens US SIze 10 AL0A4VR7000,Altra W Lone Peak 5 Black Womens US SIze 10 AL0A4VR7000,FBALYB Amazon,-3,-3,0,0,0,0
,Altra W Lone Peak 5 Black Womens US SIze 6.5 AL0A4VR7000,Altra W Lone Peak 5 Black Womens US SIze 6.5 AL0A4VR7000,FBALYB Amazon,-4,-4,0,0,0,0
,Altra W Lone Peak 5 Black Womens US SIze 6 AL0A4VR7000,Altra W Lone Peak 5 Black Womens US SIze 6 AL0A4VR7000,FBALYB Amazon,-1,-1,0,0,0,0
,Altra W Lone Peak 5 Black Womens US SIze 7.5 AL0A4VR7000,Altra W Lone Peak 5 Black Womens US SIze 7.5 AL0A4VR7000,FBALYB Amazon,-5,-5,0,0,0,0
,Altra W Lone Peak 5 Black Womens US SIze 7 AL0A4VR7000,Altra W Lone Peak 5 Black Womens US SIze 7 AL0A4VR7000,FBALYB Amazon,-4,-4,0,0,0,0
,Altra W Lone Peak 5 Black Womens US SIze 8.5 AL0A4VR7000,Altra W Lone Peak 5 Black Womens US SIze 8.5 AL0A4VR7000,FBALYB Amazon,-4,-4,0,0,0,0
,Altra W Lone Peak 5 Black Womens US SIze 8 AL0A4VR7000,Altra W Lone Peak 5 Black Womens US SIze 8 AL0A4VR7000,FBALYB Amazon,-5,-5,0,0,0,0
,Altra W Lone Peak 5 Black Womens US SIze 9.5 AL0A4VR7000,Altra W Lone Peak 5 Black Womens US SIze 9.5 AL0A4VR7000,FBALYB Amazon,-2,-2,0,0,0,0
,Altra W Lone Peak 5 Black Womens US SIze 9 AL0A4VR7000,Altra W Lone Peak 5 Black Womens US SIze 9 AL0A4VR7000,FBALYB Amazon,-2,-2,0,0,0,0
,Altra W Lone Peak 5 Ice Flow Blue Womens US SIze 10 AL0A4VR7416,Altra W Lone Peak 5 Ice Flow Blue Womens US SIze 10 AL0A4VR7416,FBALYB Amazon,42,42,0,0,0,0
,Altra W Lone Peak 5 Ice Flow Blue Womens US SIze 6.5 AL0A4VR7416,Altra W Lone Peak 5 Ice Flow Blue Womens US SIze 6.5 AL0A4VR7416,Default Ridgefield,2,2,0,0,0,0
,Altra W Lone Peak 5 Ice Flow Blue Womens US SIze 6.5 AL0A4VR7416,Altra W Lone Peak 5 Ice Flow Blue Womens US SIze 6.5 AL0A4VR7416,FBALYB Amazon,8,8,0,2,0,0
,Altra W Lone Peak 5 Ice Flow Blue Womens US SIze 6 AL0A4VR7416,Altra W Lone Peak 5 Ice Flow Blue Womens US SIze 6 AL0A4VR7416,FBALYB Amazon,-3,-3,0,0,0,0
,Altra W Lone Peak 5 Ice Flow Blue Womens US SIze 7.5 AL0A4VR7416,Altra W Lone Peak 5 Ice Flow Blue Womens US SIze 7.5 AL0A4VR7416,FBALYB Amazon,31,30,1,0,1,0
,Altra W Lone Peak 5 Ice Flow Blue Womens US SIze 7 AL0A4VR7416,Altra W Lone Peak 5 Ice Flow Blue Womens US SIze 7 AL0A4VR7416,FBALYB Amazon,19,19,0,0,0,0
,Altra W Lone Peak 5 Ice Flow Blue Womens US SIze 8.5 AL0A4VR7416,Altra W Lone Peak 5 Ice Flow Blue Womens US SIze 8.5 AL0A4VR7416,Default Ridgefield,1,1,0,0,0,0
,Altra W Lone Peak 5 Ice Flow Blue Womens US SIze 8.5 AL0A4VR7416,Altra W Lone Peak 5 Ice Flow Blue Womens US SIze 8.5 AL0A4VR7416,FBALYB Amazon,48,47,1,0,1,0
,Altra W Lone Peak 5 Ice Flow Blue Womens US SIze 8 AL0A4VR7416,Altra W Lone Peak 5 Ice Flow Blue Womens US SIze 8 AL0A4VR7416,FBALYB Amazon,60,59,1,0,1,0
,Altra W Lone Peak 5 Ice Flow Blue Womens US SIze 9.5 AL0A4VR7416,Altra W Lone Peak 5 Ice Flow Blue Womens US SIze 9.5 AL0A4VR7416,FBALYB Amazon,18,18,0,0,0,0
,Altra W Lone Peak 5 Ice Flow Blue Womens US SIze 9 AL0A4VR7416,Altra W Lone Peak 5 Ice Flow Blue Womens US SIze 9 AL0A4VR7416,Default Ridgefield,2,2,0,0,0,0
,Altra W Lone Peak 5 Ice Flow Blue Womens US SIze 9 AL0A4VR7416,Altra W Lone Peak 5 Ice Flow Blue Womens US SIze 9 AL0A4VR7416,FBALYB Amazon,40,39,1,0,1,0
,Altra W Lone Peak 5 Khaki Womens US SIze 10 AL0A4VR7017,Altra W Lone Peak 5 Khaki Womens US SIze 10 AL0A4VR7017,Default Ridgefield,6,6,0,0,0,0
,Altra W Lone Peak 5 Khaki Womens US SIze 10 AL0A4VR7017,Altra W Lone Peak 5 Khaki Womens US SIze 10 AL0A4VR7017,FBALYB Amazon,35,35,0,0,0,0
,Altra W Lone Peak 5 Khaki Womens US SIze 6.5 AL0A4VR7017,Altra W Lone Peak 5 Khaki Womens US SIze 6.5 AL0A4VR7017,FBALYB Amazon,13,13,0,0,0,0
,Altra W Lone Peak 5 Khaki Womens US SIze 6 AL0A4VR7017,Altra W Lone Peak 5 Khaki Womens US SIze 6 AL0A4VR7017,FBALYB Amazon,1,1,0,0,0,0
,Altra W Lone Peak 5 Khaki Womens US SIze 7.5 AL0A4VR7017,Altra W Lone Peak 5 Khaki Womens US SIze 7.5 AL0A4VR7017,FBALYB Amazon,32,32,0,0,0,0
,Altra W Lone Peak 5 Khaki Womens US SIze 7 AL0A4VR7017,Altra W Lone Peak 5 Khaki Womens US SIze 7 AL0A4VR7017,FBALYB Amazon,27,27,0,0,0,0
,Altra W Lone Peak 5 Khaki Womens US SIze 8.5 AL0A4VR7017,Altra W Lone Peak 5 Khaki Womens US SIze 8.5 AL0A4VR7017,FBALYB Amazon,47,47,0,0,0,0
,Altra W Lone Peak 5 Khaki Womens US SIze 8 AL0A4VR7017,Altra W Lone Peak 5 Khaki Womens US SIze 8 AL0A4VR7017,Default Ridgefield,1,1,0,0,0,0
,Altra W Lone Peak 5 Khaki Womens US SIze 8 AL0A4VR7017,Altra W Lone Peak 5 Khaki Womens US SIze 8 AL0A4VR7017,FBALYB Amazon,58,58,0,0,0,0
,Altra W Lone Peak 5 Khaki Womens US SIze 9.5 AL0A4VR7017,Altra W Lone Peak 5 Khaki Womens US SIze 9.5 AL0A4VR7017,Default Ridgefield,1,1,0,0,0,0
,Altra W Lone Peak 5 Khaki Womens US SIze 9.5 AL0A4VR7017,Altra W Lone Peak 5 Khaki Womens US SIze 9.5 AL0A4VR7017,FBALYB Amazon,11,11,0,0,0,0
,Altra W Lone Peak 5 Khaki Womens US SIze 9 AL0A4VR7017,Altra W Lone Peak 5 Khaki Womens US SIze 9 AL0A4VR7017,FBALYB Amazon,49,49,0,0,0,0
,Altra W LONE PEAK 5 PLUM/CORAL AL0A4VR7552 US Size 10,Altra W LONE PEAK 5 PLUM/CORAL AL0A4VR7552 US Size 10,Default Ridgefield,11,11,0,0,0,0
,Altra W LONE PEAK 5 PLUM/CORAL AL0A4VR7552 US Size 10,Altra W LONE PEAK 5 PLUM/CORAL AL0A4VR7552 US Size 10,FBALYB Amazon,31,31,0,0,0,0
,Altra W LONE PEAK 5 PLUM/CORAL AL0A4VR7552 US Size 6.5,Altra W LONE PEAK 5 PLUM/CORAL AL0A4VR7552 US Size 6.5,FBALYB Amazon,14,14,0,0,0,0
,Altra W LONE PEAK 5 PLUM/CORAL AL0A4VR7552 US Size 7,Altra W LONE PEAK 5 PLUM/CORAL AL0A4VR7552 US Size 7,Default Ridgefield,8,8,0,0,0,0
,Altra W LONE PEAK 5 PLUM/CORAL AL0A4VR7552 US Size 7,Altra W LONE PEAK 5 PLUM/CORAL AL0A4VR7552 US Size 7,FBALYB Amazon,28,28,0,0,0,0
,Altra W LONE PEAK 5 PLUM/CORAL AL0A4VR7552 US Size 7.5,Altra W LONE PEAK 5 PLUM/CORAL AL0A4VR7552 US Size 7.5,Default Ridgefield,10,10,0,0,0,0
,Altra W LONE PEAK 5 PLUM/CORAL AL0A4VR7552 US Size 7.5,Altra W LONE PEAK 5 PLUM/CORAL AL0A4VR7552 US Size 7.5,FBALYB Amazon,22,22,0,0,0,0
,Altra W LONE PEAK 5 PLUM/CORAL AL0A4VR7552 US Size 8,Altra W LONE PEAK 5 PLUM/CORAL AL0A4VR7552 US Size 8,FBALYB Amazon,60,60,0,0,0,0
,Altra W LONE PEAK 5 PLUM/CORAL AL0A4VR7552 US Size 8.5,Altra W LONE PEAK 5 PLUM/CORAL AL0A4VR7552 US Size 8.5,Default Ridgefield,1,1,0,0,0,0
,Altra W LONE PEAK 5 PLUM/CORAL AL0A4VR7552 US Size 8.5,Altra W LONE PEAK 5 PLUM/CORAL AL0A4VR7552 US Size 8.5,FBALYB Amazon,63,62,1,0,1,0
,Altra W LONE PEAK 5 PLUM/CORAL AL0A4VR7552 US Size 9,Altra W LONE PEAK 5 PLUM/CORAL AL0A4VR7552 US Size 9,Default Ridgefield,10,10,0,0,0,0
,Altra W LONE PEAK 5 PLUM/CORAL AL0A4VR7552 US Size 9,Altra W LONE PEAK 5 PLUM/CORAL AL0A4VR7552 US Size 9,FBALYB Amazon,28,25,3,0,3,0
,Altra W LONE PEAK 5 PLUM/CORAL AL0A4VR7552 US Size 9.5,Altra W LONE PEAK 5 PLUM/CORAL AL0A4VR7552 US Size 9.5,FBALYB Amazon,11,10,1,0,1,0
,Altra W Paradigm 5 Blue/Coral Women's US Size 10.5 AL0A4VQY460,Altra W Paradigm 5 Blue/Coral Women's US Size 10.5 AL0A4VQY460,FBALYB Amazon,-2,-2,0,0,0,0
,Altra W Paradigm 5 Blue/Coral Women's US Size 10 AL0A4VQY460,Altra W Paradigm 5 Blue/Coral Women's US Size 10 AL0A4VQY460,FBALYB Amazon,-2,-2,0,0,0,0
,Altra W Paradigm 5 Blue/Coral Women's US Size 6.5 AL0A4VQY460,Altra W Paradigm 5 Blue/Coral Women's US Size 6.5 AL0A4VQY460,FBALYB Amazon,17,17,0,0,0,0
,Altra W Paradigm 5 Blue/Coral Women's US Size 6 AL0A4VQY460,Altra W Paradigm 5 Blue/Coral Women's US Size 6 AL0A4VQY460,FBALYB Amazon,23,23,0,0,0,0
,Altra W Paradigm 5 Blue/Coral Women's US Size 7.5 AL0A4VQY460,Altra W Paradigm 5 Blue/Coral Women's US Size 7.5 AL0A4VQY460,FBALYB Amazon,-11,-11,0,0,0,0
,Altra W Paradigm 5 Blue/Coral Women's US Size 7 AL0A4VQY460,Altra W Paradigm 5 Blue/Coral Women's US Size 7 AL0A4VQY460,FBALYB Amazon,4,4,0,0,0,0
,Altra W Paradigm 5 Blue/Coral Women's US Size 8.5 AL0A4VQY460,Altra W Paradigm 5 Blue/Coral Women's US Size 8.5 AL0A4VQY460,FBALYB Amazon,-6,-6,0,0,0,0
,Altra W Paradigm 5 Blue/Coral Women's US Size 8 AL0A4VQY460,Altra W Paradigm 5 Blue/Coral Women's US Size 8 AL0A4VQY460,FBALYB Amazon,-13,-13,0,0,0,0
,Altra W Paradigm 5 Blue/Coral Women's US Size 9.5 AL0A4VQY460,Altra W Paradigm 5 Blue/Coral Women's US Size 9.5 AL0A4VQY460,FBALYB Amazon,-8,-8,0,0,0,0
,Altra W Paradigm 5 Blue/Coral Women's US Size 9 AL0A4VQY460,Altra W Paradigm 5 Blue/Coral Women's US Size 9 AL0A4VQY460,FBALYB Amazon,-7,-7,0,0,0,0
,Altra W Paradigm 5 Raspberry Womens US SIze 10 AL0A4VQY664,Altra W Paradigm 5 Raspberry Womens US SIze 10 AL0A4VQY664,FBALYB Amazon,-2,-2,0,0,0,0
,Altra W Paradigm 5 Raspberry Womens US SIze 6.5 AL0A4VQY664,Altra W Paradigm 5 Raspberry Womens US SIze 6.5 AL0A4VQY664,FBALYB Amazon,7,7,0,0,0,0
,Altra W Paradigm 5 Raspberry Womens US SIze 6 AL0A4VQY664,Altra W Paradigm 5 Raspberry Womens US SIze 6 AL0A4VQY664,FBALYB Amazon,12,12,0,0,0,0
,Altra W Paradigm 5 Raspberry Womens US SIze 7.5 AL0A4VQY664,Altra W Paradigm 5 Raspberry Womens US SIze 7.5 AL0A4VQY664,FBALYB Amazon,8,8,0,0,0,0
,Altra W Paradigm 5 Raspberry Womens US SIze 7 AL0A4VQY664,Altra W Paradigm 5 Raspberry Womens US SIze 7 AL0A4VQY664,FBALYB Amazon,6,6,0,0,0,0
,Altra W Paradigm 5 Raspberry Womens US SIze 8.5 AL0A4VQY664,Altra W Paradigm 5 Raspberry Womens US SIze 8.5 AL0A4VQY664,FBALYB Amazon,-4,-4,0,0,0,0
,Altra W Paradigm 5 Raspberry Womens US SIze 8 AL0A4VQY664,Altra W Paradigm 5 Raspberry Womens US SIze 8 AL0A4VQY664,FBALYB Amazon,-2,-2,0,0,0,0
,Altra W Paradigm 5 Raspberry Womens US SIze 9.5 AL0A4VQY664,Altra W Paradigm 5 Raspberry Womens US SIze 9.5 AL0A4VQY664,FBALYB Amazon,1,1,0,0,0,0
,Altra W Paradigm 5 Raspberry Womens US SIze 9 AL0A4VQY664,Altra W Paradigm 5 Raspberry Womens US SIze 9 AL0A4VQY664,FBALYB Amazon,-1,-1,0,0,0,0
,Altra W Soltice XT Black Womens US Size 10 AL0A4QTN000,Altra W Soltice XT Black Womens US Size 10 AL0A4QTN000,FBALYB Amazon,-4,-4,0,0,0,0
,Altra W Soltice XT Black Womens US Size 6.5 AL0A4QTN000,Altra W Soltice XT Black Womens US Size 6.5 AL0A4QTN000,FBALYB Amazon,-5,-5,0,0,0,0
,Altra W Soltice XT Black Womens US Size 6 AL0A4QTN000,Altra W Soltice XT Black Womens US Size 6 AL0A4QTN000,FBALYB Amazon,-1,-1,0,0,0,0
,Altra W Soltice XT Black Womens US Size 7.5 AL0A4QTN000,Altra W Soltice XT Black Womens US Size 7.5 AL0A4QTN000,FBALYB Amazon,-4,-4,0,0,0,0
,Altra W Soltice XT Black Womens US Size 7 AL0A4QTN000,Altra W Soltice XT Black Womens US Size 7 AL0A4QTN000,FBALYB Amazon,-3,-3,0,0,0,0
,Altra W Soltice XT Black Womens US Size 8.5 AL0A4QTN000,Altra W Soltice XT Black Womens US Size 8.5 AL0A4QTN000,FBALYB Amazon,-6,-6,0,0,0,0
,Altra W Soltice XT Black Womens US Size 9.5 AL0A4QTN000,Altra W Soltice XT Black Womens US Size 9.5 AL0A4QTN000,FBALYB Amazon,-6,-6,0,0,0,0
,Altra W Soltice XT Black Womens US Size 9 AL0A4QTN000,Altra W Soltice XT Black Womens US Size 9 AL0A4QTN000,FBALYB Amazon,-1,-1,0,0,0,0
,Altra W Superior 4.5 Black/Pink Women's US Size 6.5 AL0A4VR4060,Altra W Superior 4.5 Black/Pink Women's US Size 6.5 AL0A4VR4060,FBALYB Amazon,-2,-2,0,0,0,0
,Altra W Superior 4.5 Black/Pink Women's US Size 7.5 AL0A4VR4060,Altra W Superior 4.5 Black/Pink Women's US Size 7.5 AL0A4VR4060,FBALYB Amazon,-3,-3,0,0,0,0
,Altra W Superior 4.5 Black/Pink Women's US Size 7 AL0A4VR4060,Altra W Superior 4.5 Black/Pink Women's US Size 7 AL0A4VR4060,FBALYB Amazon,-7,-7,0,0,0,0
,Altra W Superior 4.5 Black/Pink Women's US Size 8.5 AL0A4VR4060,Altra W Superior 4.5 Black/Pink Women's US Size 8.5 AL0A4VR4060,FBALYB Amazon,-5,-5,0,0,0,0
,Altra W Superior 4.5 Black/Pink Women's US Size 8 AL0A4VR4060,Altra W Superior 4.5 Black/Pink Women's US Size 8 AL0A4VR4060,FBALYB Amazon,-1,-1,0,0,0,0
,Altra W Superior 4.5 Black/Pink Women's US Size 9.5 AL0A4VR4060,Altra W Superior 4.5 Black/Pink Women's US Size 9.5 AL0A4VR4060,FBALYB Amazon,-9,-9,0,0,0,0
,Altra W Superior 4.5 Black/Pink Women's US Size 9 AL0A4VR4060,Altra W Superior 4.5 Black/Pink Women's US Size 9 AL0A4VR4060,FBALYB Amazon,-9,-9,0,0,0,0
,Altra W Superior 4.5 Capri Breeze Women's US Size 6.5 AL0A4VR4414,Altra W Superior 4.5 Capri Breeze Women's US Size 6.5 AL0A4VR4414,FBALYB Amazon,-3,-3,0,0,0,0
,Altra W Superior 4.5 Capri Breeze Women's US Size 6 AL0A4VR4414,Altra W Superior 4.5 Capri Breeze Women's US Size 6 AL0A4VR4414,FBALYB Amazon,-3,-3,0,0,0,0
,Altra W Superior 4.5 Capri Breeze Women's US Size 7.5 AL0A4VR4414,Altra W Superior 4.5 Capri Breeze Women's US Size 7.5 AL0A4VR4414,FBALYB Amazon,-1,-1,0,0,0,0
,Altra W Superior 4.5 Capri Breeze Women's US Size 7 AL0A4VR4414,Altra W Superior 4.5 Capri Breeze Women's US Size 7 AL0A4VR4414,FBALYB Amazon,-4,-4,0,0,0,0
,Altra W Superior 4.5 Capri Breeze Women's US Size 8.5 AL0A4VR4414,Altra W Superior 4.5 Capri Breeze Women's US Size 8.5 AL0A4VR4414,FBALYB Amazon,-6,-6,0,0,0,0
,Altra W Superior 4.5 Capri Breeze Women's US Size 8 AL0A4VR4414,Altra W Superior 4.5 Capri Breeze Women's US Size 8 AL0A4VR4414,FBALYB Amazon,-3,-3,0,0,0,0
,Altra W Superior 4.5 Capri Breeze Women's US Size 9.5 AL0A4VR4414,Altra W Superior 4.5 Capri Breeze Women's US Size 9.5 AL0A4VR4414,FBALYB Amazon,-4,-4,0,0,0,0
,Altra W Superior 4.5 Capri Breeze Women's US Size 9 AL0A4VR4414,Altra W Superior 4.5 Capri Breeze Women's US Size 9 AL0A4VR4414,FBALYB Amazon,-3,-3,0,0,0,0
,Altra W Superior 4.5 Dark Slate Women's US Size 10.5 AL0A4VR4202,Altra W Superior 4.5 Dark Slate Women's US Size 10.5 AL0A4VR4202,FBALYB Amazon,-4,-4,0,0,0,0
,Altra W Superior 4.5 Dark Slate Women's US Size 10 AL0A4VR4202,Altra W Superior 4.5 Dark Slate Women's US Size 10 AL0A4VR4202,FBALYB Amazon,-3,-3,0,0,0,0
,Altra W Superior 4.5 Dark Slate Women's US Size 6.5 AL0A4VR4202,Altra W Superior 4.5 Dark Slate Women's US Size 6.5 AL0A4VR4202,FBALYB Amazon,-11,-11,0,0,0,0
,Altra W Superior 4.5 Dark Slate Women's US Size 6 AL0A4VR4202,Altra W Superior 4.5 Dark Slate Women's US Size 6 AL0A4VR4202,FBALYB Amazon,10,10,0,0,0,0
,Altra W Superior 4.5 Dark Slate Women's US Size 7.5 AL0A4VR4202,Altra W Superior 4.5 Dark Slate Women's US Size 7.5 AL0A4VR4202,FBALYB Amazon,-9,-9,0,0,0,0
,Altra W Superior 4.5 Dark Slate Women's US Size 7 AL0A4VR4202,Altra W Superior 4.5 Dark Slate Women's US Size 7 AL0A4VR4202,FBALYB Amazon,-8,-8,0,0,0,0
,Altra W Superior 4.5 Dark Slate Women's US Size 8.5 AL0A4VR4202,Altra W Superior 4.5 Dark Slate Women's US Size 8.5 AL0A4VR4202,FBALYB Amazon,-9,-9,0,0,0,0
,Altra W Superior 4.5 Dark Slate Women's US Size 8 AL0A4VR4202,Altra W Superior 4.5 Dark Slate Women's US Size 8 AL0A4VR4202,FBALYB Amazon,-9,-9,0,0,0,0
,Altra W Superior 4.5 Dark Slate Women's US Size 9.5 AL0A4VR4202,Altra W Superior 4.5 Dark Slate Women's US Size 9.5 AL0A4VR4202,FBALYB Amazon,-12,-12,0,0,0,0
,Altra W Superior 4.5 Dark Slate Women's US Size 9 AL0A4VR4202,Altra W Superior 4.5 Dark Slate Women's US Size 9 AL0A4VR4202,FBALYB Amazon,-9,-9,0,0,0,0
,Altra W Superior 4.5 Light Blue Women's US Size 10.5 AL0A4VR4444,Altra W Superior 4.5 Light Blue Women's US Size 10.5 AL0A4VR4444,FBALYB Amazon,-6,-6,0,0,0,0
,Altra W Superior 4.5 Light Blue Women's US Size 10 AL0A4VR4444,Altra W Superior 4.5 Light Blue Women's US Size 10 AL0A4VR4444,FBALYB Amazon,-3,-3,0,0,0,0
,Altra W Superior 4.5 Light Blue Women's US Size 6.5 AL0A4VR4444,Altra W Superior 4.5 Light Blue Women's US Size 6.5 AL0A4VR4444,FBALYB Amazon,-4,-4,0,0,0,0
,Altra W Superior 4.5 Light Blue Women's US Size 6 AL0A4VR4444,Altra W Superior 4.5 Light Blue Women's US Size 6 AL0A4VR4444,FBALYB Amazon,-2,-2,0,0,0,0
,Altra W Superior 4.5 Light Blue Women's US Size 7.5 AL0A4VR4444,Altra W Superior 4.5 Light Blue Women's US Size 7.5 AL0A4VR4444,FBALYB Amazon,-4,-4,0,0,0,0
,Altra W Superior 4.5 Light Blue Women's US Size 7 AL0A4VR4444,Altra W Superior 4.5 Light Blue Women's US Size 7 AL0A4VR4444,FBALYB Amazon,-2,-2,0,0,0,0
,Altra W Superior 4.5 Light Blue Women's US Size 8.5 AL0A4VR4444,Altra W Superior 4.5 Light Blue Women's US Size 8.5 AL0A4VR4444,FBALYB Amazon,-3,-3,0,0,0,0
,Altra W Superior 4.5 Light Blue Women's US Size 8 AL0A4VR4444,Altra W Superior 4.5 Light Blue Women's US Size 8 AL0A4VR4444,FBALYB Amazon,-1,-1,0,0,0,0
,Altra W Superior 4.5 Light Blue Women's US Size 9.5 AL0A4VR4444,Altra W Superior 4.5 Light Blue Women's US Size 9.5 AL0A4VR4444,FBALYB Amazon,-5,-5,0,0,0,0
,Altra W Superior 4.5 Light Blue Women's US Size 9 AL0A4VR4444,Altra W Superior 4.5 Light Blue Women's US Size 9 AL0A4VR4444,FBALYB Amazon,-3,-3,0,0,0,0
,Altra W Superior 4.5 Raspberry Womens US SIze 6.5 AL0A4VR4664,Altra W Superior 4.5 Raspberry Womens US SIze 6.5 AL0A4VR4664,FBALYB Amazon,5,5,0,0,0,0
,Altra W Superior 4.5 Raspberry Womens US SIze 6 AL0A4VR4664,Altra W Superior 4.5 Raspberry Womens US SIze 6 AL0A4VR4664,FBALYB Amazon,7,7,0,0,0,0
,Altra W Superior 4.5 Raspberry Womens US SIze 7.5 AL0A4VR4664,Altra W Superior 4.5 Raspberry Womens US SIze 7.5 AL0A4VR4664,FBALYB Amazon,-8,-8,0,0,0,0
,Altra W Superior 4.5 Raspberry Womens US SIze 7 AL0A4VR4664,Altra W Superior 4.5 Raspberry Womens US SIze 7 AL0A4VR4664,FBALYB Amazon,-1,-1,0,0,0,0
,Altra W Superior 4.5 Raspberry Womens US SIze 8.5 AL0A4VR4664,Altra W Superior 4.5 Raspberry Womens US SIze 8.5 AL0A4VR4664,FBALYB Amazon,-4,-4,0,0,0,0
,Altra W Superior 4.5 Raspberry Womens US SIze 8 AL0A4VR4664,Altra W Superior 4.5 Raspberry Womens US SIze 8 AL0A4VR4664,FBALYB Amazon,-3,-3,0,0,0,0
,Altra W Superior 4.5 Raspberry Womens US SIze 9.5 AL0A4VR4664,Altra W Superior 4.5 Raspberry Womens US SIze 9.5 AL0A4VR4664,FBALYB Amazon,1,1,0,0,0,0
,Altra W TIMP 3 GRAY/PINK AL0A4VRB262 US Size 10,Altra W TIMP 3 GRAY/PINK AL0A4VRB262 US Size 10,Default Ridgefield,2,2,0,0,0,0
,Altra W TIMP 3 GRAY/PINK AL0A4VRB262 US Size 10,Altra W TIMP 3 GRAY/PINK AL0A4VRB262 US Size 10,FBALYB Amazon,85,84,1,1,1,0
,Altra W TIMP 3 GRAY/PINK AL0A4VRB262 US Size 7,Altra W TIMP 3 GRAY/PINK AL0A4VRB262 US Size 7,Default Ridgefield,7,7,0,0,0,0
,Altra W TIMP 3 GRAY/PINK AL0A4VRB262 US Size 7,Altra W TIMP 3 GRAY/PINK AL0A4VRB262 US Size 7,FBALYB Amazon,59,58,1,0,1,0
,Altra W TIMP 3 GRAY/PINK AL0A4VRB262 US Size 7.5,Altra W TIMP 3 GRAY/PINK AL0A4VRB262 US Size 7.5,FBALYB Amazon,87,87,0,0,0,0
,Altra W TIMP 3 GRAY/PINK AL0A4VRB262 US Size 8,Altra W TIMP 3 GRAY/PINK AL0A4VRB262 US Size 8,FBALYB Amazon,141,141,0,0,0,0
,Altra W TIMP 3 GRAY/PINK AL0A4VRB262 US Size 8.5,Altra W TIMP 3 GRAY/PINK AL0A4VRB262 US Size 8.5,Default Ridgefield,2,2,0,0,0,0
,Altra W TIMP 3 GRAY/PINK AL0A4VRB262 US Size 8.5,Altra W TIMP 3 GRAY/PINK AL0A4VRB262 US Size 8.5,FBALYB Amazon,167,166,1,0,1,0
,Altra W TIMP 3 GRAY/PINK AL0A4VRB262 US Size 9,Altra W TIMP 3 GRAY/PINK AL0A4VRB262 US Size 9,Default Ridgefield,2,2,0,0,0,0
,Altra W TIMP 3 GRAY/PINK AL0A4VRB262 US Size 9,Altra W TIMP 3 GRAY/PINK AL0A4VRB262 US Size 9,FBALYB Amazon,115,113,2,0,2,0
,Altra W TIMP 3 GRAY/PINK AL0A4VRB262 US Size 9.5,Altra W TIMP 3 GRAY/PINK AL0A4VRB262 US Size 9.5,FBALYB Amazon,42,42,0,0,0,0
,Altra W Torin 4.5 Plush Blue/White Womens US SIze 10 AL0A4VR2410,Altra W Torin 4.5 Plush Blue/White Womens US SIze 10 AL0A4VR2410,FBALYB Amazon,-1,-1,0,0,0,0
,Altra W Torin 4.5 Plush Blue/White Womens US SIze 6.5 AL0A4VR2410,Altra W Torin 4.5 Plush Blue/White Womens US SIze 6.5 AL0A4VR2410,FBALYB Amazon,1,1,0,0,0,0
,Altra W Torin 4.5 Plush Blue/White Womens US SIze 6 AL0A4VR2410,Altra W Torin 4.5 Plush Blue/White Womens US SIze 6 AL0A4VR2410,FBALYB Amazon,10,10,0,0,0,0
,Altra W Torin 4.5 Plush Blue/White Womens US SIze 7.5 AL0A4VR2410,Altra W Torin 4.5 Plush Blue/White Womens US SIze 7.5 AL0A4VR2410,FBALYB Amazon,-5,-5,0,0,0,0
,Altra W Torin 4.5 Plush Blue/White Womens US SIze 7 AL0A4VR2410,Altra W Torin 4.5 Plush Blue/White Womens US SIze 7 AL0A4VR2410,FBALYB Amazon,-2,-2,0,0,0,0
,Altra W Torin 4.5 Plush Blue/White Womens US SIze 8.5 AL0A4VR2410,Altra W Torin 4.5 Plush Blue/White Womens US SIze 8.5 AL0A4VR2410,FBALYB Amazon,-3,-3,0,0,0,0
,Altra W Torin 4.5 Plush Blue/White Womens US SIze 8 AL0A4VR2410,Altra W Torin 4.5 Plush Blue/White Womens US SIze 8 AL0A4VR2410,FBALYB Amazon,-1,-1,0,0,0,0
,Altra W Torin 4.5 Plush Blue/White Womens US SIze 9.5 AL0A4VR2410,Altra W Torin 4.5 Plush Blue/White Womens US SIze 9.5 AL0A4VR2410,FBALYB Amazon,-2,-2,0,0,0,0
,Altra W Torin 4.5 Plush Blue Women's US Size 10.5 AL0A4VR2440,Altra W Torin 4.5 Plush Blue Women's US Size 10.5 AL0A4VR2440,FBALYB Amazon,-2,-2,0,0,0,0
,Altra W Torin 4.5 Plush Blue Women's US Size 10 AL0A4VR2440,Altra W Torin 4.5 Plush Blue Women's US Size 10 AL0A4VR2440,FBALYB Amazon,-13,-13,0,0,0,0
,Altra W Torin 4.5 Plush Blue Women's US Size 11 AL0A4VR2440,Altra W Torin 4.5 Plush Blue Women's US Size 11 AL0A4VR2440,FBALYB Amazon,-1,-1,0,0,0,0
,Altra W Torin 4.5 Plush Blue Women's US Size 6.5 AL0A4VR2440,Altra W Torin 4.5 Plush Blue Women's US Size 6.5 AL0A4VR2440,FBALYB Amazon,-4,-4,0,0,0,0
,Altra W Torin 4.5 Plush Blue Women's US Size 6 AL0A4VR2440,Altra W Torin 4.5 Plush Blue Women's US Size 6 AL0A4VR2440,FBALYB Amazon,12,12,0,0,0,0
,Altra W Torin 4.5 Plush Blue Women's US Size 7.5 AL0A4VR2440,Altra W Torin 4.5 Plush Blue Women's US Size 7.5 AL0A4VR2440,FBALYB Amazon,-14,-14,0,0,0,0
,Altra W Torin 4.5 Plush Blue Women's US Size 7 AL0A4VR2440,Altra W Torin 4.5 Plush Blue Women's US Size 7 AL0A4VR2440,FBALYB Amazon,-6,-6,0,0,0,0
,Altra W Torin 4.5 Plush Blue Women's US Size 8.5 AL0A4VR2440,Altra W Torin 4.5 Plush Blue Women's US Size 8.5 AL0A4VR2440,FBALYB Amazon,-4,-4,0,0,0,0
,Altra W Torin 4.5 Plush Blue Women's US Size 8 AL0A4VR2440,Altra W Torin 4.5 Plush Blue Women's US Size 8 AL0A4VR2440,FBALYB Amazon,-6,-6,0,0,0,0
,Altra W Torin 4.5 Plush Blue Women's US Size 9.5 AL0A4VR2440,Altra W Torin 4.5 Plush Blue Women's US Size 9.5 AL0A4VR2440,FBALYB Amazon,3,3,0,0,0,0
,Altra W Torin 4.5 Plush Blue Women's US Size 9 AL0A4VR2440,Altra W Torin 4.5 Plush Blue Women's US Size 9 AL0A4VR2440,FBALYB Amazon,-4,-4,0,0,0,0
,Altra W Torin 4.5 Plush Coral Womens US SIze 10 AL0A4VR2662,Altra W Torin 4.5 Plush Coral Womens US SIze 10 AL0A4VR2662,FBALYB Amazon,-5,-5,0,0,0,0
,Altra W Torin 4.5 Plush Coral Womens US SIze 6.5 AL0A4VR2662,Altra W Torin 4.5 Plush Coral Womens US SIze 6.5 AL0A4VR2662,FBALYB Amazon,-2,-2,0,0,0,0
,Altra W Torin 4.5 Plush Coral Womens US SIze 6 AL0A4VR2662,Altra W Torin 4.5 Plush Coral Womens US SIze 6 AL0A4VR2662,FBALYB Amazon,5,5,0,0,0,0
,Altra W Torin 4.5 Plush Coral Womens US SIze 7.5 AL0A4VR2662,Altra W Torin 4.5 Plush Coral Womens US SIze 7.5 AL0A4VR2662,FBALYB Amazon,-4,-4,0,0,0,0
,Altra W Torin 4.5 Plush Coral Womens US SIze 7 AL0A4VR2662,Altra W Torin 4.5 Plush Coral Womens US SIze 7 AL0A4VR2662,FBALYB Amazon,-2,-2,0,0,0,0
,Altra W Torin 4.5 Plush Coral Womens US SIze 8.5 AL0A4VR2662,Altra W Torin 4.5 Plush Coral Womens US SIze 8.5 AL0A4VR2662,FBALYB Amazon,-1,-1,0,0,0,0
,Altra W Torin 4.5 Plush Coral Womens US SIze 8 AL0A4VR2662,Altra W Torin 4.5 Plush Coral Womens US SIze 8 AL0A4VR2662,FBALYB Amazon,-1,-1,0,0,0,0
,Altra W Torin 4.5 Plush Coral Womens US SIze 9.5 AL0A4VR2662,Altra W Torin 4.5 Plush Coral Womens US SIze 9.5 AL0A4VR2662,FBALYB Amazon,-3,-3,0,0,0,0
,Altra W Torin 4.5 Plush Coral Womens US SIze 9 AL0A4VR2662,Altra W Torin 4.5 Plush Coral Womens US SIze 9 AL0A4VR2662,FBALYB Amazon,-3,-3,0,0,0,0
,Altra W Torin 4.5 Plush Dark Gray Women's US Size 10.5 AL0A4VR2221,Altra W Torin 4.5 Plush Dark Gray Women's US Size 10.5 AL0A4VR2221,FBALYB Amazon,-5,-5,0,0,0,0
,Altra W Torin 4.5 Plush Dark Gray Women's US Size 10 AL0A4VR2221,Altra W Torin 4.5 Plush Dark Gray Women's US Size 10 AL0A4VR2221,FBALYB Amazon,-5,-5,0,0,0,0
,Altra W Torin 4.5 Plush Dark Gray Women's US Size 11 AL0A4VR2221,Altra W Torin 4.5 Plush Dark Gray Women's US Size 11 AL0A4VR2221,FBALYB Amazon,-2,-2,0,0,0,0
,Altra W Torin 4.5 Plush Dark Gray Women's US Size 6.5 AL0A4VR2221,Altra W Torin 4.5 Plush Dark Gray Women's US Size 6.5 AL0A4VR2221,FBALYB Amazon,-4,-4,0,0,0,0
,Altra W Torin 4.5 Plush Dark Gray Women's US Size 6 AL0A4VR2221,Altra W Torin 4.5 Plush Dark Gray Women's US Size 6 AL0A4VR2221,FBALYB Amazon,-3,-3,0,0,0,0
,Altra W Torin 4.5 Plush Dark Gray Women's US Size 7.5 AL0A4VR2221,Altra W Torin 4.5 Plush Dark Gray Women's US Size 7.5 AL0A4VR2221,Default,0,0,0,0,0,6
,Altra W Torin 4.5 Plush Dark Gray Women's US Size 7.5 AL0A4VR2221,Altra W Torin 4.5 Plush Dark Gray Women's US Size 7.5 AL0A4VR2221,FBALYB Amazon,-5,-5,0,0,0,0
,Altra W Torin 4.5 Plush Dark Gray Women's US Size 7 AL0A4VR2221,Altra W Torin 4.5 Plush Dark Gray Women's US Size 7 AL0A4VR2221,FBALYB Amazon,-5,-5,0,0,0,0
,Altra W Torin 4.5 Plush Dark Gray Women's US Size 8.5 AL0A4VR2221,Altra W Torin 4.5 Plush Dark Gray Women's US Size 8.5 AL0A4VR2221,FBALYB Amazon,-2,-2,0,0,0,0
,Altra W Torin 4.5 Plush Dark Gray Women's US Size 8 AL0A4VR2221,Altra W Torin 4.5 Plush Dark Gray Women's US Size 8 AL0A4VR2221,FBALYB Amazon,-10,-10,0,0,0,0
,Altra W Torin 4.5 Plush Dark Gray Women's US Size 9.5 AL0A4VR2221,Altra W Torin 4.5 Plush Dark Gray Women's US Size 9.5 AL0A4VR2221,Default,0,0,0,0,0,6
,Altra W Torin 4.5 Plush Dark Gray Women's US Size 9.5 AL0A4VR2221,Altra W Torin 4.5 Plush Dark Gray Women's US Size 9.5 AL0A4VR2221,FBALYB Amazon,-9,-9,0,0,0,0
,Altra W Torin 4.5 Plush Dark Gray Women's US Size 9 AL0A4VR2221,Altra W Torin 4.5 Plush Dark Gray Women's US Size 9 AL0A4VR2221,FBALYB Amazon,-8,-8,0,0,0,0
,Altra W Torin 4.5 Plush Mineral Blue Women's US Size 10.5 AL0A4VR2419,Altra W Torin 4.5 Plush Mineral Blue Women's US Size 10.5 AL0A4VR2419,FBALYB Amazon,-3,-3,0,0,0,0
,Altra W Torin 4.5 Plush Mineral Blue Women's US Size 10 AL0A4VR2419,Altra W Torin 4.5 Plush Mineral Blue Women's US Size 10 AL0A4VR2419,Default,0,0,0,0,0,12
,Altra W Torin 4.5 Plush Mineral Blue Women's US Size 10 AL0A4VR2419,Altra W Torin 4.5 Plush Mineral Blue Women's US Size 10 AL0A4VR2419,FBALYB Amazon,-2,-2,0,0,0,0
,Altra W Torin 4.5 Plush Mineral Blue Women's US Size 11 AL0A4VR2419,Altra W Torin 4.5 Plush Mineral Blue Women's US Size 11 AL0A4VR2419,FBALYB Amazon,-5,-5,0,0,0,0
,Altra W Torin 4.5 Plush Mineral Blue Women's US Size 6.5 AL0A4VR2419,Altra W Torin 4.5 Plush Mineral Blue Women's US Size 6.5 AL0A4VR2419,FBALYB Amazon,-6,-6,0,0,0,0
,Altra W Torin 4.5 Plush Mineral Blue Women's US Size 6 AL0A4VR2419,Altra W Torin 4.5 Plush Mineral Blue Women's US Size 6 AL0A4VR2419,FBALYB Amazon,13,13,0,0,0,0
,Altra W Torin 4.5 Plush Mineral Blue Women's US Size 7.5 AL0A4VR2419,Altra W Torin 4.5 Plush Mineral Blue Women's US Size 7.5 AL0A4VR2419,FBALYB Amazon,-10,-10,0,0,0,0
,Altra W Torin 4.5 Plush Mineral Blue Women's US Size 7 AL0A4VR2419,Altra W Torin 4.5 Plush Mineral Blue Women's US Size 7 AL0A4VR2419,FBALYB Amazon,-3,-3,0,0,0,0
,Altra W Torin 4.5 Plush Mineral Blue Women's US Size 8.5 AL0A4VR2419,Altra W Torin 4.5 Plush Mineral Blue Women's US Size 8.5 AL0A4VR2419,FBALYB Amazon,-9,-9,0,0,0,0
,Altra W Torin 4.5 Plush Mineral Blue Women's US Size 8 AL0A4VR2419,Altra W Torin 4.5 Plush Mineral Blue Women's US Size 8 AL0A4VR2419,FBALYB Amazon,-3,-3,0,0,0,0
,Altra W Torin 4.5 Plush Mineral Blue Women's US Size 9.5 AL0A4VR2419,Altra W Torin 4.5 Plush Mineral Blue Women's US Size 9.5 AL0A4VR2419,FBALYB Amazon,-12,-12,0,0,0,0
,Altra W Torin 4.5 Plush Mineral Blue Women's US Size 9 AL0A4VR2419,Altra W Torin 4.5 Plush Mineral Blue Women's US Size 9 AL0A4VR2419,Default,0,0,0,0,0,6
,Altra W Torin 4.5 Plush Mineral Blue Women's US Size 9 AL0A4VR2419,Altra W Torin 4.5 Plush Mineral Blue Women's US Size 9 AL0A4VR2419,FBALYB Amazon,-8,-8,0,0,0,0
,Altra W Torin 4.5 Plush Misty Rose Women's US Size 10.5 AL0A4VR2611,Altra W Torin 4.5 Plush Misty Rose Women's US Size 10.5 AL0A4VR2611,FBALYB Amazon,-3,-3,0,0,0,0
,Altra W Torin 4.5 Plush Misty Rose Women's US Size 10 AL0A4VR2611,Altra W Torin 4.5 Plush Misty Rose Women's US Size 10 AL0A4VR2611,FBALYB Amazon,-5,-5,0,0,0,0
,Altra W Torin 4.5 Plush Misty Rose Women's US Size 11 AL0A4VR2611,Altra W Torin 4.5 Plush Misty Rose Women's US Size 11 AL0A4VR2611,FBALYB Amazon,-3,-3,0,0,0,0
,Altra W Torin 4.5 Plush Misty Rose Women's US Size 6.5 AL0A4VR2611,Altra W Torin 4.5 Plush Misty Rose Women's US Size 6.5 AL0A4VR2611,FBALYB Amazon,-4,-4,0,0,0,0
,Altra W Torin 4.5 Plush Misty Rose Women's US Size 6 AL0A4VR2611,Altra W Torin 4.5 Plush Misty Rose Women's US Size 6 AL0A4VR2611,FBALYB Amazon,2,2,0,0,0,0
,Altra W Torin 4.5 Plush Misty Rose Women's US Size 7.5 AL0A4VR2611,Altra W Torin 4.5 Plush Misty Rose Women's US Size 7.5 AL0A4VR2611,FBALYB Amazon,-2,-2,0,0,0,0
,Altra W Torin 4.5 Plush Misty Rose Women's US Size 7 AL0A4VR2611,Altra W Torin 4.5 Plush Misty Rose Women's US Size 7 AL0A4VR2611,FBALYB Amazon,-5,-5,0,0,0,0
,Altra W Torin 4.5 Plush Misty Rose Women's US Size 8.5 AL0A4VR2611,Altra W Torin 4.5 Plush Misty Rose Women's US Size 8.5 AL0A4VR2611,FBALYB Amazon,-1,-1,0,0,0,0
,Altra W Torin 4.5 Plush Misty Rose Women's US Size 8 AL0A4VR2611,Altra W Torin 4.5 Plush Misty Rose Women's US Size 8 AL0A4VR2611,FBALYB Amazon,-2,-2,0,0,0,0
,Altra W Torin 4.5 Plush Misty Rose Women's US Size 9.5 AL0A4VR2611,Altra W Torin 4.5 Plush Misty Rose Women's US Size 9.5 AL0A4VR2611,FBALYB Amazon,-3,-3,0,0,0,0
,Altra W Torin 4.5 Plush Misty Rose Women's US Size 9 AL0A4VR2611,Altra W Torin 4.5 Plush Misty Rose Women's US Size 9 AL0A4VR2611,FBALYB Amazon,-2,-2,0,0,0,0
,Always Infinity Pads 64 ct.,Always Infinity Pads 64 ct.,Default,1,1,0,0,0,0
,Always Infinity Pads 64 ct.,Always Infinity Pads 64 ct.,FBALYB Amazon,-5,-5,0,1,0,0
,Always Infinity Pads 72 ct.,Always Infinity Pads 72 ct.,FBALYB Amazon,14,14,0,0,0,0
,"ALWAYS Xtra Protection Daily Liners Long, 200ct","ALWAYS Xtra Protection Daily Liners Long, 200ct",Default Ridgefield,862,862,0,0,0,0
,"ALWAYS Xtra Protection Daily Liners Long, 200ct","ALWAYS Xtra Protection Daily Liners Long, 200ct",FBALYB Amazon,298,271,27,7,27,0
,Amarena Frutto Opaline T001399,Amarena Frutto Opaline T001399,Avrami - Ebay,553,553,0,0,0,0
,Amarena Frutto Opaline T001399,Amarena Frutto Opaline T001399,Default Ridgefield,2020,2020,0,0,0,0
,Amarena Frutto Opaline T001399,Amarena Frutto Opaline T001399,WFS,-7,-7,0,0,0,0
,Amarena Frutto Opaline T001399 - 2pk,Amarena Frutto Opaline T001399 - 2pk,WFS,-25,-25,0,0,0,0
,Amarena Frutto T001398,Amarena Frutto T001398,Avrami - Ebay,938,938,0,0,0,0
,Amarena Frutto T001398,Amarena Frutto T001398,Default Oxford,6,6,0,0,0,0
,Amarena Frutto T001398,Amarena Frutto T001398,Default Ridgefield,3516,3516,0,0,0,0
,Amarena Frutto T001398,Amarena Frutto T001398,WFS,395,395,0,0,0,0
,Amarena Gelateria T001397,Amarena Gelateria T001397,Avrami - Ebay,27,27,0,0,0,0
,Amarena Gelateria T001397,Amarena Gelateria T001397,Default Ridgefield,204,204,0,0,0,0
,Amarena Gelateria T001397,Amarena Gelateria T001397,WFS,-18,-18,0,0,0,0
,Amazon - Echo- Heather Gray Fabric,Amazon - Echo (2nd generation) - Heather Gray Fabric,Default,0,0,0,0,0,1
,Amazon - Echo- Sandstone Fabric,Amazon - Echo (2nd generation) - Sandstone Fabric,Default,0,0,0,0,0,1
,American Beef Hide,American Beef Hide ‑ 5 lb bag,Default,0,0,0,0,0,1
,American Beef Hide,American Beef Hide ‑ 5 lb bag,FBALYB Amazon,2,2,0,0,0,0
,Amlactin 20oz 2pack,Amlactin 20oz 2pack,FBALYB Amazon,-4,-4,0,0,0,0
,Amopé Pedi Perfect Electronic Foot File,Amopé Pedi Perfect Electronic Foot File,Default Ridgefield,8,8,0,0,0,0
,Amopé Pedi Perfect Electronic Foot File,Amopé Pedi Perfect Electronic Foot File,FBALYB Amazon,155,155,0,0,0,0
,ANCHOR illy B007PDDDWC,ANCHOR illy B007PDDDWC,Default Ridgefield,1,0,1,0,0,0
,ANCHOR illy B007PDDDWC,ANCHOR illy B007PDDDWC,FBALYB Amazon,-188,-188,0,206,0,0
,Anchor Listing,Anchor Listing - Don't put on Transfer,FBALYB Amazon,48,48,0,0,0,0
,Andalou Fruit Stem Cell Revitalize Serum 2pk,Andalou Fruit Stem Cell Revitalize Serum 2pk,FBALYB Amazon,27,27,0,0,0,0
,Andalou Naturals Probiotic & C Renewal Cream 1.7oz,Andalou Naturals Probiotic & C Renewal Cream 1.7oz,FBALYB Amazon,-2,-2,0,0,0,0
,"Andis Blade Carrying Case, Holds 9 Blades (Blades not included)","Andis Blade Carrying Case, Holds 9 Blades (Blades not included)",FBALYB Amazon,1,1,0,0,0,0
,"Andis Ceramic Edge Graduation Blade, SIZE: 3-1/2, 3/8"" - 9.5mm","Andis Ceramic Edge Graduation Blade, SIZE: 3-1/2, 3/8"" - 9.5mm",FBALYB Amazon,-1,-1,0,0,0,0
,"Andis Clipper Oil, 48 - 4oz. Bottles","Andis Clipper Oil, 48 - 4oz. Bottles",Default Ridgefield,218,218,0,0,0,0
,"Andis Clipper Oil, 48 - 4oz. Bottles","Andis Clipper Oil, 48 - 4oz. Bottles",FBALYB Amazon,175,175,0,0,0,0
,"Andis Clipper Oil, 48 - 4oz. Bottles 3pk","Andis Clipper Oil, 48 - 4oz. Bottles 3pk",FBALYB Amazon,-8,-9,1,0,1,0
,Andis - Cool Care Plus 15.5oz Spray Can 2pk,Andis - Cool Care Plus 15.5oz Spray Can 2pk,FBALYB Amazon,176,148,28,11,28,0
,Andis - Cool Care Plus 15.5oz Spray Can 3pk,Andis - Cool Care Plus 15.5oz Spray Can 3pk,FBALYB Amazon,6,-4,10,4,10,0
,Andis - Cool Care Plus 15.5oz Spray Can 6pk,Andis - Cool Care Plus 15.5oz Spray Can 6pk,FBALYB Amazon,0,-4,4,0,4,0
,Andis - Cool Care Plus 15.5oz Spray Can Single,Andis - Cool Care Plus 15.5oz Spray Can Single,Default Ridgefield,57,57,0,0,0,0
,Andis - Cool Care Plus 15.5oz Spray Can Single,Andis - Cool Care Plus 15.5oz Spray Can Single,FBALYB Amazon,14,-4,18,0,18,0
,Andis Deep Tooth Blade & Bracket Replacement,Andis Deep Tooth Blade & Bracket Replacement,FBALYB Amazon,1,1,0,0,0,0
,"Andis Dual Magnet Attachment Comb Dual Pack, 2 Comb,  SIZES: 0, 1","Andis Dual Magnet Attachment Comb Dual Pack, 2 Comb,  SIZES: 0, 1",FBALYB Amazon,-18,-18,0,2,0,0
,"Andis Dual Magnet Large Combs, 4-Comb Set, SIZES: 0, 1, 2, 3","Andis Dual Magnet Large Combs, 4-Comb Set, SIZES: 0, 1, 2, 3",Default Ridgefield,10,10,0,0,0,0
,"Andis Dual Magnet Large Combs, 4-Comb Set, SIZES: 0, 1, 2, 3","Andis Dual Magnet Large Combs, 4-Comb Set, SIZES: 0, 1, 2, 3",FBALYB Amazon,240,240,0,0,0,0
,"Andis Dual Magnet Large Combs, 4-Comb Set, SIZES: 0, 1, 2, 3","Andis Dual Magnet Large Combs, 4-Comb Set, SIZES: 0, 1, 2, 3",WFS,-21,-21,0,0,0,0
,"Andis Dual Magnet Small Combs, 5-Comb Set, SIZES: 0, 1, 2, 3,  4","Andis Dual Magnet Small Combs, 5-Comb Set, SIZES: 0, 1, 2, 3,  4",FBALYB Amazon,-11,-11,0,0,0,0
,"Andis T-Blade: Snap-On Blade Attachment Combs, 4-Comb Set,  SIZES: 0, 1, 2, 3","Andis T-Blade: Snap-On Blade Attachment Combs, 4-Comb Set,  SIZES: 0, 1, 2, 3",FBALYB Amazon,-13,-13,0,0,0,0
,"Andis UltraEdge Graduation Blade, SIZE: 3-1/2, 3/8"" - 9.5mm","Andis UltraEdge Graduation Blade, SIZE: 3-1/2, 3/8"" - 9.5mm",FBALYB Amazon,-3,-3,0,0,0,0
,"Andis UltraEdge Skip Tooth Blade, SIZE: 5, 1/4"" - 6.3mm","Andis UltraEdge Skip Tooth Blade, SIZE: 5, 1/4"" - 6.3mm",Default Ridgefield,4,4,0,0,0,0
,"Andis UltraEdge Skip Tooth Blade, SIZE: 5, 1/4"" - 6.3mm","Andis UltraEdge Skip Tooth Blade, SIZE: 5, 1/4"" - 6.3mm",FBALYB Amazon,64,63,1,1,1,0
,Annies 36 Ct Purple Box,Annies 36 Ct Purple Box,FBALYB Amazon,17,17,0,22,0,0
,Annie's Fruit Snacks 42 ct.,"Annie's Organic Fruit Snacks Variety Pack, 42 ct.",FBALYB Amazon,-12,-13,1,282,1,0
,Annie’s Mac & Cheese Variety 12ct,Annie’s Mac & Cheese Variety 12ct,FBALYB Amazon,0,0,0,15,0,0
,Annie's Organic Snacks 36ct,"Annie's Organic Variety Pack, Cheddar Bunnies and Bunny Graham Crackers Snack Packs, 36 Pouches",FBALYB Amazon,23,23,0,0,0,0
,Anova Sous Vide Cooker,Anova Sous Vide Wifi Precision Cooker,FBALYB Amazon,-2,-2,0,0,0,0
,Antennas Direct 4 Outdoor,Antennas Direct ClearStream 4 Outdoor UHF HDTV Antenna,Default,0,0,0,0,0,1
,Antennas Direct 4 Outdoor,Antennas Direct ClearStream 4 Outdoor UHF HDTV Antenna,FBALYB Amazon,-17,-17,0,0,0,0
,Antennas Direct Eclipse Indoor,Antennas Direct ClearStream Eclipse Sure Grip Amplified Indoor HDTV Antenna,FBALYB Amazon,-4,-4,0,0,0,0
,Antennas Direct Indoor HDTV,Antennas Direct ClearStream Eclipse Sure Grip Indoor HDTV Antenna,FBALYB Amazon,-6,-6,0,0,0,0
,API Ammo-Chips 26oz box,API Ammo-Chips 26oz box,Default,0,0,0,0,0,1
,API Ammo-Chips 26oz box,API Ammo-Chips 26oz box,FBALYB Amazon,1,1,0,0,0,0
,API Aquarium Conditioner 64oz,API STRESS COAT Aquarium Water Conditioner 64oz,FBALYB Amazon,2,2,0,0,0,0
,API Aquarium Conditioner 64oz 2pk,API Aquarium Conditioner 64oz 2pk,FBALYB Amazon,3,3,0,0,0,0
,API Automatic Fish Feeder Weekend 4ct,API Automatic Fish Feeder Weekend 4ct,FBALYB Amazon,50,50,0,0,0,0
,API MelaFix 16oz,API MelaFix for Aquariums 16oz,FBALYB Amazon,30,30,0,0,0,0
,API Pimafix 16oz,API Pimafix 16oz,Default Ridgefield,1,1,0,0,0,0
,API Pimafix 16oz,API Pimafix 16oz,FBALYB Amazon,12,11,1,0,1,0
,API PIMAFIX Antifungal Fish Remedy 8oz,API PIMAFIX Antifungal Freshwater and Saltwater Fish Remedy 8-Ounce Bottle,FBALYB Amazon,10,10,0,0,0,0
,API PondCare Aquatic Plant Tablets 25ct,API PondCare Aquatic Plant Tablets 25ct,FBALYB Amazon,-6,-6,0,18,0,0
,API PondCare Pimafix 64oz,API PondCare Pimafix 64oz,Default,0,0,0,0,0,8
,API PondCare Pimafix 64oz,API PondCare Pimafix 64oz,FBALYB Amazon,-7,-7,0,7,0,0
,API SIZE 6 Aquarium Filtration Pouch 2pk,API SIZE 6 Aquarium Filtration Pouch 2pk,FBALYB Amazon,-3,-3,0,0,0,0
,API Stress Coat 16oz 2pk,API Stress Coat 16oz 2pk,FBALYB Amazon,1,1,0,29,0,0
,API Tap Water Conditioner 16oz 2pk,API Tap Water Conditioner 16oz 2pk,FBALYB Amazon,1,1,0,0,0,0
,API Tap Water Conditioner 4oz,API Tap Water Conditioner 4oz,FBALYB Amazon,-9,-9,0,1,0,0
,Apple iPad 32GB Silver,Apple - iPad (Latest Model) with WiFi - 32GB - Silver,Default,1,1,0,0,0,0
,Apple iPad 32GB Silver,Apple - iPad (Latest Model) with WiFi - 32GB - Silver,FBALYB Amazon,-1,-1,0,0,0,0
,Apple iPad 32GB Space Gray,Apple - iPad (Latest Model) with WiFi - 32GB - Space Gray,Default,1,1,0,0,0,0
,Apple iPad 32GB Space Gray,Apple - iPad (Latest Model) with WiFi - 32GB - Space Gray,FBALYB Amazon,-1,-1,0,0,0,0
,Apple Watch 38mm Gray/Nike Band,Apple Watch Nike+ 38mm Space Gray Aluminum Case Anthracite/Black Nike Sport Band,Default,0,0,0,0,0,3
,Apple Watch Series 2 38mm Rose Gold + Pink Sand Band,Apple Watch Series 2 38mm Rose Gold + Pink Sand Band,FBALYB Amazon,8,8,0,0,0,0
,Apple Watch Series 2 42mm White,Apple Watch Series 2 42mm Silver Aluminum Case White Sport Band,FBALYB Amazon,1,1,0,0,0,0
,Apple Watch Series 3 38mm Pink GPS+Cellular,Apple Watch Series 3 38mm Pink GPS+Cellular,FBALYB Amazon,-2,-2,0,0,0,0
,Apple Watch Series 3 38mm Space Gray GPS,Apple Watch Series 3 38mm Space Gray GPS,Default,0,0,0,0,0,8
,Apple Watch Series 3 38mm Space Gray GPS,Apple Watch Series 3 38mm Space Gray GPS,FBALYB Amazon,-10,-10,0,0,0,0
,Apple Watch Series 3 38mm Space Grey GPS+Cellular, Apple Watch Series 3 38mm Space Grey GPS+Cellular,Default,2,-1,3,0,0,0
,Apple Watch Series 3 38mm Space Grey GPS+Cellular, Apple Watch Series 3 38mm Space Grey GPS+Cellular,FBALYB Amazon,-9,-9,0,0,0,0
,Apple Watch Series 3 42mm Black,Apple Watch Series 3 (GPS) 42mm Space Gray Aluminum Case with Black Sport Band,Default,0,0,0,0,0,17
,Apple Watch Series 3 42mm Black,Apple Watch Series 3 (GPS) 42mm Space Gray Aluminum Case with Black Sport Band,FBALYB Amazon,-12,-12,0,0,0,0
,Apple Watch Series 3 42mm Space Grey GPS+Cellular,Apple Watch Series 3 42mm Space Grey GPS+Cellular,Default,0,-3,3,0,0,0
,Apple Watch Series 3 42mm Space Grey GPS+Cellular,Apple Watch Series 3 42mm Space Grey GPS+Cellular,FBALYB Amazon,9,9,0,0,0,0
,Aquafresh Extreme Clean Whitening 5.6oz 4pk,Aquafresh Extreme Clean Whitening 5.6oz 4pk,FBALYB Amazon,19,19,0,24,0,0
,Aquafresh Fresh & Minty 100ml,Aquafresh Fresh & Minty 100ml,Default,0,-6,6,0,0,0
,Aquafresh Fresh & Minty 100ml,Aquafresh Fresh & Minty 100ml,Default CT,0,-392,392,0,0,0
,Aquafresh Fresh & Minty 100ml 3PK,Aquafresh Fresh & Minty 100ml 3PK,FBALYB Amazon,15,13,2,3,2,0
,Aquafresh Pump Toothpaste - Fresh & Minty,Aquafresh Pump Toothpaste - Fresh & Minty,Default CT,2302,2302,0,0,0,0
,Aquafresh Pump Toothpaste - Fresh & Minty,Aquafresh Pump Toothpaste - Fresh & Minty,Default Ridgefield,1,-199,200,0,0,0
,Aquafresh Pump Toothpaste - Fresh & Minty,Aquafresh Pump Toothpaste - Fresh & Minty,FBALYB Amazon,-4,-7,3,4,3,0
,Aquafresh Pump Toothpaste - Fresh & Minty 2PK,Aquafresh Pump Toothpaste - Fresh & Minty 2PK,FBALYB Amazon,376,370,6,0,6,0
,Aquafresh Pump Toothpaste - Fresh & Minty 3 PK,Aquafresh Pump Toothpaste - Fresh & Minty 3 PK,FBALYB Amazon,258,258,0,0,0,0
,Aquafresh Pump Toothpaste - Fresh & Minty 6PK,Aquafresh Pump Toothpaste - Fresh & Minty 6PK,FBALYB Amazon,233,225,8,15,8,0
,Aquaglow 3565,Aquaglow 3565,FBALYB Amazon,4,4,0,0,0,0
,Aquarium PondCare AlgaeFix 64oz,Aquarium PondCare AlgaeFix 64oz,FBALYB Amazon,7,7,0,0,0,0
,Aquarium Salt 16oz,Aquarium Salt 16oz,FBALYB Amazon,22,21,1,0,1,0
,Aquarium Salt 16oz 2pk,Aquarium Salt 16oz 2pk,FBALYB Amazon,-1,-1,0,0,0,0
,Aquarium Top 16,"All Glass Aquarium AAG29016 Versa Top, 16-Inch",Default,0,0,0,0,0,7
,Aquarium Top 16,"All Glass Aquarium AAG29016 Versa Top, 16-Inch",FBALYB Amazon,-11,-11,0,0,0,0
,Aquatic Planting Media - 10lb,Aquatic Planting Media - 10lb,Default,0,0,0,0,0,2
,Aquatic Planting Media - 10lb,Aquatic Planting Media - 10lb,FBALYB Amazon,1,1,0,0,0,0
,Aquatop Carbon Cartridge,Aquatop Aquarium Carbon Cartridge for PF40-UV Hang On UV Filter,Default,0,0,0,0,0,2
,Aquatop Carbon Cartridge,Aquatop Aquarium Carbon Cartridge for PF40-UV Hang On UV Filter,FBALYB Amazon,-3,-3,0,0,0,0
,Aquatop CF-500UV Canister Filter,Aquatop CF-500UV Canister Filter,FBALYB Amazon,2,2,0,0,0,0
,Aquatop Media Reactor with Pump,Aquatop Media Reactor with Pump,FBALYB Amazon,42,41,1,0,1,0
,Aquatop MR-30 Media Reactor w/ Pump,Aquatop MR-30 Media Reactor w/ Pump,Default,0,0,0,0,0,24
,Aquatop MR-30 Media Reactor w/ Pump,Aquatop MR-30 Media Reactor w/ Pump,FBALYB Amazon,-9,-9,0,0,0,0
,Aquatop Nano Aquarium Heater 25W,Aquatop Nano Aquarium Heater 25W,FBALYB Amazon,36,36,0,0,0,0
,Aqueon Aquarium Plant Food 8oz,Aqueon Aquarium Plant Food 8oz,FBALYB Amazon,2,2,0,0,0,0
,Aqueon Aquarium Top,"Aqueon AAG29036 Aquarium Versa Top, 36 x 12",Default,0,0,0,0,0,2
,Aqueon Aquarium Top,"Aqueon AAG29036 Aquarium Versa Top, 36 x 12",FBALYB Amazon,48,48,0,0,0,0
,Aqueon Cichlid Pellets Mini 8.5oz,Aqueon Cichlid Pellets Mini 8.5oz,FBALYB Amazon,33,33,0,0,0,0
,Aqueon Deluxe LED Full Hood ‑ 21106,Aqueon Deluxe LED Full Hood ‑ 21106,Default,0,0,0,0,0,7
,Aqueon Deluxe LED Full Hood ‑ 21106,Aqueon Deluxe LED Full Hood ‑ 21106,FBALYB Amazon,-4,-5,1,0,1,0
,Aqueon Filter Cartridge 100106084 2pk,Aqueon Filter Cartridge 100106084 2pk,FBALYB Amazon,-3,-3,0,40,0,0
,Aqueon Filter Cartridge Medium/24 Pack,Aqueon Filter Cartridge Medium/24 Pack,FBALYB Amazon,1,1,0,0,0,0
,Aqueon Hood LED Black 20in,Aqueon Hood LED Black 20in,FBALYB Amazon,-1,-1,0,0,0,0
,"Aqueon LED Hood, 30","Aqueon LED Background Hood, 30""",FBALYB Amazon,-3,-3,0,1,0,0
,Aqueon QuietFlow 2 Cartridges Large,"Aqueon QuietFlow Internal Replacement Filter Cartridges, Large, Pack of 2",Default,1,1,0,0,0,0
,Aqueon QuietFlow 2 Cartridges Large,"Aqueon QuietFlow Internal Replacement Filter Cartridges, Large, Pack of 2",FBALYB Amazon,-1,-1,0,0,0,0
,Aqueon QuietFlow 2 Cartridges Large 2pk,Aqueon QuietFlow 2 Cartridges Large 2pk,FBALYB Amazon,-6,-6,0,0,0,0
,Aqueon siphon vacuum with bulb ‑ 10 inch,Aqueon siphon vacuum with bulb ‑ 10 inch,Default Ridgefield,106,105,1,0,0,0
,Aqueon siphon vacuum with bulb ‑ 10 inch,Aqueon siphon vacuum with bulb ‑ 10 inch,FBALYB Amazon,244,237,7,0,7,0
,Aqueon siphon vacuum with bulb ‑ 10 inch,Aqueon siphon vacuum with bulb ‑ 10 inch,FBALYB Canada,18,18,0,0,0,0
,Aqueon Tap Water Conditioner 16oz 3pk,Aqueon Tap Water Conditioner 16oz 3pk,FBALYB Amazon,6,6,0,0,0,0
,Aqueon Tap Water Conditioner 4oz,Aqueon Tap Water Conditioner 4oz,Default,0,0,0,0,0,1
,Aqueon Tap Water Conditioner 4oz,Aqueon Tap Water Conditioner 4oz,FBALYB Amazon,7,7,0,0,0,0
,Aqueon Tropical Granules 6.5oz,Aqueon Tropical Granules 6.5oz,FBALYB Amazon,16,16,0,0,0,0
,Aqueon Water Clarifier 16oz,Aqueon Water Clarifier 16oz,Default,0,0,0,0,0,259
,Aqueon Water Clarifier 16oz 3pk,Aqueon Water Clarifier 16oz 3pk,FBALYB Amazon,2,2,0,0,0,0
,Aqueon Water Clarifier 8oz,Aqueon Water Clarifier 8oz,Default,0,0,0,0,0,13
,Aqueon Water Clarifier 8oz,Aqueon Water Clarifier 8oz,Default Ridgefield,17,17,0,0,0,0
,Aqueon Water Clarifier 8oz,Aqueon Water Clarifier 8oz,FBALYB Amazon,1,1,0,0,0,0
,AQ-XUSE-W1RJ,Fisher-Price Thomas & Friends Steam 'n Speed R/C Thomas,FBALYB Amazon,83,83,0,0,0,0
,Argan Oil Heat Defence Leave In,Argan Oil Heat Defence Leave In 150ml,Default Ridgefield,3312,3312,0,0,0,0
,Argo 35oz Corn Starch,Argo 35oz Corn Starch,FBALYB Amazon,7,7,0,0,0,0
,Argo 35oz Corn Starch 4pk,Argo 35oz Corn Starch 4pk,FBALYB Amazon,2,2,0,0,0,0
,Ariat Ariat Men's Cruiser Slip-on Shoe / Brown ARI-10023210-10 Size 10,Ariat Ariat Men's Cruiser Slip-on Shoe / Brown ARI-10023210-10 Size 10,FBALYB Amazon,9,8,1,0,1,0
,Ariat Ariat Men's Cruiser Slip-on Shoe / Brown ARI-10023210-11 Size 11,Ariat Ariat Men's Cruiser Slip-on Shoe / Brown ARI-10023210-11 Size 11,FBALYB Amazon,10,10,0,0,0,0
,Ariat Ariat Men's Cruiser Slip-on Shoe / Brown ARI-10023210-12 W Size 12 W,Ariat Ariat Men's Cruiser Slip-on Shoe / Brown ARI-10023210-12 W Size 12 W,FBALYB Amazon,8,8,0,0,0,0
,Ariat Ariat Men's Cruiser Slip-on Shoe / Brown ARI-10023210-9 Size 9,Ariat Ariat Men's Cruiser Slip-on Shoe / Brown ARI-10023210-9 Size 9,Default Ridgefield,12,12,0,0,0,0
,Ariat Ariat Men's Cruiser Slip-on Shoe / Rough Oak 10019871 Size 10,Ariat Ariat Men's Cruiser Slip-on Shoe / Rough Oak 10019871 Size 10,Default Ridgefield,39,39,0,0,0,0
,Ariat Ariat Men's Cruiser Slip-on Shoe / Rough Oak 10019871 Size 10.5,Ariat Ariat Men's Cruiser Slip-on Shoe / Rough Oak 10019871 Size 10.5,Default Ridgefield,1,1,0,0,0,0
,Ariat Ariat Men's Cruiser Slip-on Shoe / Rough Oak 10019871 Size 10.5,Ariat Ariat Men's Cruiser Slip-on Shoe / Rough Oak 10019871 Size 10.5,FBALYB Amazon,23,20,3,0,3,0
,Ariat Ariat Men's Cruiser Slip-on Shoe / Rough Oak 10019871 Size 10.5 W,Ariat Ariat Men's Cruiser Slip-on Shoe / Rough Oak 10019871 Size 10.5 W,Default Ridgefield,34,34,0,0,0,0
,Ariat Ariat Men's Cruiser Slip-on Shoe / Rough Oak 10019871 Size 11,Ariat Ariat Men's Cruiser Slip-on Shoe / Rough Oak 10019871 Size 11,FBALYB Amazon,40,40,0,0,0,0
,Ariat Ariat Men's Cruiser Slip-on Shoe / Rough Oak 10019871 Size 12,Ariat Ariat Men's Cruiser Slip-on Shoe / Rough Oak 10019871 Size 12,Default Ridgefield,38,38,0,0,0,0
,Ariat Ariat Men's Cruiser Slip-on Shoe / Rough Oak 10019871 Size 12 W,Ariat Ariat Men's Cruiser Slip-on Shoe / Rough Oak 10019871 Size 12 W,FBALYB Amazon,33,32,1,0,1,0
,Ariat Ariat Men's Cruiser Slip-on Shoe / Rough Oak 10019871 Size 13,Ariat Ariat Men's Cruiser Slip-on Shoe / Rough Oak 10019871 Size 13,FBALYB Amazon,18,15,3,0,3,0
,Ariat Ariat Men's Cruiser Slip-on Shoe / Rough Oak 10019871 Size 9,Ariat Ariat Men's Cruiser Slip-on Shoe / Rough Oak 10019871 Size 9,FBALYB Amazon,26,26,0,0,0,0
,Ariat Ariat Men's Cruiser Slip-on Shoe / Rough Oak 10019871 Size 9.5 W,Ariat Ariat Men's Cruiser Slip-on Shoe / Rough Oak 10019871 Size 9.5 W,FBALYB Amazon,30,30,0,0,0,0
,Ariat Ariat Men's Cruiser Slip-on Shoe / Vintage Bomber ARI-10023208-10 Size 10,Ariat Ariat Men's Cruiser Slip-on Shoe / Vintage Bomber ARI-10023208-10 Size 10,FBALYB Amazon,9,9,0,0,0,0
,Ariat Ariat Men's Cruiser Slip-on Shoe / Vintage Bomber ARI-10023208-11 Size 11,Ariat Ariat Men's Cruiser Slip-on Shoe / Vintage Bomber ARI-10023208-11 Size 11,Default Ridgefield,16,16,0,0,0,0
,Ariat ARIAT Men's M4 Low Rise Stretch Adkins Boot Cut ARI-10021767-29x32 Size 29x32,Ariat ARIAT Men's M4 Low Rise Stretch Adkins Boot Cut ARI-10021767-29x32 Size 29x32,FBALYB Amazon,7,7,0,0,0,0
,Ariat ARIAT Men's M4 Low Rise Stretch Adkins Boot Cut ARI-10021767-30x30 Size 30x30,Ariat ARIAT Men's M4 Low Rise Stretch Adkins Boot Cut ARI-10021767-30x30 Size 30x30,FBALYB Amazon,-1,-1,0,0,0,0
,Ariat ARIAT Men's M4 Low Rise Stretch Adkins Boot Cut ARI-10021767-32x36 Size 32x36,Ariat ARIAT Men's M4 Low Rise Stretch Adkins Boot Cut ARI-10021767-32x36 Size 32x36,FBALYB Amazon,-1,-1,0,0,0,0
,Ariat ARIAT Men's M4 Low Rise Stretch Adkins Boot Cut ARI-10021767-33x32 Size 33x32,Ariat ARIAT Men's M4 Low Rise Stretch Adkins Boot Cut ARI-10021767-33x32 Size 33x32,FBALYB Amazon,10,10,0,0,0,0
,Ariat ARIAT Men's M4 Low Rise Stretch Adkins Boot Cut ARI-10021767-34x32 Size 34x32,Ariat ARIAT Men's M4 Low Rise Stretch Adkins Boot Cut ARI-10021767-34x32 Size 34x32,FBALYB Amazon,4,4,0,0,0,0
,Ariat ARIAT Men's M4 Low Rise Stretch Adkins Boot Cut ARI-10021767-34x36 Size 34x36,Ariat ARIAT Men's M4 Low Rise Stretch Adkins Boot Cut ARI-10021767-34x36 Size 34x36,FBALYB Amazon,13,13,0,0,0,0
,Ariat ARIAT Men's M4 Low Rise Stretch Adkins Boot Cut ARI-10021767-35x32 Size 35x32,Ariat ARIAT Men's M4 Low Rise Stretch Adkins Boot Cut ARI-10021767-35x32 Size 35x32,FBALYB Amazon,6,6,0,0,0,0
,Ariat ARIAT Men's M4 Low Rise Stretch Adkins Boot Cut ARI-10021767-36x32 Size 36x32,Ariat ARIAT Men's M4 Low Rise Stretch Adkins Boot Cut ARI-10021767-36x32 Size 36x32,FBALYB Amazon,-2,-2,0,0,0,0
,Ariat ARIAT Men's M4 Low Rise Stretch Adkins Boot Cut ARI-10021767-36x36 Size 36x36,Ariat ARIAT Men's M4 Low Rise Stretch Adkins Boot Cut ARI-10021767-36x36 Size 36x36,Default Ridgefield,13,13,0,0,0,0
,Ariat Ariat Men's M5 Slim Fitted Straight Leg Jean / Deadrun ARI-10010842-29x32 Size 29x32,Ariat Ariat Men's M5 Slim Fitted Straight Leg Jean / Deadrun ARI-10010842-29x32 Size 29x32,FBALYB Amazon,10,10,0,0,0,0
,Ariat Ariat Men's M5 Slim Fitted Straight Leg Jean / Deadrun ARI-10010842-29x36 Size 29x36,Ariat Ariat Men's M5 Slim Fitted Straight Leg Jean / Deadrun ARI-10010842-29x36 Size 29x36,FBALYB Amazon,5,5,0,0,0,0
,Ariat Ariat Men's M5 Slim Fitted Straight Leg Jean / Deadrun ARI-10010842-30x30 Size 30x30,Ariat Ariat Men's M5 Slim Fitted Straight Leg Jean / Deadrun ARI-10010842-30x30 Size 30x30,FBALYB Amazon,2,2,0,0,0,0
,Ariat Ariat Men's M5 Slim Fitted Straight Leg Jean / Deadrun ARI-10010842-32x34 Size 32x34,Ariat Ariat Men's M5 Slim Fitted Straight Leg Jean / Deadrun ARI-10010842-32x34 Size 32x34,FBALYB Amazon,2,2,0,0,0,0
,Ariat Ariat Men's M5 Slim Fitted Straight Leg Jean / Deadrun ARI-10010842-32x36 Size 32x36,Ariat Ariat Men's M5 Slim Fitted Straight Leg Jean / Deadrun ARI-10010842-32x36 Size 32x36,FBALYB Amazon,7,7,0,0,0,0
,Ariat Ariat Men's M5 Slim Fitted Straight Leg Jean / Deadrun ARI-10010842-33x32 Size 33x32,Ariat Ariat Men's M5 Slim Fitted Straight Leg Jean / Deadrun ARI-10010842-33x32 Size 33x32,FBALYB Amazon,4,4,0,0,0,0
,Ariat Ariat Men's M5 Slim Fitted Straight Leg Jean / Deadrun ARI-10010842-34x32 Size 34x32,Ariat Ariat Men's M5 Slim Fitted Straight Leg Jean / Deadrun ARI-10010842-34x32 Size 34x32,FBALYB Amazon,6,6,0,0,0,0
,Ariat Ariat Men's M5 Slim Fitted Straight Leg Jean / Deadrun ARI-10010842-34x36 Size 34x36,Ariat Ariat Men's M5 Slim Fitted Straight Leg Jean / Deadrun ARI-10010842-34x36 Size 34x36,FBALYB Amazon,5,4,1,0,1,0
,Ariat Ariat Men's M5 Slim Fitted Straight Leg Jean / Deadrun ARI-10010842-35x32 Size 35x32,Ariat Ariat Men's M5 Slim Fitted Straight Leg Jean / Deadrun ARI-10010842-35x32 Size 35x32,FBALYB Amazon,4,4,0,0,0,0
,Ariat Ariat Men's M5 Slim Fitted Straight Leg Jean / Deadrun ARI-10010842-36x32 Size 36x32,Ariat Ariat Men's M5 Slim Fitted Straight Leg Jean / Deadrun ARI-10010842-36x32 Size 36x32,Default Ridgefield,11,11,0,0,0,0
,Ariat Ariat Men's M5 Slim Fitted Straight Leg Jean / Deadrun ARI-10010842-36x36 Size 36x36,Ariat Ariat Men's M5 Slim Fitted Straight Leg Jean / Deadrun ARI-10010842-36x36 Size 36x36,FBALYB Amazon,8,8,0,0,0,0
,Ariat Ariat Men's M5 Slim Fitted Straight Leg Jean / Deadrun ARI-10010842-38x32 Size 38x32,Ariat Ariat Men's M5 Slim Fitted Straight Leg Jean / Deadrun ARI-10010842-38x32 Size 38x32,FBALYB Amazon,7,7,0,0,0,0
,Ariat Ariat Men's M5 Slim Fitted Straight Leg Jean / Gambler ARI-10012703-29x36 SIze 29x36,Ariat Ariat Men's M5 Slim Fitted Straight Leg Jean / Gambler ARI-10012703-29x36 SIze 29x36,FBALYB Amazon,1,1,0,0,0,0
,Ariat Ariat Men's M5 Slim Fitted Straight Leg Jean / Gambler ARI-10012703-32x34 Size 32x34,Ariat Ariat Men's M5 Slim Fitted Straight Leg Jean / Gambler ARI-10012703-32x34 Size 32x34,FBALYB Amazon,-1,-1,0,0,0,0
,Ariat Ariat Men's M5 Slim Fitted Straight Leg Jean / Gambler ARI-10012703-32x36 Size 32x36,Ariat Ariat Men's M5 Slim Fitted Straight Leg Jean / Gambler ARI-10012703-32x36 Size 32x36,FBALYB Amazon,3,3,0,0,0,0
,Ariat Ariat Men's M5 Slim Fitted Straight Leg Jean / Gambler ARI-10012703-34x36 Size 34x36,Ariat Ariat Men's M5 Slim Fitted Straight Leg Jean / Gambler ARI-10012703-34x36 Size 34x36,FBALYB Amazon,3,2,1,0,1,0
,Ariat Ariat Men's M5 Slim Fitted Straight Leg Jean / Gambler ARI-10012703-36x32 Size 36x32,Ariat Ariat Men's M5 Slim Fitted Straight Leg Jean / Gambler ARI-10012703-36x32 Size 36x32,FBALYB Amazon,-1,-1,0,0,0,0
,Ariat Ariat Men's M5 Slim Fitted Straight Leg Jean / Gulch ARI-10014010-29x36 Size 29x36,Ariat Ariat Men's M5 Slim Fitted Straight Leg Jean / Gulch ARI-10014010-29x36 Size 29x36,FBALYB Amazon,2,-1,3,0,3,0
,Ariat Ariat Men's M5 Slim Fitted Straight Leg Jean / Gulch ARI-10014010-30x30 Size 30x30,Ariat Ariat Men's M5 Slim Fitted Straight Leg Jean / Gulch ARI-10014010-30x30 Size 30x30,FBALYB Amazon,4,4,0,0,0,0
,Ariat Ariat Men's M5 Slim Fitted Straight Leg Jean / Gulch ARI-10014010-32x34 Size 32x34,Ariat Ariat Men's M5 Slim Fitted Straight Leg Jean / Gulch ARI-10014010-32x34 Size 32x34,FBALYB Amazon,11,11,0,0,0,0
,Ariat Ariat Men's M5 Slim Fitted Straight Leg Jean / Gulch ARI-10014010-33x32 Size 33x32,Ariat Ariat Men's M5 Slim Fitted Straight Leg Jean / Gulch ARI-10014010-33x32 Size 33x32,FBALYB Amazon,1,0,1,0,1,0
,Ariat Ariat Men's M5 Slim Fitted Straight Leg Jean / Gulch ARI-10014010-34x32 Size 34x32,Ariat Ariat Men's M5 Slim Fitted Straight Leg Jean / Gulch ARI-10014010-34x32 Size 34x32,FBALYB Amazon,3,2,1,0,1,0
,Ariat Ariat Men's M5 Slim Fitted Straight Leg Jean / Gulch ARI-10014010-34x36 Size 34x36,Ariat Ariat Men's M5 Slim Fitted Straight Leg Jean / Gulch ARI-10014010-34x36 Size 34x36,FBALYB Amazon,6,6,0,0,0,0
,Ariat Ariat Men's M5 Slim Fitted Straight Leg Jean / Gulch ARI-10014010-35x32 Size 35x32,Ariat Ariat Men's M5 Slim Fitted Straight Leg Jean / Gulch ARI-10014010-35x32 Size 35x32,FBALYB Amazon,4,4,0,0,0,0
,Ariat Ariat Men's M5 Slim Fitted Straight Leg Jean / Gulch ARI-10014010-36x32 Size 36x32,Ariat Ariat Men's M5 Slim Fitted Straight Leg Jean / Gulch ARI-10014010-36x32 Size 36x32,FBALYB Amazon,-1,-1,0,0,0,0
,Ariat Ariat Men's M5 Slim Fitted Straight Leg Jean / Gulch ARI-10014010-36x36 Size 36x36,Ariat Ariat Men's M5 Slim Fitted Straight Leg Jean / Gulch ARI-10014010-36x36 Size 36x36,FBALYB Amazon,5,5,0,0,0,0
,Ariat Ariat Men's M5 Slim Fitted Straight Leg Jean / Gulch ARI-10014010-38x32 Size 38x32,Ariat Ariat Men's M5 Slim Fitted Straight Leg Jean / Gulch ARI-10014010-38x32 Size 38x32,FBALYB Amazon,4,4,0,0,0,0
,Ariat Ariat Men's M5 Slim Fitted Straight Leg Jean / Stretch ARI-10022784-29x32 Size 29x32,Ariat Ariat Men's M5 Slim Fitted Straight Leg Jean / Stretch ARI-10022784-29x32 Size 29x32,FBALYB Amazon,6,6,0,0,0,0
,Ariat Ariat Men's M5 Slim Fitted Straight Leg Jean / Stretch ARI-10022784-29x36 Size 29x36,Ariat Ariat Men's M5 Slim Fitted Straight Leg Jean / Stretch ARI-10022784-29x36 Size 29x36,FBALYB Amazon,4,4,0,0,0,0
,Ariat Ariat Men's M5 Slim Fitted Straight Leg Jean / Stretch ARI-10022784-32x34 Size 32x34,Ariat Ariat Men's M5 Slim Fitted Straight Leg Jean / Stretch ARI-10022784-32x34 Size 32x34,FBALYB Amazon,-1,-2,1,0,1,0
,Ariat Ariat Men's M5 Slim Fitted Straight Leg Jean / Stretch ARI-10022784-32x36 Size 32x36,Ariat Ariat Men's M5 Slim Fitted Straight Leg Jean / Stretch ARI-10022784-32x36 Size 32x36,FBALYB Amazon,3,3,0,0,0,0
,Ariat Ariat Men's M5 Slim Fitted Straight Leg Jean / Stretch ARI-10022784-34x36 Size 34x36,Ariat Ariat Men's M5 Slim Fitted Straight Leg Jean / Stretch ARI-10022784-34x36 Size 34x36,Default Ridgefield,4,4,0,0,0,0
,Ariat Ariat Men's M5 Slim Fitted Straight Leg Jean / Stretch ARI-10022784-35x32 Size 35x32,Ariat Ariat Men's M5 Slim Fitted Straight Leg Jean / Stretch ARI-10022784-35x32 Size 35x32,FBALYB Amazon,-1,-1,0,0,0,0
,Ariat Ariat Men's M5 Slim Fitted Straight Leg Jean / Stretch ARI-10022784-36x36 Size 36x36,Ariat Ariat Men's M5 Slim Fitted Straight Leg Jean / Stretch ARI-10022784-36x36 Size 36x36,FBALYB Amazon,1,1,0,0,0,0
,Ariat Ariat Men's M5 Slim Fitted Straight Leg Jean / Swagger ARI-10017249-29x36 Size 29x36,Ariat Ariat Men's M5 Slim Fitted Straight Leg Jean / Swagger ARI-10017249-29x36 Size 29x36,FBALYB Amazon,-1,-1,0,0,0,0
,Ariat Ariat Men's M5 Slim Fitted Straight Leg Jean / Swagger ARI-10017249-30x30 Size 30x30,Ariat Ariat Men's M5 Slim Fitted Straight Leg Jean / Swagger ARI-10017249-30x30 Size 30x30,FBALYB Amazon,-1,-1,0,0,0,0
,Ariat Ariat Men's M5 Slim Fitted Straight Leg Jean / Swagger ARI-10017249-34x32 Size 34x32,Ariat Ariat Men's M5 Slim Fitted Straight Leg Jean / Swagger ARI-10017249-34x32 Size 34x32,FBALYB Amazon,-1,-1,0,0,0,0
,Ariat Ariat Men's M5 Slim Fitted Straight Leg Jean / Swagger ARI-10017249-34x36 Size 34x36,Ariat Ariat Men's M5 Slim Fitted Straight Leg Jean / Swagger ARI-10017249-34x36 Size 34x36,FBALYB Amazon,1,1,0,0,0,0
,Ariat Ariat Men's M5 Slim Fitted Straight Leg Jean / Swagger ARI-10017249-38x32 Size 38x32,Ariat Ariat Men's M5 Slim Fitted Straight Leg Jean / Swagger ARI-10017249-38x32 Size 38x32,FBALYB Amazon,-1,-1,0,0,0,0
,Ariat Ariat Men's Midtown Rambler Casual Boot / Barn Brown 10019868 Size 10,Ariat Ariat Men's Midtown Rambler Casual Boot / Barn Brown 10019868 Size 10,FBALYB Amazon,-3,-4,1,0,1,0
,Ariat Ariat Men's Midtown Rambler Casual Boot / Barn Brown 10019868 Size 10.5,Ariat Ariat Men's Midtown Rambler Casual Boot / Barn Brown 10019868 Size 10.5,FBALYB Amazon,-2,-2,0,0,0,0
,Ariat Ariat Men's Midtown Rambler Casual Boot / Barn Brown 10019868 Size 10.5 W,Ariat Ariat Men's Midtown Rambler Casual Boot / Barn Brown 10019868 Size 10.5 W,FBALYB Amazon,-2,-2,0,0,0,0
,Ariat Ariat Men's Midtown Rambler Casual Boot / Barn Brown 10019868 Size 11,Ariat Ariat Men's Midtown Rambler Casual Boot / Barn Brown 10019868 Size 11,FBALYB Amazon,-1,-2,1,0,1,0
,Ariat Ariat Men's Midtown Rambler Casual Boot / Barn Brown 10019868 Size 12,Ariat Ariat Men's Midtown Rambler Casual Boot / Barn Brown 10019868 Size 12,FBALYB Amazon,-1,-3,2,0,2,0
,Ariat Ariat Men's Midtown Rambler Casual Boot / Barn Brown 10019868 Size 12 W,Ariat Ariat Men's Midtown Rambler Casual Boot / Barn Brown 10019868 Size 12 W,FBALYB Amazon,23,22,1,0,1,0
,Ariat Ariat Men's Midtown Rambler Casual Boot / Barn Brown 10019868 Size 13,Ariat Ariat Men's Midtown Rambler Casual Boot / Barn Brown 10019868 Size 13,FBALYB Amazon,0,-1,1,0,1,0
,Ariat Ariat Men's Midtown Rambler Casual Boot / Barn Brown 10019868 Size 9,Ariat Ariat Men's Midtown Rambler Casual Boot / Barn Brown 10019868 Size 9,FBALYB Amazon,-2,-2,0,0,0,0
,Ariat Ariat Men's Midtown Rambler Casual Boot / Barn Brown 10019868 Size 9.5 W,Ariat Ariat Men's Midtown Rambler Casual Boot / Barn Brown 10019868 Size 9.5 W,FBALYB Amazon,2,2,0,0,0,0
,Ariat Ariat Men's Rambler Recon Square Toe Work Boot / Foothill Brown 10025111 Size 10.5,Ariat Ariat Men's Rambler Recon Square Toe Work Boot / Foothill Brown 10025111 Size 10.5,FBALYB Amazon,13,13,0,0,0,0
,Ariat Ariat Men's Rambler Recon Square Toe Work Boot / Foothill Brown 10025111 Size 10.5 W,Ariat Ariat Men's Rambler Recon Square Toe Work Boot / Foothill Brown 10025111 Size 10.5 W,FBALYB Amazon,11,11,0,0,0,0
,Ariat Ariat Men's Rambler Recon Square Toe Work Boot / Foothill Brown 10025111 Size 11,Ariat Ariat Men's Rambler Recon Square Toe Work Boot / Foothill Brown 10025111 Size 11,FBALYB Amazon,11,11,0,0,0,0
,Ariat Ariat Men's Rambler Recon Square Toe Work Boot / Foothill Brown 10025111 Size 12,Ariat Ariat Men's Rambler Recon Square Toe Work Boot / Foothill Brown 10025111 Size 12,FBALYB Amazon,8,8,0,0,0,0
,Ariat Ariat Men's Rambler Recon Square Toe Work Boot / Foothill Brown 10025111 Size 13,Ariat Ariat Men's Rambler Recon Square Toe Work Boot / Foothill Brown 10025111 Size 13,FBALYB Amazon,6,6,0,0,0,0
,Ariat Ariat Men's Rambler Recon Square Toe Work Boot / Foothill Brown 10025111 Size 9,Ariat Ariat Men's Rambler Recon Square Toe Work Boot / Foothill Brown 10025111 Size 9,FBALYB Amazon,6,5,1,0,1,0
,Ariat Ariat Men's Rambler Recon Square Toe Work Boot / Foothill Brown 10025111 Size 9.5 W,Ariat Ariat Men's Rambler Recon Square Toe Work Boot / Foothill Brown 10025111 Size 9.5 W,FBALYB Amazon,12,12,0,0,0,0
,Ariat Ariat Womens Cruiser Castaway Slip On Shoe / Brown ARI-10023017-11 Size 11,Ariat Ariat Womens Cruiser Castaway Slip On Shoe / Brown ARI-10023017-11 Size 11,FBALYB Amazon,7,7,0,0,0,0
,Ariat Ariat Womens Cruiser Castaway Slip On Shoe / Brown ARI-10023017-6.5 Size 6.5,Ariat Ariat Womens Cruiser Castaway Slip On Shoe / Brown ARI-10023017-6.5 Size 6.5,FBALYB Amazon,7,7,0,0,0,0
,Ariat Ariat Womens Cruiser Castaway Slip On Shoe / Brown ARI-10023017-7 Size 7,Ariat Ariat Womens Cruiser Castaway Slip On Shoe / Brown ARI-10023017-7 Size 7,FBALYB Amazon,9,9,0,0,0,0
,Ariat Ariat Womens Cruiser Castaway Slip On Shoe / Brown ARI-10023017-8.5 Size 8.5,Ariat Ariat Womens Cruiser Castaway Slip On Shoe / Brown ARI-10023017-8.5 Size 8.5,FBALYB Amazon,13,12,1,0,1,0
,Ariat Ariat Womens Cruiser Castaway Slip On Shoe / Brown ARI-10023017-8 Size 8,Ariat Ariat Womens Cruiser Castaway Slip On Shoe / Brown ARI-10023017-8 Size 8,FBALYB Amazon,14,14,0,0,0,0
,Ariat Ariat Womens Cruiser Castaway Slip On Shoe / Brown ARI-10023017-9 Size 9,Ariat Ariat Womens Cruiser Castaway Slip On Shoe / Brown ARI-10023017-9 Size 9,FBALYB Amazon,15,15,0,0,0,0
,Ariat Ariat Women's Cruiser Slip-on Shoe Casual ARI-10024767-7.5 Size 7.5,Ariat Ariat Women's Cruiser Slip-on Shoe Casual ARI-10024767-7.5 Size 7.5,Default Ridgefield,7,7,0,0,0,0
,Ariat Ariat Women's Cruiser Slip-on Shoe Casual ARI-10024767-7 Size 7,Ariat Ariat Women's Cruiser Slip-on Shoe Casual ARI-10024767-7 Size 7,Default Ridgefield,9,9,0,0,0,0
,Ariat Ariat Women's Cruiser Slip-on Shoe Casual ARI-10024767-8.5 Size 8.5,Ariat Ariat Women's Cruiser Slip-on Shoe Casual ARI-10024767-8.5 Size 8.5,Default Ridgefield,13,13,0,0,0,0
,Ariat Ariat Women's Cruiser Slip-on Shoe Casual ARI-10024767-8 Size 8,Ariat Ariat Women's Cruiser Slip-on Shoe Casual ARI-10024767-8 Size 8,Default Ridgefield,13,13,0,0,0,0
,Ariat Ariat Women's Cruiser Slip-on Shoe Casual ARI-10024767-9.5 Size 9.5,Ariat Ariat Women's Cruiser Slip-on Shoe Casual ARI-10024767-9.5 Size 9.5,Default Ridgefield,11,11,0,0,0,0
,Ariat Ariat Women's Cruiser Slip-on Shoe Casual ARI-10024767-9 Size 9,Ariat Ariat Women's Cruiser Slip-on Shoe Casual ARI-10024767-9 Size 9,Default Ridgefield,12,12,0,0,0,0
,Ariat Ariat Women's Cruiser Slip-on Shoe Casual / Black 10027355 Size 10,Ariat Ariat Women's Cruiser Slip-on Shoe Casual / Black 10027355 Size 10,FBALYB Amazon,1,0,1,0,1,0
,Ariat Ariat Women's Cruiser Slip-on Shoe Casual / Black 10027355 Size 7,Ariat Ariat Women's Cruiser Slip-on Shoe Casual / Black 10027355 Size 7,FBALYB Amazon,1,0,1,0,1,0
,Ariat Ariat Women's Cruiser Slip-on Shoe Casual / Black 10027355 Size 7.5,Ariat Ariat Women's Cruiser Slip-on Shoe Casual / Black 10027355 Size 7.5,FBALYB Amazon,0,-1,1,0,1,0
,Ariat Ariat Women's Cruiser Slip-on Shoe Casual / Black 10027355 Size 8,Ariat Ariat Women's Cruiser Slip-on Shoe Casual / Black 10027355 Size 8,FBALYB Amazon,3,3,0,0,0,0
,Ariat Ariat Women's Cruiser Slip-on Shoe Casual / Black 10027355 Size 8.5,Ariat Ariat Women's Cruiser Slip-on Shoe Casual / Black 10027355 Size 8.5,FBALYB Amazon,0,-1,1,0,1,0
,Ariat Ariat Women's Cruiser Slip-on Shoe Casual / Black 10027355 Size 9,Ariat Ariat Women's Cruiser Slip-on Shoe Casual / Black 10027355 Size 9,FBALYB Amazon,3,2,1,0,1,0
,Ariat Ariat Women's Cruiser Slip-on Shoe Casual / Black 10027355 Size 9.5,Ariat Ariat Women's Cruiser Slip-on Shoe Casual / Black 10027355 Size 9.5,FBALYB Amazon,3,3,0,0,0,0
,Ariat Ariat Women's Cruiser Slip-on Shoe Casual / Black ARI-10027355-11 Size 11,Ariat Ariat Women's Cruiser Slip-on Shoe Casual / Black ARI-10027355-11 Size 11,FBALYB Amazon,5,5,0,0,0,0
,Ariat Ariat Women's Cruiser Slip-on Shoe Casual / Brown 10023008 Size 6.5,Ariat Ariat Women's Cruiser Slip-on Shoe Casual / Brown 10023008 Size 6.5,Default Ridgefield,2,2,0,0,0,0
,Ariat Ariat Women's Cruiser Slip-on Shoe Casual / Brown 10023008 Size 6.5,Ariat Ariat Women's Cruiser Slip-on Shoe Casual / Brown 10023008 Size 6.5,FBALYB Amazon,-1,-2,1,0,1,0
,Ariat Ariat Women's Cruiser Slip-on Shoe Casual / Brown 10023008 Size 7.5,Ariat Ariat Women's Cruiser Slip-on Shoe Casual / Brown 10023008 Size 7.5,Default Ridgefield,1,1,0,0,0,0
,Ariat Ariat Women's Cruiser Slip-on Shoe Casual / Brown 10023008 Size 7.5,Ariat Ariat Women's Cruiser Slip-on Shoe Casual / Brown 10023008 Size 7.5,FBALYB Amazon,-2,-3,1,0,1,0
,Ariat Ariat Women's Cruiser Slip-on Shoe Casual / Brown 10023008 Size 8,Ariat Ariat Women's Cruiser Slip-on Shoe Casual / Brown 10023008 Size 8,Default Ridgefield,10,10,0,0,0,0
,Ariat Ariat Women's Cruiser Slip-on Shoe Casual / Brown 10023008 Size 8,Ariat Ariat Women's Cruiser Slip-on Shoe Casual / Brown 10023008 Size 8,FBALYB Amazon,11,10,1,0,1,0
,Ariat Ariat Women's Cruiser Slip-on Shoe Casual / Brown 10023008 Size 9.5,Ariat Ariat Women's Cruiser Slip-on Shoe Casual / Brown 10023008 Size 9.5,FBALYB Amazon,5,3,2,0,2,0
,Ariat Ariat Women's Cruiser Slip-on Shoe Casual / Brown ARI-10023008-10 Size 10,Ariat Ariat Women's Cruiser Slip-on Shoe Casual / Brown ARI-10023008-10 Size 10,FBALYB Amazon,22,18,4,0,4,0
,Ariat Ariat Women's Cruiser Slip-on Shoe Casual / Brown ARI-10023008-11 Size 11,Ariat Ariat Women's Cruiser Slip-on Shoe Casual / Brown ARI-10023008-11 Size 11,Default Ridgefield,2,2,0,0,0,0
,Ariat Ariat Women's Cruiser Slip-on Shoe Casual / Brown ARI-10023008-7 Size 7,Ariat Ariat Women's Cruiser Slip-on Shoe Casual / Brown ARI-10023008-7 Size 7,FBALYB Amazon,9,7,2,0,2,0
,Ariat Ariat Women's Cruiser Slip-on Shoe Casual / Brown ARI-10023008-8.5 Size 8.5,Ariat Ariat Women's Cruiser Slip-on Shoe Casual / Brown ARI-10023008-8.5 Size 8.5,FBALYB Amazon,12,12,0,0,0,0
,Ariat Ariat Women's Cruiser Slip-on Shoe Casual / Brown ARI-10023008-9 Size 9,Ariat Ariat Women's Cruiser Slip-on Shoe Casual / Brown ARI-10023008-9 Size 9,FBALYB Amazon,-1,-1,0,0,0,0
,Ariat Ariat Women's Cruiser Slip-on Shoe Casual / Cheetah ARI-10024769-10 Size 10,Ariat Ariat Women's Cruiser Slip-on Shoe Casual / Cheetah ARI-10024769-10 Size 10,Default Ridgefield,2,2,0,0,0,0
,Ariat Ariat Women's Cruiser Slip-on Shoe Casual / Cheetah ARI-10024769-10 Size 10,Ariat Ariat Women's Cruiser Slip-on Shoe Casual / Cheetah ARI-10024769-10 Size 10,FBALYB Amazon,4,3,1,0,1,0
,Ariat Ariat Women's Cruiser Slip-on Shoe Casual / Cheetah ARI-10024769-11 Size 11,Ariat Ariat Women's Cruiser Slip-on Shoe Casual / Cheetah ARI-10024769-11 Size 11,FBALYB Amazon,8,8,0,0,0,0
,Ariat Ariat Women's Cruiser Slip-on Shoe Casual / Cheetah ARI-10024769-6.5 Size 6.5,Ariat Ariat Women's Cruiser Slip-on Shoe Casual / Cheetah ARI-10024769-6.5 Size 6.5,FBALYB Amazon,4,4,0,0,0,0
,Ariat Ariat Women's Cruiser Slip-on Shoe Casual / Cheetah ARI-10024769-7.5 Size 7.5,Ariat Ariat Women's Cruiser Slip-on Shoe Casual / Cheetah ARI-10024769-7.5 Size 7.5,FBALYB Amazon,2,2,0,0,0,0
,Ariat Ariat Women's Cruiser Slip-on Shoe Casual / Cheetah ARI-10024769-7 Size 7,Ariat Ariat Women's Cruiser Slip-on Shoe Casual / Cheetah ARI-10024769-7 Size 7,Default Ridgefield,2,2,0,0,0,0
,Ariat Ariat Women's Cruiser Slip-on Shoe Casual / Cheetah ARI-10024769-7 Size 7,Ariat Ariat Women's Cruiser Slip-on Shoe Casual / Cheetah ARI-10024769-7 Size 7,FBALYB Amazon,3,3,0,0,0,0
,Ariat Ariat Women's Cruiser Slip-on Shoe Casual / Cheetah ARI-10024769-8.5 Size 8.5,Ariat Ariat Women's Cruiser Slip-on Shoe Casual / Cheetah ARI-10024769-8.5 Size 8.5,FBALYB Amazon,3,2,1,0,1,0
,Ariat Ariat Women's Cruiser Slip-on Shoe Casual / Cheetah ARI-10024769-8 Size 8,Ariat Ariat Women's Cruiser Slip-on Shoe Casual / Cheetah ARI-10024769-8 Size 8,FBALYB Amazon,7,6,1,0,1,0
,Ariat Ariat Women's Cruiser Slip-on Shoe Casual / Cheetah ARI-10024769-9 Size 9,Ariat Ariat Women's Cruiser Slip-on Shoe Casual / Cheetah ARI-10024769-9 Size 9,Default Ridgefield,1,1,0,0,0,0
,Ariat Ariat Women's Cruiser Slip-on Shoe Casual / Cheetah ARI-10024769-9 Size 9,Ariat Ariat Women's Cruiser Slip-on Shoe Casual / Cheetah ARI-10024769-9 Size 9,FBALYB Amazon,7,7,0,0,0,0
,Ariat Ariat Women's Cruiser Slip-on Shoe Casual / Chestnut ARI-10027358-7 Size 7,Ariat Ariat Women's Cruiser Slip-on Shoe Casual / Chestnut ARI-10027358-7 Size 7,FBALYB Amazon,1,1,0,0,0,0
,Ariat Ariat Women's Cruiser Slip-on Shoe Casual / Chestnut ARI-10027358-8.5 Size 8.5,Ariat Ariat Women's Cruiser Slip-on Shoe Casual / Chestnut ARI-10027358-8.5 Size 8.5,FBALYB Amazon,6,6,0,0,0,0
,Ariat Ariat Women's Cruiser Slip-on Shoe Casual / Chestnut ARI-10027358-8 Size 8,Ariat Ariat Women's Cruiser Slip-on Shoe Casual / Chestnut ARI-10027358-8 Size 8,FBALYB Amazon,4,3,1,0,1,0
,Ariat Ariat Women's Cruiser Slip-on Shoe Casual / Chestnut ARI-10027358-9.5 Size 9.5,Ariat Ariat Women's Cruiser Slip-on Shoe Casual / Chestnut ARI-10027358-9.5 Size 9.5,FBALYB Amazon,3,2,1,0,1,0
,Ariat Ariat Women's Cruiser Slip-on Shoe Casual / Chestnut ARI-10027358-9 Size 9,Ariat Ariat Women's Cruiser Slip-on Shoe Casual / Chestnut ARI-10027358-9 Size 9,FBALYB Amazon,5,4,1,0,1,0
,Ariat Ariat Women's Cruiser Slip-on Shoe Casual / Chestnut Mustard ARI-10031603-8 Size 8,Ariat Ariat Women's Cruiser Slip-on Shoe Casual / Chestnut Mustard ARI-10031603-8 Size 8,FBALYB Amazon,11,10,1,0,1,0
,Ariat Ariat Women's Cruiser Slip-on Shoe Casual / Chestnut Mustard ARI-10031603-9 Size 9,Ariat Ariat Women's Cruiser Slip-on Shoe Casual / Chestnut Mustard ARI-10031603-9 Size 9,Default Ridgefield,11,11,0,0,0,0
,Ariat Ariat Women's Cruiser Slip-on Shoe Casual / Chocolate ARI-10021153-7 Size 7,Ariat Ariat Women's Cruiser Slip-on Shoe Casual / Chocolate ARI-10021153-7 Size 7,FBALYB Amazon,5,5,0,0,0,0
,Ariat Ariat Women's Cruiser Slip-on Shoe Casual / Chocolate ARI-10021153-8.5 Size 8.5,Ariat Ariat Women's Cruiser Slip-on Shoe Casual / Chocolate ARI-10021153-8.5 Size 8.5,FBALYB Amazon,6,6,0,0,0,0
,Ariat Ariat Women's Cruiser Slip-on Shoe Casual / Chocolate ARI-10021153-8 Size 8,Ariat Ariat Women's Cruiser Slip-on Shoe Casual / Chocolate ARI-10021153-8 Size 8,FBALYB Amazon,7,7,0,0,0,0
,Ariat Ariat Women's Cruiser Slip-on Shoe Casual / Chocolate ARI-10021153-9.5 Size 9.5,Ariat Ariat Women's Cruiser Slip-on Shoe Casual / Chocolate ARI-10021153-9.5 Size 9.5,FBALYB Amazon,10,10,0,0,0,0
,Ariat Ariat Women's Cruiser Slip-on Shoe Casual / Chocolate ARI-10021153-9 Size 9,Ariat Ariat Women's Cruiser Slip-on Shoe Casual / Chocolate ARI-10021153-9 Size 9,FBALYB Amazon,9,9,0,0,0,0
,Ariat Ariat Women's Delilah Round Toe Work Boot / Distressed Brown 10021457 Size 10,Ariat Ariat Women's Delilah Round Toe Work Boot / Distressed Brown 10021457 Size 10,FBALYB Amazon,4,0,4,0,4,0
,Ariat Ariat Women's Delilah Round Toe Work Boot / Distressed Brown 10021457 Size 11,Ariat Ariat Women's Delilah Round Toe Work Boot / Distressed Brown 10021457 Size 11,FBALYB Amazon,0,-2,2,0,2,0
,Ariat Ariat Women's Delilah Round Toe Work Boot / Distressed Brown 10021457 Size 6.5,Ariat Ariat Women's Delilah Round Toe Work Boot / Distressed Brown 10021457 Size 6.5,Default Ridgefield,6,6,0,0,0,0
,Ariat Ariat Women's Delilah Round Toe Work Boot / Distressed Brown 10021457 Size 6.5,Ariat Ariat Women's Delilah Round Toe Work Boot / Distressed Brown 10021457 Size 6.5,FBALYB Amazon,-1,-1,0,0,0,0
,Ariat Ariat Women's Delilah Round Toe Work Boot / Distressed Brown 10021457 Size 7.5,Ariat Ariat Women's Delilah Round Toe Work Boot / Distressed Brown 10021457 Size 7.5,Default Ridgefield,6,6,0,0,0,0
,Ariat Ariat Women's Delilah Round Toe Work Boot / Distressed Brown 10021457 Size 7.5,Ariat Ariat Women's Delilah Round Toe Work Boot / Distressed Brown 10021457 Size 7.5,FBALYB Amazon,-1,-1,0,0,0,0
,Ariat Ariat Women's Delilah Round Toe Work Boot / Distressed Brown 10021457 Size 8,Ariat Ariat Women's Delilah Round Toe Work Boot / Distressed Brown 10021457 Size 8,Default Ridgefield,1,1,0,0,0,0
,Ariat Ariat Women's Delilah Round Toe Work Boot / Distressed Brown 10021457 Size 8,Ariat Ariat Women's Delilah Round Toe Work Boot / Distressed Brown 10021457 Size 8,FBALYB Amazon,0,-1,1,0,1,0
,Ariat Ariat Women's Delilah Round Toe Work Boot / Distressed Brown 10021457 Size 8.5,Ariat Ariat Women's Delilah Round Toe Work Boot / Distressed Brown 10021457 Size 8.5,FBALYB Amazon,0,-1,1,0,1,0
,Ariat Ariat Women's Delilah Round Toe Work Boot / Distressed Brown 10021457 Size 9,Ariat Ariat Women's Delilah Round Toe Work Boot / Distressed Brown 10021457 Size 9,FBALYB Amazon,0,-1,1,0,1,0
,Ariat Ariat Women's Delilah Round Toe Work Boot / Distressed Brown 10021457 Size 9.5,Ariat Ariat Women's Delilah Round Toe Work Boot / Distressed Brown 10021457 Size 9.5,FBALYB Amazon,3,3,0,0,0,0
,Ariat ARIAT Women's Dixon Western Boot /Agate Green 10027280 Size 8.5,Ariat ARIAT Women's Dixon Western Boot /Agate Green 10027280 Size 8.5,FBALYB Amazon,12,12,0,0,0,0
,Ariat ARIAT Women's Dixon Western Boot / Agate Green ARI-10027280-7.5 Size 7.5,Ariat ARIAT Women's Dixon Western Boot / Agate Green ARI-10027280-7.5 Size 7.5,FBALYB Amazon,4,4,0,0,0,0
,Ariat ARIAT Women's Dixon Western Boot / Agate Green ARI-10027280-8 Size 8,Ariat ARIAT Women's Dixon Western Boot / Agate Green ARI-10027280-8 Size 8,FBALYB Amazon,11,11,0,0,0,0
,Ariat ARIAT Women's Dixon Western Boot / Weathered ARI-10027282-7.5 Size 7.5,Ariat ARIAT Women's Dixon Western Boot / Weathered ARI-10027282-7.5 Size 7.5,FBALYB Amazon,7,7,0,0,0,0
,Ariat ARIAT Women's Dixon Western Boot / Weathered ARI-10027282-8.5 Size 8.5,Ariat ARIAT Women's Dixon Western Boot / Weathered ARI-10027282-8.5 Size 8.5,FBALYB Amazon,4,4,0,0,0,0
,Ariat ARIAT Women's Dixon Western Boot / Weathered ARI-10027282-8 Size 8,Ariat ARIAT Women's Dixon Western Boot / Weathered ARI-10027282-8 Size 8,Default Ridgefield,11,11,0,0,0,0
,Ariat ARIAT Women's Dixon Western Boot / Weathered ARI-10027282-9 Size 9,Ariat ARIAT Women's Dixon Western Boot / Weathered ARI-10027282-9 Size 9,FBALYB Amazon,1,0,1,0,1,0
,Ariat Ariat Women's Fatbaby Western Boot / Black ARI-10000833-10 Size 10,Ariat Ariat Women's Fatbaby Western Boot / Black ARI-10000833-10 Size 10,FBALYB Amazon,2,2,0,0,0,0
,Ariat Ariat Women's Fatbaby Western Boot / Black ARI-10000833-6.5 Size 6.5,Ariat Ariat Women's Fatbaby Western Boot / Black ARI-10000833-6.5 Size 6.5,FBALYB Amazon,-1,-1,0,0,0,0
,Ariat Ariat Women's Fatbaby Western Boot / Black ARI-10000833-8.5 Size 8.5,Ariat Ariat Women's Fatbaby Western Boot / Black ARI-10000833-8.5 Size 8.5,Default Ridgefield,4,4,0,0,0,0
,Ariat Ariat Women's Fatbaby Western Boot / Black ARI-10000833-8 Size 8,Ariat Ariat Women's Fatbaby Western Boot / Black ARI-10000833-8 Size 8,FBALYB Amazon,8,3,5,0,5,0
,Ariat Ariat Women's Fatbaby Western Boot / Black ARI-10000833-9.5 Size 9.5,Ariat Ariat Women's Fatbaby Western Boot / Black ARI-10000833-9.5 Size 9.5,FBALYB Amazon,0,0,0,1,0,0
,Ariat Ariat Women's Fatbaby Western Boot / Black ARI-10000833-9 Size 9,Ariat Ariat Women's Fatbaby Western Boot / Black ARI-10000833-9 Size 9,Default Ridgefield,2,2,0,0,0,0
,Ariat Ariat Women's Fatbaby Western Boot / Black ARI-10000833-9 Size 9,Ariat Ariat Women's Fatbaby Western Boot / Black ARI-10000833-9 Size 9,FBALYB Amazon,0,-1,1,0,1,0
,Ariat Ariat Women's Fatbaby Western Boot / Royal Chocolate/Fudge 10016238 Size 10,Ariat Ariat Women's Fatbaby Western Boot / Royal Chocolate/Fudge 10016238 Size 10,FBALYB Amazon,3,2,1,0,1,0
,Ariat Ariat Women's Fatbaby Western Boot / Royal Chocolate/Fudge 10016238 Size 11,Ariat Ariat Women's Fatbaby Western Boot / Royal Chocolate/Fudge 10016238 Size 11,FBALYB Amazon,-1,-1,0,0,0,0
,Ariat Ariat Women's Fatbaby Western Boot / Royal Chocolate/Fudge 10016238 Size 6.5,Ariat Ariat Women's Fatbaby Western Boot / Royal Chocolate/Fudge 10016238 Size 6.5,FBALYB Amazon,-1,-2,1,0,1,0
,Ariat Ariat Women's Fatbaby Western Boot / Royal Chocolate/Fudge 10016238 Size 7,Ariat Ariat Women's Fatbaby Western Boot / Royal Chocolate/Fudge 10016238 Size 7,FBALYB Amazon,2,2,0,0,0,0
,Ariat Ariat Women's Fatbaby Western Boot / Royal Chocolate/Fudge 10016238 Size 9,Ariat Ariat Women's Fatbaby Western Boot / Royal Chocolate/Fudge 10016238 Size 9,FBALYB Amazon,-1,-1,0,0,0,0
,Ariat Ariat Women's Fatbaby Western Boot / Royal Chocolate/Fudge 10016238 Size 9.5,Ariat Ariat Women's Fatbaby Western Boot / Royal Chocolate/Fudge 10016238 Size 9.5,FBALYB Amazon,-1,-1,0,0,0,0
,Ariat Ariat Women’s New Team Softshell Jacket / Black ARI-10019206-Large,Ariat Ariat Women’s New Team Softshell Jacket / Black ARI-10019206-Large,FBALYB Amazon,-1,-1,0,0,0,0
,Ariat Ariat Women’s New Team Softshell Jacket / Black ARI-10019206-X-Large,Ariat Ariat Women’s New Team Softshell Jacket / Black ARI-10019206-X-Large,FBALYB Amazon,4,4,0,0,0,0
,Ariat Ariat Women’s New Team Softshell Jacket / Black ARI-10019206-XX-Large,Ariat Ariat Women’s New Team Softshell Jacket / Black ARI-10019206-XX-Large,FBALYB Amazon,-2,-2,0,0,0,0
,Ark Naturals Ears All Right 4oz 2pk,Ark Naturals Ears All Right 4oz 2pk,FBALYB Amazon,28,28,0,0,0,0
,Ark Naturals Gentle Digest 60ct,Ark Naturals Gentle Digest 60ct,FBALYB Amazon,6,6,0,0,0,0
,Ark Naturals Joint Rescue 60 tabs,Ark Naturals Joint Rescue 60 tabs,FBALYB Amazon,29,29,0,0,0,0
,Arm and Hammer Instant Relief 3 pack,Arm and Hammer Instant Relief 3 pack,Avrami - Ebay,243,243,0,0,0,0
,Arm and Hammer Instant Relief 3 pack,Arm and Hammer Instant Relief 3 pack,Default,0,-1008,1008,0,0,0
,Arm and Hammer Instant Relief 3 pack,Arm and Hammer Instant Relief 3 pack,Default Oxford,96,96,0,0,0,0
,Arm and Hammer Instant Relief 3 pack,Arm and Hammer Instant Relief 3 pack,Default Ridgefield,30,-608,638,0,0,0
,Arm and Hammer Instant Relief 3 pack,Arm and Hammer Instant Relief 3 pack,FBALYB Amazon,7861,7520,341,91,341,0
,Arm and Hammer Instant Relief 3 pack,Arm and Hammer Instant Relief 3 pack,WFS,234,234,0,0,0,0
,ARM & HAMMER Deodorant Clean2.5oz 3pk,ARM & HAMMER Deodorant Clean 2.5oz 3pk,FBALYB Amazon,-15,-15,0,0,0,0
,Arm&Hammer Simply Saline 6ct,Arm&Hammer Simply Saline 6ct,FBALYB Amazon,15,-85,100,75,100,0
,Arm & Hammer - Ultra Max Invisible Solid - Unscented 2.80 oz,Arm & Hammer - Ultra Max Invisible Solid - Unscented 2.80 oz,FBALYB Amazon,1,1,0,0,0,0
,Armor All 24oz Car Wash,Armor All 24oz Car Wash,Default Ridgefield,72,72,0,0,0,0
,Armor All 24oz Car Wash 2pk,Armor All 24oz Car Wash 2pk,FBALYB Amazon,78,76,2,0,2,0
,Armor All 24oz Car Wash 6pk,Armor All 24oz Car Wash 6pk,FBALYB Amazon,193,193,0,3,0,0
,Armor All 5 Piece Mat Set,,Default,0,0,0,0,0,2
,Armor All 5 Piece Mat Set,,Default Ridgefield,8,8,0,0,0,0
,Armor All Auto Care Cleaning Pack 75ct,Armor All Auto Care Cleaning Pack 75ct,Default,0,-112,112,0,0,0
,Armor All Auto Care Cleaning Pack 75ct,Armor All Auto Care Cleaning Pack 75ct,FBALYB Amazon,-37,-37,0,54,0,0
,Armor All Cleaning Wipes 25ct,Armor All Cleaning Wipes 25ct,Default,0,-826,826,0,0,0
,Armor All Cleaning Wipes 25ct,Armor All Cleaning Wipes 25ct,Default Ridgefield,7937,7937,0,0,0,0
,Armor All Cleaning Wipes 25ct,Armor All Cleaning Wipes 25ct,FBALYB Amazon,1213,1200,13,0,13,0
,Armor All Cleaning Wipes 25ct 2pk,Armor All Cleaning Wipes 25ct 2pk,Default Ridgefield,0,-11,11,0,0,0
,Armor All Cleaning Wipes 25ct 2pk,Armor All Cleaning Wipes 25ct 2pk,FBALYB Amazon,-54,-64,10,48,10,0
,Armor All Cleaning Wipes 25ct 3pk,Armor All Cleaning Wipes 25ct 3pk,FBALYB Amazon,-350,-355,5,315,5,0
,Armor All Cleaning Wipes 25ct 6pk,Armor All Cleaning Wipes 25ct 6pk,Default Ridgefield,0,-203,203,0,0,0
,Armor All Cleaning Wipes 25ct 6pk,Armor All Cleaning Wipes 25ct 6pk,FBALYB Amazon,47,47,0,0,0,0
,Armor All Glass Wipes 25c 2pk,Armor All Glass Wipes 25c 2pk,FBALYB Amazon,324,324,0,0,0,0
,Armor All Glass Wipes 25ct,Armor All Glass Wipes 25ct,Default,0,-610,610,0,0,0
,Armor All Glass Wipes 25ct,Armor All Glass Wipes 25ct,Default Ridgefield,1451,1451,0,0,0,0
,Armor All Glass Wipes 25ct 6PK,Armor All Glass Wipes 25ct 6PK,FBALYB Amazon,18,18,0,8,0,0
,Armor All Leather Wipes 20ct,Armor All Leather Wipes 20ct,Default Oxford,2,2,0,0,0,0
,ARMOR ALL MULTI PURPOSE CLEANR 6pk,ARMOR ALL MULTI PURPOSE CLEANR 6pk,FBALYB Amazon,2,2,0,2,0,0
,Armor All Protectant Wipes 25ct,Armor All Protectant Wipes 25ct,Default,0,-466,466,0,0,0
,Armor All Protectant Wipes 25ct,Armor All Protectant Wipes 25ct,Default Ridgefield,336,336,0,0,0,0
,Armor All Protectant Wipes 25ct,Armor All Protectant Wipes 25ct,FBALYB Amazon,64,59,5,0,5,0
,Armor All Protectant Wipes 25ct 2pk,Armor All Protectant Wipes 25ct 2pk,FBALYB Amazon,158,152,6,1,6,0
,Armor All Protectant Wipes 25ct 3pk,Armor All Protectant Wipes 25ct 3pk,FBALYB Amazon,1,1,0,1,0,0
,Armor All Protectant Wipes 25ct 6pk,Armor All Protectant Wipes 25ct 6pk,FBALYB Amazon,4,4,0,0,0,0
,Armor All Wipes Car Interior Cleaning,Armor All Wipes Car Interior Cleaning,Default Ridgefield,0,-200,200,0,0,0
,Armor All Wipes Car Interior Cleaning,Armor All Wipes Car Interior Cleaning,FBALYB Amazon,1,0,1,0,1,0
,Armor Protectant & Cleaning Wipes 25ct,Armor Protectant & Cleaning Wipes 25ct,FBALYB Amazon,-6,-6,0,0,0,0
,Aroy-D 1000ML Coconut Cream,Aroy-D 1000ML Coconut Cream,Default,0,-2112,2112,0,0,0
,Aroy-D 1000ML Coconut Cream,Aroy-D 1000ML Coconut Cream,FBALYB Amazon,0,0,0,1,0,0
,Aroy-D 100% Coconut Milk 500ml 12pk,Aroy-D 100% Coconut Milk 500ml 12pk,FBALYB Amazon,9,9,0,0,0,0
,Aroy-D Coconut Cream 33.8fl oz 6pk,Aroy-D Coconut Cream 33.8fl oz 6pk,FBALYB Amazon,4,4,0,2,0,0
,Aroy-d Coconut Milk 250 ml 12pk,Aroy-d Coconut Milk 250 ml 12pk,FBALYB Amazon,5,5,0,0,0,0
,Aroy-D Coconut Milk 250ml 6pk,Aroy-D Coconut Milk 250ml 6pk,FBALYB Amazon,2,2,0,0,0,0
,Aroy-D Coconut Milk 33.8 fl. oz 4pk,Aroy-D Coconut Milk 33.8 fl. oz 4pk,FBALYB Amazon,2,2,0,1,0,0
,Aroy-D Coconut Milk 33.8 fl. oz 6pk,Aroy-D Coconut Milk 33.8 fl. oz 6pk,FBALYB Amazon,20,20,0,4,0,0
,Aroy-D Pure Coconut Cream 33.8fl oz 3pk,Aroy-D Pure Coconut Cream 33.8fl oz 3pk,FBALYB Amazon,2,2,0,4,0,0
,ARROWHEAD CEREAL PUFF WHEAT 6oz 4pk,ARROWHEAD CEREAL PUFF WHEAT 6oz 4pk,FBALYB Amazon,2,0,2,0,2,0
,Artstyle Table Cloth 2pk,Artstyle Table Cloth 2pk,Avrami - Ebay,0,-1,1,0,0,0
,Artstyle Table Cloth 2pk,Artstyle Table Cloth 2pk,Default,0,-48,48,0,0,0
,Artstyle Table Cloth 2pk,Artstyle Table Cloth 2pk,FBALYB Amazon,-5,-7,2,4,2,0
,Artstyle Table Cloths 3pack,Artstyle Table Cloths 3pack,FBALYB Amazon,-1,-1,0,0,0,0
,Artstyle Tissue Poly Table Covers Octy Round 4 Pack,Artstyle Tissue Poly Table Covers Octy Round 4 Pack,FBALYB Amazon,-32,-32,0,6,0,0
,Asics Gel Pulse 11 Lite Show - 1011A645-001 Black/Laser Pink 12,Asics Gel Pulse 11 Lite Show - 1011A645-001 Black/Laser Pink 12,Default Ridgefield,8,8,0,0,0,0
,Asics Gel Pulse 11 Lite Show - 1011A645-001 Black/Laser Pink 9.5,Asics Gel Pulse 11 Lite Show - 1011A645-001 Black/Laser Pink 9.5,FBALYB Amazon,-1,-1,0,0,0,0
,ASICS Kid's Soulyte GS- 1014A080-020 Sheet Rock/Black 4,ASICS Kid's Soulyte GS- 1014A080-020 Sheet Rock/Black 4,FBALYB Amazon,-6,-6,0,0,0,0
,ASICS Kid's Soulyte GS- 1014A080-020 Sheet Rock/Black 5,ASICS Kid's Soulyte GS- 1014A080-020 Sheet Rock/Black 5,FBALYB Amazon,-2,-2,0,0,0,0
,ASICS Kid's Soulyte GS- 1014A080-020 Sheet Rock/Black 6,ASICS Kid's Soulyte GS- 1014A080-020 Sheet Rock/Black 6,FBALYB Amazon,-3,-3,0,0,0,0
,ASICS Kid's Soulyte GS- 1014A080-020 Sheet Rock/Black 7,ASICS Kid's Soulyte GS- 1014A080-020 Sheet Rock/Black 7,Default Ridgefield,23,23,0,0,0,0
,Asics Kid's Soulyte GS- 1014A080-500 Gentry Purple/ Ice Mint 4,Asics Kid's Soulyte GS- 1014A080-500 Gentry Purple/ Ice Mint 4,FBALYB Amazon,-12,-12,0,0,0,0
,Asics Kid's Soulyte GS- 1014A080-500 Gentry Purple/ Ice Mint 5,Asics Kid's Soulyte GS- 1014A080-500 Gentry Purple/ Ice Mint 5,FBALYB Amazon,-1,-1,0,0,0,0
,Asics Kid's Soulyte GS- 1014A080-500 Gentry Purple/ Ice Mint 6,Asics Kid's Soulyte GS- 1014A080-500 Gentry Purple/ Ice Mint 6,FBALYB Amazon,-4,-4,0,0,0,0
,Asics Kid's Soulyte GS- 1014A080-500 Gentry Purple/ Ice Mint 6.5,Asics Kid's Soulyte GS- 1014A080-500 Gentry Purple/ Ice Mint 6.5,FBALYB Amazon,-4,-4,0,0,0,0
,Asics Kid's Soulyte GS- 1014A080-500 Gentry Purple/ Ice Mint 7,Asics Kid's Soulyte GS- 1014A080-500 Gentry Purple/ Ice Mint 7,FBALYB Amazon,-3,-3,0,0,0,0
,Asics Men LEGENDS BLACK/REBORN BLUE 1011B001.005 US Size 10,Asics Men LEGENDS BLACK/REBORN BLUE 1011B001.005 US Size 10,FBALYB Amazon,11,11,0,0,0,0
,Asics Men LEGENDS BLACK/REBORN BLUE 1011B001.005 US Size 10.5,Asics Men LEGENDS BLACK/REBORN BLUE 1011B001.005 US Size 10.5,FBALYB Amazon,12,12,0,0,0,0
,Asics Men LEGENDS BLACK/REBORN BLUE 1011B001.005 US Size 11,Asics Men LEGENDS BLACK/REBORN BLUE 1011B001.005 US Size 11,FBALYB Amazon,5,5,0,0,0,0
,Asics Men LEGENDS BLACK/REBORN BLUE 1011B001.005 US Size 12.5,Asics Men LEGENDS BLACK/REBORN BLUE 1011B001.005 US Size 12.5,FBALYB Amazon,4,4,0,0,0,0
,Asics Men LEGENDS BLACK/REBORN BLUE 1011B001.005 US Size 13,Asics Men LEGENDS BLACK/REBORN BLUE 1011B001.005 US Size 13,FBALYB Amazon,3,3,0,0,0,0
,Asics Men LEGENDS BLACK/REBORN BLUE 1011B001.005 US Size 14,Asics Men LEGENDS BLACK/REBORN BLUE 1011B001.005 US Size 14,FBALYB Amazon,2,2,0,0,0,0
,Asics Men LEGENDS BLACK/REBORN BLUE 1011B001.005 US Size 15,Asics Men LEGENDS BLACK/REBORN BLUE 1011B001.005 US Size 15,FBALYB Amazon,2,2,0,0,0,0
,Asics Men LEGENDS BLACK/REBORN BLUE 1011B001.005 US Size 9.5,Asics Men LEGENDS BLACK/REBORN BLUE 1011B001.005 US Size 9.5,FBALYB Amazon,6,6,0,0,0,0
,Asics Men Legends Black/White 1011A983.004 US Size 10,Asics Men Legends Black/White 1011A983.004 US Size 10,FBALYB Amazon,8,6,2,0,2,0
,Asics Men Legends Black/White 1011A983.004 US Size 10.5,Asics Men Legends Black/White 1011A983.004 US Size 10.5,FBALYB Amazon,17,15,2,0,2,0
,Asics Men Legends Black/White 1011A983.004 US Size 11,Asics Men Legends Black/White 1011A983.004 US Size 11,FBALYB Amazon,-2,-2,0,0,0,0
,Asics Men Legends Black/White 1011A983.004 US Size 12.5,Asics Men Legends Black/White 1011A983.004 US Size 12.5,FBALYB Amazon,4,4,0,0,0,0
,Asics Men Legends Black/White 1011A983.004 US Size 13,Asics Men Legends Black/White 1011A983.004 US Size 13,FBALYB Amazon,3,3,0,0,0,0
,Asics Men Legends Black/White 1011A983.004 US Size 15,Asics Men Legends Black/White 1011A983.004 US Size 15,FBALYB Amazon,2,2,0,0,0,0
,Asics Men Legends Black/White 1011A983.004 US Size 9.5,Asics Men Legends Black/White 1011A983.004 US Size 9.5,FBALYB Amazon,7,7,0,0,0,0
,Asics Men Legends Metropolis/Black 1011A983.023 US SIze 10,Asics Men Legends Metropolis/Black 1011A983.023 US SIze 10,FBALYB Amazon,75,75,0,0,0,0
,Asics Men Legends Metropolis/Black 1011A983.023 US SIze 10.5,Asics Men Legends Metropolis/Black 1011A983.023 US SIze 10.5,FBALYB Amazon,68,68,0,0,0,0
,Asics Men Legends Metropolis/Black 1011A983.023 US SIze 11,Asics Men Legends Metropolis/Black 1011A983.023 US SIze 11,FBALYB Amazon,33,33,0,0,0,0
,Asics Men Legends Metropolis/Black 1011A983.023 US SIze 12,Asics Men Legends Metropolis/Black 1011A983.023 US SIze 12,FBALYB Amazon,18,18,0,0,0,0
,Asics Men Legends Metropolis/Black 1011A983.023 US SIze 12.5,Asics Men Legends Metropolis/Black 1011A983.023 US SIze 12.5,FBALYB Amazon,12,12,0,0,0,0
,Asics Men Legends Metropolis/Black 1011A983.023 US SIze 13,Asics Men Legends Metropolis/Black 1011A983.023 US SIze 13,FBALYB Amazon,12,12,0,0,0,0
,Asics Men Legends Metropolis/Black 1011A983.023 US SIze 14,Asics Men Legends Metropolis/Black 1011A983.023 US SIze 14,FBALYB Amazon,6,6,0,0,0,0
,Asics Men Legends Metropolis/Black 1011A983.023 US SIze 15,Asics Men Legends Metropolis/Black 1011A983.023 US SIze 15,FBALYB Amazon,6,6,0,0,0,0
,Asics Men Legends Metropolis/Black 1011A983.023 US SIze 8,Asics Men Legends Metropolis/Black 1011A983.023 US SIze 8,FBALYB Amazon,20,20,0,0,0,0
,Asics Men Legends Metropolis/Black 1011A983.023 US SIze 8.5,Asics Men Legends Metropolis/Black 1011A983.023 US SIze 8.5,FBALYB Amazon,20,20,0,0,0,0
,Asics Men Legends Metropolis/Black 1011A983.023 US SIze 9,Asics Men Legends Metropolis/Black 1011A983.023 US SIze 9,FBALYB Amazon,39,38,1,0,1,0
,Asics Men Legends Metropolis/Black 1011A983.023 US SIze 9.5,Asics Men Legends Metropolis/Black 1011A983.023 US SIze 9.5,FBALYB Amazon,55,55,0,0,0,0
,Asics Men Legends SHEET ROCK/HAZARD GREEN 1011B001.025 US Size 10,Asics Men Legends SHEET ROCK/HAZARD GREEN 1011B001.025 US Size 10,FBALYB Amazon,28,28,0,0,0,0
,Asics Men Legends SHEET ROCK/HAZARD GREEN 1011B001.025 US Size 10.5,Asics Men Legends SHEET ROCK/HAZARD GREEN 1011B001.025 US Size 10.5,FBALYB Amazon,17,17,0,0,0,0
,Asics Men Legends SHEET ROCK/HAZARD GREEN 1011B001.025 US Size 11,Asics Men Legends SHEET ROCK/HAZARD GREEN 1011B001.025 US Size 11,FBALYB Amazon,9,9,0,0,0,0
,Asics Men Legends SHEET ROCK/HAZARD GREEN 1011B001.025 US Size 12,Asics Men Legends SHEET ROCK/HAZARD GREEN 1011B001.025 US Size 12,FBALYB Amazon,4,4,0,0,0,0
,Asics Men Legends SHEET ROCK/HAZARD GREEN 1011B001.025 US Size 12.5,Asics Men Legends SHEET ROCK/HAZARD GREEN 1011B001.025 US Size 12.5,FBALYB Amazon,3,3,0,0,0,0
,Asics Men Legends SHEET ROCK/HAZARD GREEN 1011B001.025 US Size 13,Asics Men Legends SHEET ROCK/HAZARD GREEN 1011B001.025 US Size 13,FBALYB Amazon,1,1,0,0,0,0
,Asics Men Legends SHEET ROCK/HAZARD GREEN 1011B001.025 US Size 14,Asics Men Legends SHEET ROCK/HAZARD GREEN 1011B001.025 US Size 14,FBALYB Amazon,2,2,0,0,0,0
,Asics Men Legends SHEET ROCK/HAZARD GREEN 1011B001.025 US Size 15,Asics Men Legends SHEET ROCK/HAZARD GREEN 1011B001.025 US Size 15,FBALYB Amazon,1,0,1,0,1,0
,Asics Men Legends SHEET ROCK/HAZARD GREEN 1011B001.025 US Size 8,Asics Men Legends SHEET ROCK/HAZARD GREEN 1011B001.025 US Size 8,Default Ridgefield,8,8,0,0,0,0
,Asics Men Legends SHEET ROCK/HAZARD GREEN 1011B001.025 US Size 8.5,Asics Men Legends SHEET ROCK/HAZARD GREEN 1011B001.025 US Size 8.5,FBALYB Amazon,6,6,0,0,0,0
,Asics Men Legends SHEET ROCK/HAZARD GREEN 1011B001.025 US Size 9,Asics Men Legends SHEET ROCK/HAZARD GREEN 1011B001.025 US Size 9,FBALYB Amazon,16,16,0,0,0,0
,Asics Men Legends SHEET ROCK/HAZARD GREEN 1011B001.025 US Size 9.5,Asics Men Legends SHEET ROCK/HAZARD GREEN 1011B001.025 US Size 9.5,FBALYB Amazon,22,22,0,0,0,0
,Asics Men's Gel-Excite 6- 1011A165-001 Black/White 10,Asics Men's Gel-Excite 6- 1011A165-001 Black/White 10,FBALYB Amazon,-4,-4,0,1,0,0
,Asics Men's Gel-Excite 6- 1011A165-001 Black/White 12,Asics Men's Gel-Excite 6- 1011A165-001 Black/White 12,FBALYB Amazon,-1,-1,0,0,0,0
,Asics Men's Gel-Excite 6- 1011A165-001 Black/White 14,Asics Men's Gel-Excite 6- 1011A165-001 Black/White 14,FBALYB Amazon,-1,-1,0,0,0,0
,Asics Men's Gel-Excite 6- 1011A165-001 Black/White 9,Asics Men's Gel-Excite 6- 1011A165-001 Black/White 9,FBALYB Amazon,-3,-3,0,0,0,0
,Asics Men's Gel-Excite 6- 1011A165-001 Black/White 9.5,Asics Men's Gel-Excite 6- 1011A165-001 Black/White 9.5,FBALYB Amazon,-5,-5,0,0,0,0
,Asics Men's Gel-Excite 6- 1011A165-005 Black/Speed Red 10,Asics Men's Gel-Excite 6- 1011A165-005 Black/Speed Red 10,FBALYB Amazon,1,1,0,0,0,0
,Asics Men's Gel-Excite 6- 1011A165-005 Black/Speed Red 11.5,Asics Men's Gel-Excite 6- 1011A165-005 Black/Speed Red 11.5,FBALYB Amazon,-1,-1,0,0,0,0
,Asics Men's Gel-Excite 6- 1011A165-005 Black/Speed Red 8,Asics Men's Gel-Excite 6- 1011A165-005 Black/Speed Red 8,FBALYB Amazon,-1,-1,0,0,0,0
,Asics Men's Gel-Excite 6- 1011A165-005 Black/Speed Red 9.5,Asics Men's Gel-Excite 6- 1011A165-005 Black/Speed Red 9.5,FBALYB Amazon,-4,-4,0,0,0,0
,Asics Men's Gel-Excite 6- 1011A165-006 Black/Shocking Orange 8.5,Asics Men's Gel-Excite 6- 1011A165-006 Black/Shocking Orange 8.5,Default Ridgefield,13,13,0,0,0,0
,Asics Men's Gel-Excite 6- 1011A165-006 Black/Shocking Orange 9,Asics Men's Gel-Excite 6- 1011A165-006 Black/Shocking Orange 9,FBALYB Amazon,-5,-5,0,0,0,0
,Asics Men's Gel-Excite 6- 1011A165-020 Mid Grey/Electric Blue 10,Asics Men's Gel-Excite 6- 1011A165-020 Mid Grey/Electric Blue 10,FBALYB Amazon,-1,-1,0,1,0,0
,Asics Men's Gel-Excite 6- 1011A165-020 Mid Grey/Electric Blue 8,Asics Men's Gel-Excite 6- 1011A165-020 Mid Grey/Electric Blue 8,FBALYB Amazon,-1,-1,0,0,0,0
,Asics Men's Gel-Excite 6- 1011A165-020 Mid Grey/Electric Blue 9,Asics Men's Gel-Excite 6- 1011A165-020 Mid Grey/Electric Blue 9,Default Ridgefield,30,30,0,0,0,0
,Asics Men's Gel-Excite 6- 1011A165-020 Mid Grey/Electric Blue 9,Asics Men's Gel-Excite 6- 1011A165-020 Mid Grey/Electric Blue 9,FBALYB Saudi,5,5,0,0,0,0
,Asics Men's Gel-Excite 6- 1011A165-020 Mid Grey/Electric Blue 9.5,Asics Men's Gel-Excite 6- 1011A165-020 Mid Grey/Electric Blue 9.5,FBALYB Amazon,-4,-4,0,0,0,0
,Asics Men's Gel-Excite 6 (4E)- 1011A166-001 Black/White 11,Asics Men's Gel-Excite 6 (4E)- 1011A166-001 Black/White 11,Default Ridgefield,18,18,0,0,0,0
,Asics Men's Gel-Excite 6 (4E)- 1011A166-001 Black/White 11.5,Asics Men's Gel-Excite 6 (4E)- 1011A166-001 Black/White 11.5,Default Ridgefield,2,2,0,0,0,0
,Asics Men's Gel-Nimbus 21- 1011A169-002 Black/Classic Red 10,Asics Men's Gel-Nimbus 21- 1011A169-002 Black/Classic Red 10,FBALYB Amazon,-6,-6,0,0,0,0
,Asics Men's Gel-Nimbus 21- 1011A169-002 Black/Classic Red 10.5,Asics Men's Gel-Nimbus 21- 1011A169-002 Black/Classic Red 10.5,FBALYB Amazon,-7,-7,0,0,0,0
,Asics Men's Gel-Nimbus 21- 1011A169-002 Black/Classic Red 11,Asics Men's Gel-Nimbus 21- 1011A169-002 Black/Classic Red 11,Default Ridgefield,2,2,0,0,0,0
,Asics Men's Gel-Nimbus 21- 1011A169-002 Black/Classic Red 11,Asics Men's Gel-Nimbus 21- 1011A169-002 Black/Classic Red 11,FBALYB Amazon,-4,-4,0,0,0,0
,Asics Men's Gel-Nimbus 21- 1011A169-002 Black/Classic Red 11.5,Asics Men's Gel-Nimbus 21- 1011A169-002 Black/Classic Red 11.5,FBALYB Amazon,-2,-2,0,0,0,0
,Asics Men's Gel-Nimbus 21- 1011A169-002 Black/Classic Red 12,Asics Men's Gel-Nimbus 21- 1011A169-002 Black/Classic Red 12,FBALYB Amazon,-2,-2,0,0,0,0
,Asics Men's Gel-Nimbus 21- 1011A169-002 Black/Classic Red 8,Asics Men's Gel-Nimbus 21- 1011A169-002 Black/Classic Red 8,FBALYB Amazon,-2,-2,0,0,0,0
,Asics Men's Gel-Nimbus 21- 1011A169-002 Black/Classic Red 9,Asics Men's Gel-Nimbus 21- 1011A169-002 Black/Classic Red 9,FBALYB Amazon,-2,-2,0,0,0,0
,Asics Women Legends AQUA ANGEL/PURE SILVER 1012A859.402 US Size 10,Asics Women Legends AQUA ANGEL/PURE SILVER 1012A859.402 US Size 10,FBALYB Amazon,13,13,0,0,0,0
,Asics Women Legends AQUA ANGEL/PURE SILVER 1012A859.402 US Size 6.5,Asics Women Legends AQUA ANGEL/PURE SILVER 1012A859.402 US Size 6.5,FBALYB Amazon,13,13,0,0,0,0
,Asics Women Legends AQUA ANGEL/PURE SILVER 1012A859.402 US Size 7,Asics Women Legends AQUA ANGEL/PURE SILVER 1012A859.402 US Size 7,FBALYB Amazon,14,14,0,0,0,0
,Asics Women Legends AQUA ANGEL/PURE SILVER 1012A859.402 US Size 7.5,Asics Women Legends AQUA ANGEL/PURE SILVER 1012A859.402 US Size 7.5,FBALYB Amazon,25,25,0,0,0,0
,Asics Women Legends AQUA ANGEL/PURE SILVER 1012A859.402 US Size 8,Asics Women Legends AQUA ANGEL/PURE SILVER 1012A859.402 US Size 8,FBALYB Amazon,39,39,0,0,0,0
,Asics Women Legends AQUA ANGEL/PURE SILVER 1012A859.402 US Size 8.5,Asics Women Legends AQUA ANGEL/PURE SILVER 1012A859.402 US Size 8.5,FBALYB Amazon,52,52,0,0,0,0
,Asics Women Legends AQUA ANGEL/PURE SILVER 1012A859.402 US Size 9,Asics Women Legends AQUA ANGEL/PURE SILVER 1012A859.402 US Size 9,FBALYB Amazon,46,46,0,0,0,0
,Asics Women Legends AQUA ANGEL/PURE SILVER 1012A859.402 US Size 9.5,Asics Women Legends AQUA ANGEL/PURE SILVER 1012A859.402 US Size 9.5,FBALYB Amazon,26,26,0,0,0,0
,Asics Women Legends BLACK/LILAC OPAL 1012A859.004 US Size 10,Asics Women Legends BLACK/LILAC OPAL 1012A859.004 US Size 10,FBALYB Amazon,13,13,0,0,0,0
,Asics Women Legends BLACK/LILAC OPAL 1012A859.004 US Size 6.5,Asics Women Legends BLACK/LILAC OPAL 1012A859.004 US Size 6.5,FBALYB Amazon,13,13,0,0,0,0
,Asics Women Legends BLACK/LILAC OPAL 1012A859.004 US Size 7,Asics Women Legends BLACK/LILAC OPAL 1012A859.004 US Size 7,FBALYB Amazon,12,12,0,0,0,0
,Asics Women Legends BLACK/LILAC OPAL 1012A859.004 US Size 7.5,Asics Women Legends BLACK/LILAC OPAL 1012A859.004 US Size 7.5,FBALYB Amazon,11,11,0,0,0,0
,Asics Women Legends BLACK/LILAC OPAL 1012A859.004 US Size 8,Asics Women Legends BLACK/LILAC OPAL 1012A859.004 US Size 8,FBALYB Amazon,24,24,0,0,0,0
,Asics Women Legends BLACK/LILAC OPAL 1012A859.004 US Size 8.5,Asics Women Legends BLACK/LILAC OPAL 1012A859.004 US Size 8.5,FBALYB Amazon,39,39,0,0,0,0
,Asics Women Legends BLACK/LILAC OPAL 1012A859.004 US Size 9,Asics Women Legends BLACK/LILAC OPAL 1012A859.004 US Size 9,FBALYB Amazon,27,27,0,0,0,0
,Asics Women Legends BLACK/LILAC OPAL 1012A859.004 US Size 9.5,Asics Women Legends BLACK/LILAC OPAL 1012A859.004 US Size 9.5,FBALYB Amazon,12,12,0,0,0,0
,Asics Women Legends GRAND SHARK/DIGITAL AQUA 1012A885.402 US SIze 7.5,Asics Women Legends GRAND SHARK/DIGITAL AQUA 1012A885.402 US SIze 7.5,FBALYB Amazon,1,1,0,0,0,0
,Asics Women Legends GRAND SHARK/DIGITAL AQUA 1012A885.402 US SIze 9,Asics Women Legends GRAND SHARK/DIGITAL AQUA 1012A885.402 US SIze 9,Default Ridgefield,15,15,0,0,0,0
,Asics Women Legends GRAND SHARK/DIGITAL AQUA 1012A885.402 US SIze 9,Asics Women Legends GRAND SHARK/DIGITAL AQUA 1012A885.402 US SIze 9,FBALYB Amazon,-18,-18,0,0,0,0
,Asics Women Legends GRAND SHARK/DIGITAL AQUA 1012A885.402 US SIze 9.5,Asics Women Legends GRAND SHARK/DIGITAL AQUA 1012A885.402 US SIze 9.5,FBALYB Amazon,-1,-1,0,0,0,0
,Asics Women Legends PIEDMONT GREY/DIGITAL GRAPE 1012A859.022 US Size 10,Asics Women Legends PIEDMONT GREY/DIGITAL GRAPE 1012A859.022 US Size 10,FBALYB Amazon,11,11,0,0,0,0
,Asics Women Legends PIEDMONT GREY/DIGITAL GRAPE 1012A859.022 US Size 6.5,Asics Women Legends PIEDMONT GREY/DIGITAL GRAPE 1012A859.022 US Size 6.5,FBALYB Amazon,11,11,0,0,0,0
,Asics Women Legends PIEDMONT GREY/DIGITAL GRAPE 1012A859.022 US Size 7,Asics Women Legends PIEDMONT GREY/DIGITAL GRAPE 1012A859.022 US Size 7,FBALYB Amazon,13,13,0,0,0,0
,Asics Women Legends PIEDMONT GREY/DIGITAL GRAPE 1012A859.022 US Size 7.5,Asics Women Legends PIEDMONT GREY/DIGITAL GRAPE 1012A859.022 US Size 7.5,FBALYB Amazon,14,14,0,0,0,0
,Asics Women Legends PIEDMONT GREY/DIGITAL GRAPE 1012A859.022 US Size 8,Asics Women Legends PIEDMONT GREY/DIGITAL GRAPE 1012A859.022 US Size 8,FBALYB Amazon,28,28,0,0,0,0
,Asics Women Legends PIEDMONT GREY/DIGITAL GRAPE 1012A859.022 US Size 8.5,Asics Women Legends PIEDMONT GREY/DIGITAL GRAPE 1012A859.022 US Size 8.5,Default Ridgefield,6,6,0,0,0,0
,Asics Women Legends PIEDMONT GREY/DIGITAL GRAPE 1012A859.022 US Size 8.5,Asics Women Legends PIEDMONT GREY/DIGITAL GRAPE 1012A859.022 US Size 8.5,FBALYB Amazon,35,35,0,0,0,0
,Asics Women Legends PIEDMONT GREY/DIGITAL GRAPE 1012A859.022 US Size 9,Asics Women Legends PIEDMONT GREY/DIGITAL GRAPE 1012A859.022 US Size 9,Default Ridgefield,14,14,0,0,0,0
,Asics Women Legends PIEDMONT GREY/DIGITAL GRAPE 1012A859.022 US Size 9,Asics Women Legends PIEDMONT GREY/DIGITAL GRAPE 1012A859.022 US Size 9,FBALYB Amazon,13,13,0,0,0,0
,Asics Women Legends PIEDMONT GREY/DIGITAL GRAPE 1012A859.022 US Size 9.5,Asics Women Legends PIEDMONT GREY/DIGITAL GRAPE 1012A859.022 US Size 9.5,FBALYB Amazon,13,13,0,0,0,0
,Asics Women Legends SMOKE BLUE/PURE SILVER 1012A885-400 US Size 10,Asics Women Legends SMOKE BLUE/PURE SILVER 1012A885-400 US Size 10,FBALYB Amazon,10,10,0,0,0,0
,Asics Women Legends SMOKE BLUE/PURE SILVER 1012A885-400 US Size 6.5,Asics Women Legends SMOKE BLUE/PURE SILVER 1012A885-400 US Size 6.5,FBALYB Amazon,7,7,0,0,0,0
,Asics Women Legends SMOKE BLUE/PURE SILVER 1012A885-400 US Size 7,Asics Women Legends SMOKE BLUE/PURE SILVER 1012A885-400 US Size 7,FBALYB Amazon,10,10,0,0,0,0
,Asics Women Legends SMOKE BLUE/PURE SILVER 1012A885-400 US Size 7.5,Asics Women Legends SMOKE BLUE/PURE SILVER 1012A885-400 US Size 7.5,FBALYB Amazon,10,10,0,0,0,0
,Asics Women Legends SMOKE BLUE/PURE SILVER 1012A885-400 US Size 8,Asics Women Legends SMOKE BLUE/PURE SILVER 1012A885-400 US Size 8,FBALYB Amazon,18,18,0,0,0,0
,Asics Women Legends SMOKE BLUE/PURE SILVER 1012A885-400 US Size 8.5,Asics Women Legends SMOKE BLUE/PURE SILVER 1012A885-400 US Size 8.5,FBALYB Amazon,29,29,0,0,0,0
,Asics Women Legends SMOKE BLUE/PURE SILVER 1012A885-400 US Size 9,Asics Women Legends SMOKE BLUE/PURE SILVER 1012A885-400 US Size 9,FBALYB Amazon,20,20,0,0,0,0
,Asics Women Legends SMOKE BLUE/PURE SILVER 1012A885-400 US Size 9.5,Asics Women Legends SMOKE BLUE/PURE SILVER 1012A885-400 US Size 9.5,FBALYB Amazon,7,7,0,0,0,0
,Asics Women's Gel-Excite 6- 1012A150-020 Grey/Papaya 10,Asics Women's Gel-Excite 6- 1012A150-020 Grey/Papaya 10,FBALYB Amazon,-9,-9,0,0,0,0
,Asics Women's Gel-Excite 6- 1012A150-020 Grey/Papaya 10.5,Asics Women's Gel-Excite 6- 1012A150-020 Grey/Papaya 10.5,FBALYB Amazon,-4,-4,0,48,0,0
,Asics Women's Gel-Excite 6- 1012A150-020 Grey/Papaya 11,Asics Women's Gel-Excite 6- 1012A150-020 Grey/Papaya 11,FBALYB Amazon,-1,-1,0,0,0,0
,Asics Women's Gel-Excite 6- 1012A150-020 Grey/Papaya 6,Asics Women's Gel-Excite 6- 1012A150-020 Grey/Papaya 6,FBALYB Amazon,-11,-11,0,1,0,0
,Asics Women's Gel-Excite 6- 1012A150-020 Grey/Papaya 7,Asics Women's Gel-Excite 6- 1012A150-020 Grey/Papaya 7,FBALYB Amazon,-7,-7,0,0,0,0
,Asics Women's Gel-Excite 6- 1012A150-020 Grey/Papaya 7.5,Asics Women's Gel-Excite 6- 1012A150-020 Grey/Papaya 7.5,FBALYB Amazon,-19,-19,0,0,0,0
,Asics Women's Gel-Excite 6- 1012A150-020 Grey/Papaya 8,Asics Women's Gel-Excite 6- 1012A150-020 Grey/Papaya 8,FBALYB Amazon,-7,-7,0,0,0,0
,Asics Women's Gel-Excite 6- 1012A150-020 Grey/Papaya 8.5,Asics Women's Gel-Excite 6- 1012A150-020 Grey/Papaya 8.5,FBALYB Amazon,-9,-9,0,0,0,0
,Asics Women's Gel-Excite 6- 1012A150-020 Grey/Papaya 9,Asics Women's Gel-Excite 6- 1012A150-020 Grey/Papaya 9,FBALYB Amazon,-19,-19,0,0,0,0
,Asics Women's Gel-Excite 6- 1012A150-020 Grey/Papaya 9.5,Asics Women's Gel-Excite 6- 1012A150-020 Grey/Papaya 9.5,FBALYB Amazon,-6,-6,0,0,0,0
,Asics Women's Gel-Excite 6- 1012A150-400 Indigo Blue/Pink Rave  11,Asics Women's Gel-Excite 6- 1012A150-400 Indigo Blue/Pink Rave  11,FBALYB Amazon,-1,-1,0,0,0,0
,Asics Women's Gel-Excite 6- 1012A150-400 Indigo Blue/Pink Rave  6,Asics Women's Gel-Excite 6- 1012A150-400 Indigo Blue/Pink Rave  6,FBALYB Amazon,-13,-13,0,0,0,0
,Asics Women's Gel-Excite 6- 1012A150-400 Indigo Blue/Pink Rave  7.5,Asics Women's Gel-Excite 6- 1012A150-400 Indigo Blue/Pink Rave  7.5,FBALYB Amazon,-11,-11,0,0,0,0
,Asics Women's Gel-Excite 6 (D)- 1012A154-020 Grey/Papaya 7.5,Asics Women's Gel-Excite 6 (D)- 1012A154-020 Grey/Papaya 7.5,FBALYB Amazon,-7,-7,0,0,0,0
,Asics Women's Gel-Excite 6 (D)- 1012A154-020 Grey/Papaya 8.5,Asics Women's Gel-Excite 6 (D)- 1012A154-020 Grey/Papaya 8.5,FBALYB Amazon,-1,-1,0,0,0,0
,Asics Women's Gel-Quantum 360 4 1022A029-100 White/Mid Grey US Size 10,Asics Women's Gel-Quantum 360 4 1022A029-100 White/Mid Grey US Size 10,FBALYB Amazon,15,15,0,0,0,0
,Asics Women's Gel-Quantum 360 4 1022A029-100 White/Mid Grey US Size 10.5,Asics Women's Gel-Quantum 360 4 1022A029-100 White/Mid Grey US Size 10.5,Default,0,0,0,0,0,1
,Asics Women's Gel-Quantum 360 4 1022A029-100 White/Mid Grey US Size 10.5,Asics Women's Gel-Quantum 360 4 1022A029-100 White/Mid Grey US Size 10.5,Default Ridgefield,15,15,0,0,0,0
,Asics Women's Gel-Quantum 360 4 1022A029-100 White/Mid Grey US Size 7,Asics Women's Gel-Quantum 360 4 1022A029-100 White/Mid Grey US Size 7,FBALYB Amazon,9,9,0,0,0,0
,Asics Women's Gel-Quantum 360 4 1022A029-100 White/Mid Grey US Size 7.5,Asics Women's Gel-Quantum 360 4 1022A029-100 White/Mid Grey US Size 7.5,FBALYB Amazon,16,16,0,0,0,0
,Asics Women's Gel-Quantum 360 4 1022A029-100 White/Mid Grey US Size 8,Asics Women's Gel-Quantum 360 4 1022A029-100 White/Mid Grey US Size 8,FBALYB Amazon,35,35,0,0,0,0
,Asics Women's Gel-Quantum 360 4 1022A029-100 White/Mid Grey US Size 8.5,Asics Women's Gel-Quantum 360 4 1022A029-100 White/Mid Grey US Size 8.5,Default Ridgefield,1,1,0,0,0,0
,Asics Women's Gel-Quantum 360 4 1022A029-100 White/Mid Grey US Size 8.5,Asics Women's Gel-Quantum 360 4 1022A029-100 White/Mid Grey US Size 8.5,FBALYB Amazon,34,34,0,0,0,0
,Asics Women's Gel-Quantum 360 4 1022A029-100 White/Mid Grey US Size 9,Asics Women's Gel-Quantum 360 4 1022A029-100 White/Mid Grey US Size 9,Default,0,0,0,0,0,1
,Asics Women's Gel-Quantum 360 4 1022A029-100 White/Mid Grey US Size 9,Asics Women's Gel-Quantum 360 4 1022A029-100 White/Mid Grey US Size 9,FBALYB Amazon,32,32,0,0,0,0
,Asics Women's Gel-Quantum 360 4 1022A029-100 White/Mid Grey US Size 9.5,Asics Women's Gel-Quantum 360 4 1022A029-100 White/Mid Grey US Size 9.5,Default,0,0,0,0,0,1
,Asics Women's Gel-Quantum 360 4 1022A029-100 White/Mid Grey US Size 9.5,Asics Women's Gel-Quantum 360 4 1022A029-100 White/Mid Grey US Size 9.5,FBALYB Amazon,30,30,0,0,0,0
,Asics Women's Gel-Quantum 360 4 1022A029-20 Carbon/Black US Size 10,Asics Women's Gel-Quantum 360 4 1022A029-20 Carbon/Black US Size 10,FBALYB Amazon,45,45,0,0,0,0
,Asics Women's Gel-Quantum 360 4 1022A029-20 Carbon/Black US Size 10.5,Asics Women's Gel-Quantum 360 4 1022A029-20 Carbon/Black US Size 10.5,Default Ridgefield,23,23,0,0,0,0
,Asics Women's Gel-Quantum 360 4 1022A029-20 Carbon/Black US Size 10.5,Asics Women's Gel-Quantum 360 4 1022A029-20 Carbon/Black US Size 10.5,FBALYB Amazon,22,22,0,0,0,0
,Asics Women's Gel-Quantum 360 4 1022A029-20 Carbon/Black US Size 7,Asics Women's Gel-Quantum 360 4 1022A029-20 Carbon/Black US Size 7,FBALYB Amazon,23,23,0,0,0,0
,Asics Women's Gel-Quantum 360 4 1022A029-20 Carbon/Black US Size 7.5,Asics Women's Gel-Quantum 360 4 1022A029-20 Carbon/Black US Size 7.5,FBALYB Amazon,36,36,0,0,0,0
,Asics Women's Gel-Quantum 360 4 1022A029-20 Carbon/Black US Size 8,Asics Women's Gel-Quantum 360 4 1022A029-20 Carbon/Black US Size 8,Default,0,0,0,0,0,1
,Asics Women's Gel-Quantum 360 4 1022A029-20 Carbon/Black US Size 8,Asics Women's Gel-Quantum 360 4 1022A029-20 Carbon/Black US Size 8,FBALYB Amazon,34,34,0,1,0,0
,Asics Women's Gel-Quantum 360 4 1022A029-20 Carbon/Black US Size 8.5,Asics Women's Gel-Quantum 360 4 1022A029-20 Carbon/Black US Size 8.5,Default,0,0,0,0,0,1
,Asics Women's Gel-Quantum 360 4 1022A029-20 Carbon/Black US Size 8.5,Asics Women's Gel-Quantum 360 4 1022A029-20 Carbon/Black US Size 8.5,FBALYB Amazon,43,42,1,0,1,0
,Asics Women's Gel-Quantum 360 4 1022A029-20 Carbon/Black US Size 9,Asics Women's Gel-Quantum 360 4 1022A029-20 Carbon/Black US Size 9,Default,0,0,0,0,0,1
,Asics Women's Gel-Quantum 360 4 1022A029-20 Carbon/Black US Size 9,Asics Women's Gel-Quantum 360 4 1022A029-20 Carbon/Black US Size 9,FBALYB Amazon,46,46,0,0,0,0
,Asics Women's Gel-Quantum 360 4 1022A029-20 Carbon/Black US Size 9.5,Asics Women's Gel-Quantum 360 4 1022A029-20 Carbon/Black US Size 9.5,FBALYB Amazon,45,45,0,0,0,0
,Asics Women's Gel-Quantum 360 Knit T778N-7690 Peach/Black/Onyx US Size 6,Asics Women's Gel-Quantum 360 Knit T778N-7690 Peach/Black/Onyx US Size 6,Default Ridgefield,12,12,0,0,0,0
,Asics Women's Gel-Quantum 360 Knit T778N-7690 Peach/Black/Onyx US Size 6.5,Asics Women's Gel-Quantum 360 Knit T778N-7690 Peach/Black/Onyx US Size 6.5,Default,0,0,0,0,0,1
,Asics Women's Gel-Quantum 360 Knit T778N-7690 Peach/Black/Onyx US Size 6.5,Asics Women's Gel-Quantum 360 Knit T778N-7690 Peach/Black/Onyx US Size 6.5,Default Ridgefield,10,10,0,0,0,0
,Asics Women's Gel-Quantum 360 Knit T778N-7690 Peach/Black/Onyx US Size 7,Asics Women's Gel-Quantum 360 Knit T778N-7690 Peach/Black/Onyx US Size 7,Default Ridgefield,13,13,0,0,0,0
,Asics Women's Gel-Quantum 360 Knit T778N-7690 Peach/Black/Onyx US Size 7.5,Asics Women's Gel-Quantum 360 Knit T778N-7690 Peach/Black/Onyx US Size 7.5,Default,0,0,0,0,0,1
,Asics Women's Gel-Quantum 360 Knit T778N-7690 Peach/Black/Onyx US Size 7.5,Asics Women's Gel-Quantum 360 Knit T778N-7690 Peach/Black/Onyx US Size 7.5,Default Ridgefield,5,5,0,0,0,0
,Asics Women's Gel-Quantum 360 Knit T778N-7690 Peach/Black/Onyx US Size 8,Asics Women's Gel-Quantum 360 Knit T778N-7690 Peach/Black/Onyx US Size 8,Default Ridgefield,16,16,0,0,0,0
,Asics Women's Gel-Quantum 360 Knit T778N-7690 Peach/Black/Onyx US Size 8.5,Asics Women's Gel-Quantum 360 Knit T778N-7690 Peach/Black/Onyx US Size 8.5,Default,0,0,0,0,0,2
,Asics Women's Gel-Quantum 360 Knit T778N-7690 Peach/Black/Onyx US Size 8.5,Asics Women's Gel-Quantum 360 Knit T778N-7690 Peach/Black/Onyx US Size 8.5,Default Ridgefield,3,3,0,0,0,0
,Asics Women's Gel-Quantum 360 Knit T778N-7690 Peach/Black/Onyx US Size 9,Asics Women's Gel-Quantum 360 Knit T778N-7690 Peach/Black/Onyx US Size 9,Default Ridgefield,4,4,0,0,0,0
,Asics Women's Gel-Quantum 360 Knit T778N-7690 Peach/Black/Onyx US Size 9.5,Asics Women's Gel-Quantum 360 Knit T778N-7690 Peach/Black/Onyx US Size 9.5,Default,0,0,0,0,0,3
,Asics Women's Gel-Quantum 360 Knit T778N-7690 Peach/Black/Onyx US Size 9.5,Asics Women's Gel-Quantum 360 Knit T778N-7690 Peach/Black/Onyx US Size 9.5,Default Ridgefield,2,2,0,0,0,0
,Asics Women's GT-1000 7- 1012A030-021 Mid Grey/Flash Coral 10,Asics Women's GT-1000 7- 1012A030-021 Mid Grey/Flash Coral 10,FBALYB Amazon,-6,-6,0,0,0,0
,Asics Women's GT-1000 7- 1012A030-021 Mid Grey/Flash Coral 11,Asics Women's GT-1000 7- 1012A030-021 Mid Grey/Flash Coral 11,FBALYB Amazon,-5,-5,0,0,0,0
,Asics Women's GT-1000 7- 1012A030-021 Mid Grey/Flash Coral 6,Asics Women's GT-1000 7- 1012A030-021 Mid Grey/Flash Coral 6,FBALYB Amazon,-4,-4,0,0,0,0
,Asics Women's GT-1000 7- 1012A030-021 Mid Grey/Flash Coral 7,Asics Women's GT-1000 7- 1012A030-021 Mid Grey/Flash Coral 7,FBALYB Amazon,-10,-10,0,0,0,0
,Asics Women's GT-1000 7- 1012A030-021 Mid Grey/Flash Coral 7.5,Asics Women's GT-1000 7- 1012A030-021 Mid Grey/Flash Coral 7.5,FBALYB Amazon,-9,-9,0,0,0,0
,Asics Women's GT-1000 7- 1012A030-021 Mid Grey/Flash Coral 8,Asics Women's GT-1000 7- 1012A030-021 Mid Grey/Flash Coral 8,FBALYB Amazon,-6,-6,0,0,0,0
,Asics Women's GT-1000 7- 1012A030-021 Mid Grey/Flash Coral 8.5,Asics Women's GT-1000 7- 1012A030-021 Mid Grey/Flash Coral 8.5,FBALYB Amazon,-4,-4,0,0,0,0
,Asics Women's GT-1000 7- 1012A030-021 Mid Grey/Flash Coral 9,Asics Women's GT-1000 7- 1012A030-021 Mid Grey/Flash Coral 9,FBALYB Amazon,-8,-8,0,0,0,0
,Asics Women's GT-1000 7- 1012A030-021 Mid Grey/Flash Coral 9.5,Asics Women's GT-1000 7- 1012A030-021 Mid Grey/Flash Coral 9.5,FBALYB Amazon,-7,-7,0,0,0,0
,Assassin's Creed: The Ezio Collection for Xbox One,Assassin's Creed: The Ezio Collection for Xbox One,Default,0,0,0,0,0,11
,ASUS 16GB (Glacier Silver),"ASUS ZenFone 3 MAX ZC520TL Smartphone, 5.2-inch, 16GB (Glacier Silver)",Default,0,0,0,0,0,4
,ASUS 16GB (Glacier Silver),"ASUS ZenFone 3 MAX ZC520TL Smartphone, 5.2-inch, 16GB (Glacier Silver)",FBALYB Amazon,-30,-30,0,0,0,0
,Asus AC3100 Router, Asus Wireless AC3100 Gigabit Router (RT-AC3100),FBALYB Amazon,-1,-1,0,0,0,0
,AU-CPG0-FMM2,Shark Rocket TruePet Ultra-Light Upright (HV322),Default,0,-156,156,0,0,0
,AU-CPG0-FMM2,Shark Rocket TruePet Ultra-Light Upright (HV322),FBALYB Amazon,0,0,0,33,0,0
,"Aunt Jemima Syrup, Original 64oz","Aunt Jemima Syrup, Original 64oz",FBALYB Amazon,39,39,0,0,0,0
,Avalon Organics Tea Tree Shampoo 32oz,Avalon Organics Tea Tree Shampoo 32oz,Default,0,-28,28,0,0,0
,"Aveda 5 Volume Color Catalyst Liquid Developer, Hair Color 30 oz","Aveda 5 Volume Color Catalyst Liquid Developer, Hair Color 30 oz",Default Ridgefield,3,3,0,0,0,0
,Aveda Air Control 300ml,Aveda Air Control 300ml,Default Ridgefield,786,786,0,0,0,0
,Aveda Air Control 300ml,Aveda Air Control 300ml,FBALYB Amazon,1100,1092,8,0,8,0
,Aveda Aveda Thickening Tonic 100ml,Aveda Aveda Thickening Tonic 100ml,Default,0,0,0,0,0,21
,Aveda Aveda Thickening Tonic 100ml,Aveda Aveda Thickening Tonic 100ml,Default Ridgefield,1413,1413,0,0,0,0
,Aveda Aveda Thickening Tonic 100ml,Aveda Aveda Thickening Tonic 100ml,FBALYB Amazon,340,325,15,1,15,0
,Aveda Beautifying Body Moisturizer 200 ml,Aveda Beautifying Body Moisturizer 200 ml,Default,0,0,0,0,0,41
,Aveda Beautifying Body Polishing Treatment 15.5oz,Aveda Beautifying Body Polishing Treatment 15.5oz,FBALYB Amazon,31,31,0,0,0,0
,Aveda Beautifying Composition 50 ml,Aveda Beautifying Composition 50 ml,Default,0,0,0,0,0,4
,Aveda Beautifying Composition 50 ml,Aveda Beautifying Composition 50 ml,Default Ridgefield,5,5,0,0,0,0
,Aveda Beautifying Creme Cleansing Oil 200 ml,Aveda Beautifying Creme Cleansing Oil 200 ml,Default,0,0,0,0,0,59
,Aveda Beautifying Creme Cleansing Oil 200 ml,Aveda Beautifying Creme Cleansing Oil 200 ml,Default Ridgefield,34,34,0,0,0,0
,Aveda Be Curly Conditioner 1 Liter,Aveda Be Curly Conditioner 1 Liter,Default,0,0,0,0,0,1
,Aveda Be Curly Conditioner 1 Liter,Aveda Be Curly Conditioner 1 Liter,Default Ridgefield,51,51,0,0,0,0
,Aveda Be Curly Conditioner 1 Liter,Aveda Be Curly Conditioner 1 Liter,FBALYB Amazon,11,11,0,0,0,0
,Aveda - Be Curly Conditioner 200 Ml,Aveda - Be Curly Conditioner 200 Ml,Default,0,0,0,0,0,88
,Aveda - Be Curly Conditioner 200 Ml,Aveda - Be Curly Conditioner 200 Ml,Default Ridgefield,602,602,0,0,0,0
,Aveda - Be Curly Conditioner 200 Ml,Aveda - Be Curly Conditioner 200 Ml,FBALYB Amazon,-3,-3,0,0,0,0
,Aveda Be Curly Conditioner 200ml + Be Curly Curl Enhancer 200ml + Be Curly Shampoo 250 ML Bundle,Aveda Be Curly Conditioner 200ml + Be Curly Curl Enhancer 200ml + Be Curly Shampoo 250ml Bundle,FBALYB Amazon,-43,-43,0,0,0,0
,Aveda - Be Curly Conditioner 200 Ml & Be Curly Shampoo 250 ML Duo,Aveda - Be Curly Conditioner 200 Ml & Be Curly Shampoo 250 ML Duo,FBALYB Amazon,0,0,0,18,0,0
,Aveda Be Curly Co-Wash 1 Liter,Aveda Be Curly Co-Wash 1 Liter,Default Ridgefield,42,42,0,0,0,0
,Aveda Be Curly Co-Wash 250ml,Aveda Be Curly Co-Wash 250ml,Default,0,0,0,0,0,13
,Aveda Be Curly Co-Wash 250ml,Aveda Be Curly Co-Wash 250ml,Default Ridgefield,89,89,0,0,0,0
,Aveda Be Curly Curl Controller 200 ml,Aveda Be Curly Curl Controller 200 ml,Default Ridgefield,75,75,0,0,0,0
,Aveda Be Curly Curl Enhancer 200ml,Aveda Be Curly Curl Enhancer 200ml,Default,0,0,0,0,0,51
,Aveda Be Curly Curl Enhancer 200ml,Aveda Be Curly Curl Enhancer 200ml,Default Ridgefield,3251,3251,0,0,0,0
,Aveda Be Curly Curl Enhancer 200ml,Aveda Be Curly Curl Enhancer 200ml,FBALYB Amazon,3,3,0,0,0,0
,Aveda Be Curly Detangling Masque 150ml,Aveda Be Curly Detangling Masque 150ml,Default,0,0,0,0,0,11
,Aveda Be Curly Detangling Masque 150ml,Aveda Be Curly Detangling Masque 150ml,Default Ridgefield,13,13,0,0,0,0
,Aveda Be Curly Detangling Masque 500ml,Aveda Be Curly Detangling Masque 500ml,Default Ridgefield,30,30,0,0,0,0
,Aveda Be Curly Enhancing Hair Spray 200ml,Aveda Be Curly Enhancing Hair Spray 200ml,Default,0,0,0,0,0,39
,Aveda Be Curly Enhancing Hair Spray 200ml,Aveda Be Curly Enhancing Hair Spray 200ml,Default Ridgefield,20,20,0,0,0,0
,Aveda Be Curly Shampoo 1 Liter,Aveda Be Curly Shampoo 1 Liter,Default,0,0,0,0,0,7
,Aveda Be Curly Shampoo 1 Liter,Aveda Be Curly Shampoo 1 Liter,Default Ridgefield,20,20,0,0,0,0
,Aveda Be Curly Shampoo 1 Liter,Aveda Be Curly Shampoo 1 Liter,FBALYB Amazon,2,2,0,0,0,0
,Aveda Be Curly Shampoo 250 ML,Aveda Be Curly Shampoo 250 ML,Default,0,0,0,0,0,84
,Aveda Be Curly Shampoo 250 ML,Aveda Be Curly Shampoo 250 ML,Default Ridgefield,585,585,0,0,0,0
,Aveda Be Curly Style Prep 100ml,Aveda Be Curly Style Prep 100ml,Default,0,0,0,0,0,14
,Aveda Be Curly Style Prep 100ml,Aveda Be Curly Style Prep 100ml,Default Ridgefield,56,56,0,0,0,0
,Aveda Black Malva Conditioner 250 ml,Aveda Black Malva Conditioner 250 ml,Default,0,0,0,0,0,45
,Aveda Black Malva Conditioner 250 ml,Aveda Black Malva Conditioner 250 ml,FBALYB Amazon,2,2,0,0,0,0
,Aveda Black Malva Shampoo 1 Liter,Aveda Black Malva Shampoo 1 Liter,Default,0,0,0,0,0,32
,Aveda Black Malva Shampoo 1 Liter,Aveda Black Malva Shampoo 1 Liter,Default Ridgefield,33,33,0,0,0,0
,Aveda Blue Malva Conditioner 250 ml,Aveda Blue Malva Conditioner 250 ml,Default,0,0,0,0,0,1
,Aveda - Blue Malva Shampoo 1L,Aveda - Blue Malva Shampoo 1L,Default,0,0,0,0,0,6
,Aveda - Blue Malva Shampoo 1L,Aveda - Blue Malva Shampoo 1L,Default Ridgefield,1024,1024,0,0,0,0
,Aveda - Blue Malva Shampoo 1L,Aveda - Blue Malva Shampoo 1L,FBALYB Amazon,215,214,1,215,1,0
,Aveda Botanical Kinetics All Sensitive Lotion 150 ml,Aveda Botanical Kinetics All Sensitive Lotion 150 ml,Default,0,0,0,0,0,1
,Aveda Botanical Kinetics Deep Cleansing Herbal Masque 125 ml,Aveda Botanical Kinetics Deep Cleansing Herbal Masque 125 ml,Default,0,0,0,0,0,1
,Aveda Botanical Kinetics Deep Cleansing Herbal Masque 125 ml,Aveda Botanical Kinetics Deep Cleansing Herbal Masque 125 ml,Default Ridgefield,47,47,0,0,0,0
,Aveda Botanical Kinetics Exfoliant 150 ml,Aveda Botanical Kinetics Exfoliant 150 ml,Default Ridgefield,379,379,0,0,0,0
,Aveda Botanical Kinetics Exfoliant 150 ml,Aveda Botanical Kinetics Exfoliant 150 ml,FBALYB Amazon,-2,-2,0,0,0,0
,Aveda Botanical Kinetics Exfoliant 150 ml,Aveda Botanical Kinetics Exfoliant 150 ml,FBALYB Canada,173,173,0,0,0,0
,Aveda Botanical Kinetics Eye Creme 15 ml,Aveda Botanical Kinetics Eye Creme 15 ml,Default,0,0,0,0,0,7
,Aveda Botanical Kinetics Eye Creme 15 ml,Aveda Botanical Kinetics Eye Creme 15 ml,FBALYB Amazon,1,1,0,0,0,0
,Aveda - Botanical Kinetics Hydrating Lotion 150 Ml,Aveda - Botanical Kinetics Hydrating Lotion 150 Ml,Default,0,0,0,0,0,4
,Aveda - Botanical Kinetics Hydrating Lotion 150 Ml,Aveda - Botanical Kinetics Hydrating Lotion 150 Ml,FBALYB Amazon,19,19,0,1,0,0
,Aveda - Botanical Kinetics Hydrating Lotion Bb 500 Ml,Aveda - Botanical Kinetics Hydrating Lotion Bb 500 Ml,Default,0,0,0,0,0,4
,Aveda - Botanical Kinetics Hydrating Lotion Bb 500 Ml,Aveda - Botanical Kinetics Hydrating Lotion Bb 500 Ml,Default Ridgefield,240,240,0,0,0,0
,Aveda - Botanical Kinetics Hydrating Lotion Bb 500 Ml,Aveda - Botanical Kinetics Hydrating Lotion Bb 500 Ml,FBALYB Amazon,1,1,0,0,0,0
,Aveda Botanical Kinetics Infinity Air Starter Set,Aveda Botanical Kinetics Infinity Air Starter Set,Default,0,0,0,0,0,24
,Aveda Botanical Kinetics Infinity Air Starter Set,Aveda Botanical Kinetics Infinity Air Starter Set,Default Ridgefield,5,5,0,0,0,0
,Aveda Botanical Kinetics Purifying Creme Cleanser,Aveda Botanical Kinetics Purifying Creme Cleanser 150 ml,Default Ridgefield,5,5,0,0,0,0
,Aveda - Botanical Kinetics Purifying Gel Cleanser 150 Ml,Aveda - Botanical Kinetics Purifying Gel Cleanser 150 Ml,FBALYB Amazon,85,85,0,0,0,0
,Aveda Botanical Kinetics Rich Creme 150 ml,Aveda Botanical Kinetics Rich Creme 150 ml,Default,0,0,0,0,0,2
,Aveda - Botanical Kinetics Rich Creme 50Ml,Aveda - Botanical Kinetics Rich Creme 50Ml,Default,0,0,0,0,0,2
,Aveda - Botanical Kinetics Rich Creme 50Ml,Aveda - Botanical Kinetics Rich Creme 50Ml,Default Ridgefield,330,330,0,0,0,0
,Aveda Botanical Kinetics Skin Refiner 100 ml,Aveda Botanical Kinetics Skin Refiner 100 ml,Default Ridgefield,40,40,0,0,0,0
,Aveda Botanical Kinetics SOFT Creme 150 ml,Aveda Botanical Kinetics SOFT Creme 150 ml,Default,0,0,0,0,0,2
,Aveda Botanical Kinetics Soft Creme 50 ml,Aveda Botanical Kinetics Soft Creme 50 ml,Default Ridgefield,0,-31,31,0,0,0
,Aveda - Botanical Kinetics Toning Mist 150 Ml,Aveda - Botanical Kinetics Toning Mist 150 Ml,Default Ridgefield,295,295,0,0,0,0
,Aveda - Botanical Kinetics Toning Mist 150 Ml,Aveda - Botanical Kinetics Toning Mist 150 Ml,FBALYB Amazon,118,118,0,0,0,0
,Aveda Botanical Kinetics Toning Mist 500 ml,Aveda Botanical Kinetics Toning Mist 500 ml,Default,0,0,0,0,0,2
,Aveda Botanical Kinetics Treatment Lotion 150 ml,Aveda Botanical Kinetics Treatment Lotion 150 ml,Default,0,0,0,0,0,5
,Aveda Botanical Kinetics Treatment Lotion 150 ml,Aveda Botanical Kinetics Treatment Lotion 150 ml,FBALYB Amazon,-1,-1,0,0,0,0
,Aveda Brilliant Anti-humectant Pomade 75 ml,Aveda Brilliant Anti-humectant Pomade 75 ml,Default,0,0,0,0,0,1
,Aveda Brilliant Anti-humectant Pomade 75 ml,Aveda Brilliant Anti-humectant Pomade 75 ml,Default Ridgefield,258,258,0,0,0,0
,Aveda Brilliant Anti-humectant Pomade 75 ml,Aveda Brilliant Anti-humectant Pomade 75 ml,FBALYB Amazon,0,0,0,7,0,0
,Aveda Brilliant Conditioner 1 Liter,Aveda Brilliant Conditioner 1 Liter,Default,0,0,0,0,0,4
,Aveda Brilliant Conditioner 1 Liter,Aveda Brilliant Conditioner 1 Liter,Default Ridgefield,43,43,0,0,0,0
,Aveda Brilliant Conditioner 200 ml + Aveda Brilliant Shampoo 250 ML Duo,Aveda Brilliant Conditioner 200 ml + Aveda Brilliant Shampoo 250 ML Duo,FBALYB Amazon,2,2,0,0,0,0
,Aveda Brilliant Damage Control Spray 250 ml,Aveda Brilliant Damage Control Spray 250 ml,Default,0,0,0,0,0,4
,Aveda Brilliant Damage Control Spray 250 ml,Aveda Brilliant Damage Control Spray 250 ml,Default Ridgefield,3,3,0,0,0,0
,Aveda Brilliant Damage Control Spray 250 ml,Aveda Brilliant Damage Control Spray 250 ml,FBALYB Amazon,1,1,0,0,0,0
,Aveda Brilliant Damage Control Treatment 1 Liter,Aveda Brilliant Damage Control Treatment 1 Liter,Default Ridgefield,18,18,0,0,0,0
,Aveda Brilliant Emollient Finishing Gloss 75 ml,Aveda Brilliant Emollient Finishing Gloss 75 ml,Default,0,0,0,0,0,2
,Aveda Brilliant Emollient Finishing Gloss 75 ml,Aveda Brilliant Emollient Finishing Gloss 75 ml,FBALYB Amazon,-1,-1,0,0,0,0
,Aveda Brilliant Hair Spray 250ml,Aveda Brilliant Hair Spray 250ml,Avrami - Ebay,1,1,0,0,0,0
,Aveda Brilliant Hair Spray 250ml,Aveda Brilliant Hair Spray 250ml,Default,0,0,0,0,0,4
,Aveda Brilliant Hair Spray 250ml,Aveda Brilliant Hair Spray 250ml,Default Ridgefield,119,119,0,0,0,0
,Aveda Brilliant Hair Spray 250ml,Aveda Brilliant Hair Spray 250ml,FBALYB Amazon,60,59,1,0,1,0
,Aveda Brilliant Humectant Pomade 75 ml,Aveda Brilliant Humectant Pomade 75 ml,Default,0,0,0,0,0,7
,Aveda Brilliant Humectant Pomade 75 ml,Aveda Brilliant Humectant Pomade 75 ml,Default Ridgefield,747,747,0,0,0,0
,Aveda Brilliant Humectant Pomade 75 ml,Aveda Brilliant Humectant Pomade 75 ml,FBALYB Amazon,111,111,0,0,0,0
,Aveda Brilliant Shampoo 1 Liter,Aveda Brilliant Shampoo 1 Liter,Default,0,0,0,0,0,13
,Aveda Brilliant Shampoo 1 Liter,Aveda Brilliant Shampoo 1 Liter,FBALYB Amazon,4,4,0,0,0,0
,Aveda Brilliant Shampoo 250 ML,Aveda Brilliant Shampoo 250 ML,Default,0,0,0,0,0,1
,Aveda Brilliant Shampoo 250 ML,Aveda Brilliant Shampoo 250 ML,Default Ridgefield,1,1,0,0,0,0
,Aveda Brilliant Shampoo 250 ML,Aveda Brilliant Shampoo 250 ML,FBALYB Amazon,3,3,0,0,0,0
,Aveda Brilliant Spray on Shine 100 ml,Aveda Brilliant Spray on Shine 100 ml,Default Ridgefield,271,271,0,0,0,0
,Aveda Brilliant Spray on Shine 100 ml,Aveda Brilliant Spray on Shine 100 ml,FBALYB Amazon,58,58,0,0,0,0
,Aveda Brill Retex Gel  150ml,Aveda Brill Retex Gel  150ml,Default,0,-73,73,0,0,0
,Aveda Brill Retex Gel  150ml,Aveda Brill Retex Gel  150ml,Default Ridgefield,17,17,0,0,0,0
,Aveda Brill Retex Gel  150ml,Aveda Brill Retex Gel  150ml,FBALYB Amazon,-5,-5,0,3,0,0
,Aveda Camomile Conditioner 250 ml,Aveda Camomile Conditioner 250 ml,FBALYB Amazon,-1,-1,0,1,0,0
,Aveda - Camomile Shampoo 1L,Aveda - Camomile Shampoo 1L,Default,0,0,0,0,0,3
,Aveda - Camomile Shampoo 1L,Aveda - Camomile Shampoo 1L,Default Ridgefield,180,180,0,0,0,0
,Aveda - Camomile Shampoo 1L,Aveda - Camomile Shampoo 1L,FBALYB Amazon,94,94,0,0,0,0
,Aveda Chakra Balancing Body Mist 1 100 ml,Aveda Chakra Balancing Body Mist 1 100 ml,Default,0,0,0,0,0,1
,Aveda Chakra Balancing Body Mist 1 100 ml,Aveda Chakra Balancing Body Mist 1 100 ml,Default Ridgefield,10,10,0,0,0,0
,Aveda Chakra Balancing Body Mist 2 100 ml,Aveda Chakra Balancing Body Mist 2 100 ml,Default,0,0,0,0,0,2
,Aveda Chakra Balancing Body Mist 2 100 ml,Aveda Chakra Balancing Body Mist 2 100 ml,Default Ridgefield,8,8,0,0,0,0
,Aveda Chakra Balancing Body Mist 3 100 ml,Aveda Chakra Balancing Body Mist 3 100 ml,Default,0,0,0,0,0,16
,Aveda Chakra Balancing Body Mist 4 100 ml,Aveda Chakra Balancing Body Mist 4 100 ml,Default,0,0,0,0,0,2
,Aveda Chakra Balancing Body Mist 4 100 ml,Aveda Chakra Balancing Body Mist 4 100 ml,Default Ridgefield,13,13,0,0,0,0
,Aveda Chakra Balancing Body Mist 5 100 ml,Aveda Chakra Balancing Body Mist 5 100 ml,Default,0,0,0,0,0,4
,Aveda Chakra Balancing Body Mist 5 100 ml,Aveda Chakra Balancing Body Mist 5 100 ml,Default Ridgefield,7,7,0,0,0,0
,Aveda Chakra Balancing Body Mist 6 100 ml,Aveda Chakra Balancing Body Mist 6 100 ml,Default,0,0,0,0,0,8
,Aveda Chakra Balancing Body Mist 6 100 ml,Aveda Chakra Balancing Body Mist 6 100 ml,Default Ridgefield,8,8,0,0,0,0
,Aveda Chakra Balancing Body Mist 6 100 ml,Aveda Chakra Balancing Body Mist 6 100 ml,FBALYB Amazon,-5,-5,0,0,0,0
,Aveda Chakra Balancing Body Mist 7 100 ml,Aveda Chakra Balancing Body Mist 7 100 ml,Default,0,0,0,0,0,12
,Aveda Cherry Almond Hand and Body Wash 250 ml,Aveda Cherry Almond Hand and Body Wash 250 ml,Default,0,0,0,0,0,1
,Aveda Cherry Almond Hand and Body Wash 250 ml,Aveda Cherry Almond Hand and Body Wash 250 ml,Default Ridgefield,11,11,0,0,0,0
,Aveda Cherry Almond Softening Conditioner 200 ml,Aveda Cherry Almond Softening Conditioner 200 ml,Default,0,0,0,0,0,45
,Aveda Cherry Almond Softening Conditioner 200 ml,Aveda Cherry Almond Softening Conditioner 200 ml,Default Ridgefield,758,758,0,0,0,0
,Aveda Cherry Almond Softening Conditioner 200 ml,Aveda Cherry Almond Softening Conditioner 200 ml,FBALYB Amazon,-1,-1,0,0,0,0
,Aveda Cherry Almond Softening Leave-In Conditioner 200 ml,Aveda Cherry Almond Softening Leave-In Conditioner 200 ml,Default Ridgefield,510,510,0,0,0,0
,Aveda Clove Conditioner 250 ml,Aveda Clove Conditioner 250 ml,FBALYB Amazon,-1,-1,0,1,0,0
,Aveda - Clove Shampoo 1L,Aveda - Clove Shampoo 1L,Default,0,0,0,0,0,16
,Aveda - Clove Shampoo 1L,Aveda - Clove Shampoo 1L,FBALYB Amazon,9,9,0,1,0,0
,Aveda - Color Conserve Conditioner 1L,Aveda - Color Conserve Conditioner 1L,Default,0,-16,16,0,0,12
,Aveda - Color Conserve Conditioner 1L,Aveda - Color Conserve Conditioner 1L,Default Ridgefield,5,5,0,0,0,0
,Aveda Color Conserve Conditioner 200ml,Aveda Color Conserve Conditioner 200ml,Default,0,0,0,0,0,5
,Aveda Color Conserve Daily Protect Treatment 100 ml,Aveda Color Conserve Daily Protect Treatment 100 ml,Default,0,0,0,0,0,8
,Aveda Color Conserve Daily Protect Treatment 100 ml,Aveda Color Conserve Daily Protect Treatment 100 ml,Default Ridgefield,10,10,0,0,0,0
,Aveda Color Conserve Daily Protect Treatment 100 ml,Aveda Color Conserve Daily Protect Treatment 100 ml,FBALYB Amazon,-6,-6,0,0,0,0
,Aveda Color Conserve Shampoo 1L,Aveda Color Conserve Shampoo 1L,Default,0,-16,16,0,0,2
,Aveda Color Conserve Shampoo 1L,Aveda Color Conserve Shampoo 1L,Default Ridgefield,6,6,0,0,0,0
,Aveda Color Conserve Shampoo 1L,Aveda Color Conserve Shampoo 1L,FBALYB Amazon,345,345,0,0,0,0
,Aveda Color Conserve Shampoo 250ml,Aveda Color Conserve Shampoo 250ml,Default,0,-79,79,0,0,44
,Aveda Color Conserve Shampoo 250ml,Aveda Color Conserve Shampoo 250ml,Default Ridgefield,517,517,0,0,0,0
,Aveda Color Conserve Shampoo 250ml,Aveda Color Conserve Shampoo 250ml,FBALYB Amazon,-4,-4,0,0,0,0
,Aveda Color Conserve Shampoo 250 ML + Conditioner 200 ML,Aveda Color Conserve Shampoo 250 ML + Conditioner 200 ML,FBALYB Amazon,-5,-5,0,0,0,0
,Aveda Color Conserve Shampoo + Conditoner 33.8 oz,Aveda Color Conserve Shampoo + Conditoner 33.8 oz,FBALYB Amazon,1,1,0,0,0,0
,Aveda Color Conserve Shampoo Travel Size 50 ml,Aveda Color Conserve Shampoo Travel Size 50 ml,Default Ridgefield,32,32,0,0,0,0
,Aveda Color Conserve Strengthening Treatment 125 ml,Aveda Color Conserve Strengthening Treatment 125 ml,Default Ridgefield,13,13,0,0,0,0
,Aveda Color Conserve Strengthening Treatment 125 ml,Aveda Color Conserve Strengthening Treatment 125 ml,FBALYB Amazon,38,36,2,0,2,0
,Aveda Comforting Loose Leaf Tea 1000gr,Aveda Comforting Loose Leaf Tea 1000gr,Default,0,0,0,0,0,8
,Aveda Comforting Tea 140gr,Aveda Comforting Tea 140gr,Default,0,0,0,0,0,2
,Aveda Confixor Liquid Gel 250ml,Aveda Confixor Liquid Gel 250ml,Default,0,0,0,0,0,15
,Aveda Confixor Liquid Gel 250ml,Aveda Confixor Liquid Gel 250ml,Default Ridgefield,100,100,0,0,0,0
,Aveda Confixor Liquid Gel 250ml,Aveda Confixor Liquid Gel 250ml,FBALYB Amazon,-15,-15,0,16,0,0
,Aveda Control Force 300ml,Aveda Control Force 300ml,Default,0,-300,300,0,0,60
,Aveda Control Force 300ml,Aveda Control Force 300ml,Default Ridgefield,730,729,1,0,0,0
,Aveda Control Force 300ml,Aveda Control Force 300ml,FBALYB Amazon,187,187,0,0,0,0
,Aveda Control Paste Finishing Paste 75ml,Aveda Control Paste Finishing Paste 75ml,Default,0,0,0,0,0,22
,Aveda Control Paste Finishing Paste 75ml,Aveda Control Paste Finishing Paste 75ml,Default Ridgefield,85,85,0,0,0,0
,Aveda Control Paste Finishing Paste 75ml,Aveda Control Paste Finishing Paste 75ml,FBALYB Amazon,5,5,0,0,0,0
,Aveda Control Paste Finishing Paste 75ml,Aveda Control Paste Finishing Paste 75ml,FBALYB Canada,0,0,0,20,0,0
,Aveda Cooling Balancing Oil Concentrate 50 ml,Aveda Cooling Balancing Oil Concentrate 50 ml,Default,0,0,0,0,0,2
,Aveda Cooling Balancing Oil Concentrate 50 ml,Aveda Cooling Balancing Oil Concentrate 50 ml,Default Ridgefield,4,4,0,0,0,0
,Aveda Cooling Balancing Oil Concentrate Rollerball 7 ml,Aveda Cooling Balancing Oil Concentrate Rollerball 7 ml,Default,0,0,0,0,0,1
,Aveda Damage Remedy Conditioner 1 Liter,Aveda Damage Remedy Conditioner 1 Liter,Default Ridgefield,8,8,0,0,0,0
,Aveda - Damage Remedy Daily Repair 100Ml,Aveda - Damage Remedy Daily Repair 100Ml,Default Ridgefield,1843,1843,0,0,0,0
,Aveda - Damage Remedy Daily Repair 100Ml,Aveda - Damage Remedy Daily Repair 100Ml,FBALYB Amazon,4,4,0,9,0,0
,Aveda Damage Remedy Intensive Reconstructing Treatment 150 ML,Aveda Damage Remedy Intensive Reconstructing Treatment 150 ML,FBALYB Amazon,-1,-1,0,0,0,0
,Aveda - Damage Remedy Intensive Restructuring Treatment 150 Ml,Aveda - Damage Remedy Intensive Restructuring Treatment 150 Ml,Default Ridgefield,30,30,0,0,0,0
,Aveda - Damage Remedy Intensive Restructuring Treatment 150 Ml,Aveda - Damage Remedy Intensive Restructuring Treatment 150 Ml,FBALYB Amazon,1,1,0,0,0,0
,Aveda Damage Remedy Intensive Restructuring Treatment  Mezzo 500 ml,Aveda Damage Remedy Intensive Restructuring Treatment  Mezzo 500 ml,Default,0,0,0,0,0,13
,Aveda Damage Remedy Intensive Restructuring Treatment  Mezzo 500 ml,Aveda Damage Remedy Intensive Restructuring Treatment  Mezzo 500 ml,Default Ridgefield,67,67,0,0,0,0
,Aveda Damage Remedy Moisturizing Shampoo Travel Size 40 ml,Aveda Damage Remedy Moisturizing Shampoo Travel Size 40 ml,Default,0,0,0,0,0,1
,Aveda Damage Remedy Moisturizing Shampoo Travel Size 40 ml,Aveda Damage Remedy Moisturizing Shampoo Travel Size 40 ml,Default Ridgefield,12,12,0,0,0,0
,Aveda Damage Remedy Reconstructing Conditioner 200 ML,Aveda Damage Remedy Reconstructing Conditioner 200 ML,Default,0,0,0,0,0,1
,Aveda Damage Remedy Reconstructing Conditioner 200 ML,Aveda Damage Remedy Reconstructing Conditioner 200 ML,Default Ridgefield,900,900,0,0,0,0
,Aveda Damage Remedy Reconstructing Conditioner 200 ML,Aveda Damage Remedy Reconstructing Conditioner 200 ML,FBALYB Amazon,371,370,1,0,1,0
,Aveda Damage Remedy Reconstructing Conditioner 200 ML + Damage Remedy Reconstructing Shampoo 250 ML Duo,Aveda Damage Remedy Reconstructing Conditioner 200 ML + Damage Remedy Reconstructing Shampoo 250 ML Duo,FBALYB Amazon,1,1,0,1,0,0
,Aveda Damage Remedy Reconstructing Shampoo 1 Liter,Aveda Damage Remedy Reconstructing Shampoo 1 Liter,Default,0,0,0,0,0,16
,Aveda Damage Remedy Reconstructing Shampoo 1 Liter,Aveda Damage Remedy Reconstructing Shampoo 1 Liter,Default Ridgefield,4,4,0,0,0,0
,Aveda Damage Remedy Reconstructing Shampoo 250 ML,Aveda Damage Remedy Reconstructing Shampoo 250 ML,Default,0,0,0,0,0,25
,Aveda Damage Remedy Reconstructing Shampoo 250 ML,Aveda Damage Remedy Reconstructing Shampoo 250 ML,Default Ridgefield,700,700,0,0,0,0
,Aveda Damage Remedy Reconstructing Shampoo 250 ML,Aveda Damage Remedy Reconstructing Shampoo 250 ML,FBALYB Amazon,5,5,0,1,0,0
,Aveda Damage Remedy Split End Repair 30 ml,Aveda Damage Remedy Split End Repair 30 ml,Default,0,0,0,0,0,20
,Aveda Damage Remedy Split End Repair 30 ml,Aveda Damage Remedy Split End Repair 30 ml,Default Ridgefield,7,7,0,0,0,0
,Aveda Dry Remedy Moisturizing Conditioner 1 Liter,Aveda Dry Remedy Moisturizing Conditioner 1 Liter,Default,0,0,0,0,0,12
,Aveda Dry Remedy Moisturizing Conditioner 1 Liter,Aveda Dry Remedy Moisturizing Conditioner 1 Liter,Default Ridgefield,3,3,0,0,0,0
,Aveda Dry Remedy Moisturizing Conditioner 200 ML,Aveda Dry Remedy Moisturizing Conditioner 200 ML,Default Ridgefield,70,70,0,0,0,0
,Aveda Dry Remedy Moisturizing Conditioner 200 ML + Dry Remedy Moisturizing Shampoo 250 ml  Duo,Aveda Dry Remedy Moisturizing Conditioner 200 ML + Dry Remedy Moisturizing Shampoo 250 ml  Duo,FBALYB Amazon,2,2,0,0,0,0
,Aveda Dry Remedy Moisturizing Conditioner + Dry Remedy Moisturizing Shampoo 1 Liter Duo,Aveda Dry Remedy Moisturizing Conditioner + Dry Remedy Moisturizing Shampoo 1 Liter Duo,FBALYB Amazon,1,1,0,0,0,0
,Aveda Dry Remedy Moisturizing Masque 150 ML,Aveda Dry Remedy Moisturizing Masque 150 ML,Default Ridgefield,182,182,0,0,0,0
,Aveda Dry Remedy Moisturizing Masque 150 ML,Aveda Dry Remedy Moisturizing Masque 150 ML,FBALYB Amazon,1,1,0,0,0,0
,Aveda Dry Remedy Moisturizing Masque 150 ML,Aveda Dry Remedy Moisturizing Masque 150 ML,FBALYB Canada,0,0,0,15,0,0
,Aveda Dry Remedy Moisturizing Masque Mezzo 500 ml,Aveda Dry Remedy Moisturizing Masque Mezzo 500 ml,Default,0,0,0,0,0,2
,Aveda Dry Remedy Moisturizing Masque Mezzo 500 ml,Aveda Dry Remedy Moisturizing Masque Mezzo 500 ml,Default Ridgefield,7,7,0,0,0,0
,Aveda Dry Remedy Moisturizing Oil 25ml,Aveda Dry Remedy Moisturizing Oil 25ml,Default,0,0,0,0,0,15
,Aveda Dry Remedy Moisturizing Shampoo 1 Liter,Aveda Dry Remedy Moisturizing Shampoo 1 Liter,Default,0,0,0,0,0,3
,Aveda Dry Remedy Moisturizing Shampoo 1 Liter,Aveda Dry Remedy Moisturizing Shampoo 1 Liter,Default Ridgefield,12,12,0,0,0,0
,Aveda Dry Remedy Moisturizing Shampoo 250 ml,Aveda Dry Remedy Moisturizing Shampoo 250 ml,Default Ridgefield,2,2,0,0,0,0
,Aveda Dry Remedy Moisturizing Shampoo 250 ml,Aveda Dry Remedy Moisturizing Shampoo 250 ml,FBALYB Amazon,-2,-2,0,0,0,0
,Aveda Dry Remedy Moisturizing Shampoo Travel Size 50 ml,Aveda Dry Remedy Moisturizing Shampoo Travel Size 50 ml,Default Ridgefield,1,1,0,0,0,0
,Aveda Dry Remedy Moisturizing Shampoo Travel Size 50 ml,Aveda Dry Remedy Moisturizing Shampoo Travel Size 50 ml,FBALYB Amazon,8,8,0,0,0,0
,Aveda Dry Remedy Penetrating Treatment 250 ml,Aveda Dry Remedy Penetrating Treatment 250 ml,Default,0,0,0,0,0,2
,Aveda Essential Oil Lavander 30 ml,Aveda Essential Oil Lavander 30 ml,Default,0,0,0,0,0,5
,Aveda Essential Oil Patchouli 30 ml,Aveda Essential Oil Patchouli 30 ml,Default,0,0,0,0,0,1
,Aveda Essential Oil Tangerine 30 ml,Aveda Essential Oil Tangerine 30 ml,Default,0,0,0,0,0,2
,Aveda Essential Oil Vanilla 30 ml,Aveda Essential Oil Vanilla 30 ml,Default,0,0,0,0,0,3
,Aveda Flax Seed/Aloe Sculpturing Gel 250 ml,Aveda Flax Seed/Aloe Sculpturing Gel 250 ml,Default,0,0,0,0,0,15
,Aveda Flax Seed/Aloe Sculpturing Gel 250 ml,Aveda Flax Seed/Aloe Sculpturing Gel 250 ml,Default Ridgefield,562,562,0,0,0,0
,Aveda Flax Seed/Aloe Sculpturing Gel 250 ml,Aveda Flax Seed/Aloe Sculpturing Gel 250 ml,FBALYB Amazon,521,521,0,0,0,0
,Aveda Flax Seed/Aloe Sculpturing Gel 250 ml,Aveda Flax Seed/Aloe Sculpturing Gel 250 ml,FBALYB Canada,7,7,0,0,0,0
,Aveda Foot Relief Moisturizing Cream 125 ml,Aveda Foot Relief Moisturizing Cream 125 ml,Default,0,0,0,0,0,2
,Aveda Foot Relief Moisturizing Cream 125 ml,Aveda Foot Relief Moisturizing Cream 125 ml,Default Ridgefield,362,362,0,0,0,0
,Aveda Foot Relief Moisturizing Cream 125 ml,Aveda Foot Relief Moisturizing Cream 125 ml,FBALYB Amazon,175,175,0,2,0,0
,Aveda Hair Detoxifier Shampoo 1 Liter,Aveda Hair Detoxifier Shampoo 1 Liter,Default,0,0,0,0,0,3
,Aveda Hair Detoxifier Shampoo 1 Liter,Aveda Hair Detoxifier Shampoo 1 Liter,Default Ridgefield,2,2,0,0,0,0
,Aveda Hand Relief Moisturizing Cream 125 ml,Aveda Hand Relief Moisturizing Cream 125 ml,Default,0,0,0,0,0,5
,Aveda Hand Relief Moisturizing Cream 125 ml,Aveda Hand Relief Moisturizing Cream 125 ml,Default Ridgefield,665,665,0,0,0,0
,Aveda Hand Relief Moisturizing Cream 125 ml,Aveda Hand Relief Moisturizing Cream 125 ml,FBALYB Amazon,286,286,0,0,0,0
,Aveda Hand Relief Night Serum 30 ml,Aveda Hand Relief Night Serum 30 ml,Default,0,0,0,0,0,13
,Aveda Hand Relief Night Serum 30 ml,Aveda Hand Relief Night Serum 30 ml,Default Ridgefield,1,1,0,0,0,0
,Aveda - Hand Relief Travel Size 40 Ml,Aveda - Hand Relief Travel Size 40 Ml,Default Ridgefield,224,224,0,0,0,0
,Aveda - Hand Relief Travel Size 40 Ml,Aveda - Hand Relief Travel Size 40 Ml,FBALYB Amazon,54,47,7,0,7,0
,Aveda Invati Advanced Exfoliating Shampoo 1 Liter,Aveda Invati Advanced Exfoliating Shampoo 1 Liter,Default,0,0,0,0,0,9
,Aveda Invati Advanced Exfoliating Shampoo 1 Liter,Aveda Invati Advanced Exfoliating Shampoo 1 Liter,FBALYB Amazon,1,1,0,0,0,0
,Aveda Invati Advanced Exfoliating Shampoo 200ml,Aveda Invati Advanced Exfoliating Shampoo 200ml,Default,0,0,0,0,0,19
,Aveda Invati Advanced Exfoliating Shampoo 200ml,Aveda Invati Advanced Exfoliating Shampoo 200ml,Default Ridgefield,1386,1386,0,0,0,0
,Aveda Invati Advanced Exfoliating Shampoo 200ml,Aveda Invati Advanced Exfoliating Shampoo 200ml,FBALYB Amazon,-4,-4,0,0,0,0
,Aveda Invati Advanced Exfoliating Shampoo 200ml,Aveda Invati Advanced Exfoliating Shampoo 200ml,FBALYB Canada,4,3,1,0,1,0
,Aveda Invati Advanced Exfoliating Shampoo & Aveda Invati Advanced Thickening Conditioner 200ml,Aveda Invati Advanced Exfoliating Shampoo & Aveda Invati Advanced Thickening Conditioner 200ml,FBALYB Amazon,208,202,6,0,6,0
,Aveda Invati Advanced Scalp Revitalizer 150ml,Aveda Invati Advanced Scalp Revitalizer 150ml,Default,0,0,0,0,0,3
,Aveda Invati Advanced Scalp Revitalizer 150ml,Aveda Invati Advanced Scalp Revitalizer 150ml,Default Ridgefield,50,50,0,0,0,0
,Aveda Invati Advanced Scalp Revitalizer 150ml,Aveda Invati Advanced Scalp Revitalizer 150ml,FBALYB Amazon,-7,-7,0,1,0,0
,Aveda Invati Advanced Thickening Conditioner 1 Liter,Aveda Invati Advanced Thickening Conditioner 1 Liter,Default,0,0,0,0,0,3
,Aveda Invati Advanced Thickening Conditioner 200ml,Aveda Invati Advanced Thickening Conditioner 200ml,Default,0,-52,52,0,0,0
,Aveda Invati Advanced Thickening Conditioner 200ml,Aveda Invati Advanced Thickening Conditioner 200ml,Default Ridgefield,1110,1110,0,0,0,0
,Aveda Invati Advanced Thickening Conditioner 200ml,Aveda Invati Advanced Thickening Conditioner 200ml,FBALYB Amazon,-1,-1,0,0,0,0
,Aveda Invati Conditioner 1 Liter,Aveda Invati Conditioner 1 Liter,Default Ridgefield,36,36,0,0,0,0
,Aveda Invati Men™ Exfoliating Shampoo 1 Liter,Aveda Invati Men™ Exfoliating Shampoo 1 Liter,Default Ridgefield,2,2,0,0,0,0
,Aveda - Invati Men Exfoliating Shampoo 250 Ml,Aveda - Invati Men Exfoliating Shampoo 250 Ml,Default,0,-119,119,0,0,0
,Aveda - Invati Men Exfoliating Shampoo 250 Ml,Aveda - Invati Men Exfoliating Shampoo 250 Ml,Default Ridgefield,637,637,0,0,0,0
,Aveda - Invati Men Exfoliating Shampoo 250 Ml,Aveda - Invati Men Exfoliating Shampoo 250 Ml,FBALYB Amazon,289,289,0,0,0,0
,Aveda Invati Men Scalp Revitalizer 125 ml,Aveda Invati Men Scalp Revitalizer 125 ml,Default Ridgefield,343,342,1,0,0,0
,Aveda Invati Men Scalp Revitalizer 125 ml,Aveda Invati Men Scalp Revitalizer 125 ml,FBALYB Amazon,3,0,3,0,3,0
,Aveda Invati Shampoo 1L,Aveda Invati Shampoo 1L,Default,0,0,0,0,0,2
,Aveda Invati Shampoo 1L,Aveda Invati Shampoo 1L,Default Ridgefield,11,11,0,0,0,0
,Aveda Invati Thickening Intensive Conditioner 1 Liter,Aveda Invati Thickening Intensive Conditioner 1 Liter,Default Ridgefield,9,9,0,0,0,0
,Aveda Invati Thickening Intensive Conditioner 200 ml,Aveda Invati Thickening Intensive Conditioner 200 ml,Default Ridgefield,7,7,0,0,0,0
,AVEDA LIGHT ELEMEENTS CREME 125ML DEFINING Whip,AVEDA LIGHT ELEMEENTS CREME 125ML DEFINING Whip,Default Ridgefield,450,450,0,0,0,0
,Aveda Light Elements Shaping Wax 75 ml,Aveda Light Elements Shaping Wax 75 ml,Default,0,0,0,0,0,20
,Aveda Light Elements Shaping Wax 75 ml,Aveda Light Elements Shaping Wax 75 ml,Default Ridgefield,46,46,0,0,0,0
,Aveda Light Elements Smoothing Fluid 100ml,Aveda Light Elements Smoothing Fluid 100ml,Default,0,0,0,0,0,4
,Aveda Light Elements Smoothing Fluid 100ml,Aveda Light Elements Smoothing Fluid 100ml,Default Ridgefield,35,35,0,0,0,0
,Aveda Light Elements Smoothing Fluid 100ml,Aveda Light Elements Smoothing Fluid 100ml,FBALYB Amazon,0,0,0,1,0,0
,Aveda Light Elements Texturing Creme 75 ml,Aveda Light Elements Texturing Creme 75 ml,Default,0,0,0,0,0,3
,Aveda Light Elements Texturing Creme 75 ml,Aveda Light Elements Texturing Creme 75 ml,Default Ridgefield,1,1,0,0,0,0
,Aveda Light Elements Texturing Creme 75 ml,Aveda Light Elements Texturing Creme 75 ml,FBALYB Amazon,-1,-1,0,0,0,0
,Aveda - Lip Saver SPF 15 4.25 G,Aveda - Lip Saver SPF 15 4.25 G,Default,0,0,0,0,0,16
,Aveda - Lip Saver SPF 15 4.25 G,Aveda - Lip Saver SPF 15 4.25 G,Default Ridgefield,57,57,0,0,0,0
,Aveda Madder Root Conditioner 250 ml,Aveda Madder Root Conditioner 250 ml,Default,0,0,0,0,0,5
,Aveda Madder Root Conditioner 250 ml,Aveda Madder Root Conditioner 250 ml,Default Ridgefield,0,-86,86,0,0,0
,Aveda Madder Root Shampoo 1 Liter,Aveda Madder Root Shampoo 1 Liter,Default,0,0,0,0,0,8
,Aveda Men After Shave Cream 75ml,Aveda Men After Shave Cream 75ml,Default,0,0,0,0,0,13
,Aveda Men Liquid Pomade 200 ML,Aveda Men Liquid Pomade 200 ML,Default,0,0,0,0,0,17
,Aveda Men Liquid Pomade 200 ML,Aveda Men Liquid Pomade 200 ML,Default Ridgefield,38,38,0,0,0,0
,Aveda Men Pure Formance Aroma Spray 50ml,Aveda Men Pure Formance Aroma Spray 50ml,Default Ridgefield,69,69,0,0,0,0
,Aveda Men Pure-Formance Composition Oil 50ml,Aveda Men Pure-Formance Composition Oil 50ml,Default Ridgefield,9,9,0,0,0,0
,Aveda Men Pure-Formance Composition Oil 50ml,Aveda Men Pure-Formance Composition Oil 50ml,FBALYB Amazon,-2,-2,0,0,0,0
,Aveda Men Pure-Formance Conditioner 1 Liter,Aveda Men Pure-Formance Conditioner 1 Liter,Default,0,0,0,0,0,4
,Aveda Men Pure-Formance Conditioner 300ml,Aveda Men Pure-Formance Conditioner 300ml,Default,0,-153,153,0,0,0
,Aveda Men Pure-Formance Conditioner 300ml,Aveda Men Pure-Formance Conditioner 300ml,Default Ridgefield,3,3,0,0,0,0
,Aveda Men Pure-Formance Conditioner 300ml,Aveda Men Pure-Formance Conditioner 300ml,FBALYB Amazon,0,0,0,30,0,0
,Aveda Men Pure Formance Conditioner + Pure-Formance Shampoo 300ml DUO,Aveda Men Pure Formance Conditioner + Pure-Formance Shampoo 300ml DUO,FBALYB Amazon,-1,-1,0,1,0,0
,Aveda Men Pure-Formance Firm Hold Gel 150ml,Aveda Men Pure-Formance Firm Hold Gel 150ml,Default Ridgefield,5,5,0,0,0,0
,Aveda Men Pure-Formance Firm Hold Gel 150ml,Aveda Men Pure-Formance Firm Hold Gel 150ml,FBALYB Amazon,-1,-1,0,0,0,0
,Aveda - Men Pure-Formance Grooming Clay 75 Ml,Aveda - Men Pure-Formance Grooming Clay 75 Ml,Default,0,0,0,0,0,17
,Aveda - Men Pure-Formance Grooming Clay 75 Ml,Aveda - Men Pure-Formance Grooming Clay 75 Ml,Default Ridgefield,1190,1190,0,0,0,0
,Aveda - Men Pure-Formance Grooming Clay 75 Ml,Aveda - Men Pure-Formance Grooming Clay 75 Ml,FBALYB Amazon,1942,1942,0,4,0,0
,Aveda Men Pure-Formance Grooming Cream 125ml,Aveda Men Pure-Formance Grooming Cream 125ml,Default,0,0,0,0,0,9
,Aveda Men Pure-Formance Grooming Cream 125ml,Aveda Men Pure-Formance Grooming Cream 125ml,Default Ridgefield,817,817,0,0,0,0
,Aveda Men Pure-Formance Grooming Cream 125ml,Aveda Men Pure-Formance Grooming Cream 125ml,FBALYB Amazon,4,4,0,0,0,0
,Aveda Men Pure-Formance Pomade 75ml,Aveda Men Pure-Formance Pomade 75ml,Default Ridgefield,6,6,0,0,0,0
,Aveda Men Pure-Formance Pomade 75ml,Aveda Men Pure-Formance Pomade 75ml,FBALYB Amazon,-2,-2,0,0,0,0
,Aveda Men Pure-Formance Shampoo 1 Liter,Aveda Men Pure-Formance Shampoo 1 Liter,Default,0,0,0,0,0,15
,Aveda Men Pure-Formance Shampoo 1 Liter,Aveda Men Pure-Formance Shampoo 1 Liter,Default Ridgefield,1,1,0,0,0,0
,Aveda Men Pure-Formance Shampoo 1 Liter,Aveda Men Pure-Formance Shampoo 1 Liter,FBALYB Amazon,1,1,0,0,0,0
,Aveda - Men Pure-Formance Shampoo 300 Ml,Aveda - Men Pure-Formance Shampoo 300 Ml,Default,0,-153,153,0,0,43
,Aveda - Men Pure-Formance Shampoo 300 Ml,Aveda - Men Pure-Formance Shampoo 300 Ml,Default Ridgefield,41,41,0,0,0,0
,Aveda - Men Pure-Formance Shampoo 300 Ml,Aveda - Men Pure-Formance Shampoo 300 Ml,FBALYB Amazon,-1,-1,0,0,0,0
,Aveda Men Shave Cream 150ml,Aveda Men Shave Cream 150ml,Default Ridgefield,4,4,0,0,0,0
,Aveda Men Thickening Paste 75ml,Aveda Men Thickening Paste 75ml,Default,0,0,0,0,0,1
,Aveda Men Thickening Paste 75ml,Aveda Men Thickening Paste 75ml,Default Ridgefield,95,95,0,0,0,0
,Aveda Nuevo Cherry Almond Softening Shampoo 250ml,Aveda Nuevo Cherry Almond Softening Shampoo 250ml,Default Ridgefield,1041,1041,0,0,0,0
,Aveda Nuevo Cherry Almond Softening Shampoo 250ml,Aveda Nuevo Cherry Almond Softening Shampoo 250ml,FBALYB Amazon,598,582,16,0,16,0
,Aveda Nuevo Cherry Almond Softening Shampoo 250ml + Aveda Cherry Almond Softening Conditioner 200 ml DUO,Aveda Nuevo Cherry Almond Softening Shampoo 250ml + Aveda Cherry Almond Softening Conditioner 200 ml DUO ,FBALYB Amazon,161,161,0,0,0,0
,Aveda Nuevo Cherry Almond Softening Shampoo 250ml + Aveda Cherry Almond Softening Leave-In Conditioner 200 ml DUO,Aveda Nuevo Cherry Almond Softening Shampoo 250ml + Aveda Cherry Almond Softening Leave-In Conditioner 200 ml DUO,FBALYB Amazon,0,-1,1,0,1,0
,AVEDA NUTRI HYDRA CONDITIONER 250ML DEEP MOISTURE,AVEDA NUTRI HYDRA CONDITIONER 250ML DEEP MOISTURE,Default Ridgefield,100,100,0,0,0,0
,AVEDA NUTRI HYDRA CONDITIONER 250ML DEEP MOISTURE,AVEDA NUTRI HYDRA CONDITIONER 250ML DEEP MOISTURE,FBALYB Amazon,1,0,1,0,1,0
,AVEDA NUTRI HYDRA CONDITIONER 250ML LIGHT MOISTURE,AVEDA NUTRI HYDRA CONDITIONER 250ML LIGHT MOISTURE,Default Ridgefield,240,240,0,0,0,0
,AVEDA NUTRI HYDRA CONDITIONER 250ML LIGHT MOISTURE,AVEDA NUTRI HYDRA CONDITIONER 250ML LIGHT MOISTURE,FBALYB Amazon,2,1,1,0,1,0
,AVEDA NUTRI HYDRA SHAMPOO 250ML DEEP MOISTURE,AVEDA NUTRI HYDRA SHAMPOO 250ML DEEP MOISTURE,Default Ridgefield,140,140,0,0,0,0
,AVEDA NUTRI HYDRA SHAMPOO + CONDITIONER 250ML DEEP MOISTURE SET,AVEDA NUTRI HYDRA SHAMPOO + CONDITIONER 250ML DEEP MOISTURE SET,FBALYB Amazon,1,1,0,100,0,0
,AVEDA NUTRIPLENISH HAIR OIL 30ML MULTI USE,AVEDA NUTRIPLENISH HAIR OIL 30ML MULTI USE,Default Ridgefield,182,182,0,0,0,0
,AVEDA NUTRIPLENISH HAIR OIL 30ML MULTI USE,AVEDA NUTRIPLENISH HAIR OIL 30ML MULTI USE,FBALYB Amazon,4,4,0,0,0,0
,AVEDA NUTRI VITAMIN CONDITIONER 200ML LEAVE IN,AVEDA NUTRI VITAMIN CONDITIONER 200ML LEAVE IN,Default Ridgefield,1000,1000,0,0,0,0
,AVEDA NUTRI VITAMIN CONDITIONER 200ML LEAVE IN,AVEDA NUTRI VITAMIN CONDITIONER 200ML LEAVE IN,FBALYB Amazon,-4,-4,0,0,0,0
,Aveda Outer Peace Foaming Cleanser 125 ml,Aveda Outer Peace Foaming Cleanser 125 ml,Default,0,0,0,0,0,6
,Aveda Outer Peace Foaming Cleanser 125 ml,Aveda Outer Peace Foaming Cleanser 125 ml,Default Ridgefield,180,180,0,0,0,0
,Aveda Outer Peace Foaming Cleanser 125 ml,Aveda Outer Peace Foaming Cleanser 125 ml,FBALYB Amazon,-2,-2,0,0,0,0
,Aveda Outer Peace Relief Pads 50 Discs,Aveda Outer Peace Relief Pads 50 Discs,Default,0,0,0,0,0,27
,Aveda Outer Peace Relief Pads 50 Discs,Aveda Outer Peace Relief Pads 50 Discs,Default Ridgefield,26,26,0,0,0,0
,Aveda Phomollient Styling Foam 200ml,Aveda Phomollient Styling Foam 200ml,FBALYB Amazon,-6,-6,0,2,0,0
,Aveda Phomollient Styling Foam 200ml 2pk,Aveda Phomollient Styling Foam 200ml 2pk,FBALYB Amazon,0,0,0,25,0,0
,Aveda Phomollient Styling Foam Refill 200ml,Aveda Phomollient Styling Foam Refill 200ml,Default,0,0,0,0,0,54
,Aveda Phomollient Styling Foam Refill 200ml,Aveda Phomollient Styling Foam Refill 200ml,Default Ridgefield,26,26,0,0,0,0
,Aveda - Phomollient Styling Foam Travel Size 50 Ml,Aveda - Phomollient Styling Foam Travel Size 50 Ml,Default,0,-24,24,0,0,0
,Aveda - Phomollient Styling Foam Travel Size 50 Ml,Aveda - Phomollient Styling Foam Travel Size 50 Ml,FBALYB Amazon,1,1,0,0,0,0
,Aveda Pramasana Exfoliating Scalp Brush,Aveda Pramasana Exfoliating Scalp Brush,Default,0,0,0,0,0,4
,Aveda Pramasana Purifying Scalp Concentrate 75 ml,Aveda Pramasana Purifying Scalp Concentrate 75 ml,Default,0,0,0,0,0,4
,Aveda Pramasana Scalp Cleanser 150 ml,Aveda Pramasana Scalp Cleanser 150 ml,Default Ridgefield,38,38,0,0,0,0
,Aveda Pramasana Scalp Concentrate 75 ml,Aveda Pramasana Scalp Concentrate 75 ml,Default Ridgefield,59,59,0,0,0,0
,Aveda Pramasana Scalp Concentrate 75 ml,Aveda Pramasana Scalp Concentrate 75 ml,FBALYB Amazon,19,19,0,0,0,0
,Aveda Professional Cooling Masque 250ml,Aveda Professional Cooling Masque 250ml,Default Ridgefield,17,17,0,0,0,0
,Aveda Professional Vitamin C Complex 30ml,Aveda Professional Vitamin C Complex 30ml,Default,0,0,0,0,0,3
,Aveda - Pure Abundance Hair Potion 20 G,Aveda - Pure Abundance Hair Potion 20 G,Default,0,0,0,0,0,2
,Aveda Pure Abundance Style Prep  100ml,Aveda Pure Abundance Style Prep  100ml,Default,0,0,0,0,0,7
,Aveda Pure Abundance Style Prep  100ml,Aveda Pure Abundance Style Prep  100ml,Default Ridgefield,22,22,0,0,0,0
,Aveda Pure Abundance Style Prep  100ml,Aveda Pure Abundance Style Prep  100ml,FBALYB Amazon,-5,-5,0,0,0,0
,Aveda Pure Abundance Volumizing Clay Conditioner 200ml,Aveda Pure Abundance Volumizing Clay Conditioner 200ml,Default,0,-30,30,0,0,0
,Aveda Pure Abundance Volumizing Clay Conditioner 200ml,Aveda Pure Abundance Volumizing Clay Conditioner 200ml,Default Ridgefield,1032,1032,0,0,0,0
,Aveda Pure Abundance Volumizing Clay Conditioner 200ml,Aveda Pure Abundance Volumizing Clay Conditioner 200ml,FBALYB Amazon,107,107,0,0,0,0
,Aveda Pure Abundance Volumizing Clay Conditioner 500 ml,Aveda Pure Abundance Volumizing Clay Conditioner 500 ml,Default,0,0,0,0,0,14
,Aveda Pure Abundance Volumizing Clay Conditioner 500 ml,Aveda Pure Abundance Volumizing Clay Conditioner 500 ml,Default Ridgefield,1,1,0,0,0,0
,Aveda Pure Abundance Volumizing Hair Spray 200 ml,Aveda Pure Abundance Volumizing Hair Spray 200 ml,Default Ridgefield,368,368,0,0,0,0
,Aveda Pure Abundance Volumizing Hair Spray 200 ml,Aveda Pure Abundance Volumizing Hair Spray 200 ml,FBALYB Amazon,12,7,5,0,5,0
,Aveda Pure Abundance Volumizing Shampoo 1 Liter,Aveda Pure Abundance Volumizing Shampoo 1 Liter,Default,0,0,0,0,0,15
,Aveda Pure Abundance Volumizing Shampoo 1 Liter,Aveda Pure Abundance Volumizing Shampoo 1 Liter,Default Ridgefield,187,187,0,0,0,0
,Aveda Pure Abundance Volumizing Shampoo 1 Liter,Aveda Pure Abundance Volumizing Shampoo 1 Liter,FBALYB Amazon,2,2,0,0,0,0
,Aveda Pure Abundance Volumizing Shampoo 1 Liter + Aveda Pure Abundance Volumizing Clay Conditioner 500 ml SET,Aveda Pure Abundance Volumizing Shampoo 1 Liter + Aveda Pure Abundance Volumizing Clay Conditioner 500 ml SET,FBALYB Amazon,2,1,1,0,1,0
,Aveda Pure Abundance Volumizing Shampoo 250ml,Aveda Pure Abundance Volumizing Shampoo 250ml,Default,0,-30,30,0,0,0
,Aveda Pure Abundance Volumizing Shampoo 250ml,Aveda Pure Abundance Volumizing Shampoo 250ml,Default Ridgefield,290,290,0,0,0,0
,Aveda Pure Abundance Volumizing Shampoo 250ml,Aveda Pure Abundance Volumizing Shampoo 250ml,FBALYB Amazon,1,1,0,0,0,0
,Aveda Pure Abundance Volumizing Shampoo 250ml & Aveda Pure Abundance Volumizing Clay Conditioner 200ml,Aveda Pure Abundance Volumizing Shampoo 250ml & Aveda Pure Abundance Volumizing Clay Conditioner 200ml,Default Ridgefield,331,331,0,0,0,0
,Aveda Pure Abundance Volumizing Shampoo 250ml & Aveda Pure Abundance Volumizing Clay Conditioner 200ml,Aveda Pure Abundance Volumizing Shampoo 250ml & Aveda Pure Abundance Volumizing Clay Conditioner 200ml,FBALYB Amazon,305,305,0,0,0,0
,Aveda Pure Comfort Eye Makeup Remover 125ml,Aveda Pure Comfort Eye Makeup Remover 125ml,Default Ridgefield,4,4,0,0,0,0
,Aveda Pure Comfort Eye Makeup Remover 125ml,Aveda Pure Comfort Eye Makeup Remover 125ml,FBALYB Amazon,5,5,0,0,0,0
,Aveda Pure Formance Grooming Cream  125ml,Aveda Pure Formance Grooming Cream  125ml,FBALYB Amazon,-5,-5,0,0,0,0
,Aveda Rosemary Mint Bath Bar 200g,Aveda Rosemary Mint Bath Bar 200g,Default,0,0,0,0,0,2
,Aveda Rosemary Mint Body Lotion 200 ml,Aveda Rosemary Mint Body Lotion 200 ml,Default,0,0,0,0,0,2
,Aveda Rosemary Mint Body Lotion 200 ml,Aveda Rosemary Mint Body Lotion 200 ml,Default Ridgefield,7,7,0,0,0,0
,Aveda Rosemary Mint Conditioner 1 Liter,Aveda Rosemary Mint Conditioner 1 Liter,Default Ridgefield,2,2,0,0,0,0
,Aveda Rosemary Mint Conditioner 1 Liter,Aveda Rosemary Mint Conditioner 1 Liter,FBALYB Amazon,-1,-1,0,0,0,0
,Aveda Rosemary Mint Conditioner 250ml,Aveda Rosemary Mint Conditioner 250ml,Default Ridgefield,2792,2792,0,0,0,0
,Aveda Rosemary Mint Conditioner 250ml,Aveda Rosemary Mint Conditioner 250ml,FBALYB Amazon,1,1,0,0,0,0
,Aveda Rosemary Mint Hand & Body Wash 1 Liter,Aveda Rosemary Mint Hand & Body Wash 1 Liter,Default Ridgefield,406,406,0,0,0,0
,Aveda Rosemary Mint Hand & Body Wash 1 Liter,Aveda Rosemary Mint Hand & Body Wash 1 Liter,FBALYB Amazon,121,121,0,0,0,0
,Aveda Rosemary Mint Hand & Body Wash 250 ml,Aveda Rosemary Mint Hand & Body Wash 250 ml,Default,0,0,0,0,0,1
,Aveda Rosemary Mint Hand & Body Wash 250 ml,Aveda Rosemary Mint Hand & Body Wash 250 ml,Default Ridgefield,26,26,0,0,0,0
,Aveda Rosemary Mint Hand & Body Wash 250 ml,Aveda Rosemary Mint Hand & Body Wash 250 ml,FBALYB Amazon,223,219,4,9,4,0
,Aveda Rosemary Mint Purifying Shampoo 1 Liter,Aveda Rosemary Mint Purifying Shampoo 1 Liter,Default,0,0,0,0,0,2
,Aveda Rosemary Mint Purifying Shampoo 1 Liter,Aveda Rosemary Mint Purifying Shampoo 1 Liter,Default Ridgefield,1050,1050,0,0,0,0
,Aveda Rosemary Mint Purifying Shampoo 1 Liter,Aveda Rosemary Mint Purifying Shampoo 1 Liter,FBALYB Amazon,177,170,7,0,7,0
,Aveda - Rosemary Mint Purifying Shampoo 250Ml,Aveda - Rosemary Mint Purifying Shampoo 250Ml,Default Ridgefield,3258,3258,0,0,0,0
,Aveda - Rosemary Mint Purifying Shampoo 250Ml,Aveda - Rosemary Mint Purifying Shampoo 250Ml,FBALYB Amazon,584,553,31,0,31,0
,Aveda - Rosemary Mint Purifying Shampoo 250Ml,Aveda - Rosemary Mint Purifying Shampoo 250Ml,FBALYB Canada,0,0,0,15,0,0
,Aveda Rosemary Mint Shampoo 1L,Aveda Rosemary Mint Shampoo 1L,Default,0,0,0,0,0,13
,Aveda Rosemary Mint Shampoo 1L,Aveda Rosemary Mint Shampoo 1L,FBALYB Amazon,0,0,0,1,0,0
,Aveda Rosemary Mint Shampoo 250ml,Aveda Rosemary Mint Shampoo 250ml,FBALYB Amazon,-3,-3,0,1,0,0
,Aveda Rosemary Mint Shampoo & Conditioner 250ml,Aveda Rosemary Mint Shampoo & Conditioner 250ml ,FBALYB Amazon,24,14,10,0,10,0
,Aveda Rosemary Mint Weightless Conditioner 1 Liter,Aveda Rosemary Mint Weightless Conditioner 1 Liter,Default,0,0,0,0,0,8
,Aveda Rosemary Mint Weightless Conditioner 1 Liter,Aveda Rosemary Mint Weightless Conditioner 1 Liter,Default Ridgefield,598,598,0,0,0,0
,Aveda Rosemary Mint Weightless Conditioner 1 Liter,Aveda Rosemary Mint Weightless Conditioner 1 Liter,FBALYB Amazon,47,46,1,0,1,0
,Aveda Scalp Benefits Conditioner 1 Liter,Aveda Scalp Benefits Conditioner 1 Liter,Default Ridgefield,5,5,0,0,0,0
,Aveda Scalp Benefits Conditioner 200ml,Aveda Scalp Benefits Conditioner 200ml,Default Ridgefield,284,284,0,0,0,0
,Aveda Scalp Benefits Conditioner 200ml,Aveda Scalp Benefits Conditioner 200ml,FBALYB Amazon,19,19,0,0,0,0
,Aveda Scalp Benefits Conditioner 200ml + Scalp Benefits Shampoo 250 ml Duo,Aveda Scalp Benefits Conditioner 200ml + Scalp Benefits Shampoo 250 ml Duo,FBALYB Amazon,1,1,0,0,0,0
,Aveda Scalp Benefits Shampoo 250 ml,Aveda Scalp Benefits Shampoo 250 ml,Default Ridgefield,307,307,0,0,0,0
,Aveda Scalp Remedy Dandruff Solution 125 ml,Aveda Scalp Remedy Dandruff Solution 125 ml,Default,0,0,0,0,0,2
,Aveda Scalp Remedy Dandruff Solution 125 ml,Aveda Scalp Remedy Dandruff Solution 125 ml,Default Ridgefield,372,372,0,0,0,0
,Aveda Scalp Remedy Dandruff Solution 125 ml,Aveda Scalp Remedy Dandruff Solution 125 ml,FBALYB Amazon,3,3,0,0,0,0
,AVEDA SHAMPOO 1000ML CHERRY ALMOND,AVEDA SHAMPOO 1000ML CHERRY ALMOND,Default Ridgefield,361,361,0,0,0,0
,AVEDA SHAMPOO 1000ML CHERRY ALMOND,AVEDA SHAMPOO 1000ML CHERRY ALMOND,FBALYB Amazon,179,179,0,0,0,0
,Aveda Shampure Body Lotion 200 ml,Aveda Shampure Body Lotion 200 ml,FBALYB Amazon,-1,-1,0,0,0,0
,Aveda Shampure Composition 50 ml,Aveda Shampure Composition 50 ml,Default,0,0,0,0,0,5
,Aveda Shampure Composition 50 ml,Aveda Shampure Composition 50 ml,Default Ridgefield,21,21,0,0,0,0
,Aveda Shampure Conditioner 1L,Aveda Shampure Conditioner 1L,Default Ridgefield,1,1,0,0,0,0
,Aveda Shampure Conditioner 1L,Aveda Shampure Conditioner 1L,FBALYB Canada,0,0,0,23,0,0
,Aveda Shampure Conditioner 250ml,Aveda Shampure Conditioner 250ml,Default,0,-184,184,0,0,10
,Aveda Shampure Conditioner 250ml,Aveda Shampure Conditioner 250ml,Default Ridgefield,476,476,0,0,0,0
,Aveda Shampure Dry Conditioner 100 ml,Aveda Shampure Dry Conditioner 100 ml,Default,0,0,0,0,0,2
,Aveda Shampure Dry Conditioner 100 ml,Aveda Shampure Dry Conditioner 100 ml,Default Ridgefield,1,1,0,0,0,0
,Aveda Shampure Dry Shampoo 60 ml,Aveda Shampure Dry Shampoo 60 ml,Default,0,0,0,0,0,3
,Aveda Shampure Dry Shampoo 60 ml,Aveda Shampure Dry Shampoo 60 ml,Default Ridgefield,15,15,0,0,0,0
,Aveda Shampure Hand & Body Wash 1 Liter,Aveda Shampure Hand & Body Wash 1 Liter,Default,0,0,0,0,0,6
,Aveda Shampure Hand & Body Wash 250 ml,Aveda Shampure Hand & Body Wash 250 ml,Default,0,0,0,0,0,3
,Aveda Shampure Nurturing Conditioner 1 Liter,Aveda Shampure Nurturing Conditioner 1 Liter,Default,0,0,0,0,0,12
,Aveda Shampure Nurturing Conditioner 1 Liter,Aveda Shampure Nurturing Conditioner 1 Liter,Default Ridgefield,291,291,0,0,0,0
,Aveda Shampure Shampoo 1L,Aveda Shampure Shampoo 1L,Default Ridgefield,861,861,0,0,0,0
,Aveda Shampure Shampoo 1L,Aveda Shampure Shampoo 1L,FBALYB Amazon,-1,-1,0,0,0,0
,Aveda Shampure Shampoo 250ml,Aveda Shampure Shampoo 250ml,Default,0,-184,184,0,0,0
,Aveda Shampure Shampoo 250ml,Aveda Shampure Shampoo 250ml,Default Ridgefield,1169,1169,0,0,0,0
,Aveda Shampure Shampoo 250ml,Aveda Shampure Shampoo 250ml,FBALYB Amazon,4,4,0,0,0,0
,Aveda Shampure Shampoo & Conditioner 1L,Aveda Shampure Shampoo & Conditioner 1L ,FBALYB Amazon,1,1,0,0,0,0
,Aveda Shampure Shampoo&Conditioner 250ml,Aveda Shampure Shampoo&Conditioner 250ml,FBALYB Amazon,734,734,0,0,0,0
,Aveda Smooth Infusion Conditioner 1 Liter,Aveda Smooth Infusion Conditioner 1 Liter,Default,0,0,0,0,0,9
,Aveda Smooth Infusion Conditioner 1 Liter,Aveda Smooth Infusion Conditioner 1 Liter,Default Ridgefield,5,5,0,0,0,0
,Aveda Smooth Infusion Conditioner Travel Size 40 ml,Aveda Smooth Infusion Conditioner Travel Size 40 ml,Default Ridgefield,5,5,0,0,0,0
,Aveda Smooth Infusion Conditioner Travel Size 40 ml,Aveda Smooth Infusion Conditioner Travel Size 40 ml,FBALYB Amazon,-1,-1,0,0,0,0
,Aveda Smooth Infusion Conditoner 250ml,Aveda Smooth Infusion Conditoner 250ml,Default,0,0,0,0,0,3
,Aveda Smooth Infusion Conditoner 250ml,Aveda Smooth Infusion Conditoner 250ml,FBALYB Amazon,254,254,0,0,0,0
,Aveda Smooth Infusion Glossing Straightner 125ml,Aveda Smooth Infusion Glossing Straightner 125ml,Default Ridgefield,7,7,0,0,0,0
,Aveda Smooth Infusion Glossing Straightner 125ml,Aveda Smooth Infusion Glossing Straightner 125ml,FBALYB Amazon,1,1,0,0,0,0
,Aveda Smooth Infusion Masque 150 ml,Aveda Smooth Infusion Masque 150 ml,Default Ridgefield,2,2,0,0,0,0
,Aveda Smooth Infusion Masque 150 ml,Aveda Smooth Infusion Masque 150 ml,FBALYB Amazon,2,2,0,0,0,0
,Aveda Smooth Infusion Masque 500 ml,Aveda Smooth Infusion Masque 500 ml,Default,0,0,0,0,0,2
,Aveda Smooth Infusion Masque 500 ml,Aveda Smooth Infusion Masque 500 ml,FBALYB Amazon,10,10,0,0,0,0
,Aveda Smooth Infusion Naturally Straight 150ml,Aveda Smooth Infusion Naturally Straight 150ml,Default,0,0,0,0,0,11
,Aveda Smooth Infusion Naturally Straight 150ml,Aveda Smooth Infusion Naturally Straight 150ml,Default Ridgefield,58,58,0,0,0,0
,Aveda Smooth Infusion Naturally Straight 150ml,Aveda Smooth Infusion Naturally Straight 150ml,FBALYB Amazon,-7,-7,0,2,0,0
,Aveda Smooth Infusion Nourishing Styling Creme 250 ml,Aveda Smooth Infusion Nourishing Styling Creme 250 ml,Default,0,0,0,0,0,71
,Aveda Smooth Infusion Shampoo 1 Liter,Aveda Smooth Infusion Shampoo 1 Liter,Default,0,0,0,0,0,1
,Aveda Smooth Infusion Shampoo 1 Liter,Aveda Smooth Infusion Shampoo 1 Liter,Default Ridgefield,20,20,0,0,0,0
,Aveda Smooth Infusion Shampoo 250ml,Aveda Smooth Infusion Shampoo 250ml,Default Ridgefield,133,133,0,0,0,0
,Aveda Smooth Infusion Shampoo Travel Size 50 ml,Aveda Smooth Infusion Shampoo Travel Size 50 ml,Default Ridgefield,10,10,0,0,0,0
,Aveda Smooth Infusion Style-Prep Styler 100 ml,Aveda Smooth Infusion Style-Prep Styler 100 ml,Default,0,0,0,0,0,7
,Aveda Smooth Infusion Style-Prep Styler 100 ml,Aveda Smooth Infusion Style-Prep Styler 100 ml,Default Ridgefield,1210,1210,0,0,0,0
,Aveda Smooth Infusion Style-Prep Styler 100 ml,Aveda Smooth Infusion Style-Prep Styler 100 ml,FBALYB Amazon,115,85,30,0,30,0
,Aveda Stress Fix Body Creme 200ml,Aveda Stress Fix Body Creme 200ml,Default,0,0,0,0,0,11
,Aveda Stress Fix Body Creme 200ml,Aveda Stress Fix Body Creme 200ml,Default Ridgefield,548,548,0,0,0,0
,Aveda Stress Fix Body Creme 200ml,Aveda Stress Fix Body Creme 200ml,FBALYB Amazon,249,249,0,1,0,0
,Aveda Stress Fix Body Lotion 200 ml,Aveda Stress Fix Body Lotion 200 ml,Default Ridgefield,0,-65,65,0,0,0
,Aveda Stress-fix Composition 50 ml,Aveda Stress-fix Composition 50 ml,Default,0,0,0,0,0,5
,Aveda Stress fix Creme Cleansing Oil 200ml,Aveda Stress fix Creme Cleansing Oil 200ml,Default,0,0,0,0,0,3
,Aveda Stress fix Creme Cleansing Oil 200ml,Aveda Stress fix Creme Cleansing Oil 200ml,Default Ridgefield,15,15,0,0,0,0
,Aveda Stress-Fix Soaking Salt 454gr,Aveda Stress-Fix Soaking Salt 454gr,Default,0,0,0,0,0,7
,Aveda Stress-Fix Soaking Salt 454gr,Aveda Stress-Fix Soaking Salt 454gr,FBALYB Amazon,-1,-1,0,0,0,0
,Aveda Suncare Hair & Body Cleanser 250ml,Aveda Suncare Hair & Body Cleanser 250ml,Default,0,0,0,0,0,10
,Aveda Suncare Hair & Body Cleanser 250ml,Aveda Suncare Hair & Body Cleanser 250ml,FBALYB Amazon,1,1,0,0,0,0
,Aveda Suncare Hair Treatment Masque 125ml,Aveda Suncare Hair Treatment Masque 125ml,Default,0,0,0,0,0,7
,Aveda Suncare Hair Treatment Masque 125ml,Aveda Suncare Hair Treatment Masque 125ml,FBALYB Amazon,13,10,3,0,3,0
,Aveda Suncare Protective Hair Veil 100ml,Aveda Suncare Protective Hair Veil 100ml,Default,0,0,0,0,0,47
,Aveda Texture Tonic 125ml,Aveda Texture Tonic 125ml,Default,0,0,0,0,0,24
,Aveda Texture Tonic 125ml,Aveda Texture Tonic 125ml,Default Ridgefield,24,24,0,0,0,0
,Aveda Texture Tonic 125ml,Aveda Texture Tonic 125ml,FBALYB Amazon,-1,-1,0,1,0,0
,Aveda Tulasara Bright Concentrate 30 ml,Aveda Tulasara Bright Concentrate 30 ml,Default,0,0,0,0,0,9
,Aveda Tulasara Bright Concentrate 30 ml,Aveda Tulasara Bright Concentrate 30 ml,FBALYB Amazon,1,1,0,0,0,0
,Aveda Tulasara Calm Concentrate 30 ml,Aveda Tulasara Calm Concentrate 30 ml,Default,0,0,0,0,0,1
,Aveda Tulasara Calm Concentrate 30 ml,Aveda Tulasara Calm Concentrate 30 ml,Default Ridgefield,77,77,0,0,0,0
,Aveda Tulasara Facial Dry Brush,Aveda Tulasara Facial Dry Brush,Default,0,0,0,0,0,2
,Aveda Tulasara Facial Dry Brush,Aveda Tulasara Facial Dry Brush,Default Ridgefield,4,4,0,0,0,0
,Aveda Tulasara Firm Concentrate 30 ml,Aveda Tulasara Firm Concentrate 30 ml,Default,0,0,0,0,0,12
,Aveda Tulasara Firm Concentrate 30 ml,Aveda Tulasara Firm Concentrate 30 ml,Default Ridgefield,242,242,0,0,0,0
,Aveda Tulasara Firm Concentrate 30 ml,Aveda Tulasara Firm Concentrate 30 ml,FBALYB Amazon,11,9,2,0,2,0
,Aveda Tulasara Morning Awakening KIT (Radiation Oil+ Dry Brush),Aveda Tulasara Morning Awakening KIT (Radiation Oil+ Dry Brush),Default,0,0,0,0,0,9
,Aveda Tulasara Morning Awakening KIT (Radiation Oil+ Dry Brush),Aveda Tulasara Morning Awakening KIT (Radiation Oil+ Dry Brush),Default Ridgefield,32,32,0,0,0,0
,Aveda Tulasara Radiant Oleation Oil 50 ml,Aveda Tulasara Radiant Oleation Oil 50 ml,Default,0,0,0,0,0,4
,Aveda Tulasara Renew Morning Creme 50 ml,Aveda Tulasara Renew Morning Creme 50 ml,Default,0,0,0,0,0,45
,Aveda Tulasara Wedding Masque Overnight Eye 15ml,Aveda Tulasara Wedding Masque Overnight Eye 15ml,Default,0,0,0,0,0,40
,Aveda Tulasara Wedding Masque Overnight Eye 15ml,Aveda Tulasara Wedding Masque Overnight Eye 15ml,Default Ridgefield,1,1,0,0,0,0
,Aveda Tulasara Wedding Masque Overnight Eye 15ml,Aveda Tulasara Wedding Masque Overnight Eye 15ml,FBALYB Amazon,-1,-1,0,0,0,0
,Aveda Tulasara Wedding Masque Overnight Face 50 ml,Aveda Tulasara Wedding Masque Overnight Face 50 ml,Default,0,0,0,0,0,43
,Aveda Tulasara Wedding Masque Overnight Face 50 ml,Aveda Tulasara Wedding Masque Overnight Face 50 ml,Default Ridgefield,1,1,0,0,0,0
,Aveda Tulsara Cool Aroma Infusion 30ml,Aveda Tulsara Cool Aroma Infusion 30ml,Default Ridgefield,5,5,0,0,0,0
,Aveda Volumizing Tonic 100ml,Aveda Volumizing Tonic 100ml,Default,0,0,0,0,0,10
,Aveda Volumizing Tonic 100ml,Aveda Volumizing Tonic 100ml,Default Ridgefield,1258,1258,0,0,0,0
,Aveda Volumizing Tonic 100ml,Aveda Volumizing Tonic 100ml,FBALYB Amazon,1049,1017,32,0,32,0
,Aveda Volumizing Tonic 1 Liter,Aveda Volumizing Tonic 1 Liter,Default,0,0,0,0,0,5
,Aveda Volumizing Tonic 1 Liter,Aveda Volumizing Tonic 1 Liter,Default Ridgefield,13,13,0,0,0,0
,Aveda Volumizing Tonic  40 ml,Aveda Volumizing Tonic  40 ml,Default Ridgefield,1,1,0,0,0,0
,Aveda - Wooden Paddle Square Hair Brush,Aveda - Wooden Paddle Square Hair Brush,Default,0,0,0,0,0,28
,Aveda - Wooden Paddle Square Hair Brush,Aveda - Wooden Paddle Square Hair Brush,FBALYB Amazon,303,302,1,0,1,0
,Aveda - Wooden Paddle Square Hair Brush,Aveda - Wooden Paddle Square Hair Brush,FBALYB Canada,0,0,0,25,0,0
,Aveeno Baby Bath 18oz 2pk,Aveeno Baby Calming Comfort Bath - 18 oz - 2 pk,FBALYB Amazon,8,8,0,0,0,0
,"Aveeno Daily Moisturizing Lotion 20 fl oz., 2-pack","Aveeno Daily Moisturizing Lotion 20 fl oz., 2-pack",Default,0,0,0,0,0,35
,Axe 150ml Black Spray 6pk,Axe 150ml Black Spray 6pk,FBALYB Amazon,-42,-42,0,48,0,0
,Axe 6pk Mix,Axe 6pk Mix,FBALYB Amazon,168,168,0,5,0,0
,Axe Africa Body Spray 150ml,Axe Africa Body Spray 150ml,Default Ridgefield,3,3,0,0,0,0
,Axe Africa Body Spray 150ml 6PK,Axe Africa Body Spray 150ml 6PK,FBALYB Amazon,7,4,3,1,3,0
,Axe Anarchy For Her 2pk,Axe Anarchy For Her 2pk,FBALYB Amazon,76,42,34,0,34,0
,Axe Anarchy For Her 6pk,Axe Anarchy For Her 6pk,FBALYB Amazon,39,37,2,4,2,0
,Axe Anarchy Shower Gel 16oz,Axe Anarchy Shower Gel 16oz,Default Ridgefield,4,4,0,0,0,0
,Axe Anarchy Shower Gel 16oz 3pk,Axe Anarchy Shower Gel 16oz 3pk,FBALYB Amazon,18,18,0,6,0,0
,Axe Apollo 150ml 6pk,Axe Apollo 150ml 6pk,FBALYB Amazon,-14,-14,0,0,0,0
,Axe Appollo 150ml Deoderant,Axe Appollo 150ml Deoderant,Default Ridgefield,315,315,0,0,0,0
,Axe Black 150ml Deoderant,Axe Black 150ml Deoderant,Default Ridgefield,39,39,0,0,0,0
,Axe Body Spray Anarchy EU 4oz,Axe Body Spray Anarchy EU 4oz,Default Ridgefield,1139,1139,0,0,0,0
,AXE Body Spray MIX 12pk,AXE Body Spray MIX 12pk,FBALYB Amazon,8,8,0,0,0,0
,AXE Body Spray MIX 6pk,AXE Body Spray MIX 6pk,FBALYB Amazon,-129,-129,0,2,0,0
,Axe Body Wash 400ml Peace,Axe Body Wash 400ml Peace ,Default Ridgefield,672,672,0,0,0,0
,Axe Body Wash Africa 400ml,Axe Body Wash Africa 400ml,Default Ridgefield,666,666,0,0,0,0
,Axe Body Wash Apollo 400ml,Axe Body Wash Apollo 400ml,Default Ridgefield,676,676,0,0,0,0
,Axe Body Wash Black 400ml,Axe Body Wash Black 400ml,Default Ridgefield,720,720,0,0,0,0
,AXE BODY WASH DARK TEMPTATION 3pk,AXE BODY WASH DARK TEMPTATION 3pk,FBALYB Amazon,3,3,0,1,0,0
,Axe Body Wash Excite 400ml,Axe Body Wash Excite 400ml,Default Ridgefield,672,672,0,0,0,0
,Axe BS Anarchy for Her EU 4 oz,Axe BS Anarchy for Her EU 4 oz,Default Ridgefield,74,74,0,0,0,0
,Axe BS Anarchy for Her EU 4 oz,Axe BS Anarchy for Her EU 4 oz,FBALYB Amazon,-3,-3,0,0,0,0
,Axe Dark Temptation 150ml Deoderant,Axe Dark Temptation 150ml Deoderant,Default,0,-1290,1290,0,0,0
,Axe Dark Temptation 150ml Deoderant,Axe Dark Temptation 150ml Deoderant,Default Ridgefield,708,708,0,0,0,0
,Axe Dark Temptation 150ml Deoderant,Axe Dark Temptation 150ml Deoderant,FBALYB Amazon,-2,-2,0,0,0,0
,Axe Dark Temptation 150ml Deoderant,Axe Dark Temptation 150ml Deoderant,WFS,-22,-22,0,0,0,0
,Axe Dark Temptations 6 PK,Axe Dark Temptations 6 PK,FBALYB Amazon,781,773,8,5,8,0
,Axe Dark Temptations 6 PK,Axe Dark Temptations 6 PK,WFS,-45,-46,1,0,1,0
,Axe deodorant anarchy 150ml 6pk,Axe deodorant anarchy 150ml 6pk,FBALYB Amazon,-8,-9,1,0,1,0
,Axe Deodorant Spray Gold 150 Ml,Axe Deodorant Spray Gold 150 Ml,Default Ridgefield,96,96,0,0,0,0
,Axe Deodorant Spray Gold 150 Ml - 3pk,Axe Deodorant Spray Gold 150 Ml - 3pk,FBALYB Amazon,-162,-162,0,165,0,0
,Axe Excite 150ml 6pk (2),Axe Excite 150ml 6pk (2),Default Ridgefield,0,-3,3,0,0,0
,Axe Excite 150ml 6pk (2),Axe Excite 150ml 6pk (2),FBALYB Amazon,215,215,0,6,0,0
,Axe Excite 150ml Deoderant,Axe Excite 150ml Deoderant,Default Ridgefield,14,14,0,0,0,0
,Axe Men's Body Spray Anarchy 12pk,Axe Men's Body Spray Anarchy 12pk,FBALYB Amazon,22,21,1,10,1,0
,Axe Men's Body Spray Anarchy 2pk,Axe Men's Body Spray Anarchy 2pk,FBALYB Amazon,-42,-43,1,42,1,0
,Axe Men's Body Spray Anarchy 3pk,Axe Men's Body Spray Anarchy 3pk,FBALYB Amazon,32,29,3,0,3,0
,Axe Musk 150ml Deoderant,Axe Musk 150ml Deoderant,Default Ridgefield,3,3,0,0,0,0
,Axe Musk 150ml Deoderant 6 PK,Axe Musk 150ml Deoderant 6 PK,FBALYB Amazon,0,-1,1,0,1,0
,AXE Phoenix 2-In-1 Shampoo & Conditioner 16 Fl. Oz 2pk,AXE Phoenix 2-In-1 Shampoo & Conditioner 16 Fl. Oz 2pk,FBALYB Amazon,43,43,0,0,0,0
,"Axe Shower Gel, Kilo, 16 Fluid oz 3pack","Axe Shower Gel, Kilo, 16 Fluid oz 3pack",FBALYB Amazon,3,3,0,0,0,0
,"Axe Shower Gel, Snake Peel 16oz 2pk","Axe Shower Gel, Snake Peel 16oz 2pk",FBALYB Amazon,-2,-2,0,0,0,0
,"Axe Shower Gel, Snake Peel 16oz 3pk","Axe Shower Gel, Snake Peel 16oz 3pk",FBALYB Amazon,-1,-1,0,0,0,0
,AXE White Night Body Wash 16oz 3pk,AXE White Night Body Wash 16oz 3pk,FBALYB Amazon,19,19,0,0,0,0
,Axe You Body Wash - 16oz 2pk,Axe You Body Wash - 16oz 2pk,FBALYB Amazon,2,2,0,1,0,0
,B12 1000mcg 3pack,B12 1000mcg 3pack,FBALYB Amazon,-1,-1,0,0,0,0
,Badia Minced Garlic in Olive Oil 8oz,Badia Minced Garlic in Olive Oil 8oz,Default,0,0,0,0,0,50
,Bagel Slicer Black,Bagel Slicer Black,FBALYB Amazon,-3,-3,0,2,0,0
,Bagel Slicer Red,Bagel Slicer Red,Default Ridgefield,7,7,0,0,0,0
,Bagel Slicer Red,Bagel Slicer Red,FBALYB Amazon,-22,-22,0,23,0,0
,Bags on Board Scented Bag Refill 140ct,Bags on Board Scented Bag Refill 140ct,Default,0,0,0,0,0,1
,BAILEYS Original Irish Cream Liquor Filled Chocolate 600g,BAILEYS Original Irish Cream Liquor Filled Chocolate 600g,FBALYB Amazon,4,4,0,0,0,0
,Bakugan Battle Arena Season-6045142,Bakugan Battle Arena Season-6045142,Default Ridgefield,502,502,0,0,0,0
,Bakugan Battle Arena Season-6045142,Bakugan Battle Arena Season-6045142,FBALYB Amazon,82,79,3,1,3,0
,Bakugan Battle Arena Season-6045142,Bakugan Battle Arena Season-6045142,FBALYB Canada,-1,-1,0,74,0,0
,"Bakugan, Battle Brawlers Starter, Aquos Pyravian","Bakugan, Battle Brawlers Starter, Aquos Pyravian",FBALYB Amazon,-10,-10,0,0,0,0
,"Bakugan, Battle Brawlers Starter Aurelus Nobilious","Bakugan, Battle Brawlers Starter Aurelus Nobilious",FBALYB Amazon,-17,-17,0,9,0,0
,"Bakugan, Battle Brawlers Starter Set Darkus, Hydranoid","Bakugan, Battle Brawlers Starter Set Darkus, Hydranoid",FBALYB Amazon,-45,-45,0,1,0,0
,Bakugan TCG Starter Pack,,Default,0,-1836,1836,0,0,0
,Banana Boat-Aloe After Sun Gel 480 ml,Banana Boat-Aloe After Sun Gel 480 ml,Default Ridgefield,649,199,450,0,0,0
,Banana Boat-Aloe After Sun Gel 480 ml,Banana Boat-Aloe After Sun Gel 480 ml,FBALYB Amazon,2991,2987,4,16,4,0
,Banana Boat-Aloe After Sun Gel 480 ml,Banana Boat-Aloe After Sun Gel 480 ml,FBALYB Canada,19,19,0,0,0,0
,Banana Boat-Aloe After Sun Gel 480 ml 2PK,Banana Boat-Aloe After Sun Gel 480 ml 2PK,FBALYB Amazon,21,21,0,0,0,0
,Banana Boat-Aloe After Sun Gel 480 ml 3 PK,Banana Boat-Aloe After Sun Gel 480 ml 3 PK,FBALYB Amazon,130,130,0,1,0,0
,"Banana Boat-Sunscreen Oil SPF 15 ,240 ml","Banana Boat-Sunscreen Oil SPF 15 ,240 ml",Default Oxford,26,26,0,0,0,0
,"Banana Boat-Sunscreen Oil SPF 15 ,240 ml","Banana Boat-Sunscreen Oil SPF 15 ,240 ml",Default Ridgefield,70,10,60,0,0,0
,"Banana Boat-Sunscreen Oil SPF 15 ,240 ml","Banana Boat-Sunscreen Oil SPF 15 ,240 ml",FBALYB Amazon,1,0,1,3,1,0
,Banana Boat-Sunscreen Oil SPF 15 240 ml 2 PK,Banana Boat-Sunscreen Oil SPF 15 240 ml 2 PK,FBALYB Amazon,2,-1,3,0,3,0
,Banana Boat-Sunscreen Oil SPF 15 240 ml 4 PK,Banana Boat-Sunscreen Oil SPF 15 240 ml 4 PK,FBALYB Amazon,1,1,0,0,0,0
,Banana Boat-Sunscreen Oil SPF 15 240 ml 6 PK,Banana Boat-Sunscreen Oil SPF 15 240 ml 6 PK,FBALYB Amazon,86,86,0,0,0,0
,Banana Boat-Sunscreen Oil SPF 15 3PK,Banana Boat-Sunscreen Oil SPF 15 240 ml 3PK,FBALYB Amazon,18,15,3,1,3,0
,BARBIE ATHLETE,BARBIE ATHLETE,FBALYB Amazon,-1,-1,0,1,0,0
,BARBIE FIREFIGHTER,BARBIE FIREFIGHTER,FBALYB Amazon,-1,-1,0,1,0,0
,Bare Minerals - Barepro Performance Wear Liquid Foundation - Cool Beige 10 - 30 ml / 15 g,Bare Minerals - Barepro Performance Wear Liquid Foundation - Cool Beige 10 - 30 ml / 15 g,Default Ridgefield,1982,1982,0,0,0,0
,Bare Minerals - Barepro Performance Wear Liquid Foundation - Cool Beige 10 - 30 ml / 15 g,Bare Minerals - Barepro Performance Wear Liquid Foundation - Cool Beige 10 - 30 ml / 15 g,FBALYB Amazon,594,594,0,1,0,0
,Bare Minerals Barepro® Performance Wear Liquid Foundation Spf 20 Natural,Bare Minerals Barepro® Performance Wear Liquid Foundation Spf 20 Natural,Default Ridgefield,360,360,0,0,0,0
,Bare Minerals Barepro® Performance Wear Liquid Foundation Spf 20 Natural,Bare Minerals Barepro® Performance Wear Liquid Foundation Spf 20 Natural,FBALYB Amazon,167,167,0,0,0,0
,Bare Minerals - Barepro Performance Wear -  Natural 11 - 10g / 0.35 oz,Bare Minerals - Barepro Performance Wear -  Natural 11 - 10g / 0.35 oz,Default Ridgefield,477,477,0,0,0,0
,Bare Minerals - Barepro Performance Wear -  Natural 11 - 10g / 0.35 oz,Bare Minerals - Barepro Performance Wear -  Natural 11 - 10g / 0.35 oz,FBALYB Amazon,838,838,0,3,0,0
,Bare Minerals - Barepro Performance Wear -  Natural 11 - 10g / 0.35 oz,Bare Minerals - Barepro Performance Wear -  Natural 11 - 10g / 0.35 oz,WFS,-5,-5,0,0,0,0
,Bare Minerals Barepro® Performance Wear Powder Foundation Aspen,Bare Minerals Barepro® Performance Wear Powder Foundation Aspen,FBALYB Amazon,49,49,0,19,0,0
,Bare Minerals Barepro® Performance Wear Powder Foundation Cashmere,Bare Minerals Barepro® Performance Wear Powder Foundation Cashmere,Default Ridgefield,977,977,0,0,0,0
,Bare Minerals Barepro® Performance Wear Powder Foundation Cashmere,Bare Minerals Barepro® Performance Wear Powder Foundation Cashmere,FBALYB Amazon,-5,-5,0,5,0,0
,Bare Minerals Barepro® Performance Wear Powder Foundation Cool Beige,Bare Minerals Barepro® Performance Wear Powder Foundation Cool Beige,Default Ridgefield,47,47,0,0,0,0
,Bare Minerals Barepro® Performance Wear Powder Foundation Cool Beige,Bare Minerals Barepro® Performance Wear Powder Foundation Cool Beige,FBALYB Amazon,568,568,0,6,0,0
,Bare Minerals Barepro® Performance Wear Powder Foundation Fair,Bare Minerals Barepro® Performance Wear Powder Foundation Fair,Default Ridgefield,528,528,0,0,0,0
,Bare Minerals Barepro® Performance Wear Powder Foundation Fair,Bare Minerals Barepro® Performance Wear Powder Foundation Fair,FBALYB Amazon,693,693,0,0,0,0
,Bare Minerals Barepro® Performance Wear Powder Foundation Golden Ivory,Bare Minerals Barepro® Performance Wear Powder Foundation Golden Ivory,Default Ridgefield,50,50,0,0,0,0
,Bare Minerals Barepro® Performance Wear Powder Foundation Golden Ivory,Bare Minerals Barepro® Performance Wear Powder Foundation Golden Ivory,FBALYB Amazon,425,425,0,0,0,0
,Bare Minerals Barepro® Performance Wear Powder Foundation Light Natural,Bare Minerals Barepro® Performance Wear Powder Foundation Light Natural,Default Ridgefield,1396,1396,0,0,0,0
,Bare Minerals Barepro® Performance Wear Powder Foundation Light Natural,Bare Minerals Barepro® Performance Wear Powder Foundation Light Natural,FBALYB Amazon,1019,1019,0,5,0,0
,Bare Minerals Barepro® Performance Wear Powder Foundation Sable,Bare Minerals Barepro® Performance Wear Powder Foundation Sable,Default Ridgefield,337,337,0,0,0,0
,Bare Minerals Barepro® Performance Wear Powder Foundation Sable,Bare Minerals Barepro® Performance Wear Powder Foundation Sable,FBALYB Amazon,575,575,0,3,0,0
,Bare Minerals Barepro® Performance Wear Powder Foundation Sandalwood,Bare Minerals Barepro® Performance Wear Powder Foundation Sandalwood,Default Ridgefield,195,195,0,0,0,0
,Bare Minerals Barepro® Performance Wear Powder Foundation Sandalwood,Bare Minerals Barepro® Performance Wear Powder Foundation Sandalwood,FBALYB Amazon,304,304,0,0,0,0
,Bare Minerals Barepro® Performance Wear Powder Foundation Sandstone,Bare Minerals Barepro® Performance Wear Powder Foundation Sandstone,Default Ridgefield,1583,1583,0,0,0,0
,Bare Minerals Barepro® Performance Wear Powder Foundation Sandstone,Bare Minerals Barepro® Performance Wear Powder Foundation Sandstone,FBALYB Amazon,669,669,0,1,0,0
,Bare Minerals Barepro® Performance Wear Powder Foundation Sateen,Bare Minerals Barepro® Performance Wear Powder Foundation Sateen,Default Ridgefield,271,271,0,0,0,0
,Bare Minerals Barepro® Performance Wear Powder Foundation Sateen,Bare Minerals Barepro® Performance Wear Powder Foundation Sateen,FBALYB Amazon,98,98,0,0,0,0
,Bare Minerals Barepro® Performance Wear Powder Foundation Silk,Bare Minerals Barepro® Performance Wear Powder Foundation Silk,Default Ridgefield,685,685,0,0,0,0
,Bare Minerals Barepro® Performance Wear Powder Foundation Silk,Bare Minerals Barepro® Performance Wear Powder Foundation Silk,FBALYB Amazon,1,1,0,0,0,0
,Bare Minerals Barepro® Performance Wear Powder Foundation Warm Light,Bare Minerals Barepro® Performance Wear Powder Foundation Warm Light,Default Ridgefield,512,512,0,0,0,0
,Bare Minerals Barepro® Performance Wear Powder Foundation Warm Light,Bare Minerals Barepro® Performance Wear Powder Foundation Warm Light,FBALYB Amazon,164,164,0,1,0,0
,Bare Minerals - Barepro Performance Wear - Warm Natural 12 - 10g / 0.35 oz,Bare Minerals - Barepro Performance Wear - Warm Natural 12 - 10g / 0.35 oz,Default Ridgefield,2450,2450,0,0,0,0
,Bare Minerals - Barepro Performance Wear - Warm Natural 12 - 10g / 0.35 oz,Bare Minerals - Barepro Performance Wear - Warm Natural 12 - 10g / 0.35 oz,FBALYB Amazon,246,246,0,1,0,0
,Bare Minerals Bareskin® Complete Coverage Serum Concealer Light,Bare Minerals Bareskin® Complete Coverage Serum Concealer Light,Default Ridgefield,957,957,0,0,0,0
,Bare Minerals Bareskin® Complete Coverage Serum Concealer Light,Bare Minerals Bareskin® Complete Coverage Serum Concealer Light,FBALYB Amazon,-9,-9,0,0,0,0
,Bare Minerals Bareskin® Perfecting Veil Tan to Dark,Bare Minerals Bareskin® Perfecting Veil Tan to Dark,Default Ridgefield,96,96,0,0,0,0
,Bare Minerals Bareskin® Perfecting Veil Tan to Dark,Bare Minerals Bareskin® Perfecting Veil Tan to Dark,FBALYB Amazon,46,46,0,96,0,0
,Bare Minerals - Complexion Rescue - Ginger 06 - 30 ml / 1 fl. oz.,Bare Minerals - Complexion Rescue - Ginger 06 - 30 ml / 1 fl. oz.,Default Ridgefield,120,120,0,0,0,0
,Bare Minerals - Complexion Rescue - Ginger 06 - 30 ml / 1 fl. oz.,Bare Minerals - Complexion Rescue - Ginger 06 - 30 ml / 1 fl. oz.,FBALYB Amazon,-1,-1,0,0,0,0
,Bare Minerals - Complexion Rescue - Natural 05 - 30 ml / 1 fl. oz.,Bare Minerals - Complexion Rescue - Natural 05 - 30 ml / 1 fl. oz.,Default Ridgefield,3612,3612,0,0,0,0
,Bare Minerals - Complexion Rescue - Natural 05 - 30 ml / 1 fl. oz.,Bare Minerals - Complexion Rescue - Natural 05 - 30 ml / 1 fl. oz.,FBALYB Amazon,-151,-154,3,0,3,0
,Bare Minerals Complexion Rescue Tinted Moisturizer - Hydrating Gel Cream Broad Spectrum Spf 30 Bamboo 5.5,Bare Minerals Complexion Rescue Tinted Moisturizer - Hydrating Gel Cream Broad Spectrum Spf 30 Bamboo 5.5,Default Ridgefield,381,381,0,0,0,0
,Bare Minerals Complexion Rescue Tinted Moisturizer - Hydrating Gel Cream Broad Spectrum Spf 30 Bamboo 5.5,Bare Minerals Complexion Rescue Tinted Moisturizer - Hydrating Gel Cream Broad Spectrum Spf 30 Bamboo 5.5,FBALYB Amazon,49,49,0,0,0,0
,Bare Minerals Complexion Rescue Tinted Moisturizer - Hydrating Gel Cream Broad Spectrum Spf 30 Buttercream 03,Bare Minerals Complexion Rescue Tinted Moisturizer - Hydrating Gel Cream Broad Spectrum Spf 30 Buttercream 03,Default Ridgefield,201,201,0,0,0,0
,Bare Minerals Complexion Rescue Tinted Moisturizer - Hydrating Gel Cream Broad Spectrum Spf 30 Buttercream 03,Bare Minerals Complexion Rescue Tinted Moisturizer - Hydrating Gel Cream Broad Spectrum Spf 30 Buttercream 03,FBALYB Amazon,602,602,0,0,0,0
,Bare Minerals Complexion Rescue Tinted Moisturizer - Hydrating Gel Cream Broad Spectrum Spf 30 Buttercream 03,Bare Minerals Complexion Rescue Tinted Moisturizer - Hydrating Gel Cream Broad Spectrum Spf 30 Buttercream 03,FBALYB Dubai,32,32,0,0,0,0
,Bare Minerals Complexion Rescue Tinted Moisturizer - Hydrating Gel Cream Broad Spectrum Spf 30 Chestnut 09,Bare Minerals Complexion Rescue Tinted Moisturizer - Hydrating Gel Cream Broad Spectrum Spf 30 Chestnut 09,Default Ridgefield,204,204,0,0,0,0
,Bare Minerals Complexion Rescue Tinted Moisturizer - Hydrating Gel Cream Broad Spectrum Spf 30 Chestnut 09,Bare Minerals Complexion Rescue Tinted Moisturizer - Hydrating Gel Cream Broad Spectrum Spf 30 Chestnut 09,FBALYB Amazon,68,68,0,0,0,0
,Bare Minerals Complexion Rescue Tinted Moisturizer - Hydrating Gel Cream Broad Spectrum Spf 30 Chestnut 09,Bare Minerals Complexion Rescue Tinted Moisturizer - Hydrating Gel Cream Broad Spectrum Spf 30 Chestnut 09,FBALYB Dubai,50,50,0,0,0,0
,Bare Minerals Complexion Rescue Tinted Moisturizer - Hydrating Gel Cream Broad Spectrum Spf 30 Desert 6.5,Bare Minerals Complexion Rescue Tinted Moisturizer - Hydrating Gel Cream Broad Spectrum Spf 30 Desert 6.5,FBALYB Amazon,148,148,0,0,0,0
,Bare Minerals Complexion Rescue Tinted Moisturizer - Hydrating Gel Cream Broad Spectrum Spf 30 Desert 6.5,Bare Minerals Complexion Rescue Tinted Moisturizer - Hydrating Gel Cream Broad Spectrum Spf 30 Desert 6.5,WFS,-21,-21,0,0,0,0
,Bare Minerals Complexion Rescue Tinted Moisturizer - Hydrating Gel Cream Broad Spectrum Spf 30 Opal 01,Bare Minerals Complexion Rescue Tinted Moisturizer - Hydrating Gel Cream Broad Spectrum Spf 30 Opal 01,Default Ridgefield,722,722,0,0,0,0
,Bare Minerals Complexion Rescue Tinted Moisturizer - Hydrating Gel Cream Broad Spectrum Spf 30 Opal 01,Bare Minerals Complexion Rescue Tinted Moisturizer - Hydrating Gel Cream Broad Spectrum Spf 30 Opal 01,FBALYB Amazon,294,294,0,10,0,0
,Bare Minerals - Complexion Rescue - Wheat 4.5 - 30 ml / 1 fl. oz.,Bare Minerals - Complexion Rescue - Wheat 4.5 - 30 ml / 1 fl. oz.,Default Ridgefield,1062,1062,0,0,0,0
,Bare Minerals - Complexion Rescue - Wheat 4.5 - 30 ml / 1 fl. oz.,Bare Minerals - Complexion Rescue - Wheat 4.5 - 30 ml / 1 fl. oz.,FBALYB Amazon,1297,1297,0,7,0,0
,Bare Minerals - Concealers - Barepro 16-Hour Full Coverage Concealer - Light/Medium - Neutral 05 - 2.5g/0.08oz,Bare Minerals - Concealers - Barepro 16-Hour Full Coverage Concealer - Light/Medium - Neutral 05 - 2.5g/0.08oz,Default,0,-1,1,0,0,0
,Bare Minerals - Concealers - Barepro 16-Hour Full Coverage Concealer - Light/Medium - Neutral 05 - 2.5g/0.08oz,Bare Minerals - Concealers - Barepro 16-Hour Full Coverage Concealer - Light/Medium - Neutral 05 - 2.5g/0.08oz,Default Ridgefield,1499,1499,0,0,0,0
,Bare Minerals - Concealers - Barepro 16-Hour Full Coverage Concealer - Light/Medium - Neutral 05 - 2.5g/0.08oz,Bare Minerals - Concealers - Barepro 16-Hour Full Coverage Concealer - Light/Medium - Neutral 05 - 2.5g/0.08oz,FBALYB Amazon,282,279,3,30,2,0
,Bare Minerals - Concealers - Bareskin Complete Coverage Concealer - Fair - 6 ml / 0.2 fl oz,Bare Minerals - Concealers - Bareskin Complete Coverage Concealer - Fair - 6 ml / 0.2 fl oz,Default Ridgefield,952,952,0,0,0,0
,Bare Minerals - Concealers - Bareskin Complete Coverage Concealer - Fair - 6 ml / 0.2 fl oz,Bare Minerals - Concealers - Bareskin Complete Coverage Concealer - Fair - 6 ml / 0.2 fl oz,FBALYB Amazon,-3,-3,0,5,0,0
,Bare Minerals - Empower - Skinsorials Skinlongevity Serum - 50 ml / 1.7 fl. oz,Bare Minerals - Empower - Skinsorials Skinlongevity Serum - 50 ml / 1.7 fl. oz,Default,0,-1,1,0,0,0
,Bare Minerals - Empower - Skinsorials Skinlongevity Serum - 50 ml / 1.7 fl. oz,Bare Minerals - Empower - Skinsorials Skinlongevity Serum - 50 ml / 1.7 fl. oz,FBALYB Amazon,-2,-2,0,0,0,0
,Bare Minerals - Eyeliner - Lasting Line Long-Wearing Eyeliner - Absolute Black - 0.35 g / 0.012 oz.,Bare Minerals - Eyeliner - Lasting Line Long-Wearing Eyeliner - Absolute Black - 0.35 g / 0.012 oz.,Default Ridgefield,1198,1198,0,0,0,0
,Bare Minerals - Eyeliner - Lasting Line Long-Wearing Eyeliner - Absolute Black - 0.35 g / 0.012 oz.,Bare Minerals - Eyeliner - Lasting Line Long-Wearing Eyeliner - Absolute Black - 0.35 g / 0.012 oz.,FBALYB Amazon,90,90,0,13,0,0
,Bare Minerals - Finishers - Bareskin Perfecting Veil - Light/Medium - 9 g / 0.3 oz,Bare Minerals - Finishers - Bareskin Perfecting Veil - Light/Medium - 9 g / 0.3 oz,Default Ridgefield,900,900,0,0,0,0
,Bare Minerals - Finishers - Bareskin Perfecting Veil - Light/Medium - 9 g / 0.3 oz,Bare Minerals - Finishers - Bareskin Perfecting Veil - Light/Medium - 9 g / 0.3 oz,FBALYB Amazon,1,1,0,1,0,0
,Bare Minerals - Gen Nude Powder  Blush - Call My Blush - 6g/0.21oz,Bare Minerals - Gen Nude Powder  Blush - Call My Blush - 6g/0.21oz,Default Ridgefield,363,363,0,0,0,0
,Bare Minerals - Gen Nude Powder  Blush - Call My Blush - 6g/0.21oz,Bare Minerals - Gen Nude Powder  Blush - Call My Blush - 6g/0.21oz,FBALYB Amazon,1474,1474,0,6,0,0
,Bare Minerals - Get Started Kits - Nothing Beats The Original Get Started Mineral Foundation Kit - Light,Bare Minerals - Get Started Kits - Nothing Beats The Original Get Started Mineral Foundation Kit - Light,FBALYB Amazon,-3,-3,0,0,0,0
,Bare Minerals - Get Started Kits - Nothing Beats The Original Get Started Mineral Foundation Kit - Medium Beige,Bare Minerals - Get Started Kits - Nothing Beats The Original Get Started Mineral Foundation Kit - Medium Beige,FBALYB Amazon,-3,-3,0,0,0,0
,Bare Minerals Lashtopia Mega Volume Mineral-Based Mascara Ultimate Black,Bare Minerals Lashtopia Mega Volume Mineral-Based Mascara Ultimate Black,Default Ridgefield,251,251,0,0,0,0
,Bare Minerals Lashtopia Mega Volume Mineral-Based Mascara Ultimate Black,Bare Minerals Lashtopia Mega Volume Mineral-Based Mascara Ultimate Black,FBALYB Amazon,351,351,0,2,0,0
,Bare Minerals Lasting Line Long-Wearing Eyeliner Always Charcoal,Bare Minerals Lasting Line Long-Wearing Eyeliner Always Charcoal,Default Ridgefield,363,363,0,0,0,0
,Bare Minerals Lasting Line Long-Wearing Eyeliner Always Charcoal,Bare Minerals Lasting Line Long-Wearing Eyeliner Always Charcoal,FBALYB Amazon,299,299,0,0,0,0
,Bare Minerals Lasting Line Long-Wearing Eyeliner Lasting Brown,Bare Minerals Lasting Line Long-Wearing Eyeliner Lasting Brown,Default Ridgefield,1800,1800,0,0,0,0
,Bare Minerals Lasting Line Long-Wearing Eyeliner Lasting Brown,Bare Minerals Lasting Line Long-Wearing Eyeliner Lasting Brown,FBALYB Amazon,15,15,0,3,0,0
,Bare Minerals Lasting Line Long-Wearing Eyeliner Nonstop Navy,Bare Minerals Lasting Line Long-Wearing Eyeliner Nonstop Navy,FBALYB Amazon,8,8,0,1,0,0
,Bare Minerals Lasting LineTM Long-Wearing Eyeliner Eternal  Bronze,Bare Minerals Lasting LineTM Long-Wearing Eyeliner Eternal  Bronze,Default Ridgefield,176,176,0,0,0,0
,Bare Minerals Lasting LineTM Long-Wearing Eyeliner Eternal  Bronze,Bare Minerals Lasting LineTM Long-Wearing Eyeliner Eternal  Bronze,FBALYB Amazon,333,333,0,1,0,0
,Bare Minerals - Loose Blush - Hint  - 0.85 g / 0.03 oz,Bare Minerals - Loose Blush - Hint  - 0.85 g / 0.03 oz,Default Ridgefield,1314,1314,0,0,0,0
,Bare Minerals - Loose Blush - Hint  - 0.85 g / 0.03 oz,Bare Minerals - Loose Blush - Hint  - 0.85 g / 0.03 oz,FBALYB Amazon,154,154,0,0,0,0
,Bare Minerals Loose Powder Blush Beauty,Bare Minerals Loose Powder Blush Beauty,Default,0,0,0,0,0,38
,Bare Minerals Loose Powder Blush Beauty,Bare Minerals Loose Powder Blush Beauty,Default Ridgefield,295,295,0,0,0,0
,Bare Minerals Loose Powder Blush Beauty,Bare Minerals Loose Powder Blush Beauty,FBALYB Amazon,124,124,0,0,0,0
,Bare Minerals Loose Powder Matte Foundation Spf 15 Light 08,Bare Minerals Loose Powder Matte Foundation Spf 15 Light 08,Default Ridgefield,42,42,0,0,0,0
,Bare Minerals Loose Powder Matte Foundation Spf 15 Light 08,Bare Minerals Loose Powder Matte Foundation Spf 15 Light 08,FBALYB Amazon,170,170,0,3,0,0
,Bare Minerals Loose Powder Matte Foundation Spf 15 Medium 10,Bare Minerals Loose Powder Matte Foundation Spf 15 Medium 10,Default Ridgefield,1213,1213,0,0,0,0
,Bare Minerals Loose Powder Matte Foundation Spf 15 Medium 10,Bare Minerals Loose Powder Matte Foundation Spf 15 Medium 10,FBALYB Amazon,149,149,0,4,0,0
,Bare Minerals - Mascara - Lash Dominatio? Mascara - Black - 11 ml / 0.37 fl.oz.,Bare Minerals - Mascara - Lash Domination Mascara - Black - 11 ml / 0.37 fl.oz.,Default Ridgefield,2749,2749,0,0,0,0
,Bare Minerals - Mascara - Lash Dominatio? Mascara - Black - 11 ml / 0.37 fl.oz.,Bare Minerals - Mascara - Lash Domination Mascara - Black - 11 ml / 0.37 fl.oz.,FBALYB Amazon,968,967,1,11,1,0
,Bare Minerals - Matte Foundation Spf 15 - Fairly Light 03 - 6 g / 0.21 oz,Bare Minerals - Matte Foundation Spf 15 - Fairly Light 03 - 6 g / 0.21 oz,Default,0,-1,1,0,0,60
,Bare Minerals - Matte Foundation Spf 15 - Fairly Light 03 - 6 g / 0.21 oz,Bare Minerals - Matte Foundation Spf 15 - Fairly Light 03 - 6 g / 0.21 oz,Default Ridgefield,608,608,0,0,0,0
,Bare Minerals - Matte Foundation Spf 15 - Fairly Light 03 - 6 g / 0.21 oz,Bare Minerals - Matte Foundation Spf 15 - Fairly Light 03 - 6 g / 0.21 oz,FBALYB Amazon,270,270,0,7,0,0
,Bare Minerals - Matte Foundation Spf 15 - Fairly Medium 05 - 6 g / 0.21 oz,Bare Minerals - Matte Foundation Spf 15 - Fairly Medium 05 - 6 g / 0.21 oz,FBALYB Amazon,242,242,0,4,0,0
,Bare Minerals - Matte Foundation Spf 15 - Medium Beige 12 - 6 g / 0.21 oz,Bare Minerals - Matte Foundation Spf 15 - Medium Beige 12 - 6 g / 0.21 oz,Avrami - Ebay,1592,1592,0,0,0,0
,Bare Minerals - Matte Foundation Spf 15 - Medium Beige 12 - 6 g / 0.21 oz,Bare Minerals - Matte Foundation Spf 15 - Medium Beige 12 - 6 g / 0.21 oz,Default Ridgefield,2514,2514,0,0,0,0
,Bare Minerals - Matte Foundation Spf 15 - Medium Beige 12 - 6 g / 0.21 oz,Bare Minerals - Matte Foundation Spf 15 - Medium Beige 12 - 6 g / 0.21 oz,FBALYB Amazon,822,822,0,10,0,0
,Bare Minerals - Matte Foundation Spf 15 - Soft Medium 11 - 6 g / 0.21 oz,Bare Minerals - Matte Foundation Spf 15 - Soft Medium 11 - 6 g / 0.21 oz,Default,0,-4,4,0,0,0
,Bare Minerals - Matte Foundation Spf 15 - Soft Medium 11 - 6 g / 0.21 oz,Bare Minerals - Matte Foundation Spf 15 - Soft Medium 11 - 6 g / 0.21 oz,FBALYB Amazon,399,399,0,1,0,0
,Bare Minerals - Matte Foundation Spf 15 - Soft Medium 11 - 6 g / 0.21 oz,Bare Minerals - Matte Foundation Spf 15 - Soft Medium 11 - 6 g / 0.21 oz,WFS,-21,-21,0,0,0,0
,Bare Minerals Mineral Veil Finishing Powder Original,Bare Minerals Mineral Veil Finishing Powder Original,Default Ridgefield,1200,1200,0,0,0,0
,Bare Minerals Mineral Veil Finishing Powder Original,Bare Minerals Mineral Veil Finishing Powder Original,FBALYB Amazon,-56,-56,0,69,0,0
,Bare Minerals - Moisturize - Skinsorials Bare Haven - 50 g / 1.7 oz,Bare Minerals - Moisturize - Skinsorials Bare Haven - 50 g / 1.7 oz,FBALYB Amazon,-9,-9,0,3,0,0
,Bare Minerals - Moisturize - Skinsorials Butter Drench - 50 g / 1.7 oz,Bare Minerals - Moisturize - Skinsorials Butter Drench - 50 g / 1.7 oz,Avrami - Ebay,96,96,0,0,0,0
,Bare Minerals - Moisturize - Skinsorials Butter Drench - 50 g / 1.7 oz,Bare Minerals - Moisturize - Skinsorials Butter Drench - 50 g / 1.7 oz,Default Ridgefield,1521,1521,0,0,0,0
,Bare Minerals - Moisturize - Skinsorials Butter Drench - 50 g / 1.7 oz,Bare Minerals - Moisturize - Skinsorials Butter Drench - 50 g / 1.7 oz,FBAFBALYB UK,1,0,1,0,1,0
,Bare Minerals - Moisturize - Skinsorials Butter Drench - 50 g / 1.7 oz,Bare Minerals - Moisturize - Skinsorials Butter Drench - 50 g / 1.7 oz,FBALYB Amazon,2046,2045,1,3,1,0
,Bare Minerals - Moisturize - Skinsorials True Oasis - 50 g / 1.7 oz,Bare Minerals - Moisturize - Skinsorials True Oasis - 50 g / 1.7 oz,FBALYB Amazon,-4,-4,0,3,0,0
,Bare Minerals - Original Foundation Spf 15 - Fairly Light 03 - 8 g / 0.28 oz,Bare Minerals - Original Foundation Spf 15 - Fairly Light 03 - 8 g / 0.28 oz,Default Ridgefield,1716,1716,0,0,0,0
,Bare Minerals - Original Foundation Spf 15 - Fairly Light 03 - 8 g / 0.28 oz,Bare Minerals - Original Foundation Spf 15 - Fairly Light 03 - 8 g / 0.28 oz,FBALYB Amazon,3525,3525,0,964,0,0
,Bare Minerals - Original Foundation Spf 15 - Fairly Medium 05 - 8 g / 0.28 oz,Bare Minerals - Original Foundation Spf 15 - Fairly Medium 05 - 8 g / 0.28 oz,Default Ridgefield,1094,1094,0,0,0,0
,Bare Minerals - Original Foundation Spf 15 - Fairly Medium 05 - 8 g / 0.28 oz,Bare Minerals - Original Foundation Spf 15 - Fairly Medium 05 - 8 g / 0.28 oz,FBALYB Amazon,38,38,0,6,0,0
,Bare Minerals - Original Foundation Spf 15 - Neutral Ivory 06 - 8 g / 0.28 oz,Bare Minerals - Original Foundation Spf 15 - Neutral Ivory 06 - 8 g / 0.28 oz,Default Ridgefield,478,478,0,0,0,0
,Bare Minerals Original Loose Powder Foundation Spf 15 Golden Medium 14,Bare Minerals Original Loose Powder Foundation Spf 15 Golden Medium 14,Default Ridgefield,60,60,0,0,0,0
,Bare Minerals Original Loose Powder Foundation Spf 15 Golden Medium 14,Bare Minerals Original Loose Powder Foundation Spf 15 Golden Medium 14,FBALYB Amazon,74,74,0,1,0,0
,Bare Minerals Original Loose Powder Foundation Spf 15 Light 08,Bare Minerals Original Loose Powder Foundation Spf 15 Light 08,Default Ridgefield,670,670,0,0,0,0
,Bare Minerals Original Loose Powder Foundation Spf 15 Light 08,Bare Minerals Original Loose Powder Foundation Spf 15 Light 08,FBALYB Amazon,119,119,0,10,0,0
,Bare Minerals Original Loose Powder Foundation Spf 15 Medium  10,Bare Minerals Original Loose Powder Foundation Spf 15 Medium  10,Default Ridgefield,860,860,0,0,0,0
,Bare Minerals Original Loose Powder Foundation Spf 15 Medium  10,Bare Minerals Original Loose Powder Foundation Spf 15 Medium  10,FBALYB Amazon,144,144,0,2,0,0
,Bare Minerals Original Loose Powder Foundation Spf 15 Medium  Beige 12,Bare Minerals Original Loose Powder Foundation Spf 15 Medium  Beige 12,Default Oxford,10,10,0,0,0,0
,Bare Minerals Original Loose Powder Foundation Spf 15 Medium  Beige 12,Bare Minerals Original Loose Powder Foundation Spf 15 Medium  Beige 12,Default Ridgefield,4,4,0,0,0,0
,Bare Minerals Original Loose Powder Foundation Spf 15 Medium  Beige 12,Bare Minerals Original Loose Powder Foundation Spf 15 Medium  Beige 12,FBALYB Amazon,19,18,1,16,1,0
,Bare Minerals - Prep - Prime Time? Bb Primer -Cream Spf 30 - Light - Light - 30 ml / 1 fl. oz.,Bare Minerals - Prep - Prime Time? Bb Primer -Cream Spf 30 - Light - Light - 30 ml / 1 fl. oz.,Default Ridgefield,926,926,0,0,0,0
,Bare Minerals - Prep - Prime Time? Bb Primer -Cream Spf 30 - Light - Light - 30 ml / 1 fl. oz.,Bare Minerals - Prep - Prime Time? Bb Primer -Cream Spf 30 - Light - Light - 30 ml / 1 fl. oz.,FBALYB Amazon,1025,1025,0,2,0,0
,Bare Minerals - Prep - Prime Time? Eyelid Primer- Original Eye Primer - 3 ml / 0.1oz,Bare Minerals - Prep - Prime Time? Eyelid Primer- Original Eye Primer - 3 ml / 0.1oz,Default Ridgefield,2891,2891,0,0,0,0
,Bare Minerals - Prep - Prime Time? Eyelid Primer- Original Eye Primer - 3 ml / 0.1oz,Bare Minerals - Prep - Prime Time? Eyelid Primer- Original Eye Primer - 3 ml / 0.1oz,FBALYB Amazon,846,846,0,1,0,0
,Bare Minerals - Prep - Prime Time Original Foundation Primer For Face - 30 ml / 1 fl. oz.,Bare Minerals - Prep - Prime Time Original Foundation Primer For Face - 30 ml / 1 fl. oz.,Default Ridgefield,2075,2075,0,0,0,0
,Bare Minerals - Prep - Prime Time Original Foundation Primer For Face - 30 ml / 1 fl. oz.,Bare Minerals - Prep - Prime Time Original Foundation Primer For Face - 30 ml / 1 fl. oz.,FBALYB Amazon,-224,-226,2,222,2,0
,Bare Minerals - Prep - Prime Time Original Foundation Primer For Face - 30 ml / 1 fl. oz.,Bare Minerals - Prep - Prime Time Original Foundation Primer For Face - 30 ml / 1 fl. oz.,FBALYB Dubai,90,90,0,0,0,0
,Bare Minerals Prime Time® Bb Primer Cream Daily Defense Medium,Bare Minerals Prime Time® Bb Primer Cream Daily Defense Medium,Default Ridgefield,301,301,0,0,0,0
,Bare Minerals Prime Time® Bb Primer Cream Daily Defense Medium,Bare Minerals Prime Time® Bb Primer Cream Daily Defense Medium,FBALYB Amazon,237,237,0,0,0,0
,Bare Minerals - Purify - Skinsorials  Oil Obsessed - 120 g / 4.2 oz,Bare Minerals - Purify - Skinsorials  Oil Obsessed - 120 g / 4.2 oz,FBALYB Amazon,8,8,0,0,0,0
,Bare Minerals - Purify - Skinsorials  Pure Plush - 120 g / 4.2 oz,Bare Minerals - Purify - Skinsorials  Pure Plush - 120 g / 4.2 oz,Default,0,0,0,0,0,1
,Bare Minerals - Purify - Skinsorials  Pure Plush - 120 g / 4.2 oz,Bare Minerals - Purify - Skinsorials  Pure Plush - 120 g / 4.2 oz,Default Ridgefield,1814,1814,0,0,0,0
,Bare Minerals - Purify - Skinsorials  Pure Plush - 120 g / 4.2 oz,Bare Minerals - Purify - Skinsorials  Pure Plush - 120 g / 4.2 oz,FBALYB Amazon,1141,1141,0,0,0,0
,Bare Minerals - Purify - Skinsorials  Pure Plush - 120 g / 4.2 oz,Bare Minerals - Purify - Skinsorials  Pure Plush - 120 g / 4.2 oz,FBALYB Dubai,47,47,0,0,0,0
,Bare Minerals Warmth All-Over Face Color Bronzer,Bare Minerals Warmth All-Over Face Color Bronzer,Default Ridgefield,932,932,0,0,0,0
,Bare Minerals Warmth All-Over Face Color Bronzer,Bare Minerals Warmth All-Over Face Color Bronzer,FBALYB Amazon,1867,1866,1,13,1,0
,Barista Prima Colombia 24ct,Barista Prima Colombia 24ct,Default,0,-360,360,0,0,0
,Barista Prima Colombia 24ct 2pk,Barista Prima Colombia 24ct 2pk,FBALYB Amazon,110,109,1,1,1,0
,Barista Prima Colombia 24ct 3pk,Barista Prima Colombia 24ct 3pk,Chicago,-30,-30,0,0,0,0
,Barista Prima Colombia 24ct 3pk,Barista Prima Colombia 24ct 3pk,FBALYB Amazon,50,50,0,43,0,0
,Barista Prima Colombia 24ct 4pk,Barista Prima Colombia 24ct 4pk,FBALYB Amazon,-50,-52,2,59,2,0
,Barista Prima French 120 (5 pack) k cups,Barista Prima French 120 (5 pack) k cups,Default,0,-25,25,0,0,0
,Barista Prima French 120 (5 pack) k cups,Barista Prima French 120 (5 pack) k cups,FBALYB Amazon,-17,-19,2,0,2,0
,Barista Prima French Roast 24ct,Barista Prima French Roast 24ct,FBALYB Amazon,-1,-1,0,131,0,0
,Barista Prima French Roast 24ct 2pk,Barista Prima French Roast 24ct 2pk,Default,0,-180,180,0,0,0
,Barista Prima French Roast 24ct 2pk,Barista Prima French Roast 24ct 2pk,FBALYB Amazon,11,11,0,30,0,0
,Barista Prima French Roast 24ct 3pk,Barista Prima French Roast 24ct 3pk,FBALYB Amazon,1,1,0,0,0,0
,Barista Prima French Roast 24ct 4pk,Barista Prima French Roast 24ct 4pk,Default,0,-16,16,0,0,0
,Barista Prima French Roast 24ct 4pk,Barista Prima French Roast 24ct 4pk,FBALYB Amazon,-8,-8,0,42,0,0
,Barista Prima House Blend 24ct,Barista Prima House Blend 24ct,Default,0,-512,512,0,0,0
,Barista Prima House Blend 24ct,Barista Prima House Blend 24ct,FBALYB Amazon,1,0,1,0,1,0
,Barista Prima House Blend 24ct 2pk,Barista Prima House Blend 24ct 2pk,Default,-15,-15,0,0,0,0
,Barista Prima House Blend 24ct 3pk,Barista Prima House Blend 24ct 3pk,Default,-40,-40,0,0,0,0
,Barista Prima House Blend 24ct 3pk,Barista Prima House Blend 24ct 3pk,FBALYB Amazon,3,3,0,0,0,0
,Barista Prima House Blend 24ct 4pk,Barista Prima House Blend 24ct 4pk,FBALYB Amazon,11,11,0,0,0,0
,Barista Prima Italian 72 ct (3 pk),Barista Prima Italian 72 ct (3 pk),FBALYB Amazon,3,3,0,2,0,0
,Barista Prima Italian Roast 24ct,Barista Prima Italian Roast 24ct,Default,0,-83,83,0,0,0
,Barista Prima Italian Roast 24ct,Barista Prima Italian Roast 24ct,FBALYB Amazon,409,409,0,58,0,0
,Barista Prima Italian Roast 24ct 2pk,Barista Prima Italian Roast 24ct 2pk,Default,0,-20,20,0,0,0
,Barista Prima Italian Roast 24ct 2pk,Barista Prima Italian Roast 24ct 2pk,FBALYB Amazon,-44,-56,12,96,12,0
,Barista Prima Italian Roast 24ct 4pk,Barista Prima Italian Roast 24ct 4pk,FBALYB Amazon,-106,-110,4,190,4,0
,Bark Thin Chocolate Dark Chocolate Almond 17oz,Bark Thin Chocolate Dark Chocolate Almond 17oz,FBALYB Amazon,0,0,0,1,0,0
,BARK THINS 17Z ALMOND/PRETZEL,BARK THINS 17Z ALMOND/PRETZEL,FBALYB Amazon,24,24,0,0,0,0
,"Barkworthies Bully Stick 12"" Double Cut 4pk","Barkworthies Bully Stick 12"" Double Cut 4pk",FBALYB Amazon,1,1,0,0,0,0
,Barkworthies Bully Stick 12oz,Barkworthies Bully Stick 12oz,Default,0,0,0,0,0,6
,Barkworthies Bully Stick 12oz,Barkworthies Bully Stick 12oz,Default Ridgefield,0,-472,472,0,0,0
,Barkworthies Bully Stick 12oz 3pk,Barkworthies Bully Stick 12oz 3pk,FBALYB Amazon,1,1,0,0,0,0
,Barkworthies Cow Tails 6oz 2pk,Barkworthies Cow Tails 6oz 2pk,FBALYB Amazon,-1,-1,0,0,0,0
,"Barkworthies JR Bully Stick 6"" 5pk","Barkworthies JR Bully Stick 6"" 5pk",FBALYB Amazon,-3,-3,0,0,0,0
,Barkworthies Lamb Puffs 12oz,Barkworthies Lamb Puffs 12oz,FBALYB Amazon,2,2,0,0,0,0
,Barkworthies Large Stuffed Shin Bone,Barkworthies Large Stuffed Shin Bone,FBALYB Amazon,-1,-1,0,0,0,0
,Barkworthies Pig Ears 10ct,Barkworthies Pig Ears 10ct,FBALYB Amazon,10,10,0,0,0,0
,Batiste 200ml Dry Shampoo Original,Batiste 200ml Dry Shampoo Original,Default,0,-90182,90182,0,0,0
,Batiste 200ml Dry Shampoo Original,Batiste 200ml Dry Shampoo Original,Default Oxford,2129,2129,0,0,0,0
,Batiste 200ml Dry Shampoo Original,Batiste 200ml Dry Shampoo Original,Default Ridgefield,6535,6535,0,0,0,0
,Batiste 200ml Dry Shampoo Original,Batiste 200ml Dry Shampoo Original,FBALYB Amazon,841,841,0,8,0,0
,Batiste 200ml Dry Shampoo Original,Batiste 200ml Dry Shampoo Original,WFS,-447,-447,0,0,0,0
,Batiste 200ml Dry Shampoo Original 2 pack,Batiste 200ml Dry Shampoo Original 2 pack,FBALYB Amazon,958,885,73,0,73,0
,Batiste 200ml Dry Shampoo Original 5pk,Batiste 200ml Dry Shampoo Original 5pk,Default,0,-1,1,0,0,0
,Batiste 200ml Dry Shampoo Original 5pk,Batiste 200ml Dry Shampoo Original 5pk,FBALYB Amazon,26,20,6,0,6,0
,Batiste Beautiful Brunette 200ml / 6.73 Oz Dry Shampoo,Batiste Beautiful Brunette 200ml / 6.73 Oz Dry Shampoo,Default Ridgefield,659,659,0,0,0,0
,Batiste Beautiful Brunette 200ml / 6.73 Oz Dry Shampoo,Batiste Beautiful Brunette 200ml / 6.73 Oz Dry Shampoo,FBALYB Amazon,332,311,21,0,21,0
,Batiste Beautiful Brunette 200ml / 6.73 Oz Dry Shampoo,Batiste Beautiful Brunette 200ml / 6.73 Oz Dry Shampoo,WFS,-2,-2,0,0,0,0
,Batiste Beautiful Brunette 200ml / 6.73 Oz Dry Shampoo 3pk,Batiste Beautiful Brunette 200ml / 6.73 Oz Dry Shampoo 3pk,FBALYB Amazon,310,175,135,0,135,0
,Batiste Beautiful Brunette 200ml / 6.73 Oz Dry Shampoo 3pk,Batiste Beautiful Brunette 200ml / 6.73 Oz Dry Shampoo 3pk,FBALYB Canada,8,8,0,0,0,0
,Batiste Beautiful Brunette 200ml / 6.73 Oz Dry Shampoo - 6pk,Batiste Beautiful Brunette 200ml / 6.73 Oz Dry Shampoo - 6pk,FBALYB Amazon,18,18,0,0,0,0
,Batiste Brilliant Blonde 200 ML,Batiste Brilliant Blonde 200 ML,Avrami - Ebay,2400,2400,0,0,0,0
,Batiste Brilliant Blonde 200 ML,Batiste Brilliant Blonde 200 ML,Default Oxford,7855,7855,0,0,0,0
,Batiste Brilliant Blonde 200 ML,Batiste Brilliant Blonde 200 ML,FBALYB Amazon,179,153,26,3,26,0
,Batiste Brilliant Blonde 200 ML,Batiste Brilliant Blonde 200 ML,WFS,-261,-261,0,0,0,0
,Batiste Brilliant Blonde 200ml - 2pk,Batiste Brilliant Blonde 200ml - 2pk,FBALYB Amazon,94,93,1,0,1,0
,Batiste Brilliant Blonde 200ml - 2pk,Batiste Brilliant Blonde 200ml - 2pk,WFS,-22,-22,0,0,0,0
,Batiste Brilliant Blonde 200 ML 3pk,Batiste Brilliant Blonde 200 ML 3pk,FBALYB Amazon,-5,-34,29,95,29,0
,Batiste Brilliant Blonde 200 ML- 3pk,Batiste Brilliant Blonde 200 ML- 3pk,FBALYB Amazon,229,227,2,3,2,0
,Batiste Brilliant Blonde 200 ML - 6pk,Batiste Brilliant Blonde 200 ML - 6pk,FBALYB Amazon,3,3,0,0,0,0
,Batiste Brilliant Blonde 200 ML - 6pk,Batiste Brilliant Blonde 200 ML - 6pk,WFS,-127,-127,0,0,0,0
,Batiste Brunette 2pk,Batiste Brunette 2pk,FBALYB Amazon,910,875,35,9,35,0
,Batiste Brunette 3 Pack,Batiste Brunette 3 Pack,FBALYB Amazon,892,892,0,17,0,0
,Batiste Brunette 3 Pack,Batiste Brunette 3 Pack,WFS,-124,-124,0,0,0,0
,Batiste Divine Dark 200ml / 6.73 Oz Dry Shampoo,Batiste Divine Dark 200ml / 6.73 Oz Dry Shampoo,Avrami - Ebay,552,552,0,0,0,0
,Batiste Divine Dark 200ml / 6.73 Oz Dry Shampoo,Batiste Divine Dark 200ml / 6.73 Oz Dry Shampoo,Default,0,-149278,149278,0,0,0
,Batiste Divine Dark 200ml / 6.73 Oz Dry Shampoo,Batiste Divine Dark 200ml / 6.73 Oz Dry Shampoo,Default Oxford,131,131,0,0,0,0
,Batiste Divine Dark 200ml / 6.73 Oz Dry Shampoo,Batiste Divine Dark 200ml / 6.73 Oz Dry Shampoo,Default Ridgefield,14392,-8400,22792,0,0,0
,Batiste Divine Dark 200ml / 6.73 Oz Dry Shampoo,Batiste Divine Dark 200ml / 6.73 Oz Dry Shampoo,FBALYB Amazon,20,20,0,1,0,0
,Batiste Divine Dark 200ml / 6.73 Oz Dry Shampoo,Batiste Divine Dark 200ml / 6.73 Oz Dry Shampoo,WFS,1658,1658,0,0,0,0
,Batiste Divine Dark 2 Pack,Batiste Divine Dark 2 Pack,FBALYB Amazon,2465,2414,51,1265,51,0
,Batiste Divine Dark 6 Pack,Batiste Divine Dark 6 Pack,FBALYB Amazon,762,760,2,12,2,0
,Batiste Dry Shampoo 200ml Fresh,Batiste Dry Shampoo 200ml Fresh,Default,0,-7446,7446,0,0,6
,Batiste Dry Shampoo 200ml Fresh,Batiste Dry Shampoo 200ml Fresh,Default Ridgefield,1956,1956,0,0,0,0
,Batiste Dry Shampoo 200ml Fresh 2pk,Batiste Dry Shampoo 200ml Fresh 2pk,FBALYB Amazon,249,246,3,0,3,0
,Batiste Dry Shampoo 200ml Light,Batiste Dry Shampoo 200ml Light,Avrami - Ebay,276,276,0,0,0,0
,Batiste Dry Shampoo 200ml Light,Batiste Dry Shampoo 200ml Light,Default Ridgefield,0,-1158,1158,0,0,0
,Batiste Dry Shampoo Bare 200mL,Batiste Dry Shampoo Bare 200mL,Default,0,-4572,4572,0,0,0
,Batiste Dry Shampoo Bare 200mL,Batiste Dry Shampoo Bare 200mL,FBALYB Amazon,200,200,0,0,0,0
,Batiste Dry Shampoo Bare 200mL 6pk,Batiste Dry Shampoo Bare 200mL 6pk,FBALYB Amazon,-185,-185,0,128,0,0
,Batiste Dry Shampoo Bluch 3pk,Batiste Dry Shampoo Bluch 3pk,FBALYB Amazon,686,617,69,1202,69,0
,Batiste Dry Shampoo Blush - 200mL,Batiste Dry Shampoo Blush - 200mL,Default Oxford,1739,1739,0,0,0,0
,Batiste Dry Shampoo Blush - 200mL,Batiste Dry Shampoo Blush - 200mL,Default Ridgefield,12473,12473,0,0,0,0
,Batiste Dry Shampoo Blush - 200mL,Batiste Dry Shampoo Blush - 200mL,WFS,-49,-49,0,0,0,0
,Batiste Dry Shampoo Blush - 200mL - 2pk,Batiste Dry Shampoo Blush - 200mL - 2pk,WFS,-16,-16,0,0,0,0
,Batiste Dry Shampoo Blush - 200mL - 3pk,Batiste Dry Shampoo Blush - 200mL - 3pk,FBALYB Amazon,786,778,8,0,8,0
,Batiste Dry Shampoo Blush - 200mL - 3pk,Batiste Dry Shampoo Blush - 200mL - 3pk,WFS,-113,-113,0,0,0,0
,Batiste Dry Shampoo Blush - 200mL - 4pk,Batiste Dry Shampoo Blush - 200mL - 4pk,WFS,-28,-28,0,0,0,0
,Batiste Dry Shampoo Blush - 200mL - 6pk,Batiste Dry Shampoo Blush - 200mL - 6pk,FBALYB Amazon,499,497,2,0,2,0
,Batiste Dry Shampoo Cherry 4pk,Batiste Dry Shampoo Cherry 4pk,FBALYB Amazon,6,0,6,0,6,0
,Batiste Dry Shampoo Divine Dark 3pk,Batiste Dry Shampoo Divine Dark 3pk,FBALYB Amazon,1082,1071,11,28,11,0
,Batiste Dry Shampoo Divine Dark 3pk,Batiste Dry Shampoo Divine Dark 3pk,WFS,-23,-23,0,0,0,0
,Batiste DryShampoo Floral&Fruity 3pk,Batiste DryShampoo Floral&Fruity 3pk,FBALYB Amazon,5,3,2,4,2,0
,Batiste Dry Shampoo Original 2pk,Batiste Dry Shampoo Original 2pk,Default,0,-1,1,0,0,0
,Batiste Dry Shampoo Original 2pk,Batiste Dry Shampoo Original 2pk,FBALYB Amazon,-249,-252,3,259,3,0
,Batiste Dry Shampoo Original 3pk,Batiste Dry Shampoo Original 3pk,Default Ridgefield,1,0,1,0,0,0
,Batiste Dry Shampoo Original 3pk,Batiste Dry Shampoo Original 3pk,FBALYB Amazon,3511,3188,323,106,323,0
,Batiste Dry Shampoo Original 3pk,Batiste Dry Shampoo Original 3pk,WFS,-23,-23,0,0,0,0
,Batiste Dry Shampoo Original Mini 6pk,Batiste Dry Shampoo Original Mini 6pk,FBALYB Amazon,-2,-2,0,0,0,0
,"Batiste Dry Shampoo Spray Variety 4 Pack, 200ml - 6.7oz","Batiste Dry Shampoo Spray Variety 4 Pack, 200ml - 6.7oz",FBALYB Amazon,-609,-614,5,628,5,0
,Batiste Dry Shampoo Tropical 3pk,Batiste Dry Shampoo Tropical 3pk,FBALYB Amazon,6289,6107,182,392,182,0
,Batiste Dry Shampoo Tropical 3pk,Batiste Dry Shampoo Tropical 3pk,WFS,-26,-26,0,0,0,0
,Batiste Dry Shampoo Tropical 6.73oz 200ml,Batiste Dry Shampoo Tropical 6.73oz 200ml,Avrami - Ebay,375,375,0,0,0,0
,Batiste Dry Shampoo Tropical 6.73oz 200ml,Batiste Dry Shampoo Tropical 6.73oz 200ml,Default,0,-46763,46763,0,0,0
,Batiste Dry Shampoo Tropical 6.73oz 200ml,Batiste Dry Shampoo Tropical 6.73oz 200ml,Default Oxford,209,209,0,0,0,0
,Batiste Dry Shampoo Tropical 6.73oz 200ml,Batiste Dry Shampoo Tropical 6.73oz 200ml,Default Ridgefield,59731,59731,0,0,0,0
,Batiste Dry Shampoo Tropical 6.73oz 200ml,Batiste Dry Shampoo Tropical 6.73oz 200ml,FBALYB Amazon,2250,2241,9,11,9,0
,Batiste Dry Shampoo Tropical 6.73oz 200ml,Batiste Dry Shampoo Tropical 6.73oz 200ml,WFS,-292,-292,0,0,0,0
,"Batiste Dry Shampoo Variety 4 Pack, 200ml - 6.7oz (2 Tropical, 2 Original)","Batiste Dry Shampoo Variety 4 Pack, 200ml - 6.7oz (2 Tropical, 2 Original)",FBALYB Amazon,914,910,4,13,4,0
,Batiste Floral Essence Smpoo 200ml,Batiste Floral Essence Shampoo 200ml,Default Ridgefield,7200,7200,0,0,0,0
,Batiste Mini 50ml Original,Batiste Mini 50ml Original ,Default Ridgefield,6,6,0,0,0,0
,Batiste Mini Dry Shampoo 50ml Blush,Batiste Mini Dry Shampoo 50ml Blush,Default Ridgefield,1302,1302,0,0,0,0
,Batiste Original 6 Pk,Batiste Original 6 Pk,Default,1,0,1,0,0,0
,Batiste Original 6 Pk,Batiste Original 6 Pk,FBALYB Amazon,728,452,276,584,176,0
,Batiste Original 6 Pk,Batiste Original 6 Pk,WFS,-63,-63,0,0,0,0
,Batiste Shampoo Dry Brunette 6pk,Batiste Shampoo Dry Brunette 6pk,FBALYB Amazon,5,5,0,1,0,0
,Batiste Shampoo Dry Brunette 6pk,Batiste Shampoo Dry Brunette 6pk,WFS,-81,-81,0,0,0,0
,Batiste Shampoo Dry Cherry 2pk,Batiste Shampoo Dry Cherry 2pk,FBALYB Amazon,604,604,0,0,0,0
,Batiste Shampoo Dry Cherry 3pk,Batiste Shampoo Dry Cherry 3pk,FBALYB Amazon,1,-3,4,2,4,0
,Batiste Shampoo Dry Cherry 5pk,Batiste Shampoo Dry Cherry 5pk,FBALYB Amazon,1,1,0,0,0,0
,Batiste Shampoo Dry Cherry 6.73 Ounce (200ml),Batiste Shampoo Dry Cherry 6.73 Ounce (200ml),Default Oxford,369,369,0,0,0,0
,Batiste Shampoo Dry Cherry 6.73 Ounce (200ml),Batiste Shampoo Dry Cherry 6.73 Ounce (200ml),Default Ridgefield,2349,2349,0,0,0,0
,Batiste Shampoo Dry Cherry 6.73 Ounce (200ml),Batiste Shampoo Dry Cherry 6.73 Ounce (200ml),WFS,-1,-1,0,0,0,0
,Batiste Shampoo Dry Cherry 6pk,Batiste Shampoo Dry Cherry 6pk,FBALYB Amazon,1,-12,13,0,13,0
,Batiste Shampoo Dry Cherry 6pk,Batiste Shampoo Dry Cherry 6pk,WFS,-3,-3,0,0,0,0
,Batiste Shampoo Dry Fresh 3pk,Batiste Shampoo Dry Fresh 3pk,FBALYB Amazon,725,697,28,2,28,0
,Batiste Shampoo Dry Fresh 6pk,Batiste Shampoo Dry Fresh 6pk,FBALYB Amazon,-14,-21,7,9,7,0
,Batiste Tropical 2pk,Batiste Tropical 2pk,FBALYB Amazon,540,538,2,0,2,0
,Batiste Tropical 2pk,Batiste Tropical 2pk,FBALYB Canada,11,10,1,0,1,0
,Batiste Tropical 2pk,Batiste Tropical 2pk,WFS,-18,-18,0,0,0,0
,Batiste Tropical 6pk,Batiste Tropical 6pk,Default Ridgefield,100,0,100,0,0,0
,Batiste Tropical 6pk,Batiste Tropical 6pk,FBALYB Amazon,501,494,7,0,7,0
,Bausch & Lomb Sight Savers 2 pk,"Bausch & Lomb Sight Savers Premoistened Lens Cleaning Tissues - 100 Count, 2 pk",FBALYB Amazon,5,5,0,0,0,0
,"Bayer Aspirin, 216 Tabs","Bayer Chewable Low Dose Aspirin, 216 Tabs",FBALYB Amazon,1,1,0,0,0,0
,"Bayer Aspirin, 216 Tabs","Bayer Chewable Low Dose Aspirin, 216 Tabs",WFS,-17,-17,0,0,0,0
,Bayer Contour Next Test Strips 8pk,Bayer Contour Next Test Strips 8pk,FBALYB Amazon,0,-6,6,0,6,0
,B&B SHAMP250ML HAIRDRS INVIS Oil+B&B CNDTNR 200ML HAIRDRESS INVIS,B&B SHAMP250ML HAIRDRS INVIS Oil+B&B CNDTNR 200ML HAIRDRESS INVIS,FBALYB Amazon,113,104,9,0,9,0
,B&B SHAMPOO 250ML FULL POTEN+B&B CNDITIONER 200ML FULL POTENT,B&B SHAMPOO 250ML FULL POTEN+B&B CNDITIONER 200ML FULL POTENT,FBALYB Amazon,0,0,0,48,0,0
,BCA Hand Relief 2017 (Rosemary Mint Aroma) 150ml,Aveda BCA Hand Relief 2017 (Rosemary Mint Aroma) 150ml,Default Ridgefield,3,3,0,0,0,0
,BC Men's Stretch Pants Grey L 30,BC Men's Stretch Pants Grey L 30,FBALYB Amazon,-1,-1,0,1,0,0
,BC Men's Stretch Pants Grey XL 30,BC Men's Stretch Pants Grey XL 30,FBALYB Amazon,-2,-2,0,0,0,0
,BC Men's Stretch Pants Grey XXL 30,BC Men's Stretch Pants Grey XXL 30,Default,0,0,0,0,0,1
,BC Men's Stretch Pants Grey XXL 30,BC Men's Stretch Pants Grey XXL 30,FBALYB Amazon,-2,-2,0,0,0,0
,BC Men's Stretch Pants Grey XXL 34,BC Men's Stretch Pants Grey XXL 34,Default,0,0,0,0,0,1
,BC Men's Stretch Pants Olive XXL 34,BC Men's Stretch Pants Olive XXL 34,Default,0,0,0,0,0,1
,BC Men's Stretch Pants Sand L 30,BC Men's Stretch Pants Sand L 30,Default,0,0,0,0,0,1
,BC Men's Stretch Pants Sand L 32,BC Men's Stretch Pants Sand L 32,Default,0,0,0,0,0,2
,BC Men's Stretch Pants Sand XL 30,BC Men's Stretch Pants Sand XL 30,FBALYB Amazon,-3,-3,0,0,0,0
,BC Men's Stretch Pants Sand XL 32,BC Men's Stretch Pants Sand XL 32,Default,0,0,0,0,0,2
,BC Men's Stretch Pants Sand XXL 30,BC Men's Stretch Pants Sand XXL 30,FBALYB Amazon,-2,-2,0,0,0,0
,BC Men's Stretch Pants Sand XXL 34,BC Men's Stretch Pants Sand XXL 34,Default,0,0,0,0,0,6
,BC Men's Stretch Pants Teal XL 30,BC Men's Stretch Pants Teal XL 30,FBALYB Amazon,-1,-1,0,0,0,0
,BC Men's Stretch Pants Teal XXL 30,BC Men's Stretch Pants Teal XXL 30,Default,0,0,0,0,0,2
,BC Men's Stretch Pants Teal XXL 32,BC Men's Stretch Pants Teal XXL 32,Default,0,0,0,0,0,2
,BC Men's Stretch Pants Teal XXL 34,BC Men's Stretch Pants Teal XXL 34,FBALYB Amazon,-1,-1,0,0,0,0
,BD PrecisionGlide Needle 20G 1 1/2 100ct REF 305176,BD PrecisionGlide Needle 20G 1 1/2 100ct REF 305176,Default Ridgefield,10,10,0,0,0,0
,Beano 150 Count 2pack - Total 300pc,Beano 150 Count 2pack - Total 300pc,FBALYB Amazon,-1,-1,0,109,0,0
,Beats Headphone - Matte Black,Beats By Dre Studio Wireless Over-Ear Headphone - Black,FBALYB Amazon,-2,-2,0,1,0,0
,Beats Headphone - Titanium,Beats Studio Wireless Over-Ear Headphone - Titanium,FBALYB Amazon,-1,-1,0,0,0,0
,Beauty & Planet Conditioner,Beauty & Planet Conditioner,Default,0,0,0,0,0,11
,Beauty & Planet Conditioner,Beauty & Planet Conditioner,Default Ridgefield,16,16,0,0,0,0
,Beauty & Planet Conditioner,Beauty & Planet Conditioner,FBALYB Amazon,1,1,0,0,0,0
,Beauty & Planet Sham+Cond,Beauty & Planet Sham+Cond,FBALYB Amazon,20,20,0,0,0,0
,Beauty & Planet Shampoo,Beauty & Planet Shampoo,Default,0,0,0,0,0,22
,Beauty & Planet Shampoo,Beauty & Planet Shampoo,Default Ridgefield,237,237,0,0,0,0
,Beaux Bella Apple Cider Vinegar Shampoo 500 ml,Beaux Bella Apple Cider Vinegar Shampoo 500 ml,Default,0,0,0,0,0,1
,Becca - Becca Shimmering Skin Perfector  Pressedopal,Becca - Becca Shimmering Skin Perfector  Pressedopal,FBALYB Amazon,-1,-1,0,0,0,0
,Becca Shimmering Skin Perfector Pressed  Champagne Pop,Becca Shimmering Skin Perfector Pressed  Champagne Pop,Default,2,2,0,0,0,0
,Becca Shimmering Skin Perfector Pressed  Champagne Pop,Becca Shimmering Skin Perfector Pressed  Champagne Pop,FBALYB Amazon,-4,-4,0,0,0,0
,Becca Under Eye Brightening Corrector  Light To Medium,Becca Under Eye Brightening Corrector  Light To Medium,Default Ridgefield,26,26,0,0,0,0
,Becca Under Eye Brightening Corrector  Light To Medium,Becca Under Eye Brightening Corrector  Light To Medium,FBALYB Amazon,-1,-7,6,0,6,0
,"Bed Head Manipulator, 2 Ounce. 2 pk","Bed Head Manipulator, 2 Ounce. 2 pk",FBALYB Amazon,593,491,102,586,102,0
,"Bed Head Manipulator, 2 Ounce. 2 pk","Bed Head Manipulator, 2 Ounce. 2 pk",FBALYB Canada,0,-9,9,80,9,0
,Bed Head Maxxed Out Hold Hair Spray 2pk,Bed Head Maxxed Out Hold Hair Spray 2pk,FBALYB Amazon,74,66,8,2,8,0
,Bed Head Moisture Shampoo and Conditioner,Bed Head Moisture Shampoo and Conditioner Self-Absorbed,Default,9,9,0,0,0,0
,Bed Head Moisture Shampoo and Conditioner,Bed Head Moisture Shampoo and Conditioner Self-Absorbed,FBALYB Amazon,-23,-23,0,0,0,0
,Bed Head Self-Absorbed Shampoo and Conditioner,Bed Head Self-Absorbed Shampoo and Conditioner,FBALYB Amazon,0,0,0,26,0,0
,Beggin' Strips Dog Treats 2ct,Beggin' Strips Dog Treats By Purina Bundle of 2 Bags,Default,0,0,0,0,0,12
,BEKVÄM Step stool birch,BEKVÄM Step stool birch,FBALYB Amazon,739,739,0,1,0,0
,Bella Electirc Panini Maker Press and Sandwich Grill Polished Stainless Steel,Bella Electirc Panini Maker Press and Sandwich Grill Polished Stainless Steel,Default,0,0,0,0,0,1
,Belvita Cinnamon Brown Sugar Biscuits 25ct,"Belvita Cinnamon Brown Sugar Biscuits, 1.76 oz, 25 Count",FBALYB Amazon,1,1,0,0,0,0
,"Belvita Dark Chocolate Sandwich, 25 ct","Belvita Dark Chocolate Sandwich, 25 ct",FBALYB Amazon,259,259,0,11,0,0
,Benadryl Children Allergy 8oz,Benadryl Children Allergy 8oz,FBALYB Amazon,151,151,0,0,0,0
,"Benchmade - Fact 417 Minimalist Manual Open Folding,Spear-Point Blade Coated Finish Black","Benchmade - Fact 417 Minimalist Manual Open Folding,Spear-Point Blade Coated Finish Black",FBALYB Amazon,-18,-18,0,0,0,0
,Benchmade - Hidden Canyon Hunter 15016-2,Benchmade - Hidden Canyon Hunter 15016-2,Default Ridgefield,1,1,0,0,0,0
,Benchmade - Hidden Canyon Hunter 15016-2,Benchmade - Hidden Canyon Hunter 15016-2,FBALYB Amazon,-4,-5,1,0,1,0
,Bene Bac Probiotic Pet Gel 15g 6pk,Bene Bac Probiotic Pet Gel 15g 6pk,FBALYB Amazon,-2,-2,0,0,0,0
,"Benefiance Wrinkleresist24 Pure Retinol Express Smoothing Eye Mask, 12 x 2","Benefiance Wrinkleresist24 Pure Retinol Express Smoothing Eye Mask, 12 x 2",FBALYB Amazon,2,2,0,0,0,0
,Beneful Baked Delights Snackers 5 Pack,Beneful Baked Delights Snackers 5 Pack,FBALYB Amazon,1,1,0,0,0,0
,"Beneful Hugs Dog Treats, 8.5 oz 4pk","Beneful Hugs Dog Treats, 8.5 oz 4pk",FBALYB Amazon,1,1,0,0,0,0
,"Bengay Pain Cream, 2 Ct","Bengay Ultra Strength Pain Relieving Cream, 2 Count",FBALYB Amazon,-35,-39,4,35,4,0
,Ben's Insect Repellent Wipes 2pk,Ben's Insect Repellent Wipes 24ct,FBALYB Amazon,-4,-4,0,19,0,0
,Ben's Insect Repellent Wipes 48ct,Ben's Insect Repellent Wipes 48ct,FBALYB Amazon,5,-4,9,0,9,0
,Berkley and Jensen Anti-Diarrheal 192 Caplets,Berkley and Jensen Anti-Diarrheal 192 Caplets,FBALYB Amazon,6,6,0,0,0,0
,"Berkley Jensen Allergy Relief, 365 ct.","Berkley Jensen Allergy Relief, 365 ct.",FBALYB Amazon,7,-1,8,0,8,0
,Berkley Jensen Extra Strength Non-Aspirin PM Caplets,Berkley Jensen Extra Strength Non-Aspirin PM Caplets,FBALYB Amazon,143,118,25,0,25,0
,Best Whip N2O Charger 24 ct,Best Whip N2O Charger 24 ct,FBALYB Amazon,400,400,0,0,0,0
,Best Whip N2O Charger 24 ct 5pk,Best Whip N2O Charger 24 ct 5pk,FBALYB Amazon,80,80,0,0,0,0
,BettaSafe Water Conditioner ‑ 1.69 oz 2pk,BettaSafe Water Conditioner ‑ 1.69 oz 2pk,FBALYB Amazon,-4,-4,0,0,0,0
,Better Beely Rawhide 10ct Small Rolls 3pk,Better Beely Rawhide 10ct Small Rolls 3pk,FBALYB Amazon,10,10,0,0,0,0
,Better Belly Mini Bones 26pk,Better Belly Mini Bones 26pk,FBALYB Amazon,-15,-15,0,16,0,0
,Better Homes and Gardens 4 Piece Lamp Set with CFL Bulbs Bronze,Better Homes and Gardens 4 Piece Lamp Set with CFL Bulbs Bronze,Default Ridgefield,1,1,0,0,0,0
,Better than Boullion Organic Veggie Base,Better than Boullion Organic Veggie Base,Avrami - Ebay,133,133,0,0,0,0
,Better than Boullion Organic Veggie Base,Better than Boullion Organic Veggie Base,Default,0,-1000,1000,0,0,0
,Better than Boullion Organic Veggie Base,Better than Boullion Organic Veggie Base,FBALYB Amazon,9,4,5,15,5,0
,Better than Boullion Organic Veggie Base,Better than Boullion Organic Veggie Base,WFS,-27,-27,0,0,0,0
,Better than Boullion Organic Veggie Base 3PK,Better than Boullion Organic Veggie Base 3PK,FBALYB Amazon,25,14,11,0,11,0
,Better than Boullion Organic Veggie Base 4PK,Better than Boullion Organic Veggie Base 4PK,FBALYB Amazon,10,5,5,0,5,0
,Beyblade Burst Evolution Battle Tower,Beyblade Burst Evolution Battle Tower,Default,0,0,0,0,0,2
,Beyblade Burst Evolution Battle Tower,Beyblade Burst Evolution Battle Tower,Default Ridgefield,13,13,0,0,0,0
,Beyblade Burst Evolution Battle Tower,Beyblade Burst Evolution Battle Tower,FBALYB Amazon,-8,-9,1,1,1,0
,Beyblade Slingshot Crystal Dranzer F,Beyblade Slingshot Crystal Dranzer F,Default Ridgefield,130,130,0,0,0,0
,Beyblade Slingshot Crystal Dranzer F,Beyblade Slingshot Crystal Dranzer F,FBALYB Amazon,63,60,3,0,3,0
,Beyblade Slingshot Crystal Dranzer F,Beyblade Slingshot Crystal Dranzer F,FBALYB Canada,16,16,0,0,0,0
,Beyblade Slingshot Fang Dragoon F,Beyblade Slingshot Fang Dragoon F,Default Ridgefield,130,130,0,0,0,0
,Beyblade Slingshot Fang Dragoon F,Beyblade Slingshot Fang Dragoon F,FBALYB Amazon,93,93,0,0,0,0
,Beyblade Slingshot Fang Dragoon F,Beyblade Slingshot Fang Dragoon F,FBALYB Canada,19,19,0,0,0,0
,Beyblade Slingshot Guard Draciel S,Beyblade Slingshot Guard Draciel S,Default Ridgefield,250,250,0,0,0,0
,Beyblade Slingshot Phantom Driger S,Beyblade Slingshot Phantom Driger S,Default Ridgefield,130,130,0,0,0,0
,Beyblade Slingshot Phantom Driger S,Beyblade Slingshot Phantom Driger S,FBALYB Amazon,93,93,0,0,0,0
,Beyblade Slingshot Phantom Driger S,Beyblade Slingshot Phantom Driger S,FBALYB Canada,19,19,0,0,0,0
,BI-6VMF-S5VW,"Demet's Turtles Original, Pecans~Chocolate~Caramel, 17.5-Ounce",FBALYB Amazon,41,41,0,12,0,0
,Bialetti 12 CUPS Filter/Gasket  800006,Bialetti 12 CUPS Filter/Gasket  800006,Default,0,-42,42,0,0,0
,Bialetti 3 GASKET + 1 FILTER 12 CUPS 800006,Bialetti 3 GASKET + 1 FILTER 12 CUPS 800006,Default,0,-42,42,0,0,57
,Bialetti 3 GASKET + 1 FILTER 12 CUPS 800006,Bialetti 3 GASKET + 1 FILTER 12 CUPS 800006,Default Ridgefield,691,691,0,0,0,0
,Bialetti 3 GASKET + 1 FILTER 12 CUPS 800006,Bialetti 3 GASKET + 1 FILTER 12 CUPS 800006,FBALYB Amazon,44,33,11,0,11,0
,Bialetti 3 GASKET + 1 FILTER 1 CUP 800001,Bialetti 3 GASKET + 1 FILTER 1 CUP 800001,Default,0,-1,1,0,0,0
,Bialetti 3 GASKET + 1 FILTER 1 CUP 800001,Bialetti 3 GASKET + 1 FILTER 1 CUP 800001,Default Ridgefield,374,374,0,0,0,0
,Bialetti 3 GASKET + 1 FILTER 1 CUP 800001,Bialetti 3 GASKET + 1 FILTER 1 CUP 800001,FBALYB Amazon,-24,-36,12,3,12,0
,Bialetti 3 GASKET + 1 FILTER 2 CUPS 800002,Bialetti 3 GASKET + 1 FILTER 2 CUPS 800002,Default,0,-252,252,0,0,0
,Bialetti 3 GASKET + 1 FILTER 2 CUPS 800002,Bialetti 3 GASKET + 1 FILTER 2 CUPS 800002,Default Ridgefield,231,231,0,0,0,0
,Bialetti 3 GASKET + 1 FILTER 2 CUPS 800002,Bialetti 3 GASKET + 1 FILTER 2 CUPS 800002,FBALYB Amazon,8,8,0,0,0,0
,Bialetti 3 GASKET + 1 FILTER 2 CUPS 800002,Bialetti 3 GASKET + 1 FILTER 2 CUPS 800002,WFS,-25,-25,0,0,0,0
,Bialetti 3 GASKET + 1 FILTER 3/4 CUPS 800003,Bialetti 3 GASKET + 1 FILTER 3/4 CUPS 800003,Default,0,0,0,0,0,159
,Bialetti 3 GASKET + 1 FILTER 3/4 CUPS 800003,Bialetti 3 GASKET + 1 FILTER 3/4 CUPS 800003,FBALYB Amazon,79,77,2,7,2,0
,Bialetti 3 GASKET + 1 FILTER 6 CUPS 800004,Bialetti 3 GASKET + 1 FILTER 6 CUPS 800004,Default Ridgefield,412,412,0,0,0,0
,Bialetti 3 GASKET + 1 FILTER 6 CUPS 800004,Bialetti 3 GASKET + 1 FILTER 6 CUPS 800004,FBALYB Amazon,282,249,33,56,33,0
,Bialetti 3 GASKET + 1 FILTER 6 CUPS 800004,Bialetti 3 GASKET + 1 FILTER 6 CUPS 800004,FBALYB Canada,-3,-4,1,0,1,0
,Bialetti 3 GASKET + 1 FILTER 9 CUPS 800005,Bialetti 3 GASKET + 1 FILTER 9 CUPS 800005,Default Ridgefield,1919,1919,0,0,0,0
,Bialetti 3 GASKET + 1 FILTER 9 CUPS 800005,Bialetti 3 GASKET + 1 FILTER 9 CUPS 800005,FBALYB Amazon,484,478,6,1,6,0
,Bialetti BREAK ALPINA 3 CUPS 2762,Bialetti BREAK ALPINA 3 CUPS 2762,Default Ridgefield,29,29,0,0,0,0
,Bialetti BREAK ALPINA 3 CUPS 2762,Bialetti BREAK ALPINA 3 CUPS 2762,FBALYB Amazon,452,449,3,3,3,0
,Bialetti BRIKKA 4 CUP 6784,Bialetti BRIKKA 4 CUP 6784,Default Ridgefield,233,233,0,0,0,0
,Bialetti BRIKKA 4 CUP 6784,Bialetti BRIKKA 4 CUP 6784,FBALYB Amazon,114,114,0,4,0,0
,Bialetti Espresso Maker & Filter+Gaskets,Bialetti Espresso Maker & Filter+Gaskets,FBALYB Amazon,-2,-2,0,9,0,0
,Bialetti KITTY 10 CUPS 0004885/IN,Bialetti KITTY 10 CUPS 0004885/IN,Default Oxford,8,8,0,0,0,0
,Bialetti KITTY 10 CUPS 0004885/IN,Bialetti KITTY 10 CUPS 0004885/IN,Default Ridgefield,384,384,0,0,0,0
,Bialetti KITTY 10 CUPS 0004885/IN,Bialetti KITTY 10 CUPS 0004885/IN,FBALYB Amazon,-19,-22,3,65,3,0
,Bialetti KITTY 10 CUPS 0004885/IN,Bialetti KITTY 10 CUPS 0004885/IN,FBALYB Canada,5,5,0,0,0,0
,Bialetti Kitty 2 Cups,Bialetti Kitty 2 Cups,Default Ridgefield,105,105,0,0,0,0
,Bialetti Kitty 2 Cups,Bialetti Kitty 2 Cups,FBALYB Amazon,99,99,0,0,0,0
,Bialetti KITTY 4 CUPS 0004882/IN,Bialetti KITTY 4 CUPS 0004882/IN,Default Ridgefield,426,426,0,0,0,0
,Bialetti KITTY 4 CUPS 0004882/IN,Bialetti KITTY 4 CUPS 0004882/IN,FBALYB Amazon,33,33,0,4,0,0
,Bialetti KITTY 6 CUPS 0004883/IN,Bialetti KITTY 6 CUPS 0004883/IN,Default Ridgefield,5,5,0,0,0,0
,Bialetti KITTY 6 CUPS 0004883/IN,Bialetti KITTY 6 CUPS 0004883/IN,FBALYB Amazon,-12,-16,4,3,4,0
,Bialetti Kremina 3 Cups,Bialetti Kremina 3 Cups,Default Oxford,120,120,0,0,0,0
,"Bialetti MINI EXPRESS ""R"" 2 CUPS 1284","Bialetti MINI EXPRESS ""R"" 2 CUPS 1284",Default Oxford,168,168,0,0,0,0
,"Bialetti MINI EXPRESS ""R"" 2 CUPS 1284","Bialetti MINI EXPRESS ""R"" 2 CUPS 1284",Default Ridgefield,439,439,0,0,0,0
,"Bialetti MINI EXPRESS ""R"" 2 CUPS 1284","Bialetti MINI EXPRESS ""R"" 2 CUPS 1284",FBALYB Amazon,42,42,0,0,0,0
,Bialetti MOKA EXPRESS 12 CUPS 0001166/X2,Bialetti MOKA EXPRESS 12 CUPS 0001166/X2,Avrami - Ebay,142,142,0,0,0,0
,Bialetti MOKA EXPRESS 12 CUPS 0001166/X2,Bialetti MOKA EXPRESS 12 CUPS 0001166/X2,Default Ridgefield,1230,1228,2,0,0,0
,Bialetti MOKA EXPRESS 12 CUPS 0001166/X2,Bialetti MOKA EXPRESS 12 CUPS 0001166/X2,FBALYB Amazon,604,601,3,0,3,0
,Bialetti MOKA EXPRESS 12 CUPS 0001166/X2,Bialetti MOKA EXPRESS 12 CUPS 0001166/X2,FBALYB Canada,0,0,0,50,0,0
,Bialetti MOKA EXPRESS 12 CUPS 0001166/X2,Bialetti MOKA EXPRESS 12 CUPS 0001166/X2,FBALYB Saudi,12,12,0,13,0,0
,Bialetti MOKA EXPRESS 12 CUPS 0001166/X2,Bialetti MOKA EXPRESS 12 CUPS 0001166/X2,WFS,-73,-73,0,0,0,0
,Bialetti MOKA EXPRESS 1 CUP 1161,Bialetti MOKA EXPRESS 1 CUP 1161,Avrami - Ebay,60,60,0,0,0,0
,Bialetti MOKA EXPRESS 1 CUP 1161,Bialetti MOKA EXPRESS 1 CUP 1161,Default,0,0,0,0,0,46
,Bialetti MOKA EXPRESS 1 CUP 1161,Bialetti MOKA EXPRESS 1 CUP 1161,Default Ridgefield,415,415,0,0,0,0
,Bialetti MOKA EXPRESS 1 CUP 1161,Bialetti MOKA EXPRESS 1 CUP 1161,FBALYB Amazon,567,556,11,316,11,0
,Bialetti MOKA EXPRESS 3 CUPS 1162,Bialetti MOKA EXPRESS 3 CUPS 1162,Default Ridgefield,0,-1,1,0,0,0
,Bialetti MOKA EXPRESS 3 CUPS 1162,Bialetti MOKA EXPRESS 3 CUPS 1162,FBALYB Amazon,311,285,26,35,26,0
,Bialetti MOKA EXPRESS 3 CUPS 1162,Bialetti MOKA EXPRESS 3 CUPS 1162,FBALYB Canada,-17,-17,0,0,0,0
,Bialetti MOKA EXPRESS 3 CUPS 1162,Bialetti MOKA EXPRESS 3 CUPS 1162,WFS,629,629,0,0,0,0
,Bialetti MOKA EXPRESS 6 CUPS 1163,Bialetti MOKA EXPRESS 6 CUPS 1163,Avrami - Ebay,474,474,0,0,0,0
,Bialetti MOKA EXPRESS 6 CUPS 1163,Bialetti MOKA EXPRESS 6 CUPS 1163,Default,0,-216,216,0,0,0
,Bialetti MOKA EXPRESS 6 CUPS 1163,Bialetti MOKA EXPRESS 6 CUPS 1163,Default Ridgefield,7,7,0,0,0,0
,Bialetti MOKA EXPRESS 6 CUPS 1163,Bialetti MOKA EXPRESS 6 CUPS 1163,FBALYB Amazon,26,20,6,260,6,0
,Bialetti MOKA EXPRESS 6 CUPS 1163,Bialetti MOKA EXPRESS 6 CUPS 1163,WFS,-1,-1,0,0,0,0
,Bialetti MOKA EXPRESS 9 CUPS 1165,Bialetti MOKA EXPRESS 9 CUPS 1165,Avrami - Ebay,85,85,0,0,0,0
,Bialetti MOKA EXPRESS 9 CUPS 1165,Bialetti MOKA EXPRESS 9 CUPS 1165,Default,0,-1,1,0,0,0
,Bialetti MOKA EXPRESS 9 CUPS 1165,Bialetti MOKA EXPRESS 9 CUPS 1165,Default Ridgefield,67,67,0,0,0,0
,Bialetti MOKA EXPRESS 9 CUPS 1165,Bialetti MOKA EXPRESS 9 CUPS 1165,FBALYB Amazon,108,107,1,38,1,0
,Bialetti MOKA EXPRESS 9 CUPS 1165,Bialetti MOKA EXPRESS 9 CUPS 1165,FBALYB Canada,55,55,0,3,0,0
,Bialetti MOKA EXPRESS 9 CUPS 1165,Bialetti MOKA EXPRESS 9 CUPS 1165,WFS,325,325,0,0,0,0
,Bialetti MOKA EXPRESS ITALIA 3 CUPS,Bialetti MOKA EXPRESS ITALIA 3 CUPS,Default Ridgefield,174,174,0,0,0,0
,Bialetti MOKA EXPRESS ITALIA 6 CUPS 5323,Bialetti MOKA EXPRESS ITALIA 6 CUPS 5323,Avrami - Ebay,450,450,0,0,0,0
,Bialetti MOKA EXPRESS ITALIA 6 CUPS 5323,Bialetti MOKA EXPRESS ITALIA 6 CUPS 5323,Default,0,0,0,0,0,270
,Bialetti MOKA EXPRESS ITALIA 6 CUPS 5323,Bialetti MOKA EXPRESS ITALIA 6 CUPS 5323,Default Oxford,118,118,0,0,0,0
,Bialetti MOKA EXPRESS ITALIA 6 CUPS 5323,Bialetti MOKA EXPRESS ITALIA 6 CUPS 5323,Default Ridgefield,77,77,0,0,0,0
,Bialetti MOKA EXPRESS ITALIA 6 CUPS 5323,Bialetti MOKA EXPRESS ITALIA 6 CUPS 5323,FBALYB Amazon,52,51,1,3,1,0
,Bialetti MOKA EXPRESS ITALIA 6 CUPS 5323,Bialetti MOKA EXPRESS ITALIA 6 CUPS 5323,FBALYB Canada,15,15,0,0,0,0
,Bialetti MOKA EXPRESS ITALIA 6 CUPS 5323,Bialetti MOKA EXPRESS ITALIA 6 CUPS 5323,WFS,-41,-41,0,0,0,0
,Bialetti MOKA EXPRESS RED 1 CUP 4941,Bialetti MOKA EXPRESS RED 1 CUP 4941,Avrami - Ebay,30,30,0,0,0,0
,Bialetti MOKA EXPRESS RED 1 CUP 4941,Bialetti MOKA EXPRESS RED 1 CUP 4941,Default Ridgefield,13,13,0,0,0,0
,Bialetti MOKA EXPRESS RED 1 CUP 4941,Bialetti MOKA EXPRESS RED 1 CUP 4941,FBALYB Amazon,19,18,1,0,1,0
,Bialetti MOKA EXPRESS RED 1 CUP 4941,Bialetti MOKA EXPRESS RED 1 CUP 4941,WFS,-20,-20,0,0,0,0
,Bialetti MOKA EXPRESS RED 3 CUPS 4942,Bialetti MOKA EXPRESS RED 3 CUPS 4942,FBALYB Amazon,-31,-31,0,6,0,0
,Bialetti MOKA EXPRESS RED 3 CUPS 4942,Bialetti MOKA EXPRESS RED 3 CUPS 4942,WFS,474,474,0,0,0,0
,Bialetti MOKA EXPRESS RED 6 CUPS 4943,Bialetti MOKA EXPRESS RED 6 CUPS 4943,Avrami - Ebay,478,478,0,0,0,0
,Bialetti MOKA EXPRESS RED 6 CUPS 4943,Bialetti MOKA EXPRESS RED 6 CUPS 4943,Default,0,-1,1,0,0,6
,Bialetti MOKA EXPRESS RED 6 CUPS 4943,Bialetti MOKA EXPRESS RED 6 CUPS 4943,Default Oxford,0,-1,1,0,0,0
,Bialetti MOKA EXPRESS RED 6 CUPS 4943,Bialetti MOKA EXPRESS RED 6 CUPS 4943,FBAFBA LYB AUSTRALIA,0,0,0,25,0,0
,Bialetti MOKA EXPRESS RED 6 CUPS 4943,Bialetti MOKA EXPRESS RED 6 CUPS 4943,FBALYB Amazon,17,11,6,0,6,0
,Bialetti MOKA EXPRESS RED 6 CUPS 4943,Bialetti MOKA EXPRESS RED 6 CUPS 4943,WFS,-29,-29,0,0,0,0
,Bialetti Musa 2 Cups,Bialetti Musa 2 Cups,Default Ridgefield,2,2,0,0,0,0
,Bialetti Musa 2 Cups,Bialetti Musa 2 Cups,FBALYB Amazon,110,110,0,0,0,0
,Bialetti Musa 4 Cups,Bialetti Musa 4 Cups,Default Oxford,42,42,0,0,0,0
,Bialetti Musa 4 Cups,Bialetti Musa 4 Cups,Default Ridgefield,100,100,0,0,0,0
,Bialetti Musa 4 Cups,Bialetti Musa 4 Cups,FBALYB Amazon,185,185,0,0,0,0
,Bialetti MUSA 6 CUPS 4273,Bialetti MUSA 6 CUPS 4273,Avrami - Ebay,216,216,0,0,0,0
,Bialetti MUSA 6 CUPS 4273,Bialetti MUSA 6 CUPS 4273,Default,0,0,0,0,0,4
,Bialetti MUSA 6 CUPS 4273,Bialetti MUSA 6 CUPS 4273,Default Ridgefield,144,144,0,0,0,0
,Bialetti MUSA 6 CUPS 4273,Bialetti MUSA 6 CUPS 4273,FBALYB Amazon,-24,-24,0,7,0,0
,Bialetti RAINBOW 1 CUP LIGHT BLUE 5041,Bialetti RAINBOW 1 CUP LIGHT BLUE 5041,FBALYB Amazon,-7,-7,0,12,0,0
,Bialetti RAINBOW 3 CUPS BLUE 5242,Bialetti RAINBOW 3 CUPS BLUE 5242,Default Ridgefield,48,48,0,0,0,0
,Bialetti RAINBOW 3 CUPS BLUE 5242,Bialetti RAINBOW 3 CUPS BLUE 5242,FBALYB Amazon,-1,-1,0,0,0,0
,Bialetti RAINBOW 3 CUPS FUCHSIA 5012,Bialetti RAINBOW 3 CUPS FUCHSIA 5012,Default Ridgefield,12,12,0,0,0,0
,Bialetti RAINBOW 3 CUPS FUCHSIA 5012,Bialetti RAINBOW 3 CUPS FUCHSIA 5012,FBALYB Amazon,17,17,0,0,0,0
,Bialetti RAINBOW 3 CUPS GREEN 4972,Bialetti RAINBOW 3 CUPS GREEN 4972,Default Ridgefield,58,58,0,0,0,0
,Bialetti RAINBOW 3 CUPS GREEN 4972,Bialetti RAINBOW 3 CUPS GREEN 4972,FBALYB Amazon,70,70,0,30,0,0
,Bialetti RAINBOW 3 CUPS LIGHT BLUE 5042,Bialetti RAINBOW 3 CUPS LIGHT BLUE 5042,FBALYB Amazon,29,29,0,0,0,0
,Bialetti RAINBOW 3 CUPS LIGHT BLUE 5042,Bialetti RAINBOW 3 CUPS LIGHT BLUE 5042,WFS,-1,-1,0,0,0,0
,Bialetti RAINBOW 3 CUPS ORANGE 4992,Bialetti RAINBOW 3 CUPS ORANGE 4992,FBALYB Amazon,1,1,0,6,0,0
,Bialetti RAINBOW 3 CUPS RED 4962,Bialetti RAINBOW 3 CUPS RED 4962,Default Ridgefield,30,30,0,0,0,0
,Bialetti RAINBOW 3 CUPS RED 4962,Bialetti RAINBOW 3 CUPS RED 4962,FBALYB Amazon,61,61,0,0,0,0
,Bialetti RAINBOW 3 CUPS YELLOW 4982,Bialetti RAINBOW 3 CUPS YELLOW 4982,FBALYB Amazon,-17,-17,0,0,0,0
,Bialetti Rainbow 3 Cupts Light Blue,Bialetti Rainbow 3 Cupts Light Blue,Default,0,0,0,0,0,6
,Bialetti Rainbow 3 Cupts Light Blue,Bialetti Rainbow 3 Cupts Light Blue,Default Ridgefield,157,157,0,0,0,0
,Bialetti Rainbow 3 Cupts Light Blue,Bialetti Rainbow 3 Cupts Light Blue,FBALYB Amazon,107,107,0,0,0,0
,Bialetti Venus 10 CUPS,Bialetti Venus 10 CUPS,Default Ridgefield,20,20,0,0,0,0
,Bialetti Venus 10 CUPS,Bialetti Venus 10 CUPS,FBALYB Amazon,63,61,2,0,2,0
,Bialetti Venus 2 CUPS 1698,Bialetti Venus 2 CUPS 1698,Default,0,-1,1,0,0,51
,Bialetti Venus 2 CUPS 1698,Bialetti Venus 2 CUPS 1698,Default Ridgefield,544,544,0,0,0,0
,Bialetti Venus 2 CUPS 1698,Bialetti Venus 2 CUPS 1698,FBALYB Amazon,37,37,0,107,0,0
,Bialetti VENUS 4 CUPS 1682,Bialetti VENUS 4 CUPS 1682,Default,0,0,0,0,0,2
,Bialetti VENUS 4 CUPS 1682,Bialetti VENUS 4 CUPS 1682,Default Ridgefield,60,60,0,0,0,0
,Bialetti VENUS 4 CUPS 1682,Bialetti VENUS 4 CUPS 1682,FBALYB Amazon,693,677,16,74,16,0
,Bialetti VENUS 4 CUPS 1682,Bialetti VENUS 4 CUPS 1682,FBALYB Canada,0,-6,6,50,6,0
,Bialetti VENUS 6 CUPS 1683,Bialetti VENUS 6 CUPS 1683,Avrami - Ebay,366,366,0,0,0,0
,Bialetti VENUS 6 CUPS 1683,Bialetti VENUS 6 CUPS 1683,Default Ridgefield,284,284,0,0,0,0
,Bialetti VENUS 6 CUPS 1683,Bialetti VENUS 6 CUPS 1683,FBALYB Amazon,1711,1708,3,15,3,0
,Bialetti VENUS 6 CUPS 1683,Bialetti VENUS 6 CUPS 1683,FBALYB Canada,-4,-30,26,50,26,0
,Bialetti VENUS 6 CUPS 1683,Bialetti VENUS 6 CUPS 1683,WFS,-57,-57,0,0,0,0
,Bic1 Disposable Razors 5ct 29pk,Bic1 Disposable Razors 5ct 29pk,FBALYB Amazon,1,0,1,0,1,0
,Bic1 Disposable Razors 5 ct 8PK,Bic1 Disposable Razors 5 ct 8PK,Default Ridgefield,4,4,0,0,0,0
,Bic Disposable Razor 6pk,Bic Disposable Razor 6pk,FBALYB Amazon,-11,-11,0,1,0,0
,Bic Razors for Women 20ct,Bic Razors for Women 20ct,Default,0,0,0,0,0,28
,Bic Razors for Women 20ct,Bic Razors for Women 20ct,FBALYB Amazon,-1,-1,0,0,0,0
,BIC Whiteout 8ct,BIC Whiteout 8ct,Default Ridgefield,2,2,0,0,0,0
,BIC Whiteout 8ct,BIC Whiteout 8ct,FBALYB Amazon,1,1,0,0,0,0
,Bicycle Cards 9ct x 2 (18 total decks),Bicycle Cards 9ct x 2 (18 total decks),FBALYB Amazon,-2,-2,0,1,0,0
,Bigelow Earl Grey Tea 24ct,Bigelow Earl Grey Tea 24ct,FBALYB Amazon,4,4,0,4,0,0
,Bigelow Earl Grey Tea 24ct 4pk,Bigelow Earl Grey Tea 24ct 4pk,FBALYB Amazon,3,3,0,2,0,0
,Bigelow English Breakfast Tea 24ct,Bigelow English Breakfast Tea 24ct,Default,0,-300,300,0,0,108
,Bigelow English Breakfast Tea 24ct,Bigelow English Breakfast Tea 24ct,FBALYB Amazon,0,0,0,5,0,0
,Bigelow English Breakfast Tea 24ct 4pk,Bigelow English Breakfast Tea 24ct 4pk,FBALYB Amazon,-4,-4,0,5,0,0
,Bigelow Green Tea 24ct,Bigelow Green Tea 24ct,FBALYB Amazon,16,16,0,1,0,0
,Bigelow Green Tea 24ct 4pk,Bigelow Green Tea 24ct 4pk,FBALYB Amazon,2,2,0,0,0,0
,BIG WHEEL Spin-Out Action 48105,Kids Only THE ORIGINAL BIG WHEEL with Spin-Out Action 48105,FBALYB Amazon,-1,-1,0,0,0,0
,Bil-Jac Chicken Treats 10oz 4pk,Bil-Jac Chicken and Sweet Potato Treats 10oz 4pk,FBALYB Amazon,-3,-3,0,45,0,0
,Bil-Jac Peanut Butter Treats 10oz 4pk,Bil-Jac Peanut Butter Treats 10oz 4pk,Default,-26,-26,0,0,0,0
,Bil-Jac Peanut Butter Treats 10oz 4pk,Bil-Jac Peanut Butter Treats 10oz 4pk,FBALYB Amazon,5,5,0,0,0,0
,Bil-Jac Skin Coat Dog Treats 10oz 6pk,Bil-Jac Skin Coat Dog Treats 10oz 6pk,Default,-1,-1,0,0,0,0
,Bio‑Groom Silk Creme Rinse for Dogs 12oz,Bio‑Groom Silk Creme Rinse for Dogs 12 oz,FBALYB Amazon,1,1,0,0,0,0
,Bio Spira Freshwater 8.45oz,Bio Spira Freshwater 8.45oz,Default,0,0,0,0,0,2
,Bio Spira Freshwater 8.45oz 2pk,Bio Spira Freshwater 8.45oz 2pk,FBALYB Amazon,5,5,0,0,0,0
,Birch Benders Variety 8PK,Birch Benders Variety 8PK,FBALYB Amazon,135,135,0,0,0,0
,Birkenstock Arizona BF Black 51191 Women N EU 39/US 8-8.5,Birkenstock Arizona BF Black 51191 Women N EU 39/US 8-8.5,Default Ridgefield,4,4,0,0,0,0
,Birkenstock Arizona BF Black 51191 Women N EU 41/US 10-10.5,Birkenstock Arizona BF Black 51191 Women N EU 41/US 10-10.5,Default Ridgefield,12,12,0,0,0,0
,Birkenstock Arizona BF Black 51191 Women N EU 42/US 11-11.5,Birkenstock Arizona BF Black 51191 Women N EU 42/US 11-11.5,Default Ridgefield,4,4,0,0,0,0
,Birkenstock Arizona BF Black 51791 Men EU 44/US 11-11.5,Birkenstock Arizona BF Black 51791 Men EU 44/US 11-11.5,Default Ridgefield,59,59,0,0,0,0
,Birkenstock Arizona BF Black 51791 Men EU 44/US 11-11.5,Birkenstock Arizona BF Black 51791 Men EU 44/US 11-11.5,FBALYB Amazon,95,92,3,0,3,0
,Birkenstock Arizona BF Black 51791 Men EU 45/US 12-12.5,Birkenstock Arizona BF Black 51791 Men EU 45/US 12-12.5,Default Ridgefield,4,4,0,0,0,0
,Birkenstock Arizona BF Black 51791 Men EU 45/US 12-12.5,Birkenstock Arizona BF Black 51791 Men EU 45/US 12-12.5,FBALYB Amazon,17,17,0,0,0,0
,Birkenstock Arizona BF Black 51791 Men EU 46/US 13-13.5,Birkenstock Arizona BF Black 51791 Men EU 46/US 13-13.5,Default Ridgefield,25,25,0,0,0,0
,Birkenstock Arizona BF Black 51791 Women EU 36/US 5-5.5,Birkenstock Arizona BF Black 51791 Women EU 36/US 5-5.5,FBALYB Amazon,-1,-1,0,0,0,0
,Birkenstock Arizona BF Black 51791 Women EU 37/US 6-6.5,Birkenstock Arizona BF Black 51791 Women EU 37/US 6-6.5,Default Ridgefield,96,96,0,0,0,0
,Birkenstock Arizona BF Black 51791 Women EU 37/US 6-6.5,Birkenstock Arizona BF Black 51791 Women EU 37/US 6-6.5,FBALYB Amazon,-3,-3,0,2,0,0
,Birkenstock Arizona BF Black 51791 Women EU 38/US 7-7.5,Birkenstock Arizona BF Black 51791 Women EU 38/US 7-7.5,Default Ridgefield,143,143,0,0,0,0
,Birkenstock Arizona BF Black 51791 Women EU 38/US 7-7.5,Birkenstock Arizona BF Black 51791 Women EU 38/US 7-7.5,FBALYB Amazon,79,79,0,0,0,0
,Birkenstock Arizona BF Black 51791 Women EU 39/US 8-8.5,Birkenstock Arizona BF Black 51791 Women EU 39/US 8-8.5,Avrami - Ebay,4,4,0,0,0,0
,Birkenstock Arizona BF Black 51791 Women EU 39/US 8-8.5,Birkenstock Arizona BF Black 51791 Women EU 39/US 8-8.5,Default Ridgefield,195,195,0,0,0,0
,Birkenstock Arizona BF Black 51791 Women EU 39/US 8-8.5,Birkenstock Arizona BF Black 51791 Women EU 39/US 8-8.5,FBALYB Amazon,25,25,0,0,0,0
,Birkenstock Arizona BF Black 51791 Women EU 40/US 9-9.5,Birkenstock Arizona BF Black 51791 Women EU 40/US 9-9.5,Default Ridgefield,9,9,0,0,0,0
,Birkenstock Arizona BF Black 51791 Women EU 40/US 9-9.5,Birkenstock Arizona BF Black 51791 Women EU 40/US 9-9.5,FBALYB Amazon,172,171,1,0,1,0
,Birkenstock Arizona BF Black 51791 Women EU 41/US 10-10.5,Birkenstock Arizona BF Black 51791 Women EU 41/US 10-10.5,Avrami - Ebay,4,4,0,0,0,0
,Birkenstock Arizona BF Black 51791 Women EU 41/US 10-10.5,Birkenstock Arizona BF Black 51791 Women EU 41/US 10-10.5,Default Ridgefield,105,105,0,0,0,0
,Birkenstock Arizona BF Black 51791 Women EU 41/US 10-10.5,Birkenstock Arizona BF Black 51791 Women EU 41/US 10-10.5,FBALYB Amazon,205,205,0,0,0,0
,Birkenstock Arizona BF Black 51791 Women EU 42/US 11-11.5,Birkenstock Arizona BF Black 51791 Women EU 42/US 11-11.5,Default Ridgefield,13,13,0,0,0,0
,Birkenstock Arizona BF Black 51791 Women EU 42/US 11-11.5,Birkenstock Arizona BF Black 51791 Women EU 42/US 11-11.5,FBALYB Amazon,247,247,0,0,0,0
,Birkenstock Arizona BF Black 51791 Women EU 43/US 12-12.5,Birkenstock Arizona BF Black 51791 Women EU 43/US 12-12.5,Default Ridgefield,19,19,0,0,0,0
,Birkenstock Arizona BF Black 51791 Women EU 43/US 12-12.5,Birkenstock Arizona BF Black 51791 Women EU 43/US 12-12.5,FBALYB Amazon,162,162,0,3,0,0
,Birkenstock Arizona BF Black 51793 Women N EU 35/US 4-4.5,Birkenstock Arizona BF Black 51793 Women N EU 35/US 4-4.5,Default,0,-1,1,0,0,0
,Birkenstock Arizona BF Black 51793 Women N EU 35/US 4-4.5,Birkenstock Arizona BF Black 51793 Women N EU 35/US 4-4.5,FBALYB Amazon,29,29,0,0,0,0
,Birkenstock Arizona BF Black 51793 Women N EU 36/US 5-5.5,Birkenstock Arizona BF Black 51793 Women N EU 36/US 5-5.5,FBALYB Amazon,96,96,0,0,0,0
,Birkenstock Arizona BF Black 51793 Women N EU 37/US 6-6.5,Birkenstock Arizona BF Black 51793 Women N EU 37/US 6-6.5,FBALYB Amazon,129,129,0,0,0,0
,Birkenstock Arizona BF Black 51793 Women N EU 38/US 7-7.5,Birkenstock Arizona BF Black 51793 Women N EU 38/US 7-7.5,Default Ridgefield,12,12,0,0,0,0
,Birkenstock Arizona BF Black 51793 Women N EU 38/US 7-7.5,Birkenstock Arizona BF Black 51793 Women N EU 38/US 7-7.5,FBALYB Amazon,-30,-30,0,0,0,0
,Birkenstock Arizona BF Black 51793 Women N EU 39/US 8-8.5,Birkenstock Arizona BF Black 51793 Women N EU 39/US 8-8.5,FBALYB Amazon,-1,-1,0,0,0,0
,Birkenstock Arizona BF Blue 51751 Men EU 44/US 11-11.5,Birkenstock Arizona BF Blue 51751 Men EU 44/US 11-11.5,Default Ridgefield,12,12,0,0,0,0
,Birkenstock Arizona BF Blue 51751 Women EU 39/US 8-8.5,Birkenstock Arizona BF Blue 51751 Women EU 39/US 8-8.5,FBALYB Amazon,-2,-2,0,12,0,0
,Birkenstock Arizona BF Blue 51751 Women EU 40/US 9-9.5,Birkenstock Arizona BF Blue 51751 Women EU 40/US 9-9.5,FBALYB Amazon,-12,-12,0,0,0,0
,Birkenstock Arizona BF Blue 51751 Women EU 41/US 10-10.5,Birkenstock Arizona BF Blue 51751 Women EU 41/US 10-10.5,FBALYB Amazon,-10,-10,0,0,0,0
,Birkenstock Arizona BF Blue 51751 Women EU 42/US 11-11.5,Birkenstock Arizona BF Blue 51751 Women EU 42/US 11-11.5,FBALYB Amazon,2,2,0,0,0,0
,Birkenstock Arizona BF Blue 51751 Women EU 43/US 12-12.5,Birkenstock Arizona BF Blue 51751 Women EU 43/US 12-12.5,Default Ridgefield,12,12,0,0,0,0
,Birkenstock Arizona BF Blue 51751 Women EU 43/US 12-12.5,Birkenstock Arizona BF Blue 51751 Women EU 43/US 12-12.5,FBALYB Amazon,-2,-2,0,0,0,0
,Birkenstock Arizona BF Blue 51753 Women N EU 35/US 4-4.5,Birkenstock Arizona BF Blue 51753 Women N EU 35/US 4-4.5,FBALYB Amazon,12,12,0,0,0,0
,Birkenstock Arizona BF Blue 51753 Women N EU 36/US 5-5.5,Birkenstock Arizona BF Blue 51753 Women N EU 36/US 5-5.5,FBALYB Amazon,23,23,0,0,0,0
,Birkenstock Arizona BF Blue 51753 Women N EU 37/US 6-6.5,Birkenstock Arizona BF Blue 51753 Women N EU 37/US 6-6.5,FBALYB Amazon,55,55,0,0,0,0
,Birkenstock Arizona BF Blue 51753 Women N EU 38/US 7-7.5,Birkenstock Arizona BF Blue 51753 Women N EU 38/US 7-7.5,FBALYB Amazon,12,11,1,0,1,0
,Birkenstock Arizona BF Cosmic Sparkle Old Rose 1016116 Women EU 39/US 8-8.5,Birkenstock Arizona BF Cosmic Sparkle Old Rose 1016116 Women EU 39/US 8-8.5,FBALYB Amazon,1,1,0,0,0,0
,Birkenstock Arizona BF Dark Brown 51701 Men EU 44/US 11-11.5,Birkenstock Arizona BF Dark Brown 51701 Men EU 44/US 11-11.5,Default Ridgefield,5,5,0,0,0,0
,Birkenstock Arizona BF Dark Brown 51701 Men EU 44/US 11-11.5,Birkenstock Arizona BF Dark Brown 51701 Men EU 44/US 11-11.5,FBALYB Amazon,-6,-6,0,0,0,0
,Birkenstock Arizona BF Dark Brown 51701 Men EU 45/US 12-12.5,Birkenstock Arizona BF Dark Brown 51701 Men EU 45/US 12-12.5,FBALYB Amazon,-13,-14,1,4,1,0
,Birkenstock Arizona BF Dark Brown 51701 Women EU 36/US 5-5.5,Birkenstock Arizona BF Dark Brown 51701 Women EU 36/US 5-5.5,FBALYB Amazon,18,18,0,0,0,0
,Birkenstock Arizona BF Dark Brown 51701 Women EU 37/US 6-6.5,Birkenstock Arizona BF Dark Brown 51701 Women EU 37/US 6-6.5,Default Ridgefield,71,71,0,0,0,0
,Birkenstock Arizona BF Dark Brown 51701 Women EU 37/US 6-6.5,Birkenstock Arizona BF Dark Brown 51701 Women EU 37/US 6-6.5,FBALYB Amazon,150,150,0,1,0,0
,Birkenstock Arizona BF Dark Brown 51701 Women EU 38/US 7-7.5,Birkenstock Arizona BF Dark Brown 51701 Women EU 38/US 7-7.5,Default Ridgefield,65,65,0,0,0,0
,Birkenstock Arizona BF Dark Brown 51701 Women EU 38/US 7-7.5,Birkenstock Arizona BF Dark Brown 51701 Women EU 38/US 7-7.5,FBALYB Amazon,-48,-49,1,0,1,0
,Birkenstock Arizona BF Dark Brown 51701 Women EU 39/US 8-8.5,Birkenstock Arizona BF Dark Brown 51701 Women EU 39/US 8-8.5,Default Ridgefield,182,182,0,0,0,0
,Birkenstock Arizona BF Dark Brown 51701 Women EU 39/US 8-8.5,Birkenstock Arizona BF Dark Brown 51701 Women EU 39/US 8-8.5,FBALYB Amazon,14,10,4,0,4,0
,Birkenstock Arizona BF Dark Brown 51701 Women EU 40/US 9-9.5,Birkenstock Arizona BF Dark Brown 51701 Women EU 40/US 9-9.5,FBALYB Amazon,115,114,1,71,1,0
,Birkenstock Arizona BF Dark Brown 51701 Women EU 41/US 10-10.5,Birkenstock Arizona BF Dark Brown 51701 Women EU 41/US 10-10.5,Default Ridgefield,1,1,0,0,0,0
,Birkenstock Arizona BF Dark Brown 51701 Women EU 41/US 10-10.5,Birkenstock Arizona BF Dark Brown 51701 Women EU 41/US 10-10.5,FBALYB Amazon,170,169,1,0,1,0
,Birkenstock Arizona BF Dark Brown 51701 Women EU 42/US 11-11.5,Birkenstock Arizona BF Dark Brown 51701 Women EU 42/US 11-11.5,Default Ridgefield,14,14,0,0,0,0
,Birkenstock Arizona BF Dark Brown 51701 Women EU 42/US 11-11.5,Birkenstock Arizona BF Dark Brown 51701 Women EU 42/US 11-11.5,FBALYB Amazon,6,6,0,0,0,0
,Birkenstock Arizona BF Dark Brown 51701 Women EU 43/US 12-12.5,Birkenstock Arizona BF Dark Brown 51701 Women EU 43/US 12-12.5,Default Ridgefield,1,1,0,0,0,0
,Birkenstock Arizona BF Dark Brown 51701 Women EU 43/US 12-12.5,Birkenstock Arizona BF Dark Brown 51701 Women EU 43/US 12-12.5,FBALYB Amazon,-4,-4,0,0,0,0
,Birkenstock Arizona BF Dark Brown 51703 Women N EU 35/US 4-4.5,Birkenstock Arizona BF Dark Brown 51703 Women N EU 35/US 4-4.5,FBALYB Amazon,-6,-6,0,0,0,0
,Birkenstock Arizona BF Dark Brown 51703 Women N EU 36/US 5-5.5,Birkenstock Arizona BF Dark Brown 51703 Women N EU 36/US 5-5.5,Default Ridgefield,12,12,0,0,0,0
,Birkenstock Arizona BF Dark Brown 51703 Women N EU 36/US 5-5.5,Birkenstock Arizona BF Dark Brown 51703 Women N EU 36/US 5-5.5,FBALYB Amazon,-9,-9,0,0,0,0
,Birkenstock Arizona BF Dark Brown 51703 Women N EU 37/US 6-6.5,Birkenstock Arizona BF Dark Brown 51703 Women N EU 37/US 6-6.5,FBALYB Amazon,-22,-22,0,1,0,0
,Birkenstock Arizona BF Dark Brown 51703 Women N EU 38/US 7-7.5,Birkenstock Arizona BF Dark Brown 51703 Women N EU 38/US 7-7.5,FBALYB Amazon,-12,-12,0,0,0,0
,Birkenstock Arizona BF Dark Brown 51703 Women N EU 39/US 8-8.5,Birkenstock Arizona BF Dark Brown 51703 Women N EU 39/US 8-8.5,FBALYB Amazon,-4,-4,0,0,0,0
,Birkenstock Arizona BF Gold 1016110 Women EU 36/US 5-5.5,Birkenstock Arizona BF Gold 1016110 Women EU 36/US 5-5.5,FBALYB Amazon,22,22,0,0,0,0
,Birkenstock Arizona BF Gold 1016110 Women EU 37/US 6-6.5,Birkenstock Arizona BF Gold 1016110 Women EU 37/US 6-6.5,FBALYB Amazon,50,50,0,0,0,0
,Birkenstock Arizona BF Gold 1016110 Women EU 38/US 7-7.5,Birkenstock Arizona BF Gold 1016110 Women EU 38/US 7-7.5,FBALYB Amazon,79,78,1,0,1,0
,Birkenstock Arizona BF Gold 1016110 Women EU 39/US 8-8.5,Birkenstock Arizona BF Gold 1016110 Women EU 39/US 8-8.5,FBALYB Amazon,59,59,0,0,0,0
,Birkenstock Arizona BF Gold 1016110 Women EU 40/US 9-9.5,Birkenstock Arizona BF Gold 1016110 Women EU 40/US 9-9.5,FBALYB Amazon,34,34,0,0,0,0
,Birkenstock Arizona BF-Nubock Mocha 151183 Men N EU 44/US 11-11.5,Birkenstock Arizona BF-Nubock Mocha 151183 Men N EU 44/US 11-11.5,FBALYB Amazon,-5,-5,0,0,0,0
,Birkenstock Arizona BF-Nubock Mocha 151183 Women N EU 37/US 6-6.5,Birkenstock Arizona BF-Nubock Mocha 151183 Women N EU 37/US 6-6.5,FBALYB Amazon,8,8,0,0,0,0
,Birkenstock Arizona BF-Nubock Mocha 151183 Women N EU 38/US 7-7.5,Birkenstock Arizona BF-Nubock Mocha 151183 Women N EU 38/US 7-7.5,Default Ridgefield,59,59,0,0,0,0
,Birkenstock Arizona BF-Nubock Mocha 151183 Women N EU 38/US 7-7.5,Birkenstock Arizona BF-Nubock Mocha 151183 Women N EU 38/US 7-7.5,FBALYB Amazon,54,54,0,0,0,0
,Birkenstock Arizona BF-Nubock Mocha 151183 Women N EU 39/US 8-8.5,Birkenstock Arizona BF-Nubock Mocha 151183 Women N EU 39/US 8-8.5,FBALYB Amazon,-8,-8,0,0,0,0
,Birkenstock Arizona BF-Nubock Mocha 151183 Women N EU 40/US 9-9.5,Birkenstock Arizona BF-Nubock Mocha 151183 Women N EU 40/US 9-9.5,FBALYB Amazon,-6,-6,0,0,0,0
,Birkenstock Arizona BF-Nubock Mocha 151183 Women N EU 42/US 11-11.5,Birkenstock Arizona BF-Nubock Mocha 151183 Women N EU 42/US 11-11.5,FBALYB Amazon,-4,-4,0,0,0,0
,Birkenstock Arizona BF-Nubock Mocha 151183 Women N EU 43/US 12-12.5,Birkenstock Arizona BF-Nubock Mocha 151183 Women N EU 43/US 12-12.5,FBALYB Amazon,-2,-2,0,0,0,0
,Birkenstock Arizona BF-Nubock Stone 151213 Women N EU 35/US 4-4.5,Birkenstock Arizona BF-Nubock Stone 151213 Women N EU 35/US 4-4.5,FBALYB Amazon,5,5,0,0,0,0
,Birkenstock Arizona BF-Nubock Stone 151213 Women N EU 40/US 9-9.5,Birkenstock Arizona BF-Nubock Stone 151213 Women N EU 40/US 9-9.5,FBALYB Amazon,-1,-1,0,0,0,0
,Birkenstock Arizona BF-Nubock Stone 151213 Women N EU 41/US 10-10.5,Birkenstock Arizona BF-Nubock Stone 151213 Women N EU 41/US 10-10.5,FBALYB Amazon,-3,-3,0,0,0,0
,Birkenstock Arizona BF-Nubock Stone 151213 Women N EU 42/US 11-11.5,Birkenstock Arizona BF-Nubock Stone 151213 Women N EU 42/US 11-11.5,FBALYB Amazon,-2,-2,0,0,0,0
,Birkenstock Arizona BF-Nubock Stone 151213 Women N EU 43/US 12-12.5,Birkenstock Arizona BF-Nubock Stone 151213 Women N EU 43/US 12-12.5,FBALYB Amazon,-2,-2,0,0,0,0
,Birkenstock Arizona BF-Nubuck Mocha 151181 Men EU 44/US 11-11.5,Birkenstock Arizona BF-Nubuck Mocha 151181 Men EU 44/US 11-11.5,FBALYB Amazon,-2,-2,0,0,0,0
,Birkenstock Arizona BF-Nubuck Mocha 151181 Women EU 36/US 5-5.5,Birkenstock Arizona BF-Nubuck Mocha 151181 Women EU 36/US 5-5.5,FBALYB Amazon,-2,-2,0,0,0,0
,Birkenstock Arizona BF-Nubuck Mocha 151181 Women EU 37/US 6-6.5,Birkenstock Arizona BF-Nubuck Mocha 151181 Women EU 37/US 6-6.5,FBALYB Amazon,24,24,0,0,0,0
,Birkenstock Arizona BF-Nubuck Mocha 151181 Women EU 38/US 7-7.5,Birkenstock Arizona BF-Nubuck Mocha 151181 Women EU 38/US 7-7.5,Default Ridgefield,5,5,0,0,0,0
,Birkenstock Arizona BF-Nubuck Mocha 151181 Women EU 38/US 7-7.5,Birkenstock Arizona BF-Nubuck Mocha 151181 Women EU 38/US 7-7.5,FBALYB Amazon,50,50,0,0,0,0
,Birkenstock Arizona BF-Nubuck Mocha 151181 Women EU 39/US 8-8.5,Birkenstock Arizona BF-Nubuck Mocha 151181 Women EU 39/US 8-8.5,Default Ridgefield,2,2,0,0,0,0
,Birkenstock Arizona BF-Nubuck Mocha 151181 Women EU 39/US 8-8.5,Birkenstock Arizona BF-Nubuck Mocha 151181 Women EU 39/US 8-8.5,FBALYB Amazon,79,77,2,2,2,0
,Birkenstock Arizona BF-Nubuck Mocha 151181 Women EU 40/US 9-9.5,Birkenstock Arizona BF-Nubuck Mocha 151181 Women EU 40/US 9-9.5,FBALYB Amazon,-11,-11,0,0,0,0
,Birkenstock Arizona BF-Nubuck Mocha 151181 Women EU 41/US 10-10.5,Birkenstock Arizona BF-Nubuck Mocha 151181 Women EU 41/US 10-10.5,Default Ridgefield,1,1,0,0,0,0
,Birkenstock Arizona BF-Nubuck Mocha 151181 Women EU 41/US 10-10.5,Birkenstock Arizona BF-Nubuck Mocha 151181 Women EU 41/US 10-10.5,FBALYB Amazon,2,0,2,0,2,0
,Birkenstock Arizona BF-Nubuck Mocha 151181 Women EU 42/US 11-11.5,Birkenstock Arizona BF-Nubuck Mocha 151181 Women EU 42/US 11-11.5,Avrami - Ebay,1,1,0,0,0,0
,Birkenstock Arizona BF-Nubuck Mocha 151181 Women EU 42/US 11-11.5,Birkenstock Arizona BF-Nubuck Mocha 151181 Women EU 42/US 11-11.5,Default Ridgefield,1,1,0,0,0,0
,Birkenstock Arizona BF-Nubuck Mocha 151181 Women EU 42/US 11-11.5,Birkenstock Arizona BF-Nubuck Mocha 151181 Women EU 42/US 11-11.5,FBALYB Amazon,-2,-2,0,0,0,0
,Birkenstock Arizona BF-Nubuck Mocha 151181 Women EU 43/US 12-12.5,Birkenstock Arizona BF-Nubuck Mocha 151181 Women EU 43/US 12-12.5,Default Ridgefield,12,12,0,0,0,0
,Birkenstock Arizona BF-Nubuck Mocha 151181 Women EU 43/US 12-12.5,Birkenstock Arizona BF-Nubuck Mocha 151181 Women EU 43/US 12-12.5,FBALYB Amazon,-3,-3,0,0,0,0
,Birkenstock Arizona BF-Nubuck Mocha 151183 Women N EU 35/US 4-4.5,Birkenstock Arizona BF-Nubuck Mocha 151183 Women N EU 35/US 4-4.5,FBALYB Amazon,-5,-5,0,0,0,0
,Birkenstock Arizona BF-Nubuck Mocha 151183 Women N EU 36/US 5-5.5,Birkenstock Arizona BF-Nubuck Mocha 151183 Women N EU 36/US 5-5.5,FBALYB Amazon,15,15,0,0,0,0
,Birkenstock Arizona BF-Nubuck Mocha 151183 Women N EU 37/US 6-6.5,Birkenstock Arizona BF-Nubuck Mocha 151183 Women N EU 37/US 6-6.5,Default Ridgefield,36,36,0,0,0,0
,Birkenstock Arizona BF-Nubuck Mocha 151183 Women N EU 38/US 7-7.5,Birkenstock Arizona BF-Nubuck Mocha 151183 Women N EU 38/US 7-7.5,FBALYB Amazon,0,0,0,1,0,0
,Birkenstock Arizona BF-Nubuck Stone 151211 Men EU 44/US 11-11.5,Birkenstock Arizona BF-Nubuck Stone 151211 Men EU 44/US 11-11.5,FBALYB Amazon,6,6,0,0,0,0
,Birkenstock Arizona BF-Nubuck Stone 151211 Men EU 45/US 12-12.5,Birkenstock Arizona BF-Nubuck Stone 151211 Men EU 45/US 12-12.5,FBALYB Amazon,-8,-8,0,0,0,0
,Birkenstock Arizona BF-Nubuck Stone 151211 Women EU 36/US 5-5.5,Birkenstock Arizona BF-Nubuck Stone 151211 Women EU 36/US 5-5.5,FBALYB Amazon,-1,-1,0,0,0,0
,Birkenstock Arizona BF-Nubuck Stone 151211 Women EU 37/US 6-6.5,Birkenstock Arizona BF-Nubuck Stone 151211 Women EU 37/US 6-6.5,Default Ridgefield,14,14,0,0,0,0
,Birkenstock Arizona BF-Nubuck Stone 151211 Women EU 37/US 6-6.5,Birkenstock Arizona BF-Nubuck Stone 151211 Women EU 37/US 6-6.5,FBALYB Amazon,61,61,0,0,0,0
,Birkenstock Arizona BF-Nubuck Stone 151211 Women EU 38/US 7-7.5,Birkenstock Arizona BF-Nubuck Stone 151211 Women EU 38/US 7-7.5,FBALYB Amazon,103,100,3,0,3,0
,Birkenstock Arizona BF-Nubuck Stone 151211 Women EU 39/US 8-8.5,Birkenstock Arizona BF-Nubuck Stone 151211 Women EU 39/US 8-8.5,FBALYB Amazon,48,46,2,0,2,0
,Birkenstock Arizona BF-Nubuck Stone 151211 Women EU 40/US 9-9.5,Birkenstock Arizona BF-Nubuck Stone 151211 Women EU 40/US 9-9.5,Default Ridgefield,48,48,0,0,0,0
,Birkenstock Arizona BF-Nubuck Stone 151211 Women EU 40/US 9-9.5,Birkenstock Arizona BF-Nubuck Stone 151211 Women EU 40/US 9-9.5,FBALYB Amazon,45,45,0,0,0,0
,Birkenstock Arizona BF-Nubuck Stone 151211 Women EU 41/US 10-10.5,Birkenstock Arizona BF-Nubuck Stone 151211 Women EU 41/US 10-10.5,Default Ridgefield,1,1,0,0,0,0
,Birkenstock Arizona BF-Nubuck Stone 151211 Women EU 41/US 10-10.5,Birkenstock Arizona BF-Nubuck Stone 151211 Women EU 41/US 10-10.5,FBALYB Amazon,114,114,0,0,0,0
,Birkenstock Arizona BF-Nubuck Stone 151211 Women EU 42/US 11-11.5,Birkenstock Arizona BF-Nubuck Stone 151211 Women EU 42/US 11-11.5,FBALYB Amazon,-4,-4,0,0,0,0
,Birkenstock Arizona BF-Nubuck Stone 151211 Women EU 43/US 12-12.5,Birkenstock Arizona BF-Nubuck Stone 151211 Women EU 43/US 12-12.5,FBALYB Amazon,-1,-1,0,0,0,0
,Birkenstock Arizona BF-Nubuck Stone 151213 Women N EU 36/US 5-5.5,Birkenstock Arizona BF-Nubuck Stone 151213 Women N EU 36/US 5-5.5,FBALYB Amazon,9,9,0,0,0,0
,Birkenstock Arizona BF-Nubuck Stone 151213 Women N EU 37/US 6-6.5,Birkenstock Arizona BF-Nubuck Stone 151213 Women N EU 37/US 6-6.5,Default Ridgefield,52,52,0,0,0,0
,Birkenstock Arizona BF-Nubuck Stone 151213 Women N EU 37/US 6-6.5,Birkenstock Arizona BF-Nubuck Stone 151213 Women N EU 37/US 6-6.5,FBALYB Amazon,-8,-8,0,0,0,0
,Birkenstock Arizona BF-Nubuck Stone 151213 Women N EU 38/US 7-7.5,Birkenstock Arizona BF-Nubuck Stone 151213 Women N EU 38/US 7-7.5,FBALYB Amazon,-3,-3,0,0,0,0
,Birkenstock Arizona BF SFB Black 551251 Men EU 44/US 11-11.5,Birkenstock Arizona BF SFB Black 551251 Men EU 44/US 11-11.5,FBALYB Amazon,20,19,1,0,1,0
,Birkenstock Arizona BF SFB Black 551251 Women EU 37/US 6-6.5,Birkenstock Arizona BF SFB Black 551251 Women EU 37/US 6-6.5,FBALYB Amazon,19,19,0,0,0,0
,Birkenstock Arizona BF SFB Black 551251 Women EU 38/US 7-7.5,Birkenstock Arizona BF SFB Black 551251 Women EU 38/US 7-7.5,Default Ridgefield,36,36,0,0,0,0
,Birkenstock Arizona BF SFB Black 551251 Women EU 39/US 8-8.5,Birkenstock Arizona BF SFB Black 551251 Women EU 39/US 8-8.5,Default Ridgefield,48,48,0,0,0,0
,Birkenstock Arizona BF SFB Black 551251 Women EU 40/US 9-9.5,Birkenstock Arizona BF SFB Black 551251 Women EU 40/US 9-9.5,Default Ridgefield,87,87,0,0,0,0
,Birkenstock Arizona BF SFB Black 551251 Women EU 40/US 9-9.5,Birkenstock Arizona BF SFB Black 551251 Women EU 40/US 9-9.5,FBALYB Amazon,52,50,2,0,2,0
,Birkenstock Arizona BF SFB Black 551251 Women EU 41/US 10-10.5,Birkenstock Arizona BF SFB Black 551251 Women EU 41/US 10-10.5,FBALYB Amazon,72,72,0,0,0,0
,Birkenstock Arizona BF SFB Black 551251 Women EU 42/US 11-11.5,Birkenstock Arizona BF SFB Black 551251 Women EU 42/US 11-11.5,Default Ridgefield,1,1,0,0,0,0
,Birkenstock Arizona BF SFB Black 551251 Women EU 42/US 11-11.5,Birkenstock Arizona BF SFB Black 551251 Women EU 42/US 11-11.5,FBALYB Amazon,18,18,0,0,0,0
,Birkenstock Arizona BF SFB Black 551251 Women EU 43/US 12-12.5,Birkenstock Arizona BF SFB Black 551251 Women EU 43/US 12-12.5,FBALYB Amazon,30,29,1,0,1,0
,Birkenstock Arizona BF White 51731 Men EU 44/US 11-11.5,Birkenstock Arizona BF White 51731 Men EU 44/US 11-11.5,FBALYB Amazon,-2,-2,0,0,0,0
,Birkenstock Arizona BF White 51731 Women EU 39/US 8-8.5,Birkenstock Arizona BF White 51731 Women EU 39/US 8-8.5,FBALYB Amazon,-24,-24,0,0,0,0
,Birkenstock Arizona BF White 51731 Women EU 40/US 9-9.5,Birkenstock Arizona BF White 51731 Women EU 40/US 9-9.5,FBALYB Amazon,-26,-26,0,0,0,0
,Birkenstock Arizona BF White 51731 Women EU 41/US 10-10.5,Birkenstock Arizona BF White 51731 Women EU 41/US 10-10.5,FBALYB Amazon,-23,-23,0,0,0,0
,Birkenstock Arizona BF White 51731 Women EU 42/US 11-11.5,Birkenstock Arizona BF White 51731 Women EU 42/US 11-11.5,FBALYB Amazon,-4,-4,0,0,0,0
,Birkenstock Arizona BF White 51731 Women EU 43/US 12-12.5,Birkenstock Arizona BF White 51731 Women EU 43/US 12-12.5,FBALYB Amazon,-4,-4,0,0,0,0
,Birkenstock Arizona BF White 51733 Women N EU 35/US 4-4.5,Birkenstock Arizona BF White 51733 Women N EU 35/US 4-4.5,FBALYB Amazon,-4,-4,0,0,0,0
,Birkenstock Arizona BF White 51733 Women N EU 36/US 5-5.5,Birkenstock Arizona BF White 51733 Women N EU 36/US 5-5.5,FBALYB Amazon,81,81,0,0,0,0
,Birkenstock Arizona BF White 51733 Women N EU 37/US 6-6.5,Birkenstock Arizona BF White 51733 Women N EU 37/US 6-6.5,Default Ridgefield,39,39,0,0,0,0
,Birkenstock Arizona BF White 51733 Women N EU 37/US 6-6.5,Birkenstock Arizona BF White 51733 Women N EU 37/US 6-6.5,FBALYB Amazon,104,104,0,0,0,0
,Birkenstock Arizona BF White 51733 Women N EU 38/US 7-7.5,Birkenstock Arizona BF White 51733 Women N EU 38/US 7-7.5,FBALYB Amazon,139,139,0,0,0,0
,Birkenstock Arizona BF White 51733 Women N EU 39/US 8-8.5,Birkenstock Arizona BF White 51733 Women N EU 39/US 8-8.5,FBALYB Amazon,-5,-5,0,0,0,0
,Birkenstock Arizona EVA Black 129421 EU 46,Birkenstock Arizona EVA Black 129421 EU 46,FBALYB Amazon,144,144,0,0,0,0
,Birkenstock Arizona EVA Black 129421 Men EU 44/US 11-11.5,Birkenstock Arizona EVA Black 129421 Men EU 44/US 11-11.5,FBALYB Amazon,32,29,3,0,3,0
,Birkenstock Arizona EVA Black 129421 Men EU 45/US 12-12.5,Birkenstock Arizona EVA Black 129421 Men EU 45/US 12-12.5,Default Ridgefield,10,10,0,0,0,0
,Birkenstock Arizona EVA Black 129421 Men EU 45/US 12-12.5,Birkenstock Arizona EVA Black 129421 Men EU 45/US 12-12.5,FBALYB Amazon,102,102,0,0,0,0
,Birkenstock Arizona EVA Black 129421 Women EU 41/US 10-10.5,Birkenstock Arizona EVA Black 129421 Women EU 41/US 10-10.5,Default Ridgefield,101,101,0,0,0,0
,Birkenstock Arizona EVA Black 129421 Women EU 41/US 10-10.5,Birkenstock Arizona EVA Black 129421 Women EU 41/US 10-10.5,FBALYB Amazon,108,100,8,0,8,0
,Birkenstock Arizona EVA Black 129421 Women EU 42/US 11-11.5,Birkenstock Arizona EVA Black 129421 Women EU 42/US 11-11.5,Default Ridgefield,77,77,0,0,0,0
,Birkenstock Arizona EVA Black 129421 Women EU 42/US 11-11.5,Birkenstock Arizona EVA Black 129421 Women EU 42/US 11-11.5,FBALYB Amazon,141,141,0,0,0,0
,Birkenstock Arizona EVA Black 129421 Women EU 43/US 12-12.5,Birkenstock Arizona EVA Black 129421 Women EU 43/US 12-12.5,Default Ridgefield,111,111,0,0,0,0
,Birkenstock Arizona EVA Black 129421 Women EU 43/US 12-12.5,Birkenstock Arizona EVA Black 129421 Women EU 43/US 12-12.5,FBALYB Amazon,-123,-124,1,0,1,0
,Birkenstock Arizona EVA Black 129423 EU 36,Birkenstock Arizona EVA Black 129423 EU 36,FBALYB Amazon,244,242,2,0,2,0
,Birkenstock Arizona EVA Black 129423 EU 37,Birkenstock Arizona EVA Black 129423 EU 37,Default Ridgefield,4,4,0,0,0,0
,Birkenstock Arizona EVA Black 129423 EU 37,Birkenstock Arizona EVA Black 129423 EU 37,FBALYB Amazon,179,177,2,0,2,0
,Birkenstock Arizona EVA Black 129423 EU 38,Birkenstock Arizona EVA Black 129423 EU 38,Default Ridgefield,2,2,0,0,0,0
,Birkenstock Arizona EVA Black 129423 EU 38,Birkenstock Arizona EVA Black 129423 EU 38,FBALYB Amazon,162,156,6,0,6,0
,Birkenstock Arizona EVA Black 129423 EU 39,Birkenstock Arizona EVA Black 129423 EU 39,Default Ridgefield,1,1,0,0,0,0
,Birkenstock Arizona EVA Black 129423 EU 39,Birkenstock Arizona EVA Black 129423 EU 39,FBALYB Amazon,133,122,11,0,11,0
,Birkenstock Arizona EVA Black 129423 EU 41,Birkenstock Arizona EVA Black 129423 EU 41,Default Ridgefield,5,5,0,0,0,0
,Birkenstock Arizona EVA Black 129423 EU 41,Birkenstock Arizona EVA Black 129423 EU 41,FBALYB Amazon,6,-1,7,0,7,0
,Birkenstock Arizona EVA Black 129423 Women N EU 40/US 9-9.5,Birkenstock Arizona EVA Black 129423 Women N EU 40/US 9-9.5,Default Ridgefield,8,8,0,0,0,0
,Birkenstock Arizona EVA Black 129423 Women N EU 40/US 9-9.5,Birkenstock Arizona EVA Black 129423 Women N EU 40/US 9-9.5,FBALYB Amazon,104,102,2,0,2,0
,Birkenstock Arizona EVA Khaki 129491 Men EU 44/US 11-11.5,Birkenstock Arizona EVA Khaki 129491 Men EU 44/US 11-11.5,FBALYB Amazon,2,2,0,0,0,0
,Birkenstock Arizona EVA Khaki 129491 Men EU 45/US 12-12.5,Birkenstock Arizona EVA Khaki 129491 Men EU 45/US 12-12.5,FBALYB Amazon,-2,-2,0,0,0,0
,Birkenstock Arizona EVA Khaki 129491 Women EU 41/US 10-10.5,Birkenstock Arizona EVA Khaki 129491 Women EU 41/US 10-10.5,Default Ridgefield,3,3,0,0,0,0
,Birkenstock Arizona EVA Khaki 129491 Women EU 41/US 10-10.5,Birkenstock Arizona EVA Khaki 129491 Women EU 41/US 10-10.5,FBALYB Amazon,-5,-5,0,2,0,0
,Birkenstock Arizona EVA Khaki 129491 Women EU 42/US 11-11.5,Birkenstock Arizona EVA Khaki 129491 Women EU 42/US 11-11.5,Default Ridgefield,11,11,0,0,0,0
,Birkenstock Arizona EVA Khaki 129491 Women EU 42/US 11-11.5,Birkenstock Arizona EVA Khaki 129491 Women EU 42/US 11-11.5,FBALYB Amazon,3,3,0,0,0,0
,Birkenstock Arizona EVA Khaki 129491 Women EU 43/US 12-12.5,Birkenstock Arizona EVA Khaki 129491 Women EU 43/US 12-12.5,Default Ridgefield,1,1,0,0,0,0
,Birkenstock Arizona EVA Khaki 129491 Women EU 43/US 12-12.5,Birkenstock Arizona EVA Khaki 129491 Women EU 43/US 12-12.5,FBALYB Amazon,-5,-5,0,0,0,0
,Birkenstock Arizona EVA Khaki 129493 Women N EU 36/US 5-5.5,Birkenstock Arizona EVA Khaki 129493 Women N EU 36/US 5-5.5,FBALYB Amazon,-21,-21,0,0,0,0
,Birkenstock Arizona EVA Khaki 129493 Women N EU 37/US 6-6.5,Birkenstock Arizona EVA Khaki 129493 Women N EU 37/US 6-6.5,FBALYB Amazon,-22,-22,0,0,0,0
,Birkenstock Arizona EVA Khaki 129493 Women N EU 38/US 7-7.5,Birkenstock Arizona EVA Khaki 129493 Women N EU 38/US 7-7.5,FBALYB Amazon,-17,-17,0,0,0,0
,Birkenstock Arizona EVA Khaki 129493 Women N EU 39/US 8-8.5,Birkenstock Arizona EVA Khaki 129493 Women N EU 39/US 8-8.5,FBALYB Amazon,-14,-14,0,0,0,0
,Birkenstock Arizona EVA Khaki 129493 Women N EU 40/US 9-9.5,Birkenstock Arizona EVA Khaki 129493 Women N EU 40/US 9-9.5,FBALYB Amazon,-13,-13,0,0,0,0
,Birkenstock Arizona EVA Metallic Copper 1001499 Women EU 41/US 10-10.5,Birkenstock Arizona EVA Metallic Copper 1001499 Women EU 41/US 10-10.5,FBALYB Amazon,-6,-6,0,0,0,0
,Birkenstock Arizona EVA Metallic Copper 1001499 Women EU 42/US 11-11.5,Birkenstock Arizona EVA Metallic Copper 1001499 Women EU 42/US 11-11.5,FBALYB Amazon,-7,-7,0,0,0,0
,Birkenstock Arizona EVA Metallic Copper 1001499 Women EU 43/US 12-12.5,Birkenstock Arizona EVA Metallic Copper 1001499 Women EU 43/US 12-12.5,FBALYB Amazon,-2,-2,0,0,0,0
,Birkenstock Arizona EVA Metallic Copper 1001500 Women N EU 36/US 5-5.5,Birkenstock Arizona EVA Metallic Copper 1001500 Women N EU 36/US 5-5.5,FBALYB Amazon,-3,-3,0,0,0,0
,Birkenstock Arizona EVA Metallic Copper 1001500 Women N EU 37/US 6-6.5,Birkenstock Arizona EVA Metallic Copper 1001500 Women N EU 37/US 6-6.5,FBALYB Amazon,-3,-3,0,0,0,0
,Birkenstock Arizona EVA Metallic Copper 1001500 Women N EU 38/US 7-7.5,Birkenstock Arizona EVA Metallic Copper 1001500 Women N EU 38/US 7-7.5,FBALYB Amazon,-7,-7,0,0,0,0
,Birkenstock Arizona EVA Metallic Copper 1001500 Women N EU 39/US 8-8.5,Birkenstock Arizona EVA Metallic Copper 1001500 Women N EU 39/US 8-8.5,FBALYB Amazon,-4,-4,0,0,0,0
,Birkenstock Arizona EVA Metallic Silver 1003490 Men EU 44/US 11-11.5,Birkenstock Arizona EVA Metallic Silver 1003490 Men EU 44/US 11-11.5,Default Ridgefield,4,4,0,0,0,0
,Birkenstock Arizona EVA Metallic Silver 1003490 Men EU 44/US 11-11.5,Birkenstock Arizona EVA Metallic Silver 1003490 Men EU 44/US 11-11.5,FBALYB Amazon,2,2,0,0,0,0
,Birkenstock Arizona EVA Metallic Silver 1003490 Men EU 45/US 12-12.5,Birkenstock Arizona EVA Metallic Silver 1003490 Men EU 45/US 12-12.5,Default Ridgefield,5,5,0,0,0,0
,Birkenstock Arizona EVA Metallic Silver 1003490 Men EU 45/US 12-12.5,Birkenstock Arizona EVA Metallic Silver 1003490 Men EU 45/US 12-12.5,FBALYB Amazon,5,5,0,0,0,0
,Birkenstock Arizona EVA Metallic Silver 1003490 Women EU 41/US 10-10.5,Birkenstock Arizona EVA Metallic Silver 1003490 Women EU 41/US 10-10.5,Default,0,-1,1,0,0,0
,Birkenstock Arizona EVA Metallic Silver 1003490 Women EU 41/US 10-10.5,Birkenstock Arizona EVA Metallic Silver 1003490 Women EU 41/US 10-10.5,Default Ridgefield,2,2,0,0,0,0
,Birkenstock Arizona EVA Metallic Silver 1003490 Women EU 41/US 10-10.5,Birkenstock Arizona EVA Metallic Silver 1003490 Women EU 41/US 10-10.5,FBALYB Amazon,9,9,0,0,0,0
,Birkenstock Arizona EVA Metallic Silver 1003490 Women EU 42/US 11-11.5,Birkenstock Arizona EVA Metallic Silver 1003490 Women EU 42/US 11-11.5,Default Ridgefield,5,5,0,0,0,0
,Birkenstock Arizona EVA Metallic Silver 1003490 Women EU 43/US 12-12.5,Birkenstock Arizona EVA Metallic Silver 1003490 Women EU 43/US 12-12.5,Default Ridgefield,6,6,0,0,0,0
,Birkenstock Arizona EVA Metallic Silver 1003491 Women N EU 36/US 5-5.5,Birkenstock Arizona EVA Metallic Silver 1003491 Women N EU 36/US 5-5.5,FBALYB Amazon,-4,-4,0,0,0,0
,Birkenstock Arizona EVA Metallic Silver 1003491 Women N EU 37/US 6-6.5,Birkenstock Arizona EVA Metallic Silver 1003491 Women N EU 37/US 6-6.5,FBALYB Amazon,-2,-2,0,0,0,0
,Birkenstock Arizona EVA Metallic Silver 1003491 Women N EU 38/US 7-7.5,Birkenstock Arizona EVA Metallic Silver 1003491 Women N EU 38/US 7-7.5,Avrami - Ebay,1,1,0,0,0,0
,Birkenstock Arizona EVA Metallic Silver 1003491 Women N EU 38/US 7-7.5,Birkenstock Arizona EVA Metallic Silver 1003491 Women N EU 38/US 7-7.5,Default Ridgefield,23,23,0,0,0,0
,Birkenstock Arizona EVA Navy 1019051 EU 41,Birkenstock Arizona EVA Navy 1019051 EU 41,Default Ridgefield,13,13,0,0,0,0
,Birkenstock Arizona EVA Navy 1019051 EU 42,Birkenstock Arizona EVA Navy 1019051 EU 42,Default Ridgefield,40,40,0,0,0,0
,Birkenstock Arizona EVA Navy 1019051 EU 43,Birkenstock Arizona EVA Navy 1019051 EU 43,Default Ridgefield,18,18,0,0,0,0
,Birkenstock Arizona EVA Navy 1019051 EU 44,Birkenstock Arizona EVA Navy 1019051 EU 44,Default Ridgefield,32,32,0,0,0,0
,Birkenstock Arizona EVA Navy 1019051 EU 45,Birkenstock Arizona EVA Navy 1019051 EU 45,Default Ridgefield,11,11,0,0,0,0
,Birkenstock Arizona EVA Navy 1019142 EU 36,Birkenstock Arizona EVA Navy 1019142 EU 36,Default Ridgefield,16,16,0,0,0,0
,Birkenstock Arizona EVA Navy 1019142 EU 37,Birkenstock Arizona EVA Navy 1019142 EU 37,Default Ridgefield,40,40,0,0,0,0
,Birkenstock Arizona EVA Navy 1019142 EU 38,Birkenstock Arizona EVA Navy 1019142 EU 38,Default Ridgefield,60,60,0,0,0,0
,Birkenstock Arizona EVA Navy 1019142 EU 38,Birkenstock Arizona EVA Navy 1019142 EU 38,FBALYB Amazon,50,50,0,0,0,0
,Birkenstock Arizona EVA Navy 1019142 EU 39,Birkenstock Arizona EVA Navy 1019142 EU 39,Default Ridgefield,108,108,0,0,0,0
,Birkenstock Arizona EVA Navy 1019142 EU 40,Birkenstock Arizona EVA Navy 1019142 EU 40,Default Ridgefield,65,65,0,0,0,0
,Birkenstock Arizona EVA Navy 1019142 EU 40,Birkenstock Arizona EVA Navy 1019142 EU 40,FBALYB Amazon,50,50,0,0,0,0
,Birkenstock Arizona EVA Navy 1019142 EU 41,Birkenstock Arizona EVA Navy 1019142 EU 41,Default Ridgefield,46,46,0,0,0,0
,Birkenstock Arizona EVA Navy 129431 Men EU 44/US 11-11.5,Birkenstock Arizona EVA Navy 129431 Men EU 44/US 11-11.5,Default Ridgefield,4,4,0,0,0,0
,Birkenstock Arizona EVA Navy 129431 Men EU 44/US 11-11.5,Birkenstock Arizona EVA Navy 129431 Men EU 44/US 11-11.5,FBALYB Amazon,142,141,1,0,1,0
,Birkenstock Arizona EVA Navy 129431 Men EU 45/US 12-12.5,Birkenstock Arizona EVA Navy 129431 Men EU 45/US 12-12.5,FBALYB Amazon,-1,-1,0,0,0,0
,Birkenstock Arizona EVA Navy 129431 Men EU 46/US 13-13.5,Birkenstock Arizona EVA Navy 129431 Men EU 46/US 13-13.5,Default Ridgefield,2,2,0,0,0,0
,Birkenstock Arizona EVA Navy 129431 Men EU 46/US 13-13.5,Birkenstock Arizona EVA Navy 129431 Men EU 46/US 13-13.5,FBALYB Amazon,5,5,0,0,0,0
,Birkenstock Arizona EVA Navy 129431 Women EU 41/US 10-10.5,Birkenstock Arizona EVA Navy 129431 Women EU 41/US 10-10.5,Default Ridgefield,1,1,0,0,0,0
,Birkenstock Arizona EVA Navy 129431 Women EU 41/US 10-10.5,Birkenstock Arizona EVA Navy 129431 Women EU 41/US 10-10.5,FBALYB Amazon,-2,-2,0,0,0,0
,Birkenstock Arizona EVA Navy 129431 Women EU 42/US 11-11.5,Birkenstock Arizona EVA Navy 129431 Women EU 42/US 11-11.5,Avrami - Ebay,1,1,0,0,0,0
,Birkenstock Arizona EVA Navy 129431 Women EU 42/US 11-11.5,Birkenstock Arizona EVA Navy 129431 Women EU 42/US 11-11.5,Default Ridgefield,5,5,0,0,0,0
,Birkenstock Arizona EVA Navy 129431 Women EU 42/US 11-11.5,Birkenstock Arizona EVA Navy 129431 Women EU 42/US 11-11.5,FBALYB Amazon,45,44,1,0,1,0
,Birkenstock Arizona EVA Navy 129431 Women EU 43/US 12-12.5,Birkenstock Arizona EVA Navy 129431 Women EU 43/US 12-12.5,FBALYB Amazon,67,65,2,0,2,0
,Birkenstock Arizona EVA Navy 129433 Women N EU 36/US 5-5.5,Birkenstock Arizona EVA Navy 129433 Women N EU 36/US 5-5.5,FBALYB Amazon,-2,-2,0,0,0,0
,Birkenstock Arizona EVA Navy 129433 Women N EU 38/US 7-7.5,Birkenstock Arizona EVA Navy 129433 Women N EU 38/US 7-7.5,FBALYB Amazon,-2,-2,0,0,0,0
,Birkenstock Arizona EVA Navy 129433 Women N EU 39/US 8-8.5,Birkenstock Arizona EVA Navy 129433 Women N EU 39/US 8-8.5,FBALYB Amazon,-2,-2,0,0,0,0
,Birkenstock Arizona EVA Navy 129433 Women N EU 40/US 9-9.5,Birkenstock Arizona EVA Navy 129433 Women N EU 40/US 9-9.5,Default Ridgefield,3,3,0,0,0,0
,Birkenstock Arizona EVA Navy 129433 Women N EU 40/US 9-9.5,Birkenstock Arizona EVA Navy 129433 Women N EU 40/US 9-9.5,FBALYB Amazon,46,45,1,0,1,0
,Birkenstock Arizona EVA Turquoise 1013094 Women N EU 37/US 6-6.5,Birkenstock Arizona EVA Turquoise 1013094 Women N EU 37/US 6-6.5,FBALYB Amazon,-1,-1,0,0,0,0
,Birkenstock Arizona EVA Turquoise 1013094 Women N EU 38/US 7-7.5,Birkenstock Arizona EVA Turquoise 1013094 Women N EU 38/US 7-7.5,FBALYB Amazon,-5,-5,0,0,0,0
,Birkenstock Arizona EVA Turquoise 1013094 Women N EU 39/US 8-8.5,Birkenstock Arizona EVA Turquoise 1013094 Women N EU 39/US 8-8.5,FBALYB Amazon,-1,-1,0,0,0,0
,Birkenstock Arizona EVA White 129441 Men EU 44/US 11-11.5,Birkenstock Arizona EVA White 129441 Men EU 44/US 11-11.5,Default Ridgefield,56,56,0,0,0,0
,Birkenstock Arizona EVA White 129441 Men EU 44/US 11-11.5,Birkenstock Arizona EVA White 129441 Men EU 44/US 11-11.5,FBALYB Amazon,-1,-1,0,0,0,0
,Birkenstock Arizona EVA White 129441 Men EU 45/US 12-12.5,Birkenstock Arizona EVA White 129441 Men EU 45/US 12-12.5,FBALYB Amazon,23,23,0,0,0,0
,Birkenstock Arizona EVA White 129441 Women EU 41/US 10-10.5,Birkenstock Arizona EVA White 129441 Women EU 41/US 10-10.5,Default Ridgefield,1,1,0,0,0,0
,Birkenstock Arizona EVA White 129441 Women EU 41/US 10-10.5,Birkenstock Arizona EVA White 129441 Women EU 41/US 10-10.5,FBALYB Amazon,44,42,2,0,2,0
,Birkenstock Arizona EVA White 129441 Women EU 42/US 11-11.5,Birkenstock Arizona EVA White 129441 Women EU 42/US 11-11.5,FBALYB Amazon,79,78,1,0,1,0
,Birkenstock Arizona EVA White 129441 Women EU 43/US 12-12.5,Birkenstock Arizona EVA White 129441 Women EU 43/US 12-12.5,FBALYB Amazon,46,43,3,0,3,0
,Birkenstock Arizona NU Oiled Black 552111 Men EU 46/US 12-12.5,Birkenstock Arizona NU Oiled Black 552111 Men EU 46/US 12-12.5,Default Ridgefield,1,1,0,0,0,0
,Birkenstock Arizona NU Oiled Black 552111 Women EU 36/US 5-5.5,Birkenstock Arizona NU Oiled Black 552111 Women EU 36/US 5-5.5,FBALYB Amazon,-2,-2,0,0,0,0
,Birkenstock Arizona NU Oiled Black 552111 Women EU 37/US 6-6.5,Birkenstock Arizona NU Oiled Black 552111 Women EU 37/US 6-6.5,FBALYB Amazon,-6,-6,0,0,0,0
,Birkenstock Arizona NU Oiled Black 552111 Women EU 38/US 7-7.5,Birkenstock Arizona NU Oiled Black 552111 Women EU 38/US 7-7.5,FBALYB Amazon,-17,-17,0,0,0,0
,Birkenstock Arizona NU Oiled Black 552111 Women EU 39/US 8-8.5,Birkenstock Arizona NU Oiled Black 552111 Women EU 39/US 8-8.5,FBALYB Amazon,-13,-13,0,0,0,0
,Birkenstock Arizona NU Oiled Black 552111 Women EU 40/US 9-9.5,Birkenstock Arizona NU Oiled Black 552111 Women EU 40/US 9-9.5,FBALYB Amazon,-6,-6,0,0,0,0
,Birkenstock Arizona NU Oiled Black 552111 Women EU 41/US 10-10.5,Birkenstock Arizona NU Oiled Black 552111 Women EU 41/US 10-10.5,FBALYB Amazon,-3,-3,0,0,0,0
,Birkenstock Arizona NU Oiled Habana 52531 Men EU 44/US 11-11.5,Birkenstock Arizona NU Oiled Habana 52531 Men EU 44/US 11-11.5,Default Ridgefield,44,44,0,0,0,0
,Birkenstock Arizona NU Oiled Habana 52531 Women EU 36/US 5-5.5,Birkenstock Arizona NU Oiled Habana 52531 Women EU 36/US 5-5.5,FBALYB Amazon,-1,-1,0,0,0,0
,Birkenstock Arizona NU Oiled Habana 52531 Women EU 38/US 7-7.5,Birkenstock Arizona NU Oiled Habana 52531 Women EU 38/US 7-7.5,FBALYB Amazon,-9,-9,0,0,0,0
,Birkenstock Arizona NU Oiled Habana 52531 Women EU 39/US 8-8.5,Birkenstock Arizona NU Oiled Habana 52531 Women EU 39/US 8-8.5,FBALYB Amazon,-20,-20,0,0,0,0
,Birkenstock Arizona NU Oiled Habana 52531 Women EU 40/US 9-9.5,Birkenstock Arizona NU Oiled Habana 52531 Women EU 40/US 9-9.5,FBALYB Amazon,11,11,0,0,0,0
,Birkenstock Arizona NU Oiled Habana 52531 Women EU 41/US 10-10.5,Birkenstock Arizona NU Oiled Habana 52531 Women EU 41/US 10-10.5,FBALYB Amazon,-2,-2,0,0,0,0
,Birkenstock Arizona NU Oiled Habana 52531 Women EU 42/US 11-11.5,Birkenstock Arizona NU Oiled Habana 52531 Women EU 42/US 11-11.5,FBALYB Amazon,-3,-3,0,0,0,0
,Birkenstock Arizona NU Oiled Habana 52531 Women EU 43/US 12-12.5,Birkenstock Arizona NU Oiled Habana 52531 Women EU 43/US 12-12.5,FBALYB Amazon,-2,-2,0,0,0,0
,Birkenstock Arizona NU Oiled SFB Habana 452761 Women EU 37/US 6-6.5,Birkenstock Arizona NU Oiled SFB Habana 452761 Women EU 37/US 6-6.5,Default Ridgefield,1,1,0,0,0,0
,Birkenstock Arizona NU Oiled SFB Habana 452761 Women EU 37/US 6-6.5,Birkenstock Arizona NU Oiled SFB Habana 452761 Women EU 37/US 6-6.5,FBALYB Amazon,-3,-3,0,0,0,0
,Birkenstock Arizona NU Oiled SFB Habana 452761 Women EU 38/US 7-7.5,Birkenstock Arizona NU Oiled SFB Habana 452761 Women EU 38/US 7-7.5,Default Ridgefield,1,1,0,0,0,0
,Birkenstock Arizona NU Oiled SFB Habana 452761 Women EU 38/US 7-7.5,Birkenstock Arizona NU Oiled SFB Habana 452761 Women EU 38/US 7-7.5,FBALYB Amazon,-2,-2,0,48,0,0
,Birkenstock Arizona NU Oiled SFB Habana 452761 Women EU 39/US 8-8.5,Birkenstock Arizona NU Oiled SFB Habana 452761 Women EU 39/US 8-8.5,Default Ridgefield,1,1,0,0,0,0
,Birkenstock Arizona NU Oiled SFB Habana 452761 Women EU 39/US 8-8.5,Birkenstock Arizona NU Oiled SFB Habana 452761 Women EU 39/US 8-8.5,FBALYB Amazon,-4,-4,0,0,0,0
,Birkenstock Arizona NU Oiled SFB Habana 452761 Women EU 40/US 9-9.5,Birkenstock Arizona NU Oiled SFB Habana 452761 Women EU 40/US 9-9.5,FBALYB Amazon,-11,-11,0,0,0,0
,Birkenstock Arizona NU Oiled SFB Habana 452761 Women EU 42/US 11-11.5,Birkenstock Arizona NU Oiled SFB Habana 452761 Women EU 42/US 11-11.5,FBALYB Amazon,-1,-1,0,0,0,0
,Birkenstock Arizona NU Oiled SFB Habana 452761 Women EU 43/US 12-12.5,Birkenstock Arizona NU Oiled SFB Habana 452761 Women EU 43/US 12-12.5,FBALYB Amazon,-2,-2,0,0,0,0
,Birkenstock Arizona SFB Suede Mocca 951311 Women EU 36/US 5-5.5,Birkenstock Arizona SFB Suede Mocca 951311 Women EU 36/US 5-5.5,FBALYB Amazon,1,1,0,0,0,0
,Birkenstock Arizona SFB Suede Mocca 951311 Women EU 37/US 6-6.5,Birkenstock Arizona SFB Suede Mocca 951311 Women EU 37/US 6-6.5,FBALYB Amazon,22,22,0,0,0,0
,Birkenstock Arizona SFB Suede Mocca 951311 Women EU 38/US 7-7.5,Birkenstock Arizona SFB Suede Mocca 951311 Women EU 38/US 7-7.5,FBALYB Amazon,-10,-10,0,0,0,0
,Birkenstock Arizona SFB Suede Mocca 951311 Women EU 39/US 8-8.5,Birkenstock Arizona SFB Suede Mocca 951311 Women EU 39/US 8-8.5,FBALYB Amazon,-10,-10,0,0,0,0
,Birkenstock Arizona SFB Suede Mocca 951311 Women EU 41/US 10-10.5,Birkenstock Arizona SFB Suede Mocca 951311 Women EU 41/US 10-10.5,FBALYB Amazon,-3,-3,0,0,0,0
,Birkenstock Arizona SFB Suede Taupe 951301 Women EU 36/US 5-5.5,Birkenstock Arizona SFB Suede Taupe 951301 Women EU 36/US 5-5.5,FBALYB Amazon,-2,-2,0,0,0,0
,Birkenstock Arizona SFB Suede Taupe 951301 Women EU 37/US 6-6.5,Birkenstock Arizona SFB Suede Taupe 951301 Women EU 37/US 6-6.5,FBALYB Amazon,-6,-6,0,0,0,0
,Birkenstock Arizona SFB Suede Taupe 951301 Women EU 38/US 7-7.5,Birkenstock Arizona SFB Suede Taupe 951301 Women EU 38/US 7-7.5,FBALYB Amazon,-8,-8,0,0,0,0
,Birkenstock Arizona SFB Suede Taupe 951301 Women EU 39/US 8-8.5,Birkenstock Arizona SFB Suede Taupe 951301 Women EU 39/US 8-8.5,FBALYB Amazon,-6,-6,0,0,0,0
,Birkenstock Arizona SFB Suede Taupe 951301 Women EU 41/US 10-10.5,Birkenstock Arizona SFB Suede Taupe 951301 Women EU 41/US 10-10.5,FBALYB Amazon,-1,-1,0,0,0,0
,Birkenstock Arizona SFB Suede Taupe 951303 Women N EU 36/US 5-5.5,Birkenstock Arizona SFB Suede Taupe 951303 Women N EU 36/US 5-5.5,FBALYB Amazon,-2,-2,0,0,0,0
,Birkenstock Arizona SFB Suede Taupe 951303 Women N EU 37/US 6-6.5,Birkenstock Arizona SFB Suede Taupe 951303 Women N EU 37/US 6-6.5,FBALYB Amazon,-6,-6,0,0,0,0
,Birkenstock Arizona SFB Suede Taupe 951303 Women N EU 38/US 7-7.5,Birkenstock Arizona SFB Suede Taupe 951303 Women N EU 38/US 7-7.5,FBALYB Amazon,-8,-8,0,0,0,0
,Birkenstock Arizona SFB Suede Taupe 951303 Women N EU 39/US 8-8.5,Birkenstock Arizona SFB Suede Taupe 951303 Women N EU 39/US 8-8.5,FBALYB Amazon,-9,-9,0,0,0,0
,Birkenstock Arizona SFB Suede Taupe 951303 Women N EU 40/US 9-9.5,Birkenstock Arizona SFB Suede Taupe 951303 Women N EU 40/US 9-9.5,FBALYB Amazon,-1,-1,0,0,0,0
,Birkenstock Arizona SFB Suede Taupe 951303 Women N EU 41/US 10-10.5,Birkenstock Arizona SFB Suede Taupe 951303 Women N EU 41/US 10-10.5,FBALYB Amazon,-2,-2,0,0,0,0
,Birkenstock Boston Black Oiled Leather 59461 EU 36,Birkenstock Boston Black Oiled Leather 59461 EU 36,FBALYB Amazon,7,6,1,0,1,0
,Birkenstock Boston Black Oiled Leather 59461 EU 37,Birkenstock Boston Black Oiled Leather 59461 EU 37,FBALYB Amazon,16,13,3,0,3,0
,Birkenstock Boston Black Oiled Leather 59461 EU 38,Birkenstock Boston Black Oiled Leather 59461 EU 38,Default Ridgefield,1,1,0,0,0,0
,Birkenstock Boston Black Oiled Leather 59461 EU 38,Birkenstock Boston Black Oiled Leather 59461 EU 38,FBALYB Amazon,30,26,4,0,4,0
,Birkenstock Boston Black Oiled Leather 59461 Women EU 39/US 8-8.5,Birkenstock Boston Black Oiled Leather 59461 Women EU 39/US 8-8.5,FBALYB Amazon,12,11,1,2,1,0
,Birkenstock Boston Black Oiled Leather 59461 Women EU 40/US 9-9.5,Birkenstock Boston Black Oiled Leather 59461 Women EU 40/US 9-9.5,Default Ridgefield,23,23,0,0,0,0
,Birkenstock Boston Black Oiled Leather 59461 Women EU 40/US 9-9.5,Birkenstock Boston Black Oiled Leather 59461 Women EU 40/US 9-9.5,FBALYB Amazon,24,24,0,0,0,0
,Birkenstock Boston Black Oiled Leather 59461 Women EU 41/US 10-10.5,Birkenstock Boston Black Oiled Leather 59461 Women EU 41/US 10-10.5,Default Ridgefield,34,34,0,0,0,0
,Birkenstock Boston Black Oiled Leather 59461 Women EU 41/US 10-10.5,Birkenstock Boston Black Oiled Leather 59461 Women EU 41/US 10-10.5,FBALYB Amazon,-16,-16,0,0,0,0
,Birkenstock Boston Black Oiled Leather 59461 Women EU 42/US 11-11.5,Birkenstock Boston Black Oiled Leather 59461 Women EU 42/US 11-11.5,FBALYB Amazon,76,75,1,0,1,0
,Birkenstock Boston Black Oiled Leather 59461 Women EU 43/US 12-12.5,Birkenstock Boston Black Oiled Leather 59461 Women EU 43/US 12-12.5,FBALYB Amazon,80,79,1,0,1,0
,Birkenstock Boston FL Tabacco Brown 960811 EU 36,Birkenstock Boston FL Tabacco Brown 960811 EU 36,FBALYB Amazon,9,9,0,0,0,0
,Birkenstock Boston FL Tabacco Brown 960811 EU 37,Birkenstock Boston FL Tabacco Brown 960811 EU 37,FBALYB Amazon,1,0,1,0,1,0
,Birkenstock Boston FL Tabacco Brown 960811 EU 38,Birkenstock Boston FL Tabacco Brown 960811 EU 38,Default Ridgefield,1,1,0,0,0,0
,Birkenstock Boston FL Tabacco Brown 960811 EU 38,Birkenstock Boston FL Tabacco Brown 960811 EU 38,FBALYB Amazon,13,8,5,0,5,0
,Birkenstock Boston FL Tabacco Brown 960811 EU 39,Birkenstock Boston FL Tabacco Brown 960811 EU 39,Default Ridgefield,7,7,0,0,0,0
,Birkenstock Boston FL Tabacco Brown 960811 EU 41,Birkenstock Boston FL Tabacco Brown 960811 EU 41,FBALYB Amazon,2,1,1,0,1,0
,Birkenstock Boston FL Tabacco Brown 960811 EU 42,Birkenstock Boston FL Tabacco Brown 960811 EU 42,Default Ridgefield,2,2,0,0,0,0
,Birkenstock Boston FL Tabacco Brown 960811 EU 42,Birkenstock Boston FL Tabacco Brown 960811 EU 42,FBALYB Amazon,3,1,2,0,2,0
,Birkenstock Boston FL Tabacco Brown 960811 EU 43,Birkenstock Boston FL Tabacco Brown 960811 EU 43,Default Ridgefield,12,12,0,0,0,0
,Birkenstock Boston FL Tabacco Brown 960811 EU 44,Birkenstock Boston FL Tabacco Brown 960811 EU 44,FBALYB Amazon,7,7,0,0,0,0
,Birkenstock Boston FL Tabacco Brown 960811 EU 45,Birkenstock Boston FL Tabacco Brown 960811 EU 45,FBALYB Amazon,6,4,2,0,2,0
,Birkenstock Boston FL Tabacco Brown 960811 EU 46,Birkenstock Boston FL Tabacco Brown 960811 EU 46,Default Ridgefield,1,1,0,0,0,0
,Birkenstock Boston FL Tabacco Brown 960811 EU 46,Birkenstock Boston FL Tabacco Brown 960811 EU 46,FBALYB Amazon,9,9,0,0,0,0
,Birkenstock Boston Habana Oiled Leather 860131 EU 36,Birkenstock Boston Habana Oiled Leather 860131 EU 36,Default Ridgefield,1,1,0,0,0,0
,Birkenstock Boston Habana Oiled Leather 860131 EU 36,Birkenstock Boston Habana Oiled Leather 860131 EU 36,FBALYB Amazon,9,8,1,0,1,0
,Birkenstock Boston Habana Oiled Leather 860131 EU 37,Birkenstock Boston Habana Oiled Leather 860131 EU 37,FBALYB Amazon,38,35,3,0,3,0
,Birkenstock Boston Habana Oiled Leather 860131 EU 38,Birkenstock Boston Habana Oiled Leather 860131 EU 38,FBALYB Amazon,108,103,5,0,5,0
,Birkenstock Boston Habana Oiled Leather 860131 Men EU 44/US 11-11.5,Birkenstock Boston Habana Oiled Leather 860131 Men EU 44/US 11-11.5,Default Ridgefield,34,34,0,0,0,0
,Birkenstock Boston Habana Oiled Leather 860131 Men EU 44/US 11-11.5,Birkenstock Boston Habana Oiled Leather 860131 Men EU 44/US 11-11.5,FBALYB Amazon,92,92,0,0,0,0
,Birkenstock Boston Habana Oiled Leather 860131 Women EU 39/US 8-8.5,Birkenstock Boston Habana Oiled Leather 860131 Women EU 39/US 8-8.5,Default Ridgefield,8,8,0,0,0,0
,Birkenstock Boston Habana Oiled Leather 860131 Women EU 39/US 8-8.5,Birkenstock Boston Habana Oiled Leather 860131 Women EU 39/US 8-8.5,FBALYB Amazon,57,51,6,1,6,0
,Birkenstock Boston Habana Oiled Leather 860131 Women EU 40/US 9-9.5,Birkenstock Boston Habana Oiled Leather 860131 Women EU 40/US 9-9.5,Default Ridgefield,59,59,0,0,0,0
,Birkenstock Boston Habana Oiled Leather 860131 Women EU 40/US 9-9.5,Birkenstock Boston Habana Oiled Leather 860131 Women EU 40/US 9-9.5,FBALYB Amazon,21,20,1,0,1,0
,Birkenstock Boston Habana Oiled Leather 860131 Women EU 41/US 10-10.5,Birkenstock Boston Habana Oiled Leather 860131 Women EU 41/US 10-10.5,FBALYB Amazon,32,29,3,0,3,0
,Birkenstock Boston Habana Oiled Leather 860131 Women EU 42/US 11-11.5,Birkenstock Boston Habana Oiled Leather 860131 Women EU 42/US 11-11.5,Default Ridgefield,29,29,0,0,0,0
,Birkenstock Boston Habana Oiled Leather 860131 Women EU 42/US 11-11.5,Birkenstock Boston Habana Oiled Leather 860131 Women EU 42/US 11-11.5,FBALYB Amazon,83,82,1,0,1,0
,Birkenstock Boston Habana Oiled Leather 860131 Women EU 43/US 12-12.5,Birkenstock Boston Habana Oiled Leather 860131 Women EU 43/US 12-12.5,Avrami - Ebay,4,4,0,0,0,0
,Birkenstock Boston Habana Oiled Leather 860131 Women EU 43/US 12-12.5,Birkenstock Boston Habana Oiled Leather 860131 Women EU 43/US 12-12.5,Default Ridgefield,82,82,0,0,0,0
,Birkenstock Boston Habana Oiled Leather 860131 Women EU 43/US 12-12.5,Birkenstock Boston Habana Oiled Leather 860131 Women EU 43/US 12-12.5,FBALYB Amazon,50,50,0,0,0,0
,Birkenstock Boston NU Oiled Black 59461 EU 46,Birkenstock Boston NU Oiled Black 59461 EU 46,FBALYB Amazon,16,15,1,0,1,0
,Birkenstock Boston NU Oiled Black 59461 Men EU 44/US 11-11.5,Birkenstock Boston NU Oiled Black 59461 Men EU 44/US 11-11.5,FBALYB Amazon,21,17,4,0,4,0
,Birkenstock Boston NU Oiled Black 59461 Men EU 45/US 12-12.5,Birkenstock Boston NU Oiled Black 59461 Men EU 45/US 12-12.5,FBALYB Amazon,7,7,0,0,0,0
,Birkenstock Boston NU Oiled Habana 860131 EU 46,Birkenstock Boston NU Oiled Habana 860131 EU 46,Default Ridgefield,1,1,0,0,0,0
,Birkenstock Boston NU Oiled Habana 860131 EU 46,Birkenstock Boston NU Oiled Habana 860131 EU 46,FBALYB Amazon,32,32,0,0,0,0
,Birkenstock Boston NU Oiled Habana 860131 Men EU 45/US 12-12.5,Birkenstock Boston NU Oiled Habana 860131 Men EU 45/US 12-12.5,Default Ridgefield,3,3,0,0,0,0
,Birkenstock Boston NU Oiled Habana 860131 Men EU 45/US 12-12.5,Birkenstock Boston NU Oiled Habana 860131 Men EU 45/US 12-12.5,FBALYB Amazon,115,115,0,0,0,0
,Birkenstock Florida SFB BF Black 53011 Women EU 39/US 8-8.5,Birkenstock Florida SFB BF Black 53011 Women EU 39/US 8-8.5,Default Ridgefield,1,1,0,0,0,0
,Birkenstock Florida SFB BF Black 53011 Women EU 40/US 9-9.5,Birkenstock Florida SFB BF Black 53011 Women EU 40/US 9-9.5,FBALYB Amazon,-2,-2,0,0,0,0
,Birkenstock Florida SFB BF Black 53011 Women EU 41/US 10-10.5,Birkenstock Florida SFB BF Black 53011 Women EU 41/US 10-10.5,FBALYB Amazon,-6,-6,0,0,0,0
,Birkenstock Florida SFB BF Black 53011 Women EU 42/US 11-11.5,Birkenstock Florida SFB BF Black 53011 Women EU 42/US 11-11.5,FBALYB Amazon,-3,-3,0,0,0,0
,Birkenstock Florida SFB BF Black 53011 Women EU 43/US 12-12.5,Birkenstock Florida SFB BF Black 53011 Women EU 43/US 12-12.5,FBALYB Amazon,-3,-3,0,0,0,0
,Birkenstock Florida SFB BF Black 53013 Women N EU 35/US 4-4.5,Birkenstock Florida SFB BF Black 53013 Women N EU 35/US 4-4.5,Default Ridgefield,12,12,0,0,0,0
,Birkenstock Florida SFB BF Black 53013 Women N EU 36/US 5-5.5,Birkenstock Florida SFB BF Black 53013 Women N EU 36/US 5-5.5,FBALYB Amazon,8,8,0,0,0,0
,Birkenstock Florida SFB BF Black 53013 Women N EU 37/US 6-6.5,Birkenstock Florida SFB BF Black 53013 Women N EU 37/US 6-6.5,FBALYB Amazon,-5,-6,1,0,1,0
,Birkenstock Florida SFB BF Black 53013 Women N EU 38/US 7-7.5,Birkenstock Florida SFB BF Black 53013 Women N EU 38/US 7-7.5,FBALYB Amazon,5,5,0,0,0,0
,Birkenstock Gizeh BF Black 43691 Women EU 36/US 5-5.5,Birkenstock Gizeh BF Black 43691 Women EU 36/US 5-5.5,FBALYB Amazon,-2,-2,0,0,0,0
,Birkenstock Gizeh BF Black 43691 Women EU 37/US 6-6.5,Birkenstock Gizeh BF Black 43691 Women EU 37/US 6-6.5,Avrami - Ebay,1,1,0,0,0,0
,Birkenstock Gizeh BF Black 43691 Women EU 37/US 6-6.5,Birkenstock Gizeh BF Black 43691 Women EU 37/US 6-6.5,Default Ridgefield,1,1,0,0,0,0
,Birkenstock Gizeh BF Black 43691 Women EU 37/US 6-6.5,Birkenstock Gizeh BF Black 43691 Women EU 37/US 6-6.5,FBALYB Amazon,44,44,0,0,0,0
,Birkenstock Gizeh BF Black 43691 Women EU 38/US 7-7.5,Birkenstock Gizeh BF Black 43691 Women EU 38/US 7-7.5,FBALYB Amazon,108,108,0,0,0,0
,Birkenstock Gizeh BF Black 43691 Women EU 39/US 8-8.5,Birkenstock Gizeh BF Black 43691 Women EU 39/US 8-8.5,FBALYB Amazon,50,46,4,0,4,0
,Birkenstock Gizeh BF Black 43691 Women EU 40/US 9-9.5,Birkenstock Gizeh BF Black 43691 Women EU 40/US 9-9.5,Default Ridgefield,4,4,0,0,0,0
,Birkenstock Gizeh BF Black 43691 Women EU 40/US 9-9.5,Birkenstock Gizeh BF Black 43691 Women EU 40/US 9-9.5,FBALYB Amazon,110,109,1,0,1,0
,Birkenstock Gizeh BF Black 43691 Women EU 41/US 10-10.5,Birkenstock Gizeh BF Black 43691 Women EU 41/US 10-10.5,Default Ridgefield,2,2,0,0,0,0
,Birkenstock Gizeh BF Black 43691 Women EU 41/US 10-10.5,Birkenstock Gizeh BF Black 43691 Women EU 41/US 10-10.5,FBALYB Amazon,13,13,0,0,0,0
,Birkenstock Gizeh BF Black 43691 Women EU 43/US 12-12.5,Birkenstock Gizeh BF Black 43691 Women EU 43/US 12-12.5,Default Ridgefield,3,3,0,0,0,0
,Birkenstock Gizeh BF Black 43691 Women EU 43/US 12-12.5,Birkenstock Gizeh BF Black 43691 Women EU 43/US 12-12.5,FBALYB Amazon,6,6,0,0,0,0
,Birkenstock Gizeh BF Nubuck Mocha 43751 Women EU 36/US 5-5.5,Birkenstock Gizeh BF Nubuck Mocha 43751 Women EU 36/US 5-5.5,FBALYB Amazon,-1,-1,0,0,0,0
,Birkenstock Gizeh BF Nubuck Mocha 43751 Women EU 37/US 6-6.5,Birkenstock Gizeh BF Nubuck Mocha 43751 Women EU 37/US 6-6.5,FBALYB Amazon,-7,-7,0,0,0,0
,Birkenstock Gizeh BF Nubuck Mocha 43751 Women EU 38/US 7-7.5,Birkenstock Gizeh BF Nubuck Mocha 43751 Women EU 38/US 7-7.5,FBALYB Amazon,-12,-12,0,0,0,0
,Birkenstock Gizeh BF Nubuck Mocha 43751 Women EU 39/US 8-8.5,Birkenstock Gizeh BF Nubuck Mocha 43751 Women EU 39/US 8-8.5,FBALYB Amazon,-2,-2,0,0,0,0
,Birkenstock Gizeh BF Nubuck Mocha 43751 Women EU 40/US 9-9.5,Birkenstock Gizeh BF Nubuck Mocha 43751 Women EU 40/US 9-9.5,FBALYB Amazon,-5,-5,0,0,0,0
,Birkenstock Gizeh BF Nubuck Mocha 43751 Women EU 41/US 10-10.5,Birkenstock Gizeh BF Nubuck Mocha 43751 Women EU 41/US 10-10.5,FBALYB Amazon,-2,-2,0,0,0,0
,Birkenstock Gizeh BF Silver 43851 Women EU 37/US 6-6.5,Birkenstock Gizeh BF Silver 43851 Women EU 37/US 6-6.5,FBALYB Amazon,153,153,0,0,0,0
,Birkenstock Gizeh BF Silver 43851 Women EU 38/US 7-7.5,Birkenstock Gizeh BF Silver 43851 Women EU 38/US 7-7.5,FBALYB Amazon,219,219,0,3,0,0
,Birkenstock Gizeh BF Silver 43851 Women EU 39/US 8-8.5,Birkenstock Gizeh BF Silver 43851 Women EU 39/US 8-8.5,Default Ridgefield,6,6,0,0,0,0
,Birkenstock Gizeh BF Silver 43851 Women EU 39/US 8-8.5,Birkenstock Gizeh BF Silver 43851 Women EU 39/US 8-8.5,FBALYB Amazon,69,69,0,1,0,0
,Birkenstock Gizeh BF Silver 43851 Women EU 40/US 9-9.5,Birkenstock Gizeh BF Silver 43851 Women EU 40/US 9-9.5,FBALYB Amazon,107,107,0,0,0,0
,Birkenstock Gizeh BF Silver 43851 Women EU 41/US 10-10.5,Birkenstock Gizeh BF Silver 43851 Women EU 41/US 10-10.5,FBALYB Amazon,16,16,0,0,0,0
,Birkenstock Gizeh BF Silver 43851 Women EU 42/US 11-11.5,Birkenstock Gizeh BF Silver 43851 Women EU 42/US 11-11.5,FBALYB Amazon,-1,-1,0,0,0,0
,Birkenstock Gizeh BF White 43731 Men EU 44/US 11-11.5,Birkenstock Gizeh BF White 43731 Men EU 44/US 11-11.5,Default Ridgefield,1,1,0,0,0,0
,Birkenstock Gizeh BF White 43731 Men EU 44/US 11-11.5,Birkenstock Gizeh BF White 43731 Men EU 44/US 11-11.5,FBALYB Amazon,5,5,0,0,0,0
,Birkenstock Gizeh BF White 43731 Women EU 37/US 6-6.5,Birkenstock Gizeh BF White 43731 Women EU 37/US 6-6.5,FBALYB Amazon,116,116,0,0,0,0
,Birkenstock Gizeh BF White 43731 Women EU 38/US 7-7.5,Birkenstock Gizeh BF White 43731 Women EU 38/US 7-7.5,FBALYB Amazon,111,111,0,0,0,0
,Birkenstock Gizeh BF White 43731 Women EU 39/US 8-8.5,Birkenstock Gizeh BF White 43731 Women EU 39/US 8-8.5,FBALYB Amazon,104,104,0,0,0,0
,Birkenstock Gizeh BF White 43731 Women EU 40/US 9-9.5,Birkenstock Gizeh BF White 43731 Women EU 40/US 9-9.5,FBALYB Amazon,79,79,0,0,0,0
,Birkenstock Gizeh BF White 43731 Women EU 41/US 10-10.5,Birkenstock Gizeh BF White 43731 Women EU 41/US 10-10.5,Default Ridgefield,25,25,0,0,0,0
,Birkenstock Gizeh BF White 43731 Women EU 41/US 10-10.5,Birkenstock Gizeh BF White 43731 Women EU 41/US 10-10.5,FBALYB Amazon,22,22,0,0,0,0
,Birkenstock Gizeh EVA Beetroot Purple 1015472 Women EU 38/US 7-7.5,Birkenstock Gizeh EVA Beetroot Purple 1015472 Women EU 38/US 7-7.5,FBALYB Amazon,8,8,0,0,0,0
,Birkenstock Gizeh EVA Beetroot Purple 1015472 Women EU 39/US 8-8.5,Birkenstock Gizeh EVA Beetroot Purple 1015472 Women EU 39/US 8-8.5,FBALYB Amazon,-2,-2,0,0,0,0
,Birkenstock Gizeh EVA Beetroot Purple 1015472 Women EU 40/US 9-9.5,Birkenstock Gizeh EVA Beetroot Purple 1015472 Women EU 40/US 9-9.5,FBALYB Amazon,4,4,0,0,0,0
,Birkenstock Gizeh EVA Beetroot Purple 1015472 Women EU 41/US 10-10.5,Birkenstock Gizeh EVA Beetroot Purple 1015472 Women EU 41/US 10-10.5,Default Ridgefield,5,5,0,0,0,0
,Birkenstock Gizeh EVA Beetroot Purple 1015472 Women EU 41/US 10-10.5,Birkenstock Gizeh EVA Beetroot Purple 1015472 Women EU 41/US 10-10.5,FBALYB Amazon,5,5,0,0,0,0
,Birkenstock Gizeh EVA Black 128201 Men EU 44/US 11-11.5,Birkenstock Gizeh EVA Black 128201 Men EU 44/US 11-11.5,FBALYB Amazon,6,6,0,0,0,0
,Birkenstock Gizeh EVA Black 128201 Women EU 35/US 4-4.5,Birkenstock Gizeh EVA Black 128201 Women EU 35/US 4-4.5,Default Ridgefield,24,24,0,0,0,0
,Birkenstock Gizeh EVA Black 128201 Women EU 36/US 5-5.5,Birkenstock Gizeh EVA Black 128201 Women EU 36/US 5-5.5,Default Ridgefield,135,135,0,0,0,0
,Birkenstock Gizeh EVA Black 128201 Women EU 36/US 5-5.5,Birkenstock Gizeh EVA Black 128201 Women EU 36/US 5-5.5,FBALYB Amazon,-170,-170,0,150,0,0
,Birkenstock Gizeh EVA Black 128201 Women EU 37/US 6-6.5,Birkenstock Gizeh EVA Black 128201 Women EU 37/US 6-6.5,Default Ridgefield,131,131,0,0,0,0
,Birkenstock Gizeh EVA Black 128201 Women EU 37/US 6-6.5,Birkenstock Gizeh EVA Black 128201 Women EU 37/US 6-6.5,FBALYB Amazon,30,23,7,0,7,0
,Birkenstock Gizeh EVA Black 128201 Women EU 38/US 7-7.5,Birkenstock Gizeh EVA Black 128201 Women EU 38/US 7-7.5,Default Ridgefield,155,155,0,0,0,0
,Birkenstock Gizeh EVA Black 128201 Women EU 38/US 7-7.5,Birkenstock Gizeh EVA Black 128201 Women EU 38/US 7-7.5,FBALYB Amazon,-22,-25,3,4,3,0
,Birkenstock Gizeh EVA Black 128201 Women EU 39/US 8-8.5,Birkenstock Gizeh EVA Black 128201 Women EU 39/US 8-8.5,Default Ridgefield,205,205,0,0,0,0
,Birkenstock Gizeh EVA Black 128201 Women EU 39/US 8-8.5,Birkenstock Gizeh EVA Black 128201 Women EU 39/US 8-8.5,FBALYB Amazon,-143,-143,0,0,0,0
,Birkenstock Gizeh EVA Black 128201 Women EU 40/US 9-9.5,Birkenstock Gizeh EVA Black 128201 Women EU 40/US 9-9.5,Default Ridgefield,222,222,0,0,0,0
,Birkenstock Gizeh EVA Black 128201 Women EU 40/US 9-9.5,Birkenstock Gizeh EVA Black 128201 Women EU 40/US 9-9.5,FBALYB Amazon,-142,-153,11,0,11,0
,Birkenstock Gizeh EVA Black 128201 Women EU 41/US 10-10.5,Birkenstock Gizeh EVA Black 128201 Women EU 41/US 10-10.5,Default,12,12,0,0,0,0
,Birkenstock Gizeh EVA Black 128201 Women EU 41/US 10-10.5,Birkenstock Gizeh EVA Black 128201 Women EU 41/US 10-10.5,Default Ridgefield,1,1,0,0,0,0
,Birkenstock Gizeh EVA Black 128201 Women EU 41/US 10-10.5,Birkenstock Gizeh EVA Black 128201 Women EU 41/US 10-10.5,FBALYB Amazon,93,91,2,0,2,0
,Birkenstock Gizeh EVA Black 128201 Women EU 42/US 11-11.5,Birkenstock Gizeh EVA Black 128201 Women EU 42/US 11-11.5,FBALYB Amazon,27,26,1,0,1,0
,Birkenstock Gizeh EVA Black 128201 Women EU 43/US 12-12.5,Birkenstock Gizeh EVA Black 128201 Women EU 43/US 12-12.5,Default,1,0,1,0,0,0
,Birkenstock Gizeh EVA Black 128201 Women EU 43/US 12-12.5,Birkenstock Gizeh EVA Black 128201 Women EU 43/US 12-12.5,FBALYB Amazon,-4,-4,0,0,0,0
,Birkenstock Gizeh EVA Khaki 1019143 EU 36,Birkenstock Gizeh EVA Khaki 1019143 EU 36,FBALYB Amazon,42,42,0,0,0,0
,Birkenstock Gizeh EVA Khaki 1019143 EU 37,Birkenstock Gizeh EVA Khaki 1019143 EU 37,Default Ridgefield,77,77,0,0,0,0
,Birkenstock Gizeh EVA Khaki 1019143 EU 38,Birkenstock Gizeh EVA Khaki 1019143 EU 38,Default Ridgefield,114,114,0,0,0,0
,Birkenstock Gizeh EVA Khaki 1019143 EU 39,Birkenstock Gizeh EVA Khaki 1019143 EU 39,Default Ridgefield,113,113,0,0,0,0
,Birkenstock Gizeh EVA Khaki 1019143 EU 40,Birkenstock Gizeh EVA Khaki 1019143 EU 40,Default Ridgefield,59,59,0,0,0,0
,Birkenstock Gizeh EVA Khaki 1019143 EU 40,Birkenstock Gizeh EVA Khaki 1019143 EU 40,FBALYB Amazon,66,66,0,0,0,0
,Birkenstock Gizeh EVA Khaki 1019143 EU 41,Birkenstock Gizeh EVA Khaki 1019143 EU 41,FBALYB Amazon,70,70,0,1,0,0
,Birkenstock Gizeh EVA Khaki 1019143 EU 42,Birkenstock Gizeh EVA Khaki 1019143 EU 42,Default Ridgefield,24,24,0,0,0,0
,Birkenstock Gizeh EVA Khaki 128271 Men EU 44/US 11-11.5,Birkenstock Gizeh EVA Khaki 128271 Men EU 44/US 11-11.5,FBALYB Amazon,-4,-4,0,0,0,0
,Birkenstock Gizeh EVA Khaki 128271 Women EU 35/US 4-4.5,Birkenstock Gizeh EVA Khaki 128271 Women EU 35/US 4-4.5,Default Ridgefield,48,48,0,0,0,0
,Birkenstock Gizeh EVA Khaki 128271 Women EU 36/US 5-5.5,Birkenstock Gizeh EVA Khaki 128271 Women EU 36/US 5-5.5,FBALYB Amazon,-1,-1,0,0,0,0
,Birkenstock Gizeh EVA Khaki 128271 Women EU 37/US 6-6.5,Birkenstock Gizeh EVA Khaki 128271 Women EU 37/US 6-6.5,Default Ridgefield,1,1,0,0,0,0
,Birkenstock Gizeh EVA Khaki 128271 Women EU 37/US 6-6.5,Birkenstock Gizeh EVA Khaki 128271 Women EU 37/US 6-6.5,FBALYB Amazon,140,140,0,0,0,0
,Birkenstock Gizeh EVA Khaki 128271 Women EU 38/US 7-7.5,Birkenstock Gizeh EVA Khaki 128271 Women EU 38/US 7-7.5,FBALYB Amazon,94,94,0,0,0,0
,Birkenstock Gizeh EVA Khaki 128271 Women EU 39/US 8-8.5,Birkenstock Gizeh EVA Khaki 128271 Women EU 39/US 8-8.5,FBALYB Amazon,128,128,0,0,0,0
,Birkenstock Gizeh EVA Khaki 128271 Women EU 40/US 9-9.5,Birkenstock Gizeh EVA Khaki 128271 Women EU 40/US 9-9.5,Default Ridgefield,33,33,0,0,0,0
,Birkenstock Gizeh EVA Khaki 128271 Women EU 40/US 9-9.5,Birkenstock Gizeh EVA Khaki 128271 Women EU 40/US 9-9.5,FBALYB Amazon,135,135,0,0,0,0
,Birkenstock Gizeh EVA Khaki 128271 Women EU 41/US 10-10.5,Birkenstock Gizeh EVA Khaki 128271 Women EU 41/US 10-10.5,FBALYB Amazon,160,160,0,0,0,0
,Birkenstock Gizeh EVA Khaki 128271 Women EU 42/US 11-11.5,Birkenstock Gizeh EVA Khaki 128271 Women EU 42/US 11-11.5,FBALYB Amazon,-9,-9,0,0,0,0
,Birkenstock Gizeh EVA Khaki 128271 Women EU 43/US 12-12.5,Birkenstock Gizeh EVA Khaki 128271 Women EU 43/US 12-12.5,FBALYB Amazon,55,55,0,0,0,0
,Birkenstock Gizeh EVA Metallic Anthracite 1001505 Men EU 44/US 11-11.5,Birkenstock Gizeh EVA Metallic Anthracite 1001505 Men EU 44/US 11-11.5,FBALYB Amazon,-7,-7,0,0,0,0
,Birkenstock Gizeh EVA Metallic Anthracite 1001505 Women EU 35/US 4-4.5,Birkenstock Gizeh EVA Metallic Anthracite 1001505 Women EU 35/US 4-4.5,FBALYB Amazon,7,6,1,0,1,0
,Birkenstock Gizeh EVA Metallic Anthracite 1001505 Women EU 36/US 5-5.5,Birkenstock Gizeh EVA Metallic Anthracite 1001505 Women EU 36/US 5-5.5,Default Ridgefield,42,42,0,0,0,0
,Birkenstock Gizeh EVA Metallic Anthracite 1001505 Women EU 36/US 5-5.5,Birkenstock Gizeh EVA Metallic Anthracite 1001505 Women EU 36/US 5-5.5,FBALYB Amazon,3,3,0,0,0,0
,Birkenstock Gizeh EVA Metallic Anthracite 1001505 Women EU 37/US 6-6.5,Birkenstock Gizeh EVA Metallic Anthracite 1001505 Women EU 37/US 6-6.5,Default,0,-1,1,0,0,0
,Birkenstock Gizeh EVA Metallic Anthracite 1001505 Women EU 37/US 6-6.5,Birkenstock Gizeh EVA Metallic Anthracite 1001505 Women EU 37/US 6-6.5,Default Ridgefield,95,95,0,0,0,0
,Birkenstock Gizeh EVA Metallic Anthracite 1001505 Women EU 37/US 6-6.5,Birkenstock Gizeh EVA Metallic Anthracite 1001505 Women EU 37/US 6-6.5,FBALYB Amazon,-1,-1,0,12,0,0
,Birkenstock Gizeh EVA Metallic Anthracite 1001505 Women EU 38/US 7-7.5,Birkenstock Gizeh EVA Metallic Anthracite 1001505 Women EU 38/US 7-7.5,Default Ridgefield,253,253,0,0,0,0
,Birkenstock Gizeh EVA Metallic Anthracite 1001505 Women EU 38/US 7-7.5,Birkenstock Gizeh EVA Metallic Anthracite 1001505 Women EU 38/US 7-7.5,FBALYB Amazon,-13,-13,0,12,0,0
,Birkenstock Gizeh EVA Metallic Anthracite 1001505 Women EU 39/US 8-8.5,Birkenstock Gizeh EVA Metallic Anthracite 1001505 Women EU 39/US 8-8.5,Default Ridgefield,306,306,0,0,0,0
,Birkenstock Gizeh EVA Metallic Anthracite 1001505 Women EU 39/US 8-8.5,Birkenstock Gizeh EVA Metallic Anthracite 1001505 Women EU 39/US 8-8.5,FBALYB Amazon,39,39,0,0,0,0
,Birkenstock Gizeh EVA Metallic Anthracite 1001505 Women EU 40/US 9-9.5,Birkenstock Gizeh EVA Metallic Anthracite 1001505 Women EU 40/US 9-9.5,Default Ridgefield,3,3,0,0,0,0
,Birkenstock Gizeh EVA Metallic Anthracite 1001505 Women EU 40/US 9-9.5,Birkenstock Gizeh EVA Metallic Anthracite 1001505 Women EU 40/US 9-9.5,FBALYB Amazon,97,97,0,0,0,0
,Birkenstock Gizeh EVA Metallic Anthracite 1001505 Women EU 41/US 10-10.5,Birkenstock Gizeh EVA Metallic Anthracite 1001505 Women EU 41/US 10-10.5,Default Ridgefield,123,123,0,0,0,0
,Birkenstock Gizeh EVA Metallic Anthracite 1001505 Women EU 41/US 10-10.5,Birkenstock Gizeh EVA Metallic Anthracite 1001505 Women EU 41/US 10-10.5,FBALYB Amazon,19,19,0,36,0,0
,Birkenstock Gizeh EVA Metallic Anthracite 1001505 Women EU 42/US 11-11.5,Birkenstock Gizeh EVA Metallic Anthracite 1001505 Women EU 42/US 11-11.5,FBALYB Amazon,13,13,0,0,0,0
,Birkenstock Gizeh EVA Metallic Anthracite 1001505 Women EU 43/US 12-12.5,Birkenstock Gizeh EVA Metallic Anthracite 1001505 Women EU 43/US 12-12.5,Default Ridgefield,4,4,0,0,0,0
,Birkenstock Gizeh EVA Metallic Anthracite 1001505 Women EU 43/US 12-12.5,Birkenstock Gizeh EVA Metallic Anthracite 1001505 Women EU 43/US 12-12.5,FBALYB Amazon,66,66,0,2,0,0
,Birkenstock Gizeh EVA Metallic Copper 1001506 Men EU 44/US 11-11.5,Birkenstock Gizeh EVA Metallic Copper 1001506 Men EU 44/US 11-11.5,Default Ridgefield,5,5,0,0,0,0
,Birkenstock Gizeh EVA Metallic Copper 1001506 Men EU 44/US 11-11.5,Birkenstock Gizeh EVA Metallic Copper 1001506 Men EU 44/US 11-11.5,FBALYB Amazon,5,5,0,0,0,0
,Birkenstock Gizeh EVA Metallic Copper 1001506 Women EU 35/US 4-4.5,Birkenstock Gizeh EVA Metallic Copper 1001506 Women EU 35/US 4-4.5,FBALYB Amazon,-1,-1,0,0,0,0
,Birkenstock Gizeh EVA Metallic Copper 1001506 Women EU 37/US 6-6.5,Birkenstock Gizeh EVA Metallic Copper 1001506 Women EU 37/US 6-6.5,Default Ridgefield,66,66,0,0,0,0
,Birkenstock Gizeh EVA Metallic Copper 1001506 Women EU 37/US 6-6.5,Birkenstock Gizeh EVA Metallic Copper 1001506 Women EU 37/US 6-6.5,FBALYB Amazon,61,61,0,0,0,0
,Birkenstock Gizeh EVA Metallic Copper 1001506 Women EU 38/US 7-7.5,Birkenstock Gizeh EVA Metallic Copper 1001506 Women EU 38/US 7-7.5,Default Ridgefield,1,1,0,0,0,0
,Birkenstock Gizeh EVA Metallic Copper 1001506 Women EU 38/US 7-7.5,Birkenstock Gizeh EVA Metallic Copper 1001506 Women EU 38/US 7-7.5,FBALYB Amazon,-4,-4,0,0,0,0
,Birkenstock Gizeh EVA Metallic Copper 1001506 Women EU 39/US 8-8.5,Birkenstock Gizeh EVA Metallic Copper 1001506 Women EU 39/US 8-8.5,Default Ridgefield,1,1,0,0,0,0
,Birkenstock Gizeh EVA Metallic Copper 1001506 Women EU 39/US 8-8.5,Birkenstock Gizeh EVA Metallic Copper 1001506 Women EU 39/US 8-8.5,FBALYB Amazon,-4,-4,0,0,0,0
,Birkenstock Gizeh EVA Metallic Copper 1001506 Women EU 40/US 9-9.5,Birkenstock Gizeh EVA Metallic Copper 1001506 Women EU 40/US 9-9.5,FBALYB Amazon,-1,-1,0,0,0,0
,Birkenstock Gizeh EVA Metallic Copper 1001506 Women EU 41/US 10-10.5,Birkenstock Gizeh EVA Metallic Copper 1001506 Women EU 41/US 10-10.5,FBALYB Amazon,-7,-7,0,1,0,0
,Birkenstock Gizeh EVA Metallic Copper 1001506 Women EU 42/US 11-11.5,Birkenstock Gizeh EVA Metallic Copper 1001506 Women EU 42/US 11-11.5,FBALYB Amazon,-4,-4,0,0,0,0
,Birkenstock Gizeh EVA Metallic Copper 1001506 Women EU 43/US 12-12.5,Birkenstock Gizeh EVA Metallic Copper 1001506 Women EU 43/US 12-12.5,Default Ridgefield,4,4,0,0,0,0
,Birkenstock Gizeh EVA Metallic Copper 1001506 Women EU 43/US 12-12.5,Birkenstock Gizeh EVA Metallic Copper 1001506 Women EU 43/US 12-12.5,FBALYB Amazon,-4,-4,0,0,0,0
,Birkenstock Gizeh EVA Metallic Silver 1003496 Women EU 35/US 4-4.5,Birkenstock Gizeh EVA Metallic Silver 1003496 Women EU 35/US 4-4.5,FBALYB Amazon,-3,-3,0,0,0,0
,Birkenstock Gizeh EVA Metallic Silver 1003496 Women EU 36/US 5-5.5,Birkenstock Gizeh EVA Metallic Silver 1003496 Women EU 36/US 5-5.5,FBALYB Amazon,-7,-7,0,0,0,0
,Birkenstock Gizeh EVA Metallic Silver 1003496 Women EU 37/US 6-6.5,Birkenstock Gizeh EVA Metallic Silver 1003496 Women EU 37/US 6-6.5,FBALYB Amazon,149,149,0,0,0,0
,Birkenstock Gizeh EVA Metallic Silver 1003496 Women EU 38/US 7-7.5,Birkenstock Gizeh EVA Metallic Silver 1003496 Women EU 38/US 7-7.5,Default Ridgefield,2,2,0,0,0,0
,Birkenstock Gizeh EVA Metallic Silver 1003496 Women EU 38/US 7-7.5,Birkenstock Gizeh EVA Metallic Silver 1003496 Women EU 38/US 7-7.5,FBALYB Amazon,40,40,0,0,0,0
,Birkenstock Gizeh EVA Metallic Silver 1003496 Women EU 39/US 8-8.5,Birkenstock Gizeh EVA Metallic Silver 1003496 Women EU 39/US 8-8.5,FBALYB Amazon,6,6,0,0,0,0
,Birkenstock Gizeh EVA Metallic Silver 1003496 Women EU 40/US 9-9.5,Birkenstock Gizeh EVA Metallic Silver 1003496 Women EU 40/US 9-9.5,FBALYB Amazon,16,14,2,0,2,0
,Birkenstock Gizeh EVA Metallic Silver 1003496 Women EU 41/US 10-10.5,Birkenstock Gizeh EVA Metallic Silver 1003496 Women EU 41/US 10-10.5,FBALYB Amazon,16,16,0,0,0,0
,Birkenstock Gizeh EVA Navy 1019161 EU 36,Birkenstock Gizeh EVA Navy 1019161 EU 36,Default Ridgefield,18,18,0,0,0,0
,Birkenstock Gizeh EVA Navy 1019161 EU 37,Birkenstock Gizeh EVA Navy 1019161 EU 37,Default Ridgefield,30,30,0,0,0,0
,Birkenstock Gizeh EVA Navy 1019161 EU 38,Birkenstock Gizeh EVA Navy 1019161 EU 38,Default Ridgefield,114,114,0,0,0,0
,Birkenstock Gizeh EVA Navy 1019161 EU 39,Birkenstock Gizeh EVA Navy 1019161 EU 39,Default Ridgefield,112,112,0,0,0,0
,Birkenstock Gizeh EVA Navy 1019161 EU 40,Birkenstock Gizeh EVA Navy 1019161 EU 40,Default Ridgefield,100,100,0,0,0,0
,Birkenstock Gizeh EVA Navy 1019161 EU 41,Birkenstock Gizeh EVA Navy 1019161 EU 41,Default Ridgefield,34,34,0,0,0,0
,Birkenstock Gizeh EVA Navy 1019161 EU 42,Birkenstock Gizeh EVA Navy 1019161 EU 42,Default Ridgefield,12,12,0,0,0,0
,Birkenstock Gizeh EVA Navy 128211 Men EU 44/US 11-11.5,Birkenstock Gizeh EVA Navy 128211 Men EU 44/US 11-11.5,FBALYB Amazon,7,7,0,0,0,0
,Birkenstock Gizeh EVA Navy 128211 Women EU 35/US 4-4.5,Birkenstock Gizeh EVA Navy 128211 Women EU 35/US 4-4.5,FBALYB Amazon,-2,-2,0,0,0,0
,Birkenstock Gizeh EVA Navy 128211 Women EU 36/US 5-5.5,Birkenstock Gizeh EVA Navy 128211 Women EU 36/US 5-5.5,FBALYB Amazon,-6,-6,0,0,0,0
,Birkenstock Gizeh EVA Navy 128211 Women EU 37/US 6-6.5,Birkenstock Gizeh EVA Navy 128211 Women EU 37/US 6-6.5,Default Ridgefield,3,3,0,0,0,0
,Birkenstock Gizeh EVA Navy 128211 Women EU 37/US 6-6.5,Birkenstock Gizeh EVA Navy 128211 Women EU 37/US 6-6.5,FBALYB Amazon,83,82,1,0,1,0
,Birkenstock Gizeh EVA Navy 128211 Women EU 38/US 7-7.5,Birkenstock Gizeh EVA Navy 128211 Women EU 38/US 7-7.5,FBALYB Amazon,77,77,0,0,0,0
,Birkenstock Gizeh EVA Navy 128211 Women EU 39/US 8-8.5,Birkenstock Gizeh EVA Navy 128211 Women EU 39/US 8-8.5,FBALYB Amazon,87,87,0,0,0,0
,Birkenstock Gizeh EVA Navy 128211 Women EU 40/US 9-9.5,Birkenstock Gizeh EVA Navy 128211 Women EU 40/US 9-9.5,Default Ridgefield,1,1,0,0,0,0
,Birkenstock Gizeh EVA Navy 128211 Women EU 40/US 9-9.5,Birkenstock Gizeh EVA Navy 128211 Women EU 40/US 9-9.5,FBALYB Amazon,142,142,0,12,0,0
,Birkenstock Gizeh EVA Navy 128211 Women EU 41/US 10-10.5,Birkenstock Gizeh EVA Navy 128211 Women EU 41/US 10-10.5,Default Ridgefield,1,1,0,0,0,0
,Birkenstock Gizeh EVA Navy 128211 Women EU 41/US 10-10.5,Birkenstock Gizeh EVA Navy 128211 Women EU 41/US 10-10.5,FBALYB Amazon,182,182,0,0,0,0
,Birkenstock Gizeh EVA Navy 128211 Women EU 42/US 11-11.5,Birkenstock Gizeh EVA Navy 128211 Women EU 42/US 11-11.5,FBALYB Amazon,-4,-4,0,0,0,0
,Birkenstock Gizeh EVA Navy 128211 Women EU 43/US 12-12.5,Birkenstock Gizeh EVA Navy 128211 Women EU 43/US 12-12.5,FBALYB Amazon,24,24,0,0,0,0
,Birkenstock Gizeh EVA White 128221 Men EU 44/US 11-11.5,Birkenstock Gizeh EVA White 128221 Men EU 44/US 11-11.5,Default Ridgefield,24,24,0,0,0,0
,Birkenstock Gizeh EVA White 128221 Women EU 35/US 4-4.5,Birkenstock Gizeh EVA White 128221 Women EU 35/US 4-4.5,Default Ridgefield,24,24,0,0,0,0
,Birkenstock Gizeh EVA White 128221 Women EU 36/US 5-5.5,Birkenstock Gizeh EVA White 128221 Women EU 36/US 5-5.5,Default Ridgefield,18,18,0,0,0,0
,Birkenstock Gizeh EVA White 128221 Women EU 36/US 5-5.5,Birkenstock Gizeh EVA White 128221 Women EU 36/US 5-5.5,FBALYB Amazon,-2,-2,0,0,0,0
,Birkenstock Gizeh EVA White 128221 Women EU 37/US 6-6.5,Birkenstock Gizeh EVA White 128221 Women EU 37/US 6-6.5,Default,12,12,0,0,0,0
,Birkenstock Gizeh EVA White 128221 Women EU 37/US 6-6.5,Birkenstock Gizeh EVA White 128221 Women EU 37/US 6-6.5,Default Ridgefield,30,30,0,0,0,0
,Birkenstock Gizeh EVA White 128221 Women EU 37/US 6-6.5,Birkenstock Gizeh EVA White 128221 Women EU 37/US 6-6.5,FBALYB Amazon,-27,-27,0,0,0,0
,Birkenstock Gizeh EVA White 128221 Women EU 38/US 7-7.5,Birkenstock Gizeh EVA White 128221 Women EU 38/US 7-7.5,Default Ridgefield,114,114,0,0,0,0
,Birkenstock Gizeh EVA White 128221 Women EU 38/US 7-7.5,Birkenstock Gizeh EVA White 128221 Women EU 38/US 7-7.5,FBALYB Amazon,-7,-7,0,0,0,0
,Birkenstock Gizeh EVA White 128221 Women EU 39/US 8-8.5,Birkenstock Gizeh EVA White 128221 Women EU 39/US 8-8.5,Default Ridgefield,114,114,0,0,0,0
,Birkenstock Gizeh EVA White 128221 Women EU 39/US 8-8.5,Birkenstock Gizeh EVA White 128221 Women EU 39/US 8-8.5,FBALYB Amazon,-7,-7,0,0,0,0
,Birkenstock Gizeh EVA White 128221 Women EU 40/US 9-9.5,Birkenstock Gizeh EVA White 128221 Women EU 40/US 9-9.5,FBALYB Amazon,90,90,0,0,0,0
,Birkenstock Gizeh EVA White 128221 Women EU 41/US 10-10.5,Birkenstock Gizeh EVA White 128221 Women EU 41/US 10-10.5,Default Ridgefield,35,35,0,0,0,0
,Birkenstock Gizeh EVA White 128221 Women EU 41/US 10-10.5,Birkenstock Gizeh EVA White 128221 Women EU 41/US 10-10.5,FBALYB Amazon,-14,-14,0,0,0,0
,Birkenstock Gizeh EVA White 128221 Women EU 42/US 11-11.5,Birkenstock Gizeh EVA White 128221 Women EU 42/US 11-11.5,Default Ridgefield,12,12,0,0,0,0
,Birkenstock Gizeh EVA White 128221 Women EU 42/US 11-11.5,Birkenstock Gizeh EVA White 128221 Women EU 42/US 11-11.5,FBALYB Amazon,-29,-29,0,48,0,0
,Birkenstock Gizeh EVA White 128221 Women EU 43/US 12-12.5,Birkenstock Gizeh EVA White 128221 Women EU 43/US 12-12.5,Default Ridgefield,6,6,0,0,0,0
,Birkenstock Gizeh EVA White 128221 Women EU 43/US 12-12.5,Birkenstock Gizeh EVA White 128221 Women EU 43/US 12-12.5,FBALYB Amazon,13,13,0,0,0,0
,Birkenstock Gizeh OL Habana 743831 Women EU 38/US 7-7.5,Birkenstock Gizeh OL Habana 743831 Women EU 38/US 7-7.5,Default Ridgefield,41,41,0,0,0,0
,Birkenstock Gizeh OL Habana 743831 Women EU 39/US 8-8.5,Birkenstock Gizeh OL Habana 743831 Women EU 39/US 8-8.5,Default Ridgefield,40,40,0,0,0,0
,Birkenstock Gizeh OL Habana 743831 Women EU 40/US 9-9.5,Birkenstock Gizeh OL Habana 743831 Women EU 40/US 9-9.5,Default Ridgefield,8,8,0,0,0,0
,Birkenstock Gizeh OL Habana 743831 Women EU 40/US 9-9.5,Birkenstock Gizeh OL Habana 743831 Women EU 40/US 9-9.5,FBALYB Amazon,10,10,0,0,0,0
,Birkenstock Madrid BF Black 40793 Women N EU 35/US 4-4.5,Birkenstock Madrid BF Black 40793 Women N EU 35/US 4-4.5,Default Ridgefield,12,12,0,0,0,0
,Birkenstock Madrid BF Black 40793 Women N EU 35/US 4-4.5,Birkenstock Madrid BF Black 40793 Women N EU 35/US 4-4.5,FBALYB Amazon,2,2,0,0,0,0
,Birkenstock Madrid BF Black 40793 Women N EU 36/US 5-5.5,Birkenstock Madrid BF Black 40793 Women N EU 36/US 5-5.5,Default Ridgefield,36,36,0,0,0,0
,Birkenstock Madrid BF Black 40793 Women N EU 37/US 6-6.5,Birkenstock Madrid BF Black 40793 Women N EU 37/US 6-6.5,FBALYB Amazon,14,14,0,0,0,0
,Birkenstock Madrid BF Black 40793 Women N EU 38/US 7-7.5,Birkenstock Madrid BF Black 40793 Women N EU 38/US 7-7.5,Default Ridgefield,24,24,0,0,0,0
,Birkenstock Madrid BF-Nubuck Mocha 40091 Women EU 37/US 6-6.5,Birkenstock Madrid BF-Nubuck Mocha 40091 Women EU 37/US 6-6.5,Default,0,-1,1,0,0,0
,Birkenstock Madrid BF-Nubuck Mocha 40091 Women EU 37/US 6-6.5,Birkenstock Madrid BF-Nubuck Mocha 40091 Women EU 37/US 6-6.5,Default Ridgefield,35,35,0,0,0,0
,Birkenstock Madrid BF-Nubuck Mocha 40091 Women EU 37/US 6-6.5,Birkenstock Madrid BF-Nubuck Mocha 40091 Women EU 37/US 6-6.5,FBALYB Amazon,37,37,0,0,0,0
,Birkenstock Madrid BF-Nubuck Mocha 40091 Women EU 38/US 7-7.5,Birkenstock Madrid BF-Nubuck Mocha 40091 Women EU 38/US 7-7.5,Default Ridgefield,41,41,0,0,0,0
,Birkenstock Madrid BF-Nubuck Mocha 40091 Women EU 38/US 7-7.5,Birkenstock Madrid BF-Nubuck Mocha 40091 Women EU 38/US 7-7.5,FBALYB Amazon,40,40,0,0,0,0
,Birkenstock Madrid BF-Nubuck Mocha 40091 Women EU 39/US 8-8.5,Birkenstock Madrid BF-Nubuck Mocha 40091 Women EU 39/US 8-8.5,Default Ridgefield,39,39,0,0,0,0
,Birkenstock Madrid BF-Nubuck Mocha 40091 Women EU 39/US 8-8.5,Birkenstock Madrid BF-Nubuck Mocha 40091 Women EU 39/US 8-8.5,FBALYB Amazon,39,39,0,0,0,0
,Birkenstock Madrid BF-Nubuck Mocha 40091 Women EU 40/US 9-9.5,Birkenstock Madrid BF-Nubuck Mocha 40091 Women EU 40/US 9-9.5,Default Ridgefield,43,43,0,0,0,0
,Birkenstock Madrid BF-Nubuck Mocha 40091 Women EU 40/US 9-9.5,Birkenstock Madrid BF-Nubuck Mocha 40091 Women EU 40/US 9-9.5,FBALYB Amazon,44,44,0,0,0,0
,Birkenstock Madrid BF-Nubuck Mocha 40091 Women EU 41/US 10-10.5,Birkenstock Madrid BF-Nubuck Mocha 40091 Women EU 41/US 10-10.5,Default Ridgefield,17,17,0,0,0,0
,Birkenstock Madrid BF-Nubuck Mocha 40091 Women EU 41/US 10-10.5,Birkenstock Madrid BF-Nubuck Mocha 40091 Women EU 41/US 10-10.5,FBALYB Amazon,19,19,0,0,0,0
,Birkenstock Madrid BF White 40733 Women N EU 35/US 4-4.5,Birkenstock Madrid BF White 40733 Women N EU 35/US 4-4.5,Default Ridgefield,12,12,0,0,0,0
,Birkenstock Madrid BF White 40733 Women N EU 36/US 5-5.5,Birkenstock Madrid BF White 40733 Women N EU 36/US 5-5.5,Avrami - Ebay,1,1,0,0,0,0
,Birkenstock Madrid BF White 40733 Women N EU 36/US 5-5.5,Birkenstock Madrid BF White 40733 Women N EU 36/US 5-5.5,Default Ridgefield,35,35,0,0,0,0
,Birkenstock Madrid BF White 40733 Women N EU 37/US 6-6.5,Birkenstock Madrid BF White 40733 Women N EU 37/US 6-6.5,Default Ridgefield,40,40,0,0,0,0
,Birkenstock Madrid BF White 40733 Women N EU 38/US 7-7.5,Birkenstock Madrid BF White 40733 Women N EU 38/US 7-7.5,Default Ridgefield,24,24,0,0,0,0
,Birkenstock Madrid EVA Black 128163 EU 36,Birkenstock Madrid EVA Black 128163 EU 36,Default Ridgefield,20,20,0,0,0,0
,Birkenstock Madrid EVA Black 128163 EU 36,Birkenstock Madrid EVA Black 128163 EU 36,FBALYB Amazon,14,14,0,0,0,0
,Birkenstock Madrid EVA Black 128163 EU 37,Birkenstock Madrid EVA Black 128163 EU 37,Default Ridgefield,16,16,0,0,0,0
,Birkenstock Madrid EVA Black 128163 EU 37,Birkenstock Madrid EVA Black 128163 EU 37,FBALYB Amazon,47,47,0,0,0,0
,Birkenstock Madrid EVA Black 128163 EU 38,Birkenstock Madrid EVA Black 128163 EU 38,Default Ridgefield,50,50,0,0,0,0
,Birkenstock Madrid EVA Black 128163 EU 38,Birkenstock Madrid EVA Black 128163 EU 38,FBALYB Amazon,45,43,2,0,2,0
,Birkenstock Madrid EVA Black 128163 EU 39,Birkenstock Madrid EVA Black 128163 EU 39,Default Ridgefield,47,47,0,0,0,0
,Birkenstock Madrid EVA Black 128163 EU 39,Birkenstock Madrid EVA Black 128163 EU 39,FBALYB Amazon,45,45,0,0,0,0
,Birkenstock Madrid EVA Black 128163 EU 40,Birkenstock Madrid EVA Black 128163 EU 40,Default Ridgefield,1,1,0,0,0,0
,Birkenstock Madrid EVA Black 128163 EU 40,Birkenstock Madrid EVA Black 128163 EU 40,FBALYB Amazon,100,100,0,0,0,0
,Birkenstock Madrid EVA Black 128163 EU 41,Birkenstock Madrid EVA Black 128163 EU 41,Default Ridgefield,1,1,0,0,0,0
,Birkenstock Madrid EVA Black 128163 EU 41,Birkenstock Madrid EVA Black 128163 EU 41,FBALYB Amazon,61,61,0,0,0,0
,Birkenstock Mayari BF Black 71791 Men EU 44/US 11-11.5,Birkenstock Mayari BF Black 71791 Men EU 44/US 11-11.5,Default Ridgefield,17,17,0,0,0,0
,Birkenstock Mayari BF Black 71791 Men EU 44/US 11-11.5,Birkenstock Mayari BF Black 71791 Men EU 44/US 11-11.5,FBALYB Amazon,6,6,0,0,0,0
,Birkenstock Mayari BF Black 71791 Women EU 36/US 5-5.5,Birkenstock Mayari BF Black 71791 Women EU 36/US 5-5.5,FBALYB Amazon,-6,-6,0,0,0,0
,Birkenstock Mayari BF Black 71791 Women EU 37/US 6-6.5,Birkenstock Mayari BF Black 71791 Women EU 37/US 6-6.5,Default Ridgefield,8,8,0,0,0,0
,Birkenstock Mayari BF Black 71791 Women EU 37/US 6-6.5,Birkenstock Mayari BF Black 71791 Women EU 37/US 6-6.5,FBALYB Amazon,124,124,0,0,0,0
,Birkenstock Mayari BF Black 71791 Women EU 38/US 7-7.5,Birkenstock Mayari BF Black 71791 Women EU 38/US 7-7.5,FBALYB Amazon,55,55,0,96,0,0
,Birkenstock Mayari BF Black 71791 Women EU 39/US 8-8.5,Birkenstock Mayari BF Black 71791 Women EU 39/US 8-8.5,FBALYB Amazon,75,74,1,0,1,0
,Birkenstock Mayari BF Black 71791 Women EU 40/US 9-9.5,Birkenstock Mayari BF Black 71791 Women EU 40/US 9-9.5,Default Ridgefield,14,14,0,0,0,0
,Birkenstock Mayari BF Black 71791 Women EU 40/US 9-9.5,Birkenstock Mayari BF Black 71791 Women EU 40/US 9-9.5,FBALYB Amazon,81,81,0,0,0,0
,Birkenstock Mayari BF Black 71791 Women EU 41/US 10-10.5,Birkenstock Mayari BF Black 71791 Women EU 41/US 10-10.5,Default Ridgefield,10,10,0,0,0,0
,Birkenstock Mayari BF Black 71791 Women EU 41/US 10-10.5,Birkenstock Mayari BF Black 71791 Women EU 41/US 10-10.5,FBALYB Amazon,36,36,0,0,0,0
,Birkenstock Mayari BF Black 71791 Women EU 42/US 11-11.5,Birkenstock Mayari BF Black 71791 Women EU 42/US 11-11.5,FBALYB Amazon,-7,-7,0,0,0,0
,Birkenstock Mayari BF Black 71791 Women EU 43/US 12-12.5,Birkenstock Mayari BF Black 71791 Women EU 43/US 12-12.5,FBALYB Amazon,-1,-1,0,24,0,0
,Birkenstock Mayari BF Black 71793 Women N EU 37/US 6-6.5,Birkenstock Mayari BF Black 71793 Women N EU 37/US 6-6.5,FBALYB Amazon,-5,-5,0,0,0,0
,Birkenstock Mayari BF Black 71793 Women N EU 38/US 7-7.5,Birkenstock Mayari BF Black 71793 Women N EU 38/US 7-7.5,FBALYB Amazon,-7,-7,0,0,0,0
,Birkenstock Mayari BF Black 71793 Women N EU 39/US 8-8.5,Birkenstock Mayari BF Black 71793 Women N EU 39/US 8-8.5,FBALYB Amazon,18,18,0,0,0,0
,Birkenstock Mayari BF Black 71793 Women N EU 40/US 9-9.5,Birkenstock Mayari BF Black 71793 Women N EU 40/US 9-9.5,FBALYB Amazon,-3,-3,0,0,0,0
,Birkenstock Mayari BF Black 71793 Women N EU 41/US 10-10.5,Birkenstock Mayari BF Black 71793 Women N EU 41/US 10-10.5,FBALYB Amazon,-3,-3,0,0,0,0
,Birkenstock Mayari BF Black 71793 Women N EU 42/US 11-11.5,Birkenstock Mayari BF Black 71793 Women N EU 42/US 11-11.5,FBALYB Amazon,-1,-1,0,0,0,0
,Birkenstock Mayari BF Black 71793 Women N EU 43/US 12-12.5,Birkenstock Mayari BF Black 71793 Women N EU 43/US 12-12.5,FBALYB Amazon,-2,-2,0,0,0,0
,Birkenstock Mayari BF-Nubuck Mocha 71061 Women EU 36/US 5-5.5,Birkenstock Mayari BF-Nubuck Mocha 71061 Women EU 36/US 5-5.5,FBALYB Amazon,-3,-3,0,0,0,0
,Birkenstock Mayari BF-Nubuck Mocha 71061 Women EU 37/US 6-6.5,Birkenstock Mayari BF-Nubuck Mocha 71061 Women EU 37/US 6-6.5,Default Ridgefield,17,17,0,0,0,0
,Birkenstock Mayari BF-Nubuck Mocha 71061 Women EU 37/US 6-6.5,Birkenstock Mayari BF-Nubuck Mocha 71061 Women EU 37/US 6-6.5,FBALYB Amazon,36,36,0,0,0,0
,Birkenstock Mayari BF-Nubuck Mocha 71061 Women EU 38/US 7-7.5,Birkenstock Mayari BF-Nubuck Mocha 71061 Women EU 38/US 7-7.5,Avrami - Ebay,12,12,0,0,0,0
,Birkenstock Mayari BF-Nubuck Mocha 71061 Women EU 38/US 7-7.5,Birkenstock Mayari BF-Nubuck Mocha 71061 Women EU 38/US 7-7.5,FBALYB Amazon,9,9,0,0,0,0
,Birkenstock Mayari BF-Nubuck Mocha 71061 Women EU 39/US 8-8.5,Birkenstock Mayari BF-Nubuck Mocha 71061 Women EU 39/US 8-8.5,Default Ridgefield,6,6,0,0,0,0
,Birkenstock Mayari BF-Nubuck Mocha 71061 Women EU 39/US 8-8.5,Birkenstock Mayari BF-Nubuck Mocha 71061 Women EU 39/US 8-8.5,FBALYB Amazon,-9,-9,0,1,0,0
,Birkenstock Mayari BF-Nubuck Mocha 71061 Women EU 40/US 9-9.5,Birkenstock Mayari BF-Nubuck Mocha 71061 Women EU 40/US 9-9.5,FBALYB Amazon,0,-3,3,0,3,0
,Birkenstock Mayari BF-Nubuck Mocha 71061 Women EU 42/US 11-11.5,Birkenstock Mayari BF-Nubuck Mocha 71061 Women EU 42/US 11-11.5,FBALYB Amazon,-4,-4,0,0,0,0
,Birkenstock Mayari BF-Nubuck Mocha 71061 Women EU 43/US 12-12.5,Birkenstock Mayari BF-Nubuck Mocha 71061 Women EU 43/US 12-12.5,FBALYB Amazon,-1,-1,0,0,0,0
,Birkenstock Mayari BF-Nubuck Mocha 71063 Women N EU 36/US 5-5.5,Birkenstock Mayari BF-Nubuck Mocha 71063 Women N EU 36/US 5-5.5,FBALYB Amazon,-3,-3,0,0,0,0
,Birkenstock Mayari BF-Nubuck Mocha 71063 Women N EU 37/US 6-6.5,Birkenstock Mayari BF-Nubuck Mocha 71063 Women N EU 37/US 6-6.5,FBALYB Amazon,-8,-8,0,0,0,0
,Birkenstock Mayari BF-Nubuck Mocha 71063 Women N EU 38/US 7-7.5,Birkenstock Mayari BF-Nubuck Mocha 71063 Women N EU 38/US 7-7.5,FBALYB Amazon,-19,-19,0,0,0,0
,Birkenstock Mayari BF-Nubuck Mocha 71063 Women N EU 39/US 8-8.5,Birkenstock Mayari BF-Nubuck Mocha 71063 Women N EU 39/US 8-8.5,FBALYB Amazon,-24,-24,0,0,0,0
,Birkenstock Mayari BF-Nubuck Mocha 71063 Women N EU 40/US 9-9.5,Birkenstock Mayari BF-Nubuck Mocha 71063 Women N EU 40/US 9-9.5,FBALYB Amazon,-5,-5,0,0,0,0
,Birkenstock Mayari BF-Nubuck Mocha 71063 Women N EU 41/US 10-10.5,Birkenstock Mayari BF-Nubuck Mocha 71063 Women N EU 41/US 10-10.5,FBALYB Amazon,-3,-3,0,0,0,0
,Birkenstock Mayari BF-Nubuck Mocha 71063 Women N EU 43/US 12-12.5,Birkenstock Mayari BF-Nubuck Mocha 71063 Women N EU 43/US 12-12.5,Default Ridgefield,6,6,0,0,0,0
,Birkenstock Mayari BF-Nubuck Stone 71071 Women EU 37/US 6-6.5,Birkenstock Mayari BF-Nubuck Stone 71071 Women EU 37/US 6-6.5,FBALYB Amazon,64,64,0,0,0,0
,Birkenstock Mayari BF-Nubuck Stone 71071 Women EU 38/US 7-7.5,Birkenstock Mayari BF-Nubuck Stone 71071 Women EU 38/US 7-7.5,FBALYB Amazon,17,15,2,0,2,0
,Birkenstock Mayari BF-Nubuck Stone 71071 Women EU 39/US 8-8.5,Birkenstock Mayari BF-Nubuck Stone 71071 Women EU 39/US 8-8.5,FBALYB Amazon,-5,-5,0,0,0,0
,Birkenstock Mayari BF-Nubuck Stone 71071 Women EU 40/US 9-9.5,Birkenstock Mayari BF-Nubuck Stone 71071 Women EU 40/US 9-9.5,Default Ridgefield,1,1,0,0,0,0
,Birkenstock Mayari BF-Nubuck Stone 71071 Women EU 40/US 9-9.5,Birkenstock Mayari BF-Nubuck Stone 71071 Women EU 40/US 9-9.5,FBALYB Amazon,-2,-2,0,0,0,0
,Birkenstock Mayari BF-Nubuck Stone 71071 Women EU 41/US 10-10.5,Birkenstock Mayari BF-Nubuck Stone 71071 Women EU 41/US 10-10.5,FBALYB Amazon,-2,-2,0,0,0,0
,Birkenstock Mayari BF Silver 71081 Women EU 37/US 6-6.5,Birkenstock Mayari BF Silver 71081 Women EU 37/US 6-6.5,Default Ridgefield,3,3,0,0,0,0
,Birkenstock Mayari BF Silver 71081 Women EU 37/US 6-6.5,Birkenstock Mayari BF Silver 71081 Women EU 37/US 6-6.5,FBALYB Amazon,57,57,0,0,0,0
,Birkenstock Mayari BF Silver 71081 Women EU 38/US 7-7.5,Birkenstock Mayari BF Silver 71081 Women EU 38/US 7-7.5,FBALYB Amazon,8,8,0,0,0,0
,Birkenstock Mayari BF Silver 71081 Women EU 39/US 8-8.5,Birkenstock Mayari BF Silver 71081 Women EU 39/US 8-8.5,Default Ridgefield,17,17,0,0,0,0
,Birkenstock Mayari BF Silver 71081 Women EU 39/US 8-8.5,Birkenstock Mayari BF Silver 71081 Women EU 39/US 8-8.5,FBALYB Amazon,11,11,0,0,0,0
,Birkenstock Mayari BF Silver 71081 Women EU 40/US 9-9.5,Birkenstock Mayari BF Silver 71081 Women EU 40/US 9-9.5,FBALYB Amazon,11,11,0,0,0,0
,Birkenstock Mayari BF Silver 71081 Women EU 41/US 10-10.5,Birkenstock Mayari BF Silver 71081 Women EU 41/US 10-10.5,FBALYB Amazon,-1,-1,0,0,0,0
,Birkenstock Mayari BF Silver 71081 Women EU 42/US 11-11.5,Birkenstock Mayari BF Silver 71081 Women EU 42/US 11-11.5,FBALYB Amazon,-2,-2,0,0,0,0
,Birkenstock Mayari BF Silver 71081 Women EU 43/US 12-12.5,Birkenstock Mayari BF Silver 71081 Women EU 43/US 12-12.5,Default Ridgefield,5,5,0,0,0,0
,Birkenstock Mayari BF Silver 71083 Women N EU 36/US 5-5.5,Birkenstock Mayari BF Silver 71083 Women N EU 36/US 5-5.5,FBALYB Amazon,-14,-14,0,0,0,0
,Birkenstock Mayari BF Silver 71083 Women N EU 37/US 6-6.5,Birkenstock Mayari BF Silver 71083 Women N EU 37/US 6-6.5,FBALYB Amazon,-1,-1,0,0,0,0
,Birkenstock Mayari BF Silver 71083 Women N EU 38/US 7-7.5,Birkenstock Mayari BF Silver 71083 Women N EU 38/US 7-7.5,Default Oxford,1,1,0,0,0,0
,Birkenstock Mayari BF Silver 71083 Women N EU 38/US 7-7.5,Birkenstock Mayari BF Silver 71083 Women N EU 38/US 7-7.5,Default Ridgefield,11,11,0,0,0,0
,Birkenstock Mayari BF Silver 71083 Women N EU 38/US 7-7.5,Birkenstock Mayari BF Silver 71083 Women N EU 38/US 7-7.5,FBALYB Amazon,23,23,0,0,0,0
,Birkenstock Mayari BF Silver 71083 Women N EU 39/US 8-8.5,Birkenstock Mayari BF Silver 71083 Women N EU 39/US 8-8.5,Default Oxford,2,2,0,0,0,0
,Birkenstock Mayari BF Silver 71083 Women N EU 39/US 8-8.5,Birkenstock Mayari BF Silver 71083 Women N EU 39/US 8-8.5,FBALYB Amazon,34,34,0,0,0,0
,Birkenstock Mayari BF Silver 71083 Women N EU 40/US 9-9.5,Birkenstock Mayari BF Silver 71083 Women N EU 40/US 9-9.5,Default Ridgefield,11,11,0,0,0,0
,Birkenstock Mayari BF Silver 71083 Women N EU 41/US 10-10.5,Birkenstock Mayari BF Silver 71083 Women N EU 41/US 10-10.5,FBALYB Amazon,-3,-3,0,0,0,0
,Birkenstock Mayari BF Silver 71083 Women N EU 42/US 11-11.5,Birkenstock Mayari BF Silver 71083 Women N EU 42/US 11-11.5,FBALYB Amazon,-2,-2,0,0,0,0
,Birkenstock Mayari BF Silver 71083 Women N EU 43/US 12-12.5,Birkenstock Mayari BF Silver 71083 Women N EU 43/US 12-12.5,Default Ridgefield,1,1,0,0,0,0
,Birkenstock Mayari BF White 71051 Men EU 44/US 11-11.5,Birkenstock Mayari BF White 71051 Men EU 44/US 11-11.5,Default Ridgefield,4,4,0,0,0,0
,Birkenstock Mayari BF White 71051 Women EU 39/US 8-8.5,Birkenstock Mayari BF White 71051 Women EU 39/US 8-8.5,Avrami - Ebay,1,1,0,0,0,0
,Birkenstock Mayari BF White 71051 Women EU 39/US 8-8.5,Birkenstock Mayari BF White 71051 Women EU 39/US 8-8.5,FBALYB Amazon,-1,-1,0,0,0,0
,Birkenstock Mayari BF White 71051 Women EU 40/US 9-9.5,Birkenstock Mayari BF White 71051 Women EU 40/US 9-9.5,FBALYB Amazon,-1,-1,0,0,0,0
,Birkenstock Mayari BF White 71051 Women EU 41/US 10-10.5,Birkenstock Mayari BF White 71051 Women EU 41/US 10-10.5,FBALYB Amazon,-8,-8,0,0,0,0
,Birkenstock Mayari BF White 71051 Women EU 43/US 12-12.5,Birkenstock Mayari BF White 71051 Women EU 43/US 12-12.5,Default Ridgefield,6,6,0,0,0,0
,Birkenstock Mayari NU Oiled Habana 171321 Women EU 37/US 6-6.5,Birkenstock Mayari NU Oiled Habana 171321 Women EU 37/US 6-6.5,FBALYB Amazon,-2,-2,0,0,0,0
,Birkenstock Mayari NU Oiled Habana 171321 Women EU 38/US 7-7.5,Birkenstock Mayari NU Oiled Habana 171321 Women EU 38/US 7-7.5,FBALYB Amazon,-2,-2,0,0,0,0
,Birkenstock Mayari NU Oiled Habana 171321 Women EU 39/US 8-8.5,Birkenstock Mayari NU Oiled Habana 171321 Women EU 39/US 8-8.5,FBALYB Amazon,-6,-6,0,0,0,0
,Birkenstock Mayari NU Oiled Habana 171321 Women EU 40/US 9-9.5,Birkenstock Mayari NU Oiled Habana 171321 Women EU 40/US 9-9.5,FBALYB Amazon,-1,-1,0,0,0,0
,Birkenstock Mayari NU Oiled Habana 171321 Women EU 41/US 10-10.5,Birkenstock Mayari NU Oiled Habana 171321 Women EU 41/US 10-10.5,FBALYB Amazon,-1,-1,0,0,0,0
,Birkenstock Milano BF-Nubuck Mocha 634501 Men EU 44/US 11-11.5,Birkenstock Milano BF-Nubuck Mocha 634501 Men EU 44/US 11-11.5,FBALYB Amazon,2,2,0,3,0,0
,Birkenstock Milano BF-Nubuck Mocha 634501 Women EU 43/US 12-12.5,Birkenstock Milano BF-Nubuck Mocha 634501 Women EU 43/US 12-12.5,FBALYB Amazon,6,6,0,0,0,0
,Birkenstock Milano Black 34791 Men EU 44/US 11-11.5,Birkenstock Milano Black 34791 Men EU 44/US 11-11.5,Default Ridgefield,2,2,0,0,0,0
,Birkenstock Milano Black 34791 Men EU 45/US 12-12.5,Birkenstock Milano Black 34791 Men EU 45/US 12-12.5,Default Ridgefield,1,1,0,0,0,0
,Birkenstock Milano Black 34791 Men EU 46/US 13-13.5,Birkenstock Milano Black 34791 Men EU 46/US 13-13.5,Default Ridgefield,16,16,0,0,0,0
,Birkenstock Milano Dark Brown 34701 Men EU 43/US 10-10.5,Birkenstock Milano Dark Brown 34701 Men EU 43/US 10-10.5,Default Ridgefield,1,1,0,0,0,0
,Birkenstock Milano Dark Brown 34701 Men EU 46/US 13-13.5,Birkenstock Milano Dark Brown 34701 Men EU 46/US 13-13.5,Default Ridgefield,8,8,0,0,0,0
,Birkenstock Milano EVA Scuba Blue 1009355 Kids N EU 32/US 1-1.5,Birkenstock Milano EVA Scuba Blue 1009355 Kids N EU 32/US 1-1.5,Default Ridgefield,4,4,0,0,0,0
,Birkenstock Milano EVA Scuba Blue 1009355 Kids N EU 32/US 1-1.5,Birkenstock Milano EVA Scuba Blue 1009355 Kids N EU 32/US 1-1.5,FBALYB Amazon,5,5,0,0,0,0
,Birkenstock Milano EVA Scuba Blue 1009355 Kids N EU 34/US 3-3.5,Birkenstock Milano EVA Scuba Blue 1009355 Kids N EU 34/US 3-3.5,Default Ridgefield,5,5,0,0,0,0
,Birkenstock Milano EVA Scuba Blue 1009355 Kids N EU 34/US 3-3.5,Birkenstock Milano EVA Scuba Blue 1009355 Kids N EU 34/US 3-3.5,FBALYB Amazon,6,6,0,0,0,0
,Birkenstock Milano OL Habana 34871 EU 36,Birkenstock Milano OL Habana 34871 EU 36,FBALYB Amazon,24,24,0,0,0,0
,Birkenstock Milano OL Habana 34871 EU 37,Birkenstock Milano OL Habana 34871 EU 37,FBALYB Amazon,65,64,1,0,1,0
,Birkenstock Milano OL Habana 34871 EU 38,Birkenstock Milano OL Habana 34871 EU 38,Default Ridgefield,1,1,0,0,0,0
,Birkenstock Milano OL Habana 34871 EU 38,Birkenstock Milano OL Habana 34871 EU 38,FBALYB Amazon,180,180,0,0,0,0
,Birkenstock Milano OL Habana 34871 EU 39,Birkenstock Milano OL Habana 34871 EU 39,FBALYB Amazon,110,110,0,0,0,0
,Birkenstock Milano OL Habana 34871 EU 40,Birkenstock Milano OL Habana 34871 EU 40,FBALYB Amazon,77,75,2,0,2,0
,Birkenstock Milano OL Habana 34871 Men EU 44/US 11-11.5,Birkenstock Milano OL Habana 34871 Men EU 44/US 11-11.5,Default Ridgefield,54,54,0,0,0,0
,Birkenstock Milano OL Habana 34871 Men EU 44/US 11-11.5,Birkenstock Milano OL Habana 34871 Men EU 44/US 11-11.5,FBALYB Amazon,75,75,0,0,0,0
,Birkenstock Milano OL Habana 34871 Men EU 45/US 12-12.5,Birkenstock Milano OL Habana 34871 Men EU 45/US 12-12.5,FBALYB Amazon,94,94,0,0,0,0
,Birkenstock Milano OL Habana 34871 Men EU 46/US 13-13.5,Birkenstock Milano OL Habana 34871 Men EU 46/US 13-13.5,FBALYB Amazon,62,62,0,0,0,0
,Birkenstock Milano OL Habana 34871 Women EU 41/US 10-10.5,Birkenstock Milano OL Habana 34871 Women EU 41/US 10-10.5,Default Ridgefield,2,2,0,0,0,0
,Birkenstock Milano OL Habana 34871 Women EU 41/US 10-10.5,Birkenstock Milano OL Habana 34871 Women EU 41/US 10-10.5,FBALYB Amazon,64,60,4,0,4,0
,Birkenstock Milano OL Habana 34871 Women EU 42/US 11-11.5,Birkenstock Milano OL Habana 34871 Women EU 42/US 11-11.5,Default Ridgefield,72,72,0,0,0,0
,Birkenstock Milano OL Habana 34871 Women EU 42/US 11-11.5,Birkenstock Milano OL Habana 34871 Women EU 42/US 11-11.5,FBALYB Amazon,10,9,1,0,1,0
,Birkenstock Milano OL Habana 34871 Women EU 43/US 12-12.5,Birkenstock Milano OL Habana 34871 Women EU 43/US 12-12.5,FBALYB Amazon,17,17,0,0,0,0
,Birkenstock Profi Birki PU Black 74011 Men EU 44/US 11-11.5,Birkenstock Profi Birki PU Black 74011 Men EU 44/US 11-11.5,Default Ridgefield,3,3,0,0,0,0
,Birkenstock Profi Birki PU Black 74011 Men EU 44/US 11-11.5,Birkenstock Profi Birki PU Black 74011 Men EU 44/US 11-11.5,FBALYB Amazon,81,76,5,0,5,0
,Birkenstock Profi Birki PU Black 74011 Men EU 45/US 12-12.5,Birkenstock Profi Birki PU Black 74011 Men EU 45/US 12-12.5,FBALYB Amazon,10,10,0,0,0,0
,Birkenstock Profi Birki PU Black 74011 Women EU 40/US 9-9.5,Birkenstock Profi Birki PU Black 74011 Women EU 40/US 9-9.5,FBALYB Amazon,-4,-4,0,0,0,0
,Birkenstock Profi Birki PU Black 74011 Women EU 41/US 10-10.5,Birkenstock Profi Birki PU Black 74011 Women EU 41/US 10-10.5,FBALYB Amazon,1,1,0,1,0,0
,Birkenstock Profi Birki PU Black 74011 Women EU 42/US 11-11.5,Birkenstock Profi Birki PU Black 74011 Women EU 42/US 11-11.5,FBALYB Amazon,14,14,0,0,0,0
,Birkenstock Profi Birki PU Black 74011 Women EU 43/US 12-12.5,Birkenstock Profi Birki PU Black 74011 Women EU 43/US 12-12.5,Default Ridgefield,1,1,0,0,0,0
,Birkenstock Profi Birki PU Black 74011 Women EU 43/US 12-12.5,Birkenstock Profi Birki PU Black 74011 Women EU 43/US 12-12.5,FBALYB Amazon,-5,-5,0,0,0,0
,Birkenstock Rio Kids EVA Beetroot Purple 1015463 N EU 32/US 1-1.5,Birkenstock Rio Kids EVA Beetroot Purple 1015463 N EU 32/US 1-1.5,Default Ridgefield,4,4,0,0,0,0
,Birkenstock Rio Kids EVA Beetroot Purple 1015463 N EU 33/US 2-2.5,Birkenstock Rio Kids EVA Beetroot Purple 1015463 N EU 33/US 2-2.5,Default Ridgefield,6,6,0,0,0,0
,Birkenstock Rio Kids EVA Beetroot Purple 1015463 N EU 34/US 3-3.5,Birkenstock Rio Kids EVA Beetroot Purple 1015463 N EU 34/US 3-3.5,Default Ridgefield,12,12,0,0,0,0
,Birkenstock Rio Kids EVA Beetroot Purple 1015463 N EU 34/US 3-3.5,Birkenstock Rio Kids EVA Beetroot Purple 1015463 N EU 34/US 3-3.5,FBALYB Amazon,0,0,0,6,0,0
,Bisquick Pancake Mix 80 oz,Bisquick Pancake Mix 80 oz,FBALYB Amazon,5,5,0,0,0,0
,Bissell Lift-Off Upright Vacuum 2087,"Bissell Pet Hair Eraser Lift-Off Upright Vacuum, Multicolor - 2087",Default,0,0,0,0,0,2
,Bissell Pet Hair Eraser Upright Vacuum 1650W Green,Bissell Pet Hair Eraser Upright Vacuum 1650W Green,FBALYB Amazon,-3,-3,0,3,0,0
,Bissell Proheat 1986,Bissell Proheat 1986,FBALYB Amazon,-6,-6,0,6,0,0
,BISSELL ProHeat 2X Revolution Upright Deep Cleaner (1548),BISSELL ProHeat 2X Revolution Upright Deep Cleaner (1548),Default,0,0,0,0,0,1
,BISSELL ProHeat 2X Revolution Upright Deep Cleaner (1548),BISSELL ProHeat 2X Revolution Upright Deep Cleaner (1548),FBALYB Amazon,0,0,0,1,0,0
,B+J Loperamide Caps 96ct 2ct,B+J Loperamide Caps 96ct 2ct,Default,1,1,0,0,0,0
,B+J Loperamide Caps 96ct 2ct,B+J Loperamide Caps 96ct 2ct,FBALYB Amazon,-356,-356,0,58,0,0
,B+J LOPERAMIDE  CAPS 96CT 2PK,B+J LOPERAMIDE  CAPS 96CT 2PK,FBALYB Amazon,359,359,0,0,0,0
,Bl451,Nutri Ninja Pro,FBALYB Amazon,-1,-1,0,8,0,0
,Bl451,Nutri Ninja Pro,FBASKCK Amazon,100,100,0,0,0,0
,Bl482,Nutri Ninja Auto iQ (BL482),Default,1,1,0,0,0,0
,Bl482,Nutri Ninja Auto iQ (BL482),FBALYB Amazon,-6,-6,0,0,0,0
,"Black Forest Gummy Bears, 6 lbs","Black Forest Gummy Bears, 6 lbs",FBALYB Amazon,9,9,0,0,0,0
,Black/Grey Go walk Slip on 6,Black/Grey Go walk Slip on 6,Default,1,1,0,0,0,0
,Black/Grey Go walk Slip on 6,Black/Grey Go walk Slip on 6,FBALYB Amazon,-4,-5,1,0,1,0
,Black/Grey Go walk Slip on 6.5,Black/Grey Go walk Slip on 6.5,Default,2,1,1,0,0,0
,Black/Grey Go walk Slip on 6.5,Black/Grey Go walk Slip on 6.5,FBALYB Amazon,-2,-4,2,0,2,0
,Black/Grey Go walk Slip on 7,Black/Grey Go walk Slip on 7,Default,1,1,0,0,0,0
,Black/Grey Go walk Slip on 7,Black/Grey Go walk Slip on 7,FBALYB Amazon,-2,-2,0,0,0,0
,Black/Grey Go walk Slip on 7.5,Black/Grey Go walk Slip on 7.5,FBALYB Amazon,-2,-2,0,0,0,0
,Black/Grey Go walk Slip on 8,Black/Grey Go walk Slip on 8,Default,1,1,0,0,0,0
,Black/Grey Go walk Slip on 8,Black/Grey Go walk Slip on 8,FBALYB Amazon,-1,-1,0,0,0,0
,Black/Grey Go walk Slip on 8.5,Black/Grey Go walk Slip on 8.5,FBALYB Amazon,0,0,0,1,0,0
,Black/Grey Go walk Slip on 9,Black/Grey Go walk Slip on 9,FBALYB Amazon,-1,-1,0,0,0,0
,Black Hockey Tape 1inch 4pk,Black Hockey Tape 1inch 4pk,FBALYB Amazon,1,0,1,0,1,0
,Black Hockey Tape 6 Pack,Black Hockey Tape 6 Pack,Default,0,-171,171,0,0,0
,Black Hockey Tape 6 Pack,Black Hockey Tape 6 Pack,Default Ridgefield,250,248,2,0,0,0
,Black Hockey Tape 6 Pack,Black Hockey Tape 6 Pack,FBALYB Amazon,301,301,0,0,0,0
,Blender Bottle 2pk Grey/Green,Blender Bottle 2pk Grey/Green,FBALYB Amazon,-2,-4,2,0,2,0
,Blender Bottle 2pk Red/Black,Blender Bottle 2pk Red/Black,FBALYB Amazon,1,1,0,0,0,0
,Ble Ornmt Japanese Torii Gate,Ble Ornmt Japanese Torii Gate,FBALYB Amazon,-1,-1,0,0,0,0
,Blistex 11 Pieces,Blistex Lip Balm + Medicated Lip Ointment / 11 Pieces,FBALYB Amazon,3,3,0,0,0,0
,Blistex Berry-Baies,Blistex Berry-Baies,Avrami - Ebay,12,12,0,0,0,0
,Blistex Berry-Baies,Blistex Berry-Baies,Default Ridgefield,13,13,0,0,0,0
,Blistex Lip Balm 6 Flavors,Blistex Lip Balm 6 Flavors,Default Ridgefield,77,77,0,0,0,0
,Blistex Lip Balm 6 Flavors,Blistex Lip Balm 6 Flavors,FBALYB Amazon,278,278,0,0,0,0
,Blistex Lip Balm 6 Flavors,Blistex Lip Balm 6 Flavors,WFS,-7,-7,0,0,0,0
,Blistex Lip Medex,Blistex Lip Medex,Avrami - Ebay,12,12,0,0,0,0
,Blistex Lip Medex,Blistex Lip Medex,Default Ridgefield,697,697,0,0,0,0
,Blistex Medicated Lip Ointment,Blistex Medicated Lip Ointment,Avrami - Ebay,12,12,0,0,0,0
,Blistex Medicated Lip Ointment,Blistex Medicated Lip Ointment,Default Ridgefield,13,13,0,0,0,0
,Blistex Mint-Menthe,Blistex Mint-Menthe,Avrami - Ebay,12,12,0,0,0,0
,Blistex Mint-Menthe,Blistex Mint-Menthe,Default Ridgefield,13,13,0,0,0,0
,Blistex Mint-Menthe 12pk,Blistex Mint-Menthe 12pk,FBALYB Amazon,-1,-1,0,0,0,0
,Blistex Regular-Ordinaire,Blistex Regular-Ordinaire,Avrami - Ebay,12,12,0,0,0,0
,Blistex Regular-Ordinaire,Blistex Regular-Ordinaire,Default Ridgefield,25,25,0,0,0,0
,Blistex Regular-Ordinaire 24pk,Blistex Regular-Ordinaire 24pk,FBALYB Amazon,-1,-1,0,0,0,0
,Blistex Ultra Protection,Blistex Ultra Protection,Avrami - Ebay,12,12,0,0,0,0
,Blistex Ultra Protection,Blistex Ultra Protection,Default Ridgefield,497,497,0,0,0,0
,Blistex Ultra Protection,Blistex Ultra Protection,FBALYB Amazon,-1,-1,0,0,0,0
,BlondeLife Shampoo&Conditioner 33 oz,BlondeLife Shampoo&Conditioner 33 oz,FBALYB Amazon,-5,-5,0,0,0,0
,BlowPro Blow Out Hair Spray 10oz,BlowPro Blow Out Hair Spray 10oz,FBALYB Amazon,1,1,0,0,0,0
,Blue and red Toothpaste squeezer 2 ct,Blue and red Toothpaste squeezer 2 ct,FBAAP Amazon,4,4,0,0,0,0
,Blue and red Toothpaste squeezer 2 ct,Blue and red Toothpaste squeezer 2 ct,FBALYB Amazon,88,86,2,4,2,0
,Blue and red Toothpaste squeezer 4 ct,Blue and red Toothpaste squeezer 4 ct,FBALYB Amazon,0,0,0,1,0,0
,Blue Diamond Almonds 32 CT,Blue Diamond Almonds 32 CT,Default,0,0,0,0,0,30
,Blue Diamond Almonds 32 CT,Blue Diamond Almonds 32 CT,FBALYB Amazon,17,17,0,0,0,0
,Blue Diamond Smokehouse Almonds 45 OZ,Blue Diamond Smokehouse Almonds 45 OZ,FBALYB Amazon,1,1,0,0,0,0
,Blue Jean Signature Jar Candle,Blue Jean Signature Jar Candle,FBALYB Amazon,4,4,0,0,0,0
,Blue Jean Watercolor Jar Candle,Blue Jean Watercolor Jar Candle ,Avrami - Ebay,8,8,0,0,0,0
,Blue Jean Watercolor Jar Candle,Blue Jean Watercolor Jar Candle ,Default,0,-300,300,0,0,0
,Blue Jean Watercolor Jar Candle,Blue Jean Watercolor Jar Candle ,Default Ridgefield,35,35,0,0,0,0
,Blue Naturally Fresh Kitten Litter 14lb,Blue Naturally Fresh Kitten Litter 14lb,FBALYB Amazon,1,1,0,0,0,0
,Blue Packing Cubes Set + vacuum pack bag,Blue Packing Cubes Set + vacuum pack bag,FBALYB Amazon,-1,-1,0,0,0,0
,"Blue Ribbon 3"" Fish Net","Blue Ribbon 3"" Easy Catch Fish Net",Default,0,-115056,115056,0,0,0
,"Blue Ribbon 3"" Fish Net","Blue Ribbon 3"" Easy Catch Fish Net",FBAAP Amazon,0,-1,1,0,0,0
,"Blue Ribbon 3"" Fish Net","Blue Ribbon 3"" Easy Catch Fish Net",FBALYB Amazon,220,220,0,16,0,0
,"Blue Ribbon 3"" Fish Net 2pk","Blue Ribbon 3"" Fish Net 2pk",FBALYB Amazon,2,2,0,0,0,0
,Blue Rotating Toothpaste squeezer,Blue Rotating Toothpaste squeezer,Default,0,-1003,1003,0,0,0
,Blue Rotating Toothpaste squeezer,Blue Rotating Toothpaste squeezer,Default Ridgefield,0,-200,200,0,0,0
,BluMaan Cavalier 2.5oz,BluMaan Cavalier 2.5oz,Default,0,-2,2,0,0,0
,BluMaan Cavalier 2.5oz,BluMaan Cavalier 2.5oz,Default Oxford,0,-2,2,0,0,0
,BluMaan Cavalier 2.5oz,BluMaan Cavalier 2.5oz,Default Ridgefield,0,-22,22,0,0,0
,BluMaan Cavalier 2.5oz,BluMaan Cavalier 2.5oz,FBALYB Amazon,-10,-20,10,3,10,0
,BluMaan Fifth Sample 3.7oz,BluMaan Fifth Sample 3.7oz,Avrami - Ebay,100,100,0,0,0,0
,BluMaan Fifth Sample 3.7oz,BluMaan Fifth Sample 3.7oz,FBALYB Amazon,126,124,2,0,2,0
,BluMaan Fifth Sample 3.7oz,BluMaan Fifth Sample 3.7oz,WFS,-87,-87,0,0,0,0
,BluMaan Meraki 2.5oz,BluMaan Meraki 2.5oz,Avrami - Ebay,2,2,0,0,0,0
,BluMaan Meraki 2.5oz,BluMaan Meraki 2.5oz,FBALYB Amazon,-6,-12,6,1,6,0
,BluMaan Monarch 2.5oz,BluMaan Monarch 2.5oz,Avrami - Ebay,5,5,0,0,0,0
,BluMaan Monarch 2.5oz,BluMaan Monarch 2.5oz,FBALYB Amazon,-10,-10,0,1,0,0
,Blundstone Rustic 1306 size 6,Blundstone Rustic 1306 size 6,FBALYB Amazon,-1,-1,0,0,0,0
,Blundstone STYLE # 062 TPU - Dress Boot - Premium Leather 5.5,Blundstone STYLE # 062 TPU - Dress Boot - Premium Leather 5.5,FBALYB Amazon,-1,-1,0,0,0,0
,Blundstone STYLE # 062 TPU - Dress Boot - Premium Leather 6,Blundstone STYLE # 062 TPU - Dress Boot - Premium Leather 6,FBALYB Amazon,-3,-3,0,0,0,0
,Blundstone STYLE # 062 TPU - Dress Boot - Premium Leather 6.5,Blundstone STYLE # 062 TPU - Dress Boot - Premium Leather 6.5,FBALYB Amazon,-3,-3,0,0,0,0
,Blundstone STYLE # 062 TPU - Dress Boot - Premium Leather 7,Blundstone STYLE # 062 TPU - Dress Boot - Premium Leather 7,FBALYB Amazon,-3,-3,0,0,0,0
,Blundstone STYLE # 062 TPU - Dress Boot - Premium Leather 7.5,Blundstone STYLE # 062 TPU - Dress Boot - Premium Leather 7.5,FBALYB Amazon,-1,-1,0,0,0,0
,Blundstone STYLE # 062 TPU - Dress Boot - Premium Leather 8,Blundstone STYLE # 062 TPU - Dress Boot - Premium Leather 8,FBALYB Amazon,-2,-2,0,0,0,0
,Blundstone STYLE # 062 TPU - Dress Boot - Premium Leather 9,Blundstone STYLE # 062 TPU - Dress Boot - Premium Leather 9,FBALYB Amazon,-2,-2,0,0,0,0
,Blundstone STYLE # 063 TUP - Dress Boot - Premium Leather 10,Blundstone STYLE # 063 TUP - Dress Boot - Premium Leather 10,FBALYB Amazon,-10,-11,1,0,1,0
,Blundstone STYLE # 063 TUP - Dress Boot - Premium Leather 10.5,Blundstone STYLE # 063 TUP - Dress Boot - Premium Leather 10.5,FBALYB Amazon,25,25,0,0,0,0
,Blundstone STYLE # 063 TUP - Dress Boot - Premium Leather 11,Blundstone STYLE # 063 TUP - Dress Boot - Premium Leather 11,Default Oxford,5,5,0,0,0,0
,Blundstone STYLE # 063 TUP - Dress Boot - Premium Leather 11,Blundstone STYLE # 063 TUP - Dress Boot - Premium Leather 11,FBALYB Amazon,42,42,0,2,0,0
,Blundstone STYLE # 063 TUP - Dress Boot - Premium Leather 12,Blundstone STYLE # 063 TUP - Dress Boot - Premium Leather 12,FBALYB Amazon,48,48,0,0,0,0
,Blundstone STYLE # 063 TUP - Dress Boot - Premium Leather 4,Blundstone STYLE # 063 TUP - Dress Boot - Premium Leather 4,Default Ridgefield,5,5,0,0,0,0
,Blundstone STYLE # 063 TUP - Dress Boot - Premium Leather 4,Blundstone STYLE # 063 TUP - Dress Boot - Premium Leather 4,FBALYB Amazon,5,5,0,0,0,0
,Blundstone STYLE # 063 TUP - Dress Boot - Premium Leather 4.5,Blundstone STYLE # 063 TUP - Dress Boot - Premium Leather 4.5,FBALYB Amazon,-8,-8,0,0,0,0
,Blundstone STYLE # 063 TUP - Dress Boot - Premium Leather 5,Blundstone STYLE # 063 TUP - Dress Boot - Premium Leather 5,FBALYB Amazon,-10,-10,0,0,0,0
,Blundstone STYLE # 063 TUP - Dress Boot - Premium Leather 5.5,Blundstone STYLE # 063 TUP - Dress Boot - Premium Leather 5.5,Default Ridgefield,1,1,0,0,0,0
,Blundstone STYLE # 063 TUP - Dress Boot - Premium Leather 5.5,Blundstone STYLE # 063 TUP - Dress Boot - Premium Leather 5.5,FBALYB Amazon,-8,-8,0,0,0,0
,Blundstone STYLE # 063 TUP - Dress Boot - Premium Leather 6,Blundstone STYLE # 063 TUP - Dress Boot - Premium Leather 6,Default Ridgefield,8,8,0,0,0,0
,Blundstone STYLE # 063 TUP - Dress Boot - Premium Leather 6,Blundstone STYLE # 063 TUP - Dress Boot - Premium Leather 6,FBALYB Amazon,-1,-1,0,0,0,0
,Blundstone STYLE # 063 TUP - Dress Boot - Premium Leather 6.5,Blundstone STYLE # 063 TUP - Dress Boot - Premium Leather 6.5,FBALYB Amazon,-7,-7,0,0,0,0
,Blundstone STYLE # 063 TUP - Dress Boot - Premium Leather 7,Blundstone STYLE # 063 TUP - Dress Boot - Premium Leather 7,Default Ridgefield,51,51,0,0,0,0
,Blundstone STYLE # 063 TUP - Dress Boot - Premium Leather 7,Blundstone STYLE # 063 TUP - Dress Boot - Premium Leather 7,FBALYB Amazon,-9,-9,0,0,0,0
,Blundstone STYLE # 063 TUP - Dress Boot - Premium Leather 7.5,Blundstone STYLE # 063 TUP - Dress Boot - Premium Leather 7.5,FBALYB Amazon,26,26,0,0,0,0
,Blundstone STYLE # 063 TUP - Dress Boot - Premium Leather 8,Blundstone STYLE # 063 TUP - Dress Boot - Premium Leather 8,FBALYB Amazon,-13,-13,0,0,0,0
,Blundstone STYLE # 063 TUP - Dress Boot - Premium Leather 8.5,Blundstone STYLE # 063 TUP - Dress Boot - Premium Leather 8.5,FBALYB Amazon,-6,-6,0,0,0,0
,Blundstone STYLE # 063 TUP - Dress Boot - Premium Leather 9,Blundstone STYLE # 063 TUP - Dress Boot - Premium Leather 9,Default Ridgefield,2,2,0,0,0,0
,Blundstone STYLE # 063 TUP - Dress Boot - Premium Leather 9,Blundstone STYLE # 063 TUP - Dress Boot - Premium Leather 9,FBALYB Amazon,1,1,0,0,0,0
,Blundstone STYLE # 063 TUP - Dress Boot - Premium Leather 9.5,Blundstone STYLE # 063 TUP - Dress Boot - Premium Leather 9.5,FBALYB Amazon,11,11,0,0,0,0
,Blundstone STYLE #: 1306 PU/TPU - Elastic Sided - Dress 10,Blundstone STYLE #: 1306 PU/TPU - Elastic Sided - Dress 10,FBALYB Amazon,-5,-5,0,0,0,0
,Blundstone STYLE #: 1306 PU/TPU - Elastic Sided - Dress 10.5,Blundstone STYLE #: 1306 PU/TPU - Elastic Sided - Dress 10.5,FBALYB Amazon,15,15,0,4,0,0
,Blundstone STYLE #: 1306 PU/TPU - Elastic Sided - Dress 11,Blundstone STYLE #: 1306 PU/TPU - Elastic Sided - Dress 11,Default Ridgefield,51,51,0,0,0,0
,Blundstone STYLE #: 1306 PU/TPU - Elastic Sided - Dress 11,Blundstone STYLE #: 1306 PU/TPU - Elastic Sided - Dress 11,FBALYB Amazon,-2,-2,0,0,0,0
,Blundstone STYLE #: 1306 PU/TPU - Elastic Sided - Dress 12,Blundstone STYLE #: 1306 PU/TPU - Elastic Sided - Dress 12,FBALYB Amazon,32,32,0,0,0,0
,Blundstone STYLE #: 1306 PU/TPU - Elastic Sided - Dress 4,Blundstone STYLE #: 1306 PU/TPU - Elastic Sided - Dress 4,FBALYB Amazon,-6,-6,0,0,0,0
,Blundstone STYLE #: 1306 PU/TPU - Elastic Sided - Dress 4.5,Blundstone STYLE #: 1306 PU/TPU - Elastic Sided - Dress 4.5,FBALYB Amazon,-3,-3,0,1,0,0
,Blundstone STYLE #: 1306 PU/TPU - Elastic Sided - Dress 5,Blundstone STYLE #: 1306 PU/TPU - Elastic Sided - Dress 5,FBALYB Amazon,-3,-3,0,0,0,0
,Blundstone STYLE #: 1306 PU/TPU - Elastic Sided - Dress 5.5,Blundstone STYLE #: 1306 PU/TPU - Elastic Sided - Dress 5.5,Default Ridgefield,1,1,0,0,0,0
,Blundstone STYLE #: 1306 PU/TPU - Elastic Sided - Dress 5.5,Blundstone STYLE #: 1306 PU/TPU - Elastic Sided - Dress 5.5,FBALYB Amazon,-8,-8,0,0,0,0
,Blundstone STYLE #: 1306 PU/TPU - Elastic Sided - Dress 6,Blundstone STYLE #: 1306 PU/TPU - Elastic Sided - Dress 6,Default Oxford,4,4,0,0,0,0
,Blundstone STYLE #: 1306 PU/TPU - Elastic Sided - Dress 6,Blundstone STYLE #: 1306 PU/TPU - Elastic Sided - Dress 6,Default Ridgefield,1,1,0,0,0,0
,Blundstone STYLE #: 1306 PU/TPU - Elastic Sided - Dress 6,Blundstone STYLE #: 1306 PU/TPU - Elastic Sided - Dress 6,FBALYB Amazon,-12,-12,0,0,0,0
,Blundstone STYLE #: 1306 PU/TPU - Elastic Sided - Dress 6.5,Blundstone STYLE #: 1306 PU/TPU - Elastic Sided - Dress 6.5,Default Ridgefield,1,1,0,0,0,0
,Blundstone STYLE #: 1306 PU/TPU - Elastic Sided - Dress 6.5,Blundstone STYLE #: 1306 PU/TPU - Elastic Sided - Dress 6.5,FBALYB Amazon,-5,-5,0,1,0,0
,Blundstone STYLE #: 1306 PU/TPU - Elastic Sided - Dress 7,Blundstone STYLE #: 1306 PU/TPU - Elastic Sided - Dress 7,FBALYB Amazon,-9,-9,0,0,0,0
,Blundstone STYLE #: 1306 PU/TPU - Elastic Sided - Dress 7.5,Blundstone STYLE #: 1306 PU/TPU - Elastic Sided - Dress 7.5,FBALYB Amazon,26,24,2,0,2,0
,Blundstone STYLE #: 1306 PU/TPU - Elastic Sided - Dress 8,Blundstone STYLE #: 1306 PU/TPU - Elastic Sided - Dress 8,Default Ridgefield,1,1,0,0,0,0
,Blundstone STYLE #: 1306 PU/TPU - Elastic Sided - Dress 8,Blundstone STYLE #: 1306 PU/TPU - Elastic Sided - Dress 8,FBALYB Amazon,-46,-47,1,42,1,0
,Blundstone STYLE #: 1306 PU/TPU - Elastic Sided - Dress 8.5,Blundstone STYLE #: 1306 PU/TPU - Elastic Sided - Dress 8.5,Default Ridgefield,18,18,0,0,0,0
,Blundstone STYLE #: 1306 PU/TPU - Elastic Sided - Dress 8.5,Blundstone STYLE #: 1306 PU/TPU - Elastic Sided - Dress 8.5,FBALYB Amazon,17,17,0,0,0,0
,Blundstone STYLE #: 1306 PU/TPU - Elastic Sided - Dress 9,Blundstone STYLE #: 1306 PU/TPU - Elastic Sided - Dress 9,FBALYB Amazon,-4,-4,0,0,0,0
,Blundstone STYLE #: 1306 PU/TPU - Elastic Sided - Dress 9.5,Blundstone STYLE #: 1306 PU/TPU - Elastic Sided - Dress 9.5,FBALYB Amazon,-7,-7,0,0,0,0
,Blundstone STYLE #: 1308 PU/TPU - Elastic Sided Dress 10,Bundstone STYLE #: 1308 PU/TPU - Elastic Sided Dress 10,Default Oxford,5,5,0,0,0,0
,Blundstone STYLE #: 1308 PU/TPU - Elastic Sided Dress 10,Bundstone STYLE #: 1308 PU/TPU - Elastic Sided Dress 10,FBALYB Amazon,-6,-7,1,0,1,0
,Blundstone STYLE #: 1308 PU/TPU - Elastic Sided Dress 10.5,Blundstone STYLE #: 1308 PU/TPU - Elastic Sided Dress 10.5,FBALYB Amazon,7,7,0,0,0,0
,Blundstone STYLE #: 1308 PU/TPU - Elastic Sided Dress 11,Blundstone STYLE #: 1308 PU/TPU - Elastic Sided Dress 11,FBALYB Amazon,6,6,0,0,0,0
,Blundstone STYLE #: 1308 PU/TPU - Elastic Sided Dress 4,Bundstone STYLE #: 1308 PU/TPU - Elastic Sided Dress 4,Default Oxford,5,5,0,0,0,0
,Blundstone STYLE #: 1308 PU/TPU - Elastic Sided Dress 5l,Bundstone STYLE #: 1308 PU/TPU - Elastic Sided Dress 5,Default Oxford,5,5,0,0,0,0
,Blundstone STYLE #: 1308 PU/TPU - Elastic Sided Dress 6,Bundstone STYLE #: 1308 PU/TPU - Elastic Sided Dress 6,FBALYB Amazon,-1,-1,0,0,0,0
,Blundstone STYLE #: 1308 PU/TPU - Elastic Sided Dress 6.5,Blundstone STYLE #: 1308 PU/TPU - Elastic Sided Dress 6.5,FBALYB Amazon,-1,-1,0,0,0,0
,Blundstone STYLE #: 1308 PU/TPU - Elastic Sided Dress 7,Bundstone STYLE #: 1308 PU/TPU - Elastic Sided Dress 7,Default Ridgefield,10,10,0,0,0,0
,Blundstone STYLE #: 1308 PU/TPU - Elastic Sided Dress 7,Bundstone STYLE #: 1308 PU/TPU - Elastic Sided Dress 7,FBALYB Amazon,10,10,0,0,0,0
,Blundstone STYLE #: 1308 PU/TPU - Elastic Sided Dress 7.5,Blundstone STYLE #: 1308 PU/TPU - Elastic Sided Dress 7.5,FBALYB Amazon,14,14,0,0,0,0
,Blundstone STYLE #: 1308 PU/TPU - Elastic Sided Dress 8,Bundstone STYLE #: 1308 PU/TPU - Elastic Sided Dress 8,Default Oxford,4,4,0,0,0,0
,Blundstone STYLE #: 1308 PU/TPU - Elastic Sided Dress 8,Bundstone STYLE #: 1308 PU/TPU - Elastic Sided Dress 8,Default Ridgefield,1,1,0,0,0,0
,Blundstone STYLE #: 1308 PU/TPU - Elastic Sided Dress 8,Bundstone STYLE #: 1308 PU/TPU - Elastic Sided Dress 8,FBALYB Amazon,-3,-3,0,0,0,0
,Blundstone STYLE #: 1308 PU/TPU - Elastic Sided Dress 8.5,Blundstone STYLE #: 1308 PU/TPU - Elastic Sided Dress 8.5,FBALYB Amazon,-1,-1,0,0,0,0
,Blundstone STYLE #: 1308 PU/TPU - Elastic Sided Dress 9,Bundstone STYLE #: 1308 PU/TPU - Elastic Sided Dress 9,Default Ridgefield,1,1,0,0,0,0
,Blundstone STYLE #: 1308 PU/TPU - Elastic Sided Dress 9,Bundstone STYLE #: 1308 PU/TPU - Elastic Sided Dress 9,FBALYB Amazon,-5,-5,0,0,0,0
,Blundstone STYLE #: 1308 PU/TPU - Elastic Sided Dress 9.5,Blundstone STYLE #: 1308 PU/TPU - Elastic Sided Dress 9.5,FBALYB Amazon,-3,-3,0,0,0,0
,Blundstone STYLE #: 1309 PU/TPU Elastic Sided V Cut 6,Blundstone STYLE #: 1309 PU/TPU Elastic Sided V Cut 6,FBALYB Amazon,-1,-1,0,0,0,0
,Blundstone STYLE #: 1309 PU/TPU Elastic Sided V Cut 7,Blundstone STYLE #: 1309 PU/TPU Elastic Sided V Cut 7,Default Ridgefield,5,5,0,0,0,0
,Blundstone STYLE #: 1309 PU/TPU Elastic Sided V Cut 8,Blundstone STYLE #: 1309 PU/TPU Elastic Sided V Cut 8,Default Ridgefield,1,1,0,0,0,0
,Blundstone STYLE #: 1309 PU/TPU Elastic Sided V Cut 8,Blundstone STYLE #: 1309 PU/TPU Elastic Sided V Cut 8,FBALYB Amazon,1,1,0,0,0,0
,Blundstone STYLE #: 1309 PU/TPU Elastic Sided V Cut 8.5,Blundstone STYLE #: 1309 PU/TPU Elastic Sided V Cut 8.5,Default Ridgefield,1,1,0,0,0,0
,Blundstone STYLE #: 1309 PU/TPU Elastic Sided V Cut 8.5,Blundstone STYLE #: 1309 PU/TPU Elastic Sided V Cut 8.5,FBALYB Amazon,2,2,0,0,0,0
,Blundstone STYLE #: 1309 PU/TPU Elastic Sided V Cut 9,Blundstone STYLE #: 1309 PU/TPU Elastic Sided V Cut 9,FBALYB Amazon,-1,-1,0,0,0,0
,Blundstone STYLE #: 1351 PU/TPU Elastic Sided V Cut 4,Blundstone STYLE #: 1351 PU/TPU Elastic Sided V Cut 4,FBALYB Amazon,-3,-3,0,0,0,0
,Blundstone STYLE #: 1351 PU/TPU Elastic Sided V Cut 5.5,Blundstone STYLE #: 1351 PU/TPU Elastic Sided V Cut 5.5,FBALYB Amazon,-1,-1,0,0,0,0
,Blundstone STYLE #: 1351 PU/TPU Elastic Sided V Cut 6,Blundstone STYLE #: 1351 PU/TPU Elastic Sided V Cut 6,FBALYB Amazon,-2,-2,0,0,0,0
,Blundstone STYLE #: 1351 PU/TPU Elastic Sided V Cut 7.5,Blundstone STYLE #: 1351 PU/TPU Elastic Sided V Cut 7.5,FBALYB Amazon,-1,-1,0,0,0,0
,Blundstone STYLE #: 1448 PU/TPU Elastic Sided Womens 4.5,Blundstone STYLE #: 1448 PU/TPU Elastic Sided Womens 4.5,FBALYB Amazon,-1,-1,0,0,0,0
,Blundstone STYLE #: 1448 PU/TPU Elastic Sided Womens 5.5,Blundstone STYLE #: 1448 PU/TPU Elastic Sided Womens 5.5,FBALYB Amazon,-1,-1,0,0,0,0
,Blundstone STYLE #: 1448 PU/TPU Elastic Sided Womens 6.5,Blundstone STYLE #: 1448 PU/TPU Elastic Sided Womens 6.5,FBALYB Amazon,-2,-2,0,0,0,0
,Blundstone STYLE #: 1448 PU/TPU Elastic Sided Womens 7,Blundstone STYLE #: 1448 PU/TPU Elastic Sided Womens 7,FBALYB Amazon,-1,-1,0,0,0,0
,Blundstone STYLE #: 1609 Chelsea Boots Antique Brown 10,Blundstone STYLE #: 1609 Chelsea Boots Antique Brown 10,Default Ridgefield,1,1,0,0,0,0
,Blundstone STYLE #: 1609 Chelsea Boots Antique Brown 10,Blundstone STYLE #: 1609 Chelsea Boots Antique Brown 10,FBALYB Amazon,10,10,0,2,0,0
,Blundstone STYLE #: 1609 Chelsea Boots Antique Brown 10.5,Blundstone STYLE #: 1609 Chelsea Boots Antique Brown 10.5,FBALYB Amazon,14,14,0,0,0,0
,Blundstone STYLE #: 1609 Chelsea Boots Antique Brown 11,Blundstone STYLE #: 1609 Chelsea Boots Antique Brown 11,Default Ridgefield,1,1,0,0,0,0
,Blundstone STYLE #: 1609 Chelsea Boots Antique Brown 11,Blundstone STYLE #: 1609 Chelsea Boots Antique Brown 11,FBALYB Amazon,14,13,1,0,1,0
,Blundstone STYLE #: 1609 Chelsea Boots Antique Brown 7,Blundstone STYLE #: 1609 Chelsea Boots Antique Brown 7,FBALYB Amazon,10,10,0,0,0,0
,Blundstone STYLE #: 1609 Chelsea Boots Antique Brown 7.5,Blundstone STYLE #: 1609 Chelsea Boots Antique Brown 7.5,FBALYB Amazon,8,8,0,0,0,0
,Blundstone STYLE #: 1609 Chelsea Boots Antique Brown 9,Blundstone STYLE #: 1609 Chelsea Boots Antique Brown 9,Default Ridgefield,1,1,0,0,0,0
,Blundstone STYLE #: 1609 Chelsea Boots Antique Brown 9.5,Blundstone STYLE #: 1609 Chelsea Boots Antique Brown 9.5,FBALYB Amazon,4,4,0,0,0,0
,Blundstone STYLE #: 1630 PU/TPU Elastic Sided Womens 4.5,Blundstone STYLE #: 1630 PU/TPU Elastic Sided Womens 4.5,Default Ridgefield,2,2,0,0,0,0
,Blundstone STYLE #: 1630 PU/TPU Elastic Sided Womens 6.5,Blundstone STYLE #: 1630 PU/TPU Elastic Sided Womens 6.5,Default Ridgefield,1,1,0,0,0,0
,Blundstone STYLE #: 1630 PU/TPU Elastic Sided Womens 6.5,Blundstone STYLE #: 1630 PU/TPU Elastic Sided Womens 6.5,FBALYB Amazon,-3,-3,0,0,0,0
,Blundstone STYLE #: 500 PU/TPU Elastic Sided V Cut 10,Blundstone STYLE #: 500 PU/TPU Elastic Sided V Cut 10,FBALYB Amazon,-19,-19,0,37,0,0
,Blundstone STYLE #: 500 PU/TPU Elastic Sided V Cut 10.5,Blundstone STYLE #: 500 PU/TPU Elastic Sided V Cut 10.5,FBALYB Amazon,25,25,0,0,0,0
,Blundstone STYLE #: 500 PU/TPU Elastic Sided V Cut 11,Blundstone STYLE #: 500 PU/TPU Elastic Sided V Cut 11,FBALYB Amazon,-7,-7,0,36,0,0
,Blundstone STYLE #: 500 PU/TPU Elastic Sided V Cut 12,Blundstone STYLE #: 500 PU/TPU Elastic Sided V Cut 12,FBALYB Amazon,22,22,0,0,0,0
,Blundstone STYLE #: 500 PU/TPU Elastic Sided V Cut 6,Blundstone STYLE #: 500 PU/TPU Elastic Sided V Cut 6,FBALYB Amazon,-10,-10,0,0,0,0
,Blundstone STYLE #: 500 PU/TPU Elastic Sided V Cut 6.5,Blundstone STYLE #: 500 PU/TPU Elastic Sided V Cut 6.5,Default Ridgefield,1,1,0,0,0,0
,Blundstone STYLE #: 500 PU/TPU Elastic Sided V Cut 6.5,Blundstone STYLE #: 500 PU/TPU Elastic Sided V Cut 6.5,FBALYB Amazon,70,70,0,0,0,0
,Blundstone STYLE #: 500 PU/TPU Elastic Sided V Cut 7,Blundstone STYLE #: 500 PU/TPU Elastic Sided V Cut 7,FBALYB Amazon,34,34,0,2,0,0
,Blundstone STYLE #: 500 PU/TPU Elastic Sided V Cut 7.5,Blundstone STYLE #: 500 PU/TPU Elastic Sided V Cut 7.5,FBALYB Amazon,27,27,0,0,0,0
,Blundstone STYLE #: 500 PU/TPU Elastic Sided V Cut 8,Blundstone STYLE #: 500 PU/TPU Elastic Sided V Cut 8,FBALYB Amazon,20,20,0,0,0,0
,Blundstone STYLE #: 500 PU/TPU Elastic Sided V Cut 8.5,Blundstone STYLE #: 500 PU/TPU Elastic Sided V Cut 8.5,Default Ridgefield,14,14,0,0,0,0
,Blundstone STYLE #: 500 PU/TPU Elastic Sided V Cut 8.5,Blundstone STYLE #: 500 PU/TPU Elastic Sided V Cut 8.5,FBALYB Amazon,7,7,0,0,0,0
,Blundstone STYLE #: 500 PU/TPU Elastic Sided V Cut 9,Blundstone STYLE #: 500 PU/TPU Elastic Sided V Cut 9,Default Ridgefield,2,2,0,0,0,0
,Blundstone STYLE #: 500 PU/TPU Elastic Sided V Cut 9,Blundstone STYLE #: 500 PU/TPU Elastic Sided V Cut 9,FBALYB Amazon,19,19,0,0,0,0
,Blundstone STYLE #: 500 PU/TPU Elastic Sided V Cut 9.5,Blundstone STYLE #: 500 PU/TPU Elastic Sided V Cut 9.5,FBALYB Amazon,-7,-7,0,40,0,0
,Blundstone STYLE #: 510 PU/TPU Elastic Sided V Cut 10,Blundstone STYLE #: 510 PU/TPU Elastic Sided V Cut 10,FBALYB Amazon,-15,-15,0,0,0,0
,Blundstone STYLE #: 510 PU/TPU Elastic Sided V Cut 10.5,Blundstone STYLE #: 510 PU/TPU Elastic Sided V Cut 10.5,FBALYB Amazon,15,14,1,0,1,0
,Blundstone STYLE #: 510 PU/TPU Elastic Sided V Cut 11,Blundstone STYLE #: 510 PU/TPU Elastic Sided V Cut 11,FBALYB Amazon,-17,-17,0,12,0,0
,Blundstone STYLE #: 510 PU/TPU Elastic Sided V Cut 12,Blundstone STYLE #: 510 PU/TPU Elastic Sided V Cut 12,Avrami - Ebay,11,11,0,0,0,0
,Blundstone STYLE #: 510 PU/TPU Elastic Sided V Cut 12,Blundstone STYLE #: 510 PU/TPU Elastic Sided V Cut 12,Default Ridgefield,1,1,0,0,0,0
,Blundstone STYLE #: 510 PU/TPU Elastic Sided V Cut 5,Blundstone STYLE #: 510 PU/TPU Elastic Sided V Cut 5,FBALYB Amazon,-10,-10,0,0,0,0
,Blundstone STYLE #: 510 PU/TPU Elastic Sided V Cut 5.5,Blundstone STYLE #: 510 PU/TPU Elastic Sided V Cut 5.5,FBALYB Amazon,-4,-4,0,0,0,0
,Blundstone STYLE #: 510 PU/TPU Elastic Sided V Cut 6,Blundstone STYLE #: 510 PU/TPU Elastic Sided V Cut 6,Default Ridgefield,1,1,0,0,0,0
,Blundstone STYLE #: 510 PU/TPU Elastic Sided V Cut 6,Blundstone STYLE #: 510 PU/TPU Elastic Sided V Cut 6,FBALYB Amazon,-7,-7,0,0,0,0
,Blundstone STYLE #: 510 PU/TPU Elastic Sided V Cut 6.5,Blundstone STYLE #: 510 PU/TPU Elastic Sided V Cut 6.5,FBALYB Amazon,-10,-10,0,0,0,0
,Blundstone STYLE #: 510 PU/TPU Elastic Sided V Cut 7,Blundstone STYLE #: 510 PU/TPU Elastic Sided V Cut 7,Default Ridgefield,1,1,0,0,0,0
,Blundstone STYLE #: 510 PU/TPU Elastic Sided V Cut 7,Blundstone STYLE #: 510 PU/TPU Elastic Sided V Cut 7,FBALYB Amazon,-12,-12,0,0,0,0
,Blundstone STYLE #: 510 PU/TPU Elastic Sided V Cut 7.5,Blundstone STYLE #: 510 PU/TPU Elastic Sided V Cut 7.5,Default Ridgefield,23,23,0,0,0,0
,Blundstone STYLE #: 510 PU/TPU Elastic Sided V Cut 7.5,Blundstone STYLE #: 510 PU/TPU Elastic Sided V Cut 7.5,FBALYB Amazon,20,20,0,0,0,0
,Blundstone STYLE #: 510 PU/TPU Elastic Sided V Cut 8,Blundstone STYLE #: 510 PU/TPU Elastic Sided V Cut 8,Default Ridgefield,1,1,0,0,0,0
,Blundstone STYLE #: 510 PU/TPU Elastic Sided V Cut 8,Blundstone STYLE #: 510 PU/TPU Elastic Sided V Cut 8,FBALYB Amazon,-15,-15,0,7,0,0
,Blundstone STYLE #: 510 PU/TPU Elastic Sided V Cut 8.5,Blundstone STYLE #: 510 PU/TPU Elastic Sided V Cut 8.5,FBALYB Amazon,-8,-8,0,0,0,0
,Blundstone STYLE #: 510 PU/TPU Elastic Sided V Cut 9,Blundstone STYLE #: 510 PU/TPU Elastic Sided V Cut 9,FBALYB Amazon,23,23,0,0,0,0
,Blundstone STYLE #: 510 PU/TPU Elastic Sided V Cut 9.5,Blundstone STYLE #: 510 PU/TPU Elastic Sided V Cut 9.5,FBALYB Amazon,-22,-22,0,0,0,0
,Blundstone STYLE #: 519 PU/TPU Olive Elastic Sided V Cut 10,Blundstone STYLE #: 519 PU/TPU Olive Elastic Sided V Cut 10,FBALYB Amazon,3,3,0,0,0,0
,Blundstone STYLE #: 519 PU/TPU Olive Elastic Sided V Cut 10.5,Blundstone STYLE #: 519 PU/TPU Olive Elastic Sided V Cut 10.5,Default Ridgefield,12,12,0,0,0,0
,Blundstone STYLE #: 519 PU/TPU Olive Elastic Sided V Cut 10.5,Blundstone STYLE #: 519 PU/TPU Olive Elastic Sided V Cut 10.5,FBALYB Amazon,17,17,0,8,0,0
,Blundstone STYLE #: 519 PU/TPU Olive Elastic Sided V Cut 11,Blundstone STYLE #: 519 PU/TPU Olive Elastic Sided V Cut 11,Default Ridgefield,4,4,0,0,0,0
,Blundstone STYLE #: 519 PU/TPU Olive Elastic Sided V Cut 11,Blundstone STYLE #: 519 PU/TPU Olive Elastic Sided V Cut 11,FBALYB Amazon,16,16,0,4,0,0
,Blundstone STYLE #: 519 PU/TPU Olive Elastic Sided V Cut 12,Blundstone STYLE #: 519 PU/TPU Olive Elastic Sided V Cut 12,Default Ridgefield,12,12,0,0,0,0
,Blundstone STYLE #: 519 PU/TPU Olive Elastic Sided V Cut 5.5,Blundstone STYLE #: 519 PU/TPU Olive Elastic Sided V Cut 5.5,FBALYB Amazon,-1,-1,0,0,0,0
,Blundstone STYLE #: 519 PU/TPU Olive Elastic Sided V Cut 6,Blundstone STYLE #: 519 PU/TPU Olive Elastic Sided V Cut 6,Default,0,-1,1,0,0,0
,Blundstone STYLE #: 519 PU/TPU Olive Elastic Sided V Cut 6,Blundstone STYLE #: 519 PU/TPU Olive Elastic Sided V Cut 6,FBALYB Amazon,-1,-1,0,0,0,0
,Blundstone STYLE #: 519 PU/TPU Olive Elastic Sided V Cut 6.5,Blundstone STYLE #: 519 PU/TPU Olive Elastic Sided V Cut 6.5,FBALYB Amazon,-13,-13,0,16,0,0
,Blundstone STYLE #: 519 PU/TPU Olive Elastic Sided V Cut 7,Blundstone STYLE #: 519 PU/TPU Olive Elastic Sided V Cut 7,Default Ridgefield,3,3,0,0,0,0
,Blundstone STYLE #: 519 PU/TPU Olive Elastic Sided V Cut 7,Blundstone STYLE #: 519 PU/TPU Olive Elastic Sided V Cut 7,FBALYB Amazon,5,5,0,0,0,0
,Blundstone STYLE #: 519 PU/TPU Olive Elastic Sided V Cut 7.5,Blundstone STYLE #: 519 PU/TPU Olive Elastic Sided V Cut 7.5,FBALYB Amazon,4,4,0,0,0,0
,Blundstone STYLE #: 519 PU/TPU Olive Elastic Sided V Cut 8,Blundstone STYLE #: 519 PU/TPU Olive Elastic Sided V Cut 8,FBALYB Amazon,-4,-4,0,7,0,0
,Blundstone STYLE #: 519 PU/TPU Olive Elastic Sided V Cut 8.5,Blundstone STYLE #: 519 PU/TPU Olive Elastic Sided V Cut 8.5,Default Ridgefield,3,3,0,0,0,0
,Blundstone STYLE #: 519 PU/TPU Olive Elastic Sided V Cut 8.5,Blundstone STYLE #: 519 PU/TPU Olive Elastic Sided V Cut 8.5,FBALYB Amazon,7,7,0,0,0,0
,Blundstone STYLE #: 519 PU/TPU Olive Elastic Sided V Cut 9,Blundstone STYLE #: 519 PU/TPU Olive Elastic Sided V Cut 9,FBALYB Amazon,3,3,0,0,0,0
,Blundstone STYLE #: 519 PU/TPU Olive Elastic Sided V Cut 9.5,Blundstone STYLE #: 519 PU/TPU Olive Elastic Sided V Cut 9.5,FBALYB Amazon,15,15,0,0,0,0
,Blundstone STYLE #: 558 PU/TPU Lined Elastic Sided V Cut 10,Blundstone STYLE #: 558 PU/TPU Lined Elastic Sided V Cut 10,FBALYB Amazon,46,46,0,0,0,0
,Blundstone STYLE #: 558 PU/TPU Lined Elastic Sided V Cut 10.5,Blundstone STYLE #: 558 PU/TPU Lined Elastic Sided V Cut 10.5,Default Ridgefield,36,36,0,0,0,0
,Blundstone STYLE #: 558 PU/TPU Lined Elastic Sided V Cut 10.5,Blundstone STYLE #: 558 PU/TPU Lined Elastic Sided V Cut 10.5,FBALYB Amazon,24,24,0,0,0,0
,Blundstone STYLE #: 558 PU/TPU Lined Elastic Sided V Cut 11,Blundstone STYLE #: 558 PU/TPU Lined Elastic Sided V Cut 11,FBALYB Amazon,41,41,0,0,0,0
,Blundstone STYLE #: 558 PU/TPU Lined Elastic Sided V Cut 12,Blundstone STYLE #: 558 PU/TPU Lined Elastic Sided V Cut 12,FBALYB Amazon,16,16,0,0,0,0
,Blundstone STYLE #: 558 PU/TPU Lined Elastic Sided V Cut 13,Blundstone STYLE #: 558 PU/TPU Lined Elastic Sided V Cut 13,FBALYB Amazon,18,18,0,0,0,0
,Blundstone STYLE #: 558 PU/TPU Lined Elastic Sided V Cut 6,Blundstone STYLE #: 558 PU/TPU Lined Elastic Sided V Cut 6,Avrami - Ebay,1,1,0,0,0,0
,Blundstone STYLE #: 558 PU/TPU Lined Elastic Sided V Cut 6,Blundstone STYLE #: 558 PU/TPU Lined Elastic Sided V Cut 6,Default Ridgefield,3,3,0,0,0,0
,Blundstone STYLE #: 558 PU/TPU Lined Elastic Sided V Cut 6,Blundstone STYLE #: 558 PU/TPU Lined Elastic Sided V Cut 6,FBALYB Amazon,4,4,0,0,0,0
,Blundstone STYLE #: 558 PU/TPU Lined Elastic Sided V Cut 6.5,Blundstone STYLE #: 558 PU/TPU Lined Elastic Sided V Cut 6.5,Default Ridgefield,1,1,0,0,0,0
,Blundstone STYLE #: 558 PU/TPU Lined Elastic Sided V Cut 6.5,Blundstone STYLE #: 558 PU/TPU Lined Elastic Sided V Cut 6.5,FBALYB Amazon,-4,-4,0,24,0,0
,Blundstone STYLE #: 558 PU/TPU Lined Elastic Sided V Cut 7,Blundstone STYLE #: 558 PU/TPU Lined Elastic Sided V Cut 7,FBALYB Amazon,-44,-45,1,42,1,0
,Blundstone STYLE #: 558 PU/TPU Lined Elastic Sided V Cut 7.5,Blundstone STYLE #: 558 PU/TPU Lined Elastic Sided V Cut 7.5,Default Ridgefield,1,1,0,0,0,0
,Blundstone STYLE #: 558 PU/TPU Lined Elastic Sided V Cut 7.5,Blundstone STYLE #: 558 PU/TPU Lined Elastic Sided V Cut 7.5,FBALYB Amazon,-18,-18,0,0,0,0
,Blundstone STYLE #: 558 PU/TPU Lined Elastic Sided V Cut 8,Blundstone STYLE #: 558 PU/TPU Lined Elastic Sided V Cut 8,FBALYB Amazon,-29,-29,0,31,0,0
,Blundstone STYLE #: 558 PU/TPU Lined Elastic Sided V Cut 8.5,Blundstone STYLE #: 558 PU/TPU Lined Elastic Sided V Cut 8.5,FBALYB Amazon,49,49,0,0,0,0
,Blundstone STYLE #: 558 PU/TPU Lined Elastic Sided V Cut 9,Blundstone STYLE #: 558 PU/TPU Lined Elastic Sided V Cut 9,FBALYB Amazon,7,7,0,0,0,0
,Blundstone STYLE #: 558 PU/TPU Lined Elastic Sided V Cut 9.5,Blundstone STYLE #: 558 PU/TPU Lined Elastic Sided V Cut 9.5,Default Ridgefield,7,7,0,0,0,0
,Blundstone STYLE #: 558 PU/TPU Lined Elastic Sided V Cut 9.5,Blundstone STYLE #: 558 PU/TPU Lined Elastic Sided V Cut 9.5,FBALYB Amazon,12,12,0,24,0,0
,Blundstone STYLE #: 585 PU/TPU Lined Elastic Sided V Cut 10,Blundstone STYLE #: 585 PU/TPU Lined Elastic Sided V Cut 10,FBALYB Amazon,95,95,0,0,0,0
,Blundstone STYLE #: 585 PU/TPU Lined Elastic Sided V Cut 10.5,Blundstone STYLE #: 585 PU/TPU Lined Elastic Sided V Cut 10.5,Default Ridgefield,37,37,0,0,0,0
,Blundstone STYLE #: 585 PU/TPU Lined Elastic Sided V Cut 10.5,Blundstone STYLE #: 585 PU/TPU Lined Elastic Sided V Cut 10.5,FBALYB Amazon,45,45,0,0,0,0
,Blundstone STYLE #: 585 PU/TPU Lined Elastic Sided V Cut 11,Blundstone STYLE #: 585 PU/TPU Lined Elastic Sided V Cut 11,FBALYB Amazon,55,55,0,8,0,0
,Blundstone STYLE #: 585 PU/TPU Lined Elastic Sided V Cut 12,Blundstone STYLE #: 585 PU/TPU Lined Elastic Sided V Cut 12,Default Ridgefield,6,6,0,0,0,0
,Blundstone STYLE #: 585 PU/TPU Lined Elastic Sided V Cut 12,Blundstone STYLE #: 585 PU/TPU Lined Elastic Sided V Cut 12,FBALYB Amazon,32,31,1,0,1,0
,Blundstone STYLE #: 585 PU/TPU Lined Elastic Sided V Cut 13,Blundstone STYLE #: 585 PU/TPU Lined Elastic Sided V Cut 13,FBALYB Amazon,52,51,1,0,1,0
,Blundstone STYLE #: 585 PU/TPU Lined Elastic Sided V Cut 4,Blundstone STYLE #: 585 PU/TPU Lined Elastic Sided V Cut 4,FBALYB Amazon,-4,-4,0,0,0,0
,Blundstone STYLE #: 585 PU/TPU Lined Elastic Sided V Cut 4.5,Blundstone STYLE #: 585 PU/TPU Lined Elastic Sided V Cut 4.5,FBALYB Amazon,14,14,0,0,0,0
,Blundstone STYLE #: 585 PU/TPU Lined Elastic Sided V Cut 5,Blundstone STYLE #: 585 PU/TPU Lined Elastic Sided V Cut 5,Default Ridgefield,1,1,0,0,0,0
,Blundstone STYLE #: 585 PU/TPU Lined Elastic Sided V Cut 5,Blundstone STYLE #: 585 PU/TPU Lined Elastic Sided V Cut 5,FBALYB Amazon,-3,-3,0,0,0,0
,Blundstone STYLE #: 585 PU/TPU Lined Elastic Sided V Cut 5.5,Blundstone STYLE #: 585 PU/TPU Lined Elastic Sided V Cut 5.5,Default Ridgefield,1,1,0,0,0,0
,Blundstone STYLE #: 585 PU/TPU Lined Elastic Sided V Cut 5.5,Blundstone STYLE #: 585 PU/TPU Lined Elastic Sided V Cut 5.5,FBALYB Amazon,-2,-2,0,0,0,0
,Blundstone STYLE #: 585 PU/TPU Lined Elastic Sided V Cut 6,Blundstone STYLE #: 585 PU/TPU Lined Elastic Sided V Cut 6,FBALYB Amazon,16,16,0,1,0,0
,Blundstone STYLE #: 585 PU/TPU Lined Elastic Sided V Cut 6.5,Blundstone STYLE #: 585 PU/TPU Lined Elastic Sided V Cut 6.5,Default Ridgefield,1,1,0,0,0,0
,Blundstone STYLE #: 585 PU/TPU Lined Elastic Sided V Cut 6.5,Blundstone STYLE #: 585 PU/TPU Lined Elastic Sided V Cut 6.5,FBALYB Amazon,21,21,0,0,0,0
,Blundstone STYLE #: 585 PU/TPU Lined Elastic Sided V Cut 7,Blundstone STYLE #: 585 PU/TPU Lined Elastic Sided V Cut 7,FBALYB Amazon,54,54,0,0,0,0
,Blundstone STYLE #: 585 PU/TPU Lined Elastic Sided V Cut 8,Blundstone STYLE #: 585 PU/TPU Lined Elastic Sided V Cut 8,FBALYB Amazon,56,56,0,0,0,0
,Blundstone STYLE #: 585 PU/TPU Lined Elastic Sided V Cut 8.5,Blundstone STYLE #: 585 PU/TPU Lined Elastic Sided V Cut 8.5,FBALYB Amazon,26,26,0,1,0,0
,Blundstone STYLE #: 585 PU/TPU Lined Elastic Sided V Cut 9,Blundstone STYLE #: 585 PU/TPU Lined Elastic Sided V Cut 9,Avrami - Ebay,1,1,0,0,0,0
,Blundstone STYLE #: 585 PU/TPU Lined Elastic Sided V Cut 9,Blundstone STYLE #: 585 PU/TPU Lined Elastic Sided V Cut 9,FBALYB Amazon,6,6,0,0,0,0
,Blundstone STYLE #: 585 PU/TPU Lined Elastic Sided V Cut 9.5,Blundstone STYLE #: 585 PU/TPU Lined Elastic Sided V Cut 9.5,FBALYB Amazon,6,6,0,0,0,0
,Blundstone STYLE #: 587 TPU Premium Leather Lined 10,Blundstone STYLE #: 587 TPU Premium Leather Lined 10,FBALYB Amazon,-10,-10,0,13,0,0
,Blundstone STYLE #: 587 TPU Premium Leather Lined 10.5,Blundstone STYLE #: 587 TPU Premium Leather Lined 10.5,FBALYB Amazon,22,22,0,0,0,0
,Blundstone STYLE #: 587 TPU Premium Leather Lined 11,Blundstone STYLE #: 587 TPU Premium Leather Lined 11,FBALYB Amazon,-5,-5,0,0,0,0
,Blundstone STYLE #: 587 TPU Premium Leather Lined 13,Blundstone STYLE #: 587 TPU Premium Leather Lined 13,FBALYB Amazon,10,10,0,1,0,0
,Blundstone STYLE #: 587 TPU Premium Leather Lined 6.5,Blundstone STYLE #: 587 TPU Premium Leather Lined 6.5,FBALYB Amazon,-2,-2,0,0,0,0
,Blundstone STYLE #: 587 TPU Premium Leather Lined 7,Blundstone STYLE #: 587 TPU Premium Leather Lined 7,FBALYB Amazon,-8,-8,0,0,0,0
,Blundstone STYLE #: 587 TPU Premium Leather Lined 7.5,Blundstone STYLE #: 587 TPU Premium Leather Lined 7.5,Default Ridgefield,1,1,0,0,0,0
,Blundstone STYLE #: 587 TPU Premium Leather Lined 7.5,Blundstone STYLE #: 587 TPU Premium Leather Lined 7.5,FBALYB Amazon,-7,-7,0,0,0,0
,Blundstone STYLE #: 587 TPU Premium Leather Lined 8,Blundstone STYLE #: 587 TPU Premium Leather Lined 8,FBALYB Amazon,-3,-3,0,0,0,0
,Blundstone STYLE #: 587 TPU Premium Leather Lined 8.5,Blundstone STYLE #: 587 TPU Premium Leather Lined 8.5,FBALYB Amazon,-7,-7,0,0,0,0
,Blundstone STYLE #: 587 TPU Premium Leather Lined 9,Blundstone STYLE #: 587 TPU Premium Leather Lined 9,FBALYB Amazon,-5,-5,0,0,0,0
,Blundstone STYLE #: 587 TPU Premium Leather Lined 9.5,Blundstone STYLE #: 587 TPU Premium Leather Lined 9.5,Default Ridgefield,4,4,0,0,0,0
,Blundstone STYLE #: 587 TPU Premium Leather Lined 9.5,Blundstone STYLE #: 587 TPU Premium Leather Lined 9.5,FBALYB Amazon,-11,-11,0,0,0,0
,Bob Ross 150/200 ml Large Oil Set 14 Paints,Bob Ross 150/200 ml Large Oil Set 14 Paints,FBALYB Amazon,5,5,0,0,0,0
,"Bob Ross 2"" Blender Brush R6443","Bob Ross 2"" Blender Brush R6443",Default,0,0,0,0,0,1002
,"Bob Ross 2"" Blender Brush R6443","Bob Ross 2"" Blender Brush R6443",Default Ridgefield,180,180,0,0,0,0
,"Bob Ross 2"" Blender Brush R6443","Bob Ross 2"" Blender Brush R6443",FBALYB Amazon,-2,-2,0,0,0,0
,Bob Ross 37 ML 14 Bundle Kit,Bob Ross 37 ML 14 Bundle Kit,FBALYB Amazon,75,75,0,0,0,0
,Bob Ross 500ml Gesso Grey,Bob Ross 500ml Gesso Grey,Default Ridgefield,50,50,0,0,0,0
,Bob Ross 500ml Gesso Grey,Bob Ross 500ml Gesso Grey,FBALYB Amazon,55,54,1,0,1,0
,Bob Ross 6 Fan Blender R6416,Bob Ross 6 Fan Blender R6416,Default Ridgefield,1229,1229,0,0,0,0
,Bob Ross Alizarin Crimson 37ml,Bob Ross Alizarin Crimson 37ml,Default Ridgefield,1773,1773,0,0,0,0
,"Bob Ross Background Blender Brush 2""","Bob Ross Background Blender Brush 2""",Default,0,-200,200,0,0,0
,"Bob Ross Background Blender Brush 2""","Bob Ross Background Blender Brush 2""",Default Ridgefield,2083,2083,0,0,0,0
,"Bob Ross Background Blender Brush 2""","Bob Ross Background Blender Brush 2""",FBALYB Amazon,436,427,9,2,9,0
,Bob Ross Base Coat Value Pack,Bob Ross Base Coat Value Pack,Default,0,-375,375,0,0,0
,Bob Ross Base Coat Value Pack,Bob Ross Base Coat Value Pack,FBALYB Amazon,-2,-3,1,0,1,0
,Bob Ross Brush Bundle 12 pieces,Bob Ross Brush Bundle 12 pieces,Default Ridgefield,75,75,0,0,0,0
,Bob Ross Brush Bundle 12 pieces,Bob Ross Brush Bundle 12 pieces,FBALYB Amazon,260,259,1,0,1,0
,Bob Ross Brush Cleaning Bucket & Screen,Bob Ross Brush Cleaning Bucket & Screen,FBALYB Amazon,-9,-12,3,6,3,0
,Bob Ross Brush Conditioner 4oz,Bob Ross Brush Conditioner 4oz,FBALYB Amazon,1,1,0,0,0,0
,Bob Ross Cadmium Yellow 37ml,Bob Ross Cadmium Yellow 37ml,Default Ridgefield,2345,2345,0,0,0,0
,Bob Ross Filbert Brush Size 6,Bob Ross Filbert Brush Size 6,Default Ridgefield,1168,1168,0,0,0,0
,Bob Ross Flower Painting Set,Bob Ross Flower Painting Set,Default Ridgefield,12,12,0,0,0,0
,Bob Ross Indian Yellow 200ml,Bob Ross Indian Yellow 200ml,Default Ridgefield,206,206,0,0,0,0
,Bob Ross Indian Yellow 200ml,Bob Ross Indian Yellow 200ml,FBALYB Amazon,39,37,2,0,2,0
,Bob Ross Landscape Oil Full Set of 14 Paints:,Bob Ross Landscape Oil Full Set of 14 Paints,Default Ridgefield,86,86,0,0,0,0
,Bob Ross Landscape Oil Full Set of 14 Paints:,Bob Ross Landscape Oil Full Set of 14 Paints,FBALYB Amazon,237,237,0,0,0,0
,Bob Ross Light Bright Red 200ml,Bob Ross Light Bright Red 200ml,Default Ridgefield,221,221,0,0,0,0
,Bob Ross Light Bright Red 200ml,Bob Ross Light Bright Red 200ml,FBALYB Amazon,10,10,0,0,0,0
,Bob Ross Light Red 37ml,Bob Ross Light Red 37ml,Default,0,0,0,0,0,27
,Bob Ross Light Red 37ml,Bob Ross Light Red 37ml,Default Ridgefield,2433,2433,0,0,0,0
,Bob Ross Liquid Base Coat Clear 8oz,Bob Ross Liquid Base Coat Clear 8oz,Default,0,-1179,1179,0,0,0
,Bob Ross Liquid Base Coat Clear 8oz,Bob Ross Liquid Base Coat Clear 8oz,Default Ridgefield,691,691,0,0,0,0
,Bob Ross Liquid Base Coat Clear 8oz,Bob Ross Liquid Base Coat Clear 8oz,FBALYB Amazon,42,42,0,1,0,0
,Bob Ross Liquid Black 8oz,Bob Ross Liquid Black 8oz,Default,0,-980,980,0,0,0
,Bob Ross Liquid Black 8oz,Bob Ross Liquid Black 8oz,Default Ridgefield,658,658,0,0,0,0
,Bob Ross Liquid Black 8oz,Bob Ross Liquid Black 8oz,FBALYB Amazon,27,27,0,0,0,0
,Bob Ross Liquid Oil Paint White 16oz,Bob Ross Liquid Oil Paint White 16oz,Avrami - Ebay,245,245,0,0,0,0
,Bob Ross Liquid Oil Paint White 16oz,Bob Ross Liquid Oil Paint White 16oz,Default Ridgefield,2213,2213,0,0,0,0
,Bob Ross Liquid Oil Paint White 16oz,Bob Ross Liquid Oil Paint White 16oz,FBALYB Amazon,136,133,3,50,3,0
,Bob Ross Liquid Oil Paint White 16oz,Bob Ross Liquid Oil Paint White 16oz,FBALYB Canada,-1,-1,0,50,0,0
,Bob Ross Liquid Oil Paint White 16oz,Bob Ross Liquid Oil Paint White 16oz,WFS,-192,-192,0,0,0,0
,Bob Ross Liquid White 100ml,Bob Ross Liquid White 100ml,Default Ridgefield,173,173,0,0,0,0
,Bob Ross Liquid White Oil Paint 8oz,Bob Ross Liquid White Oil Paint 8oz,Default,0,-980,980,0,0,0
,Bob Ross Liquid White Oil Paint 8oz,Bob Ross Liquid White Oil Paint 8oz,Default Ridgefield,1016,1016,0,0,0,0
,Bob Ross Liquid White Oil Paint 8oz,Bob Ross Liquid White Oil Paint 8oz,FBALYB Amazon,164,148,16,172,16,0
,Bob Ross Liquid White Oil Paint 8oz,Bob Ross Liquid White Oil Paint 8oz,WFS,-1,-1,0,0,0,0
,Bob Ross LSC Oil Titanium White 200ml,Bob Ross LSC Oil Titanium White 200ml,Default Ridgefield,206,206,0,0,0,0
,Bob Ross LSC Oil Titanium White 200ml,Bob Ross LSC Oil Titanium White 200ml,FBALYB Amazon,1,1,0,0,0,0
,Bob Ross Midnight Black 200ml,Bob Ross Midnight Black 200ml,Default Ridgefield,222,222,0,0,0,0
,Bob Ross Midnight Black 200ml,Bob Ross Midnight Black 200ml,FBALYB Amazon,0,-1,1,0,1,0
,Bob Ross Midnight Black 37ml,Bob Ross Midnight Black 37ml,Avrami - Ebay,123,123,0,0,0,0
,Bob Ross Midnight Black 37ml,Bob Ross Midnight Black 37ml,Default Ridgefield,2431,2431,0,0,0,0
,Bob Ross Midnight Black 37ml,Bob Ross Midnight Black 37ml,WFS,-13,-13,0,0,0,0
,Bob Ross Mountain Mixture 200ml,Bob Ross Mountain Mixture 200ml,Default Ridgefield,222,222,0,0,0,0
,Bob Ross Mountain Mixture 200ml,Bob Ross Mountain Mixture 200ml,FBALYB Amazon,58,58,0,0,0,0
,Bob Ross Mountain Mixture 37ml,Bob Ross Mountain Mixture 37ml,Default Ridgefield,2309,2309,0,0,0,0
,Bob Ross Oil Cadmium Yellow 200ml,Bob Ross Oil Cadmium Yellow 200ml,Default Ridgefield,219,219,0,0,0,0
,Bob Ross Oil Cadmium Yellow 200ml,Bob Ross Oil Cadmium Yellow 200ml,FBALYB Amazon,27,27,0,0,0,0
,Bob Ross Oil Paint Dark Sienna 37ml,Bob Ross Oil Paint Dark Sienna 37ml,Default Ridgefield,2559,2559,0,0,0,0
,Bob Ross Oil Paint Dark Sienna 37ml,Bob Ross Oil Paint Dark Sienna 37ml,FBALYB Amazon,-1,-1,0,0,0,0
,Bob Ross Oil Paint Indian Yellow 37ml,Bob Ross Oil Paint Indian Yellow 37ml,Default,0,0,0,0,0,4
,Bob Ross Oil Paint Indian Yellow 37ml,Bob Ross Oil Paint Indian Yellow 37ml,Default Ridgefield,2546,2546,0,0,0,0
,Bob Ross Oil Paint Midnight Black 150ml,Bob Ross Oil Paint Midnight Black 150ml,FBALYB Amazon,1,1,0,0,0,0
,Bob Ross Oil Paint Phthalo Green 37ml,Bob Ross Oil Paint Phthalo Green 37ml,Default Ridgefield,2246,2246,0,0,0,0
,Bob Ross Oil Paint Sap Green 37ml,Bob Ross Oil Paint Sap Green 37ml,Default Ridgefield,2478,2478,0,0,0,0
,Bob Ross Oil Paint Titanium White 150ml,Bob Ross Oil Paint Titanium White 150ml,Default,0,0,0,0,0,15
,Bob Ross Oil Paint Titanium White 37ml,Bob Ross Oil Paint Titanium White 37ml,Default Ridgefield,2324,2324,0,0,0,0
,Bob Ross Oil Paint Titanium White 37ml,Bob Ross Oil Paint Titanium White 37ml,FBALYB Amazon,1,1,0,0,0,0
,Bob Ross Oil Paint Van Dyke Brown 37ml,Bob Ross Oil Paint Vandyke Brown 37ml,Default Ridgefield,2427,2427,0,0,0,0
,Bob Ross Oil Paint Van Dyke Brown 37ml,Bob Ross Oil Paint Vandyke Brown 37ml,FBALYB Amazon,-1,-1,0,1,0,0
,Bob Ross Painting Supplies Knife Set with Background Blender Brush Kit,Bob Ross Painting Supplies Knife Set with Background Blender Brush Kit,FBALYB Amazon,11,10,1,0,1,0
,Bob Ross Phthalo Blue 200ml,Bob Ross Phthalo Blue 200ml ,Default Ridgefield,224,224,0,0,0,0
,Bob Ross Phthalo Blue 200ml,Bob Ross Phthalo Blue 200ml ,FBALYB Amazon,22,21,1,0,1,0
,Bob Ross Phthalo Green 200ml,Bob Ross Phthalo Green 200ml,Default Ridgefield,220,220,0,0,0,0
,Bob Ross Phthalo Green 200ml,Bob Ross Phthalo Green 200ml,FBALYB Amazon,46,46,0,0,0,0
,Bob Ross Prussian Blue 37ml,Bob Ross Prussian Blue 37ml,Default Ridgefield,2477,2477,0,0,0,0
,Bob Ross Pthalo Blue 37ml,Bob Ross Pthalo Blue 37ml,Default Ridgefield,2068,2068,0,0,0,0
,BobRoss R6519 Brush Beater Rack,BobRoss R6519 Brush Beater Rack,Default Ridgefield,210,210,0,0,0,0
,BobRoss R6519 Brush Beater Rack,BobRoss R6519 Brush Beater Rack,FBALYB Amazon,13,11,2,0,2,0
,Bob Ross Ran Blender Brush Size 3,Bob Ross Fan Blender Brush Size 3,Default,0,0,0,0,0,5
,Bob Ross Ran Blender Brush Size 3,Bob Ross Fan Blender Brush Size 3,Default Ridgefield,1263,1263,0,0,0,0
,Bob Ross Ran Blender Brush Size 3,Bob Ross Fan Blender Brush Size 3,FBALYB Amazon,-3,-4,1,3,1,0
,Bob Ross Sap Green 200ml,Bob Ross Sap Green 200ml,Default Ridgefield,221,221,0,0,0,0
,Bob Ross Sap Green 200ml,Bob Ross Sap Green 200ml,FBALYB Amazon,-1,-3,2,3,2,0
,Bob Ross Small 37ml Paint Bundle,Bob Ross Small 37ml Paint Bundle,Default,0,-199,199,0,0,5
,Bob Ross Small 37ml Paint Bundle,Bob Ross Small 37ml Paint Bundle,FBALYB Amazon,7,7,0,31,0,0
,Bob Ross Variety 8oz 3pk,Bob Ross Variety 8oz 3pk,FBALYB Amazon,120,107,13,199,13,0
,Bob Ross Yellow Ochre 200ml,Bob Ross Yellow Ochre 200ml,Default Ridgefield,220,220,0,0,0,0
,Bob Ross Yellow Ochre 200ml,Bob Ross Yellow Ochre 200ml,FBALYB Amazon,49,49,0,0,0,0
,Bob Ross Yellow Ochre 37ML,Bob Ross Yellow Ochre 37ML,Default Ridgefield,2189,2189,0,0,0,0
,Bobs Red Mill Choc Cake Mix GF pack of 4,Bobs Red Mill Choc Cake Mix GF pack of 4,FBALYB Amazon,6,5,1,0,1,0
,Bobs Red Mill CranAlmond Granola (6 pack),Bobs Red Mill CranAlmond Granola (6 pack),FBALYB Amazon,41,41,0,0,0,0
,Bobs Red Mill Lemon BB Granola (2 pack),Bobs Red Mill Lemon BB Granola (2 pack),FBALYB Amazon,73,73,0,0,0,0
,Bobs Red Mill Lemon BB Granola (6 pack),Bobs Red Mill Lemon BB Granola (6 pack),FBALYB Amazon,5,4,1,0,1,0
,B&O Headphones Play E8 2.0-1646100,B&O Headphones Play E8 2.0-1646100,FBALYB Amazon,71,71,0,0,0,0
,B&O Headphones Play E8 2.0-1646100,B&O Headphones Play E8 2.0-1646100,WFS,-2,-2,0,0,0,0
,Bonacure color silver Shampoo 8.45oz,Bonacure color silver Shampoo 8.45oz,Default Ridgefield,19,19,0,0,0,0
,Bondi 7 Blue Haze Black Iris Wide Sz 11 Wd Wide 1110531-BHBI Size 11,Bondi 7 Blue Haze Black Iris Wide Sz 11 Wd Wide 1110531-BHBI Size 11,Default Ridgefield,5,5,0,0,0,0
,Bonide Copper Fungicide 32oz,Bonide Copper Fungicide 32oz,Default,0,0,0,0,0,12
,Bonide Copper Fungicide 32oz,Bonide Copper Fungicide 32oz,FBALYB Amazon,0,0,0,1,0,0
,Bonide Copper Fungicide 32oz 2pk,Bonide Copper Fungicide 32oz 2pk,FBALYB Amazon,13,13,0,0,0,0
,Bonide Fungonil Fungicide 16oz,Bonide Fungonil Fungicide 16oz,Default,0,0,0,0,0,40
,Bonide Insect Soap 32oz,Bonide Insect Soap 32oz,FBALYB Amazon,1,1,0,0,0,0
,Bonide Poison Ivy/Oak Killer 32oz 3pk,Bonide Poison Ivy/Oak Killer 32oz 3pk,FBALYB Amazon,24,24,0,0,0,0
,Boogie Board,Boogie Board,FBALYB Amazon,-1,-1,0,0,0,0
,bottle ink T52 black4014519422853,bottle ink T52 black4014519422853,Default Ridgefield,71,71,0,0,0,0
,bottle ink T52 black4014519422853,bottle ink T52 black4014519422853,FBALYB Amazon,-150,-150,0,0,0,0
,bottle ink T52 bl-bk4014519422914,bottle ink T52 bl-bk4014519422914,Default Ridgefield,479,479,0,0,0,0
,bottle ink T52 bl-bk4014519422914,bottle ink T52 bl-bk4014519422914,FBALYB Amazon,1,1,0,0,0,0
,bottle ink T52 blue4014519422884,bottle ink T52 blue4014519422884,Default Ridgefield,851,851,0,0,0,0
,bottle ink T52 blue4014519422884,bottle ink T52 blue4014519422884,FBALYB Amazon,-32,-33,1,0,1,0
,bottle ink T52 green4014519422907,bottle ink T52 green4014519422907,Default Ridgefield,141,141,0,0,0,0
,bottle ink T52 red4014519422877,bottle ink T52 red4014519422877,Default Ridgefield,144,144,0,0,0,0
,bottle ink T52 turqu.4014519422891,bottle ink T52 turqu.4014519422891,Default Ridgefield,193,193,0,0,0,0
,bottle ink T52 turqu.4014519422891,bottle ink T52 turqu.4014519422891,FBALYB Amazon,-1,-1,0,0,0,0
,Bounce Sheets 260 ct Box,Bounce Outdoor Fresh 4 in 1 Fabric Softener Sheets 260 ct Box,FBALYB Amazon,17,17,0,0,0,0
,Boxers or Briefs Game,Boxers or Briefs Game,Default Ridgefield,-2,-2,0,0,0,0
,Boxers or Briefs Game,Boxers or Briefs Game,FBALYB Amazon,267,265,2,0,2,0
,Boxers or Briefs Game,Boxers or Briefs Game,WFS,-22,-22,0,0,0,0
,box ink cartridges T10 bk-bl4014519427322,box ink cartridges T10 bk-bl4014519427322,Default,0,-141,141,0,0,0
,box ink cartridges T10 bk-bl4014519427322,box ink cartridges T10 bk-bl4014519427322,Default Ridgefield,305,305,0,0,0,0
,box ink cartridges T10 black4014519416173,box ink cartridges T10 black4014519416173,Default,0,-14196,14196,0,0,0
,box ink cartridges T10 black4014519416173,box ink cartridges T10 black4014519416173,Default Ridgefield,652,591,61,0,0,0
,box ink cartridges T10 blue4014519416197,box ink cartridges T10 blue4014519416197,Default,0,-6533,6533,0,0,0
,box ink cartridges T10 blue4014519416197,box ink cartridges T10 blue4014519416197,Default Ridgefield,2416,2416,0,0,0,0
,box ink cartridges T10 green4014519429593,box ink cartridges T10 green4014519429593,Default,0,-141,141,0,0,0
,box ink cartridges T10 green4014519429593,box ink cartridges T10 green4014519429593,Default Ridgefield,235,235,0,0,0,0
,box ink cartridges T10 red4014519416180,box ink cartridges T10 red4014519416180,Default,0,-141,141,0,0,0
,box ink cartridges T10 red4014519416180,box ink cartridges T10 red4014519416180,Default Ridgefield,385,385,0,0,0,0
,box ink cartridges T10 turq.4014519416630,box ink cartridges T10 turq.4014519416630,Default,0,-141,141,0,0,0
,box ink cartridges T10 turq.4014519416630,box ink cartridges T10 turq.4014519416630,Default Ridgefield,643,643,0,0,0,0
,box ink cartridges T10 turq.4014519416630,box ink cartridges T10 turq.4014519416630,FBALYB Amazon,4,4,0,0,0,0
,box ink cartridges T10 violet4014519419358,box ink cartridges T10 violet4014519419358,Default,0,-141,141,0,0,0
,box ink cartridges T10 violet4014519419358,box ink cartridges T10 violet4014519419358,Default Ridgefield,286,286,0,0,0,0
,Boyd Chemi-Pure Elite 11oz 2pk,Boyd Chemi-Pure Elite 11oz 2pk,FBALYB Amazon,15,15,0,0,0,0
,Boyd Chemi-Pure Green - 11 oz,Boyd Chemi-Pure Green - 11 oz ,Default,0,0,0,0,0,1
,BRACH'S 5 LB STAR BRITE MNT,BRACH'S 5 LB STAR BRITE MNT,FBALYB Amazon,-3,-3,0,14,0,0
,Brachs Jelly Beans 54oz Bag,Brachs Jelly Beans 54oz Bag,FBALYB Amazon,17,17,0,41,0,0
,Brach's Lemon Drops 9oz Bag 6pk,Brach's Lemon Drops 9oz Bag 6pk,FBALYB Amazon,-2,-2,0,0,0,0
,BRACHS MIXED CANDY 5LB BAG,BRACHS MIXED CANDY 5LB GUSSET BAG,FBALYB Amazon,15,15,0,12,0,0
,Brasso wadding 75g,Brasso wadding 75g,FBALYB Amazon,4,4,0,1,0,0
,"Bratz SnowKissed Doll, Jade","Bratz SnowKissed Doll, Jade",Default Ridgefield,1,1,0,0,0,0
,Braun CCR2 CCR-2 Refill Crtges -12 Crtge,Braun CCR2 CCR-2 Refill Crtges -12 Crtge,FBALYB Amazon,5,4,1,0,1,0
,BRAUN COMBIPACK70B,BRAUN COMBIPACK70B,FBALYB Amazon,-4,-4,0,0,0,0
,BRAUN COMBIPACK70S,BRAUN COMBIPACK70S,FBALYB Amazon,-75,-75,0,56,0,0
,BRAUN COMBIPACK92S,BRAUN COMBIPACK92S,FBALYB Amazon,-7,-7,0,1,0,0
,Braun Irt6520 thermometer,Braun Irt6520 thermometer,Default Ridgefield,162,162,0,0,0,0
,Braun Irt6520 thermometer,Braun Irt6520 thermometer,FBALYB Amazon,82,82,0,24,0,0
,Braun Kombipack 21B 4210201163626,Braun Kombipack 21B 4210201163626,FBALYB Amazon,-2,-2,0,0,0,0
,Braun Kombipack 31S 4210201072829,Braun Kombipack 31S 4210201072829,FBALYB Amazon,0,-2,2,0,2,0
,Braun Kombipack 51B 4210201105824,Braun Kombipack 51B 4210201105824,FBALYB Amazon,-1,-1,0,0,0,0
,Braun Kombipack 51S 4210201072911,Braun Kombipack 51S 4210201072911,Default,2,2,0,0,0,0
,Braun Kombipack 51S 4210201072911,Braun Kombipack 51S 4210201072911,FBALYB Amazon,-27,-27,0,0,0,0
,Braun Kombipack 52S 4210201072195,Braun Kombipack 52S 4210201072195,FBALYB Amazon,-1,-1,0,0,0,0
,Braun Oral-B 3D Replacement Head 2pc 2pk,Braun Oral-B 3D Replacement Head 2pc 2pk,Default,0,-148,148,0,0,0
,Braun Oral-B 3D Replacement Head 2pc 2pk,Braun Oral-B 3D Replacement Head 2pc 2pk,FBALYB Amazon,-10,-10,0,0,0,0
,Braun Series 7 - 7893 Razor,Braun Series 7 - 7893 Razor,FBALYB Amazon,-1,-1,0,0,0,0
,Braun Shaver Replacement Part 92B Black,Braun Shaver Replacement Part 92B Black,FBALYB Amazon,-2,-2,0,2,0,0
,Bravo Bonus Bites Chicken 3oz,Bravo Bonus Bites Chicken 3oz,FBALYB Amazon,-4,-4,0,1,0,0
,Bravo Bonus Bites Chicken 3oz 3pk,Bravo Bonus Bites Chicken 3oz 3pk,FBALYB Amazon,0,0,0,2,0,0
,Bravo! Dry Roasted Duck Feet Bulk - 200/Case,Bravo! Dry Roasted Duck Feet Bulk - 200/Case,FBALYB Amazon,-7,-7,0,12,0,0
,Bravo Healthy Bites Salmon Food 1oz,Bravo Healthy Bites Salmon Food 1oz,Default,0,0,0,0,0,2
,Bravo! Homestyle Freeze-Dried Beef 2lb,Bravo! Homestyle Freeze-Dried Beef 2lb,FBALYB Amazon,-1,-1,0,1,0,0
,Bravo! Homestyle Freeze-Dried Beef 6lb,Bravo! Homestyle Freeze-Dried Beef 6lb,Default,0,0,0,0,0,30
,Bravo! Homestyle Freeze-Dried Beef 6lb,Bravo! Homestyle Freeze-Dried Beef 6lb,FBALYB Amazon,6,6,0,0,0,0
,Bravo! Homestyle Freeze-Dried Pork 6lb,Bravo! Homestyle Freeze-Dried Pork 6lb,FBALYB Amazon,3,3,0,0,0,0
,Bravo! Homestyle Freeze-Dried Turkey 2lb,Bravo! Homestyle Freeze-Dried Turkey 2lb,FBALYB Amazon,0,0,0,2,0,0
,Bravo! Homestyle Freeze-Dried Turkey 6lb,Bravo! Homestyle Freeze-Dried Turkey 6lb,Default,0,0,0,0,0,18
,Bravo! Homestyle Freeze-Dried Turkey 6lb,Bravo! Homestyle Freeze-Dried Turkey 6lb,FBALYB Amazon,-5,-5,0,1,0,0
,Bravo Salmon Bites 2oz,Bravo Salmon Bites 2oz,FBALYB Amazon,-11,-11,0,16,0,0
,Bravo Salmon Bites 2oz 3pk,Bravo Salmon Bites 2oz 3pk,FBALYB Amazon,1,1,0,1,0,0
,Bravo! Trail Mix Training Treats 4oz,Bravo! Trail Mix Training Treats 4oz,Default,0,0,0,0,0,25
,Bravo! Trail Mix Training Treats 4oz,Bravo! Trail Mix Training Treats 4oz,FBALYB Amazon,5,5,0,0,0,0
,Breathalyzer Ethylotest Key Ring,Breathalyzer Ethylotest Key Ring,Default Ridgefield,135,135,0,0,0,0
,Breathalyzer Ethylotest Key Ring,Breathalyzer Ethylotest Key Ring,FBALYB Canada,77,72,5,1,5,0
,Breathe Right Clear 44ct 2pk,Breathe Right Clear 44ct 2pk,FBALYB Amazon,0,-1,1,0,1,0
,Breathe Right Tan 44ct,Breathe Right Tan 44ct,FBALYB Amazon,17,17,0,0,0,0
,Breathe Right Tan 72ct,Breathe Right Tan 72ct,Default Ridgefield,14,14,0,0,0,0
,Breville BBL620SIL Fresh and Furious Blender,,Default,0,-68,68,0,0,0
,Breville BBL620SIL Fresh and Furious Blender,,Default CT,0,-7,7,0,0,0
,Breville BBL620SIL Fresh and Furious Blender,,Default Ridgefield,0,-32,32,0,0,0
,Breville BBL620SIL Fresh and Furious Blender,,FBALYB Amazon,-1,-1,0,1,0,0
,Breville BDC400 Precision Coffee Maker with Glass Carafe,Breville BDC400 Precision Coffee Maker with Glass Carafe,Default,0,-2,2,0,0,0
,Breville BDC400 Precision Coffee Maker with Glass Carafe,Breville BDC400 Precision Coffee Maker with Glass Carafe,FBALYB Amazon,-1,-1,0,0,0,0
,Breville Bes810,Breville Bes810,Default,0,-5,5,0,0,0
,Breville Bes810,Breville Bes810,Default Ridgefield,0,-9,9,0,0,0
,Breville BES840XL Infuser Espresso Machine,Breville BES840XL Infuser Espresso Machine,Default Ridgefield,0,-8,8,0,0,0
,Breville BES840XL Infuser Espresso Machine,Breville BES840XL Infuser Espresso Machine,FBALYB Amazon,-3,-3,0,0,0,0
,Breville BGR200XL Panini Oven,Breville BGR200XL Panini Oven,Default,0,-43,43,0,0,0
,Breville BGR200XL Panini Oven,Breville BGR200XL Panini Oven,FBALYB Amazon,-3,-3,0,0,0,0
,Breville bje510xl,Breville BJE510XL Juice Fountain Multi-Speed 900-Watt Juicer,Default,0,-18,18,0,0,0
,Breville BOV450XL Oven 021614054050,Breville BOV450XL Mini Smart Oven with Element IQ,FBALYB Amazon,0,0,0,2,0,0
,Breville BOV800XL Smart Oven Toaster,Breville BOV800XL Smart Oven 1800-Watt Convection Toaster Oven with Element IQ,FBALYB Amazon,0,0,0,4,0,0
,Breville BPZ600XL Crispy Crust Pizza Maker,Breville BPZ600XL Crispy Crust Pizza Maker,Default Ridgefield,0,-36,36,0,0,0
,Breville BWM640XL The Smart Waffle Maker 4 Slice,Breville BWM640XL The Smart Waffle Maker 4 Slice,Default,0,-601,601,0,0,0
,Breville BWM640XL The Smart Waffle Maker 4 Slice,Breville BWM640XL The Smart Waffle Maker 4 Slice,Default Ridgefield,0,-5,5,0,0,0
,Breville BWM640XL The Smart Waffle Maker 4 Slice,Breville BWM640XL The Smart Waffle Maker 4 Slice,FBALYB Amazon,-1,-1,0,0,0,0
,Breville Control Blender,Breville BBL605XL Hemisphere Control Blender,FBALYB Amazon,-1,-1,0,2,0,0
,Breville ES870XL,Breville ES870XL,Default,30,30,0,0,0,0
,Breville ES870XL,Breville ES870XL,FBALYB Amazon,-30,-30,0,0,0,0
,Breville ESP8XL,BREVILLE ESP8XL,Default,0,-3,3,0,0,127
,Breville ESP8XL,BREVILLE ESP8XL,Default Ridgefield,0,-13,13,0,0,0
,Breville ESP8XL,BREVILLE ESP8XL,FBALYB Amazon,-149,-149,0,0,0,0
,Breville Ice Cream Maker BCI600XL,Breville Ice Cream Maker BCI600XL,Default Ridgefield,0,-103,103,0,0,0
,Breville Ice Cream Maker BCI600XL,Breville Ice Cream Maker BCI600XL,FBALYB Amazon,-1,-1,0,0,0,0
,Breville Juice Fountain BJE830SIL,Breville Juice Fountain BJE830SIL,Default Ridgefield,0,-5,5,0,0,0
,Breville No Mess Waffle Maker BWM520XL,Breville No Mess Waffle Maker BWM520XL,Default Ridgefield,0,-3,3,0,0,0
,Breville Pro 2 Slice Smart Waffle Maker,Breville Pro 2 Slice Smart Waffle Maker,FBALYB Amazon,-1,-1,0,0,0,0
,Breville the Dose Control Coffee Grinder,Breville the Dose Control Coffee Grinder,Default,0,-1,1,0,0,0
,Breville the Dose Control Coffee Grinder,Breville the Dose Control Coffee Grinder,Default Ridgefield,0,-8,8,0,0,0
,Breville the Dose Control Coffee Grinder,Breville the Dose Control Coffee Grinder,FBALYB Amazon,0,-1,1,0,1,0
,Brinno Time Lapse Camera BCC200,"Brinno BCC200 Time Lapse Construction Camera Pro, Black",FBALYB Amazon,-1,-2,1,0,1,0
,Brita Filteration System,Brita Faucet Mount Filteration System Stainless Steel,FBALYB Amazon,-8,-8,0,0,0,0
,Brita Filteration System White,Brita Faucet Mount Filteration System White,FBALYB Amazon,-4,-4,0,0,0,0
,"Brita On Tap Filters, 4Pk, White","Brita On Tap Replacement Filters, 4-Pack, White",FBALYB Amazon,-1,-1,0,0,0,0
,Brita On Tap Replacement Filters 2 Pack Chrome,Brita On Tap Replacement Filters 2 Pack Chrome,Avrami - Ebay,20,20,0,0,0,0
,Brita On Tap Replacement Filters 2 Pack Chrome,Brita On Tap Replacement Filters 2 Pack Chrome,FBALYB Amazon,-30,-30,0,28,0,0
,Brita On Tap Replacement Filters 2 Pack Chrome,Brita On Tap Replacement Filters 2 Pack Chrome,WFS,-140,-140,0,0,0,0
,Brita On Tap Replacement Filters 2 Pack White,Brita On Tap Replacement Filters 2 Pack White,Default Ridgefield,3,3,0,0,0,0
,Brita On Tap Replacement Filters 2 Pack White,Brita On Tap Replacement Filters 2 Pack White,FBALYB Amazon,354,354,0,1,0,0
,"Brita On Tap Replacement Filters, 4-Pack Chrome","Brita On Tap Replacement Filters, 4-Pack Chrome",FBALYB Amazon,-3,-6,3,0,3,0
,"Brita On Tap Replacement Filters, 4-Pack White","Brita On Tap Replacement Filters, 4-Pack White",FBALYB Amazon,1,1,0,0,0,0
,Brita Pitcher Replacement Filters 8ct,Brita Pitcher Replacement Filters 8ct,Default Ridgefield,4,4,0,0,0,0
,Brita Pitcher Replacement Filters 8ct,Brita Pitcher Replacement Filters 8ct,FBALYB Amazon,-364,-393,29,1037,29,0
,Brita Pitcher Replacement Filters 8ct,Brita Pitcher Replacement Filters 8ct,WFS,-10,-10,0,0,0,0
,Brita Repl. Filter for Pitchers 16ct,Brita Repl. Filter for Pitchers 16ct (2pk),Default,0,-300,300,0,0,0
,Brita Repl. Filter for Pitchers 16ct,Brita Repl. Filter for Pitchers 16ct (2pk),FBALYB Amazon,274,274,0,0,0,0
,Brita Water Filter Refill,Brita Water Filter Refill,Default,0,0,0,0,0,4
,Brita Water Filter Refill,Brita Water Filter Refill,Default Ridgefield,96,96,0,0,0,0
,Bronco Equine Fly Spray 32oz,Bronco Equine Fly Spray 32oz,FBALYB Amazon,12,12,0,0,0,0
,Brooks Adrenaline GTS 19 Mens Navy/Gold/Grey Size 10,Brooks Adrenaline GTS 19 Mens Navy/Gold/Grey Size 10,FBALYB Amazon,-2,-2,0,0,0,0
,Brooks Adrenaline GTS 19 Mens Navy/Gold/Grey Size 11,Brooks Adrenaline GTS 19 Mens Navy/Gold/Grey Size 11,FBALYB Amazon,-1,-1,0,0,0,0
,Brooks Adrenaline GTS 19 Mens Navy/Gold/Grey Size 13,Brooks Adrenaline GTS 19 Mens Navy/Gold/Grey Size 13,FBALYB Amazon,-1,-1,0,0,0,0
,Brooks Adrenaline GTS 20 Grey/Blue/Navy Size 10,Brooks Adrenaline GTS 20 Grey/Blue/Navy Size 10,FBALYB Amazon,0,0,0,36,0,0
,Brooks Adrenaline GTS 20 Grey/Blue/Navy Size 11,Brooks Adrenaline GTS 20 Grey/Blue/Navy Size 11,FBALYB Amazon,-1,-1,0,0,0,0
,Brooks Adrenaline GTS 20 Grey/Blue/Navy Size 12,Brooks Adrenaline GTS 20 Grey/Blue/Navy Size 12,FBALYB Amazon,-3,-3,0,0,0,0
,Brooks Adrenaline GTS 20 Grey/Blue/Navy Size 13,Brooks Adrenaline GTS 20 Grey/Blue/Navy Size 13,Default,0,-10,10,0,0,0
,Brooks Adrenaline GTS 20 Grey/Blue/Navy Size 8,Brooks Adrenaline GTS 20 Grey/Blue/Navy Size 8,FBALYB Amazon,-4,-4,0,0,0,0
,Brooks Adrenaline GTS 20 Grey/Blue/Navy Size 9,Brooks Adrenaline GTS 20 Grey/Blue/Navy Size 9,FBALYB Amazon,-1,-1,0,30,0,0
,Brooks Adrenaline GTS 20 Mens Black/Grey Size 10,Brooks Adrenaline GTS 20 Mens Black/Grey Size 10,Default,1,1,0,0,0,0
,Brooks Adrenaline GTS 20 Mens Black/Grey Size 10,Brooks Adrenaline GTS 20 Mens Black/Grey Size 10,FBALYB Amazon,-2,-2,0,0,0,0
,Brooks Adrenaline GTS 20 Mens Black/Grey Size 9,Brooks Adrenaline GTS 20 Mens Black/Grey Size 9,FBALYB Amazon,12,11,1,0,1,0
,Brooks Adrenaline GTS 20 Womens Black/Grey Size 10,Brooks Adrenaline GTS 20 Womens Black/Grey Size 10,FBALYB Amazon,-1,-1,0,0,0,0
,Brooks Adrenaline GTS 20 Womens Black/Grey Size 7,Brooks Adrenaline GTS 20 Womens Black/Grey Size 7,FBALYB Amazon,-4,-4,0,0,0,0
,Brooks Adrenaline GTS 20 Womens Black/Grey Size 8,Brooks Adrenaline GTS 20 Womens Black/Grey Size 8,FBALYB Amazon,-8,-8,0,0,0,0
,Brooks Adrenaline GTS 20 Womens Black/Grey Size 9,Brooks Adrenaline GTS 20 Womens Black/Grey Size 9,FBALYB Amazon,-5,-5,0,0,0,0
,Brooks Ghost 12 Men Black/Grey Size 10,Brooks Ghost 12 Men Black/Grey Size 10,FBALYB Amazon,-1,-2,1,0,1,0
,Brooks Ghost 12 Men Black/Grey Size 11,Brooks Ghost 12 Men Black/Grey Size 11,FBALYB Amazon,-3,-3,0,0,0,0
,Brooks Ghost 12 Men Black/Grey Size 12,Brooks Ghost 12 Men Black/Grey Size 12,FBALYB Amazon,-2,-2,0,0,0,0
,Brooks Ghost 12 Men Black/Grey Size 8,Brooks Ghost 12 Men Black/Grey Size 8,FBALYB Amazon,-3,-3,0,0,0,0
,Brooks Ghost 12 Men Black/Grey Size 9,Brooks Ghost 12 Men Black/Grey Size 9,FBALYB Amazon,-6,-6,0,0,0,0
,Brooks Ghost 12 Men Black/Pear/Oyster Size 10,Brooks Ghost 12 Men Black/Pear/Oyster Size 10,Default,2,2,0,0,0,0
,Brooks Ghost 12 Men Black/Pear/Oyster Size 10,Brooks Ghost 12 Men Black/Pear/Oyster Size 10,FBALYB Amazon,-3,-3,0,0,0,0
,Brooks Ghost 12 Men Black/Pear/Oyster Size 11,Brooks Ghost 12 Men Black/Pear/Oyster Size 11,Default,1,1,0,0,0,0
,Brooks Ghost 12 Men Black/Pear/Oyster Size 11,Brooks Ghost 12 Men Black/Pear/Oyster Size 11,FBALYB Amazon,-4,-4,0,0,0,0
,Brooks Ghost 12 Men Black/Pear/Oyster Size 12,Brooks Ghost 12 Men Black/Pear/Oyster Size 12,FBALYB Amazon,-1,-1,0,0,0,0
,Brooks Ghost 12 Men Black/Pear/Oyster Size 9,Brooks Ghost 12 Men Black/Pear/Oyster Size 9,Default,2,2,0,0,0,0
,Brooks Ghost 12 Men Black/Pear/Oyster Size 9,Brooks Ghost 12 Men Black/Pear/Oyster Size 9,FBALYB Amazon,-5,-5,0,0,0,0
,Brooks Ghost 12 Men Navy/Deep Water/Gold Size 10,Brooks Ghost 12 Men Navy/Deep Water/Gold Size 10,FBALYB Amazon,-4,-4,0,0,0,0
,Brooks Ghost 12 Men Navy/Deep Water/Gold Size 11,Brooks Ghost 12 Men Navy/Deep Water/Gold Size 11,Default Ridgefield,11,11,0,0,0,0
,Brooks Ghost 12 Men Navy/Deep Water/Gold Size 11,Brooks Ghost 12 Men Navy/Deep Water/Gold Size 11,FBALYB Amazon,-2,-2,0,0,0,0
,Brooks Ghost 12 Men Navy/Deep Water/Gold Size 12,Brooks Ghost 12 Men Navy/Deep Water/Gold Size 12,FBALYB Amazon,4,4,0,0,0,0
,Brooks Ghost 12 Men Navy/Deep Water/Gold Size 9,Brooks Ghost 12 Men Navy/Deep Water/Gold Size 9,FBALYB Amazon,-3,-3,0,0,0,0
,Brooks Ghost 12 Womens Black/Hollyhock/Pink Size 7,Brooks Ghost 12 Womens Black/Hollyhock/Pink Size 7,FBALYB Amazon,-11,-11,0,6,0,0
,Brooks Ghost 12 Womens Black/Hollyhock/Pink Size 9,Brooks Ghost 12 Womens Black/Hollyhock/Pink Size 9,FBALYB Amazon,-7,-7,0,6,0,0
,Brooks Glycerin 17 Mens Black/Ebony Size 10,Brooks Glycerin 17 Mens Black/Ebony Size 10,FBALYB Amazon,-7,-7,0,0,0,0
,Brooks Glycerin 17 Mens Black/Ebony Size 11,Brooks Glycerin 17 Mens Black/Ebony Size 11,FBALYB Amazon,-3,-3,0,0,0,0
,Brooks Glycerin 17 Mens Black/Ebony Size 12,Brooks Glycerin 17 Mens Black/Ebony Size 12,FBALYB Amazon,-2,-2,0,0,0,0
,Brooks Glycerin 17 Mens Black/Ebony Size 13,Brooks Glycerin 17 Mens Black/Ebony Size 13,FBALYB Amazon,-1,-1,0,0,0,0
,Brooks Glycerin 17 Mens Black/Ebony Size 14,Brooks Glycerin 17 Mens Black/Ebony Size 14,FBALYB Amazon,-1,-1,0,0,0,0
,Brooks Glycerin 17 Mens Black/Ebony Size 9,Brooks Glycerin 17 Mens Black/Ebony Size 9,FBALYB Amazon,-9,-9,0,0,0,0
,Brooks Glycerin 17 Mens Grey/Navy/Gold Size 10,Brooks Glycerin 17 Mens Grey/Navy/Gold Size 10,FBALYB Amazon,-3,-3,0,0,0,0
,Brooks Glycerin 17 Mens Grey/Navy/Gold Size 13,Brooks Glycerin 17 Mens Grey/Navy/Gold Size 13,FBALYB Amazon,-1,-1,0,0,0,0
,Brooks Glycerin 17 Mens Grey/Navy/Gold Size 9,Brooks Glycerin 17 Mens Grey/Navy/Gold Size 9,FBALYB Amazon,-1,-1,0,0,0,0
,Brooks Glycerin 17Mens Grey/Navy White Size 10,Brooks Glycerin 17Mens Grey/Navy White Size 10,Default Ridgefield,4,4,0,0,0,0
,Brooks Glycerin 17Mens Grey/Navy White Size 10,Brooks Glycerin 17Mens Grey/Navy White Size 10,FBALYB Amazon,28,28,0,2,0,0
,Brooks Glycerin 17Mens Grey/Navy White Size 10,Brooks Glycerin 17Mens Grey/Navy White Size 10,WFS,-6,-6,0,0,0,0
,Brooks Glycerin 17Mens Grey/Navy White Size 11,Brooks Glycerin 17Mens Grey/Navy White Size 11,FBALYB Amazon,-2,-2,0,0,0,0
,Brooks Glycerin 17Mens Grey/Navy White Size 13,Brooks Glycerin 17Mens Grey/Navy White Size 13,FBALYB Amazon,-1,-1,0,0,0,0
,Brooks Glycerin 17Mens Grey/Navy White Size 7,Brooks Glycerin 17Mens Grey/Navy White Size 7,Default Ridgefield,7,7,0,0,0,0
,Brooks Glycerin 17Mens Grey/Navy White Size 9,Brooks Glycerin 17Mens Grey/Navy White Size 9,FBALYB Amazon,-1,-1,0,0,0,0
,Brooks Glycerin 17 Womens Ebony/Wild Aster/Fig Size 10,Brooks Glycerin 17 Womens Ebony/Wild Aster/Fig Size 10,FBALYB Amazon,-1,-1,0,0,0,0
,Brooks Glycerin 17 Womens Ebony/Wild Aster/Fig Size 7,Brooks Glycerin 17 Womens Ebony/Wild Aster/Fig Size 7,FBALYB Amazon,-9,-9,0,0,0,0
,Brooks Glycerin 17 Womens Ebony/Wild Aster/Fig Size 9,Brooks Glycerin 17 Womens Ebony/Wild Aster/Fig Size 9,FBALYB Amazon,-1,-1,0,0,0,0
,Brooks Glycerin 17 Womens Feldspar/Aqua Foam/Grey Size 10,Brooks Glycerin 17 Womens Feldspar/Aqua Foam/Grey Size 10,FBALYB Amazon,-1,-1,0,0,0,0
,Brooks Glycerin 17 Womens Feldspar/Aqua Foam/Grey Size 11,Brooks Glycerin 17 Womens Feldspar/Aqua Foam/Grey Size 11,FBALYB Amazon,-1,-1,0,0,0,0
,Brooks Glycerin 17 Womens Feldspar/Aqua Foam/Grey Size 7,Brooks Glycerin 17 Womens Feldspar/Aqua Foam/Grey Size 7,FBALYB Amazon,-2,-2,0,0,0,0
,Brooks Glycerin 17 Womens Feldspar/Aqua Foam/Grey Size 8,Brooks Glycerin 17 Womens Feldspar/Aqua Foam/Grey Size 8,FBALYB Amazon,-1,-1,0,0,0,0
,Brooks Glycerin 17 Womens Feldspar/Aqua Foam/Grey Size 9,Brooks Glycerin 17 Womens Feldspar/Aqua Foam/Grey Size 9,FBALYB Amazon,-2,-2,0,0,0,0
,Brookside Dark Chocolates 40,Brookside Dark Chocolates 40,FBALYB Amazon,-221,-222,1,232,1,0
,Brooks Launch 6 Mens Alloy/Black/Grey Size 9,Brooks Launch 6 Mens Alloy/Black/Grey Size 9,FBALYB Amazon,-1,-1,0,0,0,0
,Brooks Launch 6 Mens Peacoat/Blue/Gold Size 10,Brooks Launch 6 Mens Peacoat/Blue/Gold Size 10,FBALYB Amazon,-2,-2,0,0,0,0
,Brooks Men ADRENALINE GTS21 BLUE/INDIGO/NIGHTLIFE 1103491D441 Size 10,Brooks Men ADRENALINE GTS21 BLUE/INDIGO/NIGHTLIFE 1103491D441 Size 10,FBALYB Amazon,1,0,1,0,1,0
,Brooks Men ADRENALINE GTS21 BLUE/INDIGO/NIGHTLIFE 1103491D441 Size 10.5,Brooks Men ADRENALINE GTS21 BLUE/INDIGO/NIGHTLIFE 1103491D441 Size 10.5,FBALYB Amazon,-3,-3,0,0,0,0
,Brooks Men ADRENALINE GTS21 BLUE/INDIGO/NIGHTLIFE 1103491D441 Size 8,Brooks Men ADRENALINE GTS21 BLUE/INDIGO/NIGHTLIFE 1103491D441 Size 8,FBALYB Amazon,8,8,0,0,0,0
,Brooks Men ADRENALINE GTS21 BLUE/INDIGO/NIGHTLIFE 1103491D441 Size 8.5,Brooks Men ADRENALINE GTS21 BLUE/INDIGO/NIGHTLIFE 1103491D441 Size 8.5,FBALYB Amazon,18,18,0,0,0,0
,Brooks Men ADRENALINE GTS21 BLUE/INDIGO/NIGHTLIFE 1103491D441 Size 9,Brooks Men ADRENALINE GTS21 BLUE/INDIGO/NIGHTLIFE 1103491D441 Size 9,Default Ridgefield,1,1,0,0,0,0
,Brooks Men ADRENALINE GTS21 BLUE/INDIGO/NIGHTLIFE 1103491D441 Size 9,Brooks Men ADRENALINE GTS21 BLUE/INDIGO/NIGHTLIFE 1103491D441 Size 9,FBALYB Amazon,16,16,0,0,0,0
,Brooks Men ADRENALINE GTS21 BLUE/INDIGO/NIGHTLIFE 1103491D441 Size 9.5,Brooks Men ADRENALINE GTS21 BLUE/INDIGO/NIGHTLIFE 1103491D441 Size 9.5,FBALYB Amazon,13,13,0,0,0,0
,Brooks Men ADRENALINE GTS21 GREY/WHITE/INDIGO 1103491D176 Size 10,Brooks Men ADRENALINE GTS21 GREY/WHITE/INDIGO 1103491D176 Size 10,Default Ridgefield,40,40,0,0,0,0
,Brooks Men ADRENALINE GTS21 GREY/WHITE/INDIGO 1103491D176 Size 10.5,Brooks Men ADRENALINE GTS21 GREY/WHITE/INDIGO 1103491D176 Size 10.5,Default Ridgefield,40,40,0,0,0,0
,Brooks Men ADRENALINE GTS21 GREY/WHITE/INDIGO 1103491D176 Size 11,Brooks Men ADRENALINE GTS21 GREY/WHITE/INDIGO 1103491D176 Size 11,FBALYB Amazon,15,15,0,0,0,0
,Brooks Men ADRENALINE GTS21 GREY/WHITE/INDIGO 1103491D176 Size 11.5,Brooks Men ADRENALINE GTS21 GREY/WHITE/INDIGO 1103491D176 Size 11.5,Default Ridgefield,20,20,0,0,0,0
,Brooks Men ADRENALINE GTS21 GREY/WHITE/INDIGO 1103491D176 Size 12,Brooks Men ADRENALINE GTS21 GREY/WHITE/INDIGO 1103491D176 Size 12,Default Ridgefield,20,20,0,0,0,0
,Brooks Men ADRENALINE GTS21 GREY/WHITE/INDIGO 1103491D176 Size 8,Brooks Men ADRENALINE GTS21 GREY/WHITE/INDIGO 1103491D176 Size 8,Default Ridgefield,20,20,0,0,0,0
,Brooks Men ADRENALINE GTS21 GREY/WHITE/INDIGO 1103491D176 Size 9,Brooks Men ADRENALINE GTS21 GREY/WHITE/INDIGO 1103491D176 Size 9,FBALYB Amazon,2,1,1,0,1,0
,Brooks Men ADRENALINE GTS21 GREY/WHITE/INDIGO 1103491D176 Size 9.5,Brooks Men ADRENALINE GTS21 GREY/WHITE/INDIGO 1103491D176 Size 9.5,Default Ridgefield,20,20,0,0,0,0
,Brooks Men ADRENALINE GTS21 NAVY/RED CLAY/ GRAY 1103491D452 Size 10,Brooks Men ADRENALINE GTS21 NAVY/RED CLAY/ GRAY 1103491D452 Size 10,FBALYB Amazon,15,14,1,0,1,0
,Brooks Men ADRENALINE GTS21 NAVY/RED CLAY/ GRAY 1103491D452 Size 10.5,Brooks Men ADRENALINE GTS21 NAVY/RED CLAY/ GRAY 1103491D452 Size 10.5,FBALYB Amazon,24,24,0,0,0,0
,Brooks Men ADRENALINE GTS21 NAVY/RED CLAY/ GRAY 1103491D452 Size 11,Brooks Men ADRENALINE GTS21 NAVY/RED CLAY/ GRAY 1103491D452 Size 11,FBALYB Amazon,-1,-2,1,0,1,0
,Brooks Men ADRENALINE GTS21 NAVY/RED CLAY/ GRAY 1103491D452 Size 11.5,Brooks Men ADRENALINE GTS21 NAVY/RED CLAY/ GRAY 1103491D452 Size 11.5,FBALYB Amazon,4,4,0,0,0,0
,Brooks Men ADRENALINE GTS21 NAVY/RED CLAY/ GRAY 1103491D452 Size 12,Brooks Men ADRENALINE GTS21 NAVY/RED CLAY/ GRAY 1103491D452 Size 12,FBALYB Amazon,13,13,0,0,0,0
,Brooks Men ADRENALINE GTS21 NAVY/RED CLAY/ GRAY 1103491D452 Size 13,Brooks Men ADRENALINE GTS21 NAVY/RED CLAY/ GRAY 1103491D452 Size 13,FBALYB Amazon,1,1,0,0,0,0
,Brooks Men ADRENALINE GTS21 NAVY/RED CLAY/ GRAY 1103491D452 Size 8,Brooks Men ADRENALINE GTS21 NAVY/RED CLAY/ GRAY 1103491D452 Size 8,FBALYB Amazon,12,11,1,0,1,0
,Brooks Men ADRENALINE GTS21 NAVY/RED CLAY/ GRAY 1103491D452 Size 8.5,Brooks Men ADRENALINE GTS21 NAVY/RED CLAY/ GRAY 1103491D452 Size 8.5,FBALYB Amazon,1,1,0,0,0,0
,Brooks Men ADRENALINE GTS21 NAVY/RED CLAY/ GRAY 1103491D452 Size 9,Brooks Men ADRENALINE GTS21 NAVY/RED CLAY/ GRAY 1103491D452 Size 9,FBALYB Amazon,-5,-5,0,7,0,0
,Brooks Men ADRENALINE GTS21 NAVY/RED CLAY/ GRAY 1103491D452 Size 9.5,Brooks Men ADRENALINE GTS21 NAVY/RED CLAY/ GRAY 1103491D452 Size 9.5,FBALYB Amazon,11,11,0,0,0,0
,Brooks Men GHOST 13 BLACK/BLACK 1103481D072 Size 10,Brooks Men GHOST 13 BLACK/BLACK 1103481D072 Size 10,FBALYB Amazon,-7,-7,0,0,0,0
,Brooks Men GHOST 13 BLACK/BLACK 1103481D072 Size 10.5,Brooks Men GHOST 13 BLACK/BLACK 1103481D072 Size 10.5,FBALYB Amazon,-8,-8,0,0,0,0
,Brooks Men GHOST 13 BLACK/BLACK 1103481D072 Size 11,Brooks Men GHOST 13 BLACK/BLACK 1103481D072 Size 11,FBALYB Amazon,-6,-6,0,0,0,0
,Brooks Men GHOST 13 BLACK/BLACK 1103481D072 Size 11.5,Brooks Men GHOST 13 BLACK/BLACK 1103481D072 Size 11.5,FBALYB Amazon,-3,-3,0,0,0,0
,Brooks Men GHOST 13 BLACK/BLACK 1103481D072 Size 12,Brooks Men GHOST 13 BLACK/BLACK 1103481D072 Size 12,FBALYB Amazon,-4,-4,0,0,0,0
,Brooks Men GHOST 13 BLACK/BLACK 1103481D072 Size 13,Brooks Men GHOST 13 BLACK/BLACK 1103481D072 Size 13,FBALYB Amazon,-1,-1,0,0,0,0
,Brooks Men GHOST 13 BLACK/BLACK 1103481D072 Size 7.5,Brooks Men GHOST 13 BLACK/BLACK 1103481D072 Size 7.5,Default Ridgefield,22,22,0,0,0,0
,Brooks Men GHOST 13 BLACK/BLACK 1103481D072 Size 8,Brooks Men GHOST 13 BLACK/BLACK 1103481D072 Size 8,FBALYB Amazon,31,31,0,0,0,0
,Brooks Men GHOST 13 BLACK/BLACK 1103481D072 Size 8.5,Brooks Men GHOST 13 BLACK/BLACK 1103481D072 Size 8.5,FBALYB Amazon,-1,-3,2,0,2,0
,Brooks Men GHOST 13 BLACK/BLACK 1103481D072 Size 9,Brooks Men GHOST 13 BLACK/BLACK 1103481D072 Size 9,FBALYB Amazon,-2,-3,1,0,1,0
,Brooks Men GHOST 13 BLACK/BLACK 1103481D072 Size 9.5,Brooks Men GHOST 13 BLACK/BLACK 1103481D072 Size 9.5,FBALYB Amazon,-3,-4,1,0,1,0
,Brooks Men GHOST 13 BLACK/NIGHTLIFE/WHITE 1103481D039 Size 10,Brooks Men GHOST 13 BLACK/NIGHTLIFE/WHITE 1103481D039 Size 10,FBALYB Amazon,0,-1,1,0,1,0
,Brooks Men GHOST 13 BLACK/NIGHTLIFE/WHITE 1103481D039 Size 10.5,Brooks Men GHOST 13 BLACK/NIGHTLIFE/WHITE 1103481D039 Size 10.5,FBALYB Amazon,-6,-7,1,0,1,0
,Brooks Men GHOST 13 BLACK/NIGHTLIFE/WHITE 1103481D039 Size 11,Brooks Men GHOST 13 BLACK/NIGHTLIFE/WHITE 1103481D039 Size 11,FBALYB Amazon,-3,-3,0,1,0,0
,Brooks Men GHOST 13 BLACK/NIGHTLIFE/WHITE 1103481D039 Size 11.5,Brooks Men GHOST 13 BLACK/NIGHTLIFE/WHITE 1103481D039 Size 11.5,FBALYB Amazon,3,1,2,0,2,0
,Brooks Men GHOST 13 BLACK/NIGHTLIFE/WHITE 1103481D039 Size 12,Brooks Men GHOST 13 BLACK/NIGHTLIFE/WHITE 1103481D039 Size 12,FBALYB Amazon,-2,-2,0,0,0,0
,Brooks Men GHOST 13 BLACK/NIGHTLIFE/WHITE 1103481D039 Size 13,Brooks Men GHOST 13 BLACK/NIGHTLIFE/WHITE 1103481D039 Size 13,FBALYB Amazon,-3,-3,0,0,0,0
,Brooks Men GHOST 13 BLACK/NIGHTLIFE/WHITE 1103481D039 Size 8,Brooks Men GHOST 13 BLACK/NIGHTLIFE/WHITE 1103481D039 Size 8,FBALYB Amazon,-1,-1,0,0,0,0
,Brooks Men GHOST 13 BLACK/NIGHTLIFE/WHITE 1103481D039 Size 8.5,Brooks Men GHOST 13 BLACK/NIGHTLIFE/WHITE 1103481D039 Size 8.5,Default Ridgefield,5,5,0,0,0,0
,Brooks Men GHOST 13 BLACK/NIGHTLIFE/WHITE 1103481D039 Size 8.5,Brooks Men GHOST 13 BLACK/NIGHTLIFE/WHITE 1103481D039 Size 8.5,FBALYB Amazon,-7,-7,0,0,0,0
,Brooks Men GHOST 13 BLACK/NIGHTLIFE/WHITE 1103481D039 Size 9,Brooks Men GHOST 13 BLACK/NIGHTLIFE/WHITE 1103481D039 Size 9,FBALYB Amazon,-1,-1,0,0,0,0
,Brooks Men GHOST 13 BLACK/NIGHTLIFE/WHITE 1103481D039 Size 9.5,Brooks Men GHOST 13 BLACK/NIGHTLIFE/WHITE 1103481D039 Size 9.5,FBALYB Amazon,-1,-1,0,0,0,0
,Brooks Men GHOST 13 GREY/NAVY/NIGHTLIFE 1103481D055 Size 10,Brooks Men GHOST 13 GREY/NAVY/NIGHTLIFE 1103481D055 Size 10,Default Ridgefield,1,1,0,0,0,0
,Brooks Men GHOST 13 GREY/NAVY/NIGHTLIFE 1103481D055 Size 10,Brooks Men GHOST 13 GREY/NAVY/NIGHTLIFE 1103481D055 Size 10,FBALYB Amazon,50,50,0,0,0,0
,Brooks Men GHOST 13 GREY/NAVY/NIGHTLIFE 1103481D055 Size 10.5,Brooks Men GHOST 13 GREY/NAVY/NIGHTLIFE 1103481D055 Size 10.5,FBALYB Amazon,-12,-14,2,0,2,0
,Brooks Men GHOST 13 GREY/NAVY/NIGHTLIFE 1103481D055 Size 11,Brooks Men GHOST 13 GREY/NAVY/NIGHTLIFE 1103481D055 Size 11,Default Ridgefield,55,55,0,0,0,0
,Brooks Men GHOST 13 GREY/NAVY/NIGHTLIFE 1103481D055 Size 11.5,Brooks Men GHOST 13 GREY/NAVY/NIGHTLIFE 1103481D055 Size 11.5,FBALYB Amazon,-1,-1,0,0,0,0
,Brooks Men GHOST 13 GREY/NAVY/NIGHTLIFE 1103481D055 Size 12,Brooks Men GHOST 13 GREY/NAVY/NIGHTLIFE 1103481D055 Size 12,FBALYB Amazon,38,38,0,0,0,0
,Brooks Men GHOST 13 GREY/NAVY/NIGHTLIFE 1103481D055 Size 13,Brooks Men GHOST 13 GREY/NAVY/NIGHTLIFE 1103481D055 Size 13,FBALYB Amazon,-2,-3,1,0,1,0
,Brooks Men GHOST 13 GREY/NAVY/NIGHTLIFE 1103481D055 Size 8,Brooks Men GHOST 13 GREY/NAVY/NIGHTLIFE 1103481D055 Size 8,FBALYB Amazon,46,46,0,0,0,0
,Brooks Men GHOST 13 GREY/NAVY/NIGHTLIFE 1103481D055 Size 8.5,Brooks Men GHOST 13 GREY/NAVY/NIGHTLIFE 1103481D055 Size 8.5,FBALYB Amazon,20,17,3,0,3,0
,Brooks Men GHOST 13 GREY/NAVY/NIGHTLIFE 1103481D055 Size 9,Brooks Men GHOST 13 GREY/NAVY/NIGHTLIFE 1103481D055 Size 9,FBALYB Amazon,21,19,2,0,2,0
,Brooks Men GHOST 13 GREY/NAVY/NIGHTLIFE 1103481D055 Size 9.5,Brooks Men GHOST 13 GREY/NAVY/NIGHTLIFE 1103481D055 Size 9.5,FBALYB Amazon,6,6,0,0,0,0
,Brooks Men GHOST 13 PEACOAT/INDIGO/NIGHTLIFE 1103481D474 Size 10,Brooks Men GHOST 13 PEACOAT/INDIGO/NIGHTLIFE 1103481D474 Size 10,FBALYB Amazon,-2,-2,0,0,0,0
,Brooks Men GHOST 13 PEACOAT/INDIGO/NIGHTLIFE 1103481D474 Size 10.5,Brooks Men GHOST 13 PEACOAT/INDIGO/NIGHTLIFE 1103481D474 Size 10.5,FBALYB Amazon,-1,-1,0,0,0,0
,Brooks Men GHOST 13 PEACOAT/INDIGO/NIGHTLIFE 1103481D474 Size 11,Brooks Men GHOST 13 PEACOAT/INDIGO/NIGHTLIFE 1103481D474 Size 11,FBALYB Amazon,-1,-1,0,0,0,0
,Brooks Men GHOST 13 PEACOAT/INDIGO/NIGHTLIFE 1103481D474 Size 11.5,Brooks Men GHOST 13 PEACOAT/INDIGO/NIGHTLIFE 1103481D474 Size 11.5,FBALYB Amazon,-1,-1,0,0,0,0
,Brooks Men GHOST 13 PEACOAT/INDIGO/NIGHTLIFE 1103481D474 Size 13,Brooks Men GHOST 13 PEACOAT/INDIGO/NIGHTLIFE 1103481D474 Size 13,FBALYB Amazon,-2,-2,0,0,0,0
,Brooks Men GHOST 13 PEACOAT/INDIGO/NIGHTLIFE 1103481D474 Size 8.5,Brooks Men GHOST 13 PEACOAT/INDIGO/NIGHTLIFE 1103481D474 Size 8.5,FBALYB Amazon,2,2,0,0,0,0
,Brooks Men GHOST 13 PEACOAT/INDIGO/NIGHTLIFE 1103481D474 Size 9,Brooks Men GHOST 13 PEACOAT/INDIGO/NIGHTLIFE 1103481D474 Size 9,FBALYB Amazon,0,-1,1,0,1,0
,Brooks Men GLYCERIN 19 NAVY/BLUE/NIGHTLIFE 1103561D443 Size 10,Brooks Men GLYCERIN 19 NAVY/BLUE/NIGHTLIFE 1103561D443 Size 10,FBALYB Amazon,-5,-5,0,0,0,0
,Brooks Men GLYCERIN 19 NAVY/BLUE/NIGHTLIFE 1103561D443 Size 10.5,Brooks Men GLYCERIN 19 NAVY/BLUE/NIGHTLIFE 1103561D443 Size 10.5,FBALYB Amazon,2,2,0,0,0,0
,Brooks Men GLYCERIN 19 NAVY/BLUE/NIGHTLIFE 1103561D443 Size 11.5,Brooks Men GLYCERIN 19 NAVY/BLUE/NIGHTLIFE 1103561D443 Size 11.5,FBALYB Amazon,2,2,0,0,0,0
,Brooks Men GLYCERIN 19 NAVY/BLUE/NIGHTLIFE 1103561D443 Size 12,Brooks Men GLYCERIN 19 NAVY/BLUE/NIGHTLIFE 1103561D443 Size 12,Default Ridgefield,15,15,0,0,0,0
,Brooks Men GLYCERIN 19 NAVY/BLUE/NIGHTLIFE 1103561D443 Size 8,Brooks Men GLYCERIN 19 NAVY/BLUE/NIGHTLIFE 1103561D443 Size 8,FBALYB Amazon,-3,-4,1,0,1,0
,Brooks Men GLYCERIN 19 NAVY/BLUE/NIGHTLIFE 1103561D443 Size 8.5,Brooks Men GLYCERIN 19 NAVY/BLUE/NIGHTLIFE 1103561D443 Size 8.5,FBALYB Amazon,-4,-4,0,0,0,0
,Brooks Men GLYCERIN 19 NAVY/BLUE/NIGHTLIFE 1103561D443 Size 9,Brooks Men GLYCERIN 19 NAVY/BLUE/NIGHTLIFE 1103561D443 Size 9,FBALYB Amazon,1,1,0,0,0,0
,Brooks Men GLYCERIN 19 NAVY/BLUE/NIGHTLIFE 1103561D443 Size 9.5,Brooks Men GLYCERIN 19 NAVY/BLUE/NIGHTLIFE 1103561D443 Size 9.5,FBALYB Amazon,-2,-2,0,0,0,0
,Brooks Men LAUNCH 8 BLUE/ORANGE/WHITE 1103581D463 Size 10,Brooks Men LAUNCH 8 BLUE/ORANGE/WHITE 1103581D463 Size 10,FBALYB Amazon,27,27,0,0,0,0
,Brooks Men LAUNCH 8 BLUE/ORANGE/WHITE 1103581D463 Size 10.5,Brooks Men LAUNCH 8 BLUE/ORANGE/WHITE 1103581D463 Size 10.5,FBALYB Amazon,31,31,0,0,0,0
,Brooks Men LAUNCH 8 BLUE/ORANGE/WHITE 1103581D463 Size 11,Brooks Men LAUNCH 8 BLUE/ORANGE/WHITE 1103581D463 Size 11,Default Ridgefield,24,24,0,0,0,0
,Brooks Men LAUNCH 8 BLUE/ORANGE/WHITE 1103581D463 Size 11.5,Brooks Men LAUNCH 8 BLUE/ORANGE/WHITE 1103581D463 Size 11.5,FBALYB Amazon,8,8,0,0,0,0
,Brooks Men LAUNCH 8 BLUE/ORANGE/WHITE 1103581D463 Size 12,Brooks Men LAUNCH 8 BLUE/ORANGE/WHITE 1103581D463 Size 12,FBALYB Amazon,3,3,0,0,0,0
,Brooks Men LAUNCH 8 BLUE/ORANGE/WHITE 1103581D463 Size 13,Brooks Men LAUNCH 8 BLUE/ORANGE/WHITE 1103581D463 Size 13,FBALYB Amazon,16,16,0,0,0,0
,Brooks Men LAUNCH 8 BLUE/ORANGE/WHITE 1103581D463 Size 8,Brooks Men LAUNCH 8 BLUE/ORANGE/WHITE 1103581D463 Size 8,FBALYB Amazon,17,17,0,0,0,0
,Brooks Men LAUNCH 8 BLUE/ORANGE/WHITE 1103581D463 Size 8.5,Brooks Men LAUNCH 8 BLUE/ORANGE/WHITE 1103581D463 Size 8.5,FBALYB Amazon,17,17,0,0,0,0
,Brooks Men LAUNCH 8 BLUE/ORANGE/WHITE 1103581D463 Size 9,Brooks Men LAUNCH 8 BLUE/ORANGE/WHITE 1103581D463 Size 9,FBALYB Amazon,15,15,0,0,0,0
,Brooks Men LAUNCH 8 BLUE/ORANGE/WHITE 1103581D463 Size 9.5,Brooks Men LAUNCH 8 BLUE/ORANGE/WHITE 1103581D463 Size 9.5,FBALYB Amazon,11,11,0,0,0,0
,Brooks Men LAUNCH 8 NIGHTLIFE/BLACK/WHITE 1103581D774 Size 10,Brooks Men LAUNCH 8 NIGHTLIFE/BLACK/WHITE 1103581D774 Size 10,FBALYB Amazon,5,5,0,0,0,0
,Brooks Men LAUNCH 8 NIGHTLIFE/BLACK/WHITE 1103581D774 Size 10.5,Brooks Men LAUNCH 8 NIGHTLIFE/BLACK/WHITE 1103581D774 Size 10.5,FBALYB Amazon,-2,-2,0,0,0,0
,Brooks Men LAUNCH 8 NIGHTLIFE/BLACK/WHITE 1103581D774 Size 11.5,Brooks Men LAUNCH 8 NIGHTLIFE/BLACK/WHITE 1103581D774 Size 11.5,FBALYB Amazon,-2,-2,0,0,0,0
,Brooks Men LAUNCH 8 NIGHTLIFE/BLACK/WHITE 1103581D774 Size 12,Brooks Men LAUNCH 8 NIGHTLIFE/BLACK/WHITE 1103581D774 Size 12,FBALYB Amazon,1,1,0,0,0,0
,Brooks Men LAUNCH 8 NIGHTLIFE/BLACK/WHITE 1103581D774 Size 13,Brooks Men LAUNCH 8 NIGHTLIFE/BLACK/WHITE 1103581D774 Size 13,FBALYB Amazon,5,5,0,0,0,0
,Brooks Men LAUNCH 8 NIGHTLIFE/BLACK/WHITE 1103581D774 Size 8,Brooks Men LAUNCH 8 NIGHTLIFE/BLACK/WHITE 1103581D774 Size 8,FBALYB Amazon,7,7,0,0,0,0
,Brooks Men LAUNCH 8 NIGHTLIFE/BLACK/WHITE 1103581D774 Size 9,Brooks Men LAUNCH 8 NIGHTLIFE/BLACK/WHITE 1103581D774 Size 9,FBALYB Amazon,1,1,0,0,0,0
,Brooks Men LAUNCH 8 NIGHTLIFE/BLACK/WHITE 1103581D774 Size 9.5,Brooks Men LAUNCH 8 NIGHTLIFE/BLACK/WHITE 1103581D774 Size 9.5,FBALYB Amazon,1,0,1,0,1,0
,Brooks Men LEVITATE 4 WHITE/BLACK 1103451D121 Size 10,Brooks Men LEVITATE 4 WHITE/BLACK 1103451D121 Size 10,FBALYB Amazon,12,12,0,0,0,0
,Brooks Men LEVITATE 4 WHITE/BLACK 1103451D121 Size 10.5,Brooks Men LEVITATE 4 WHITE/BLACK 1103451D121 Size 10.5,FBALYB Amazon,12,12,0,0,0,0
,Brooks Men LEVITATE 4 WHITE/BLACK 1103451D121 Size 11,Brooks Men LEVITATE 4 WHITE/BLACK 1103451D121 Size 11,FBALYB Amazon,4,4,0,0,0,0
,Brooks Men LEVITATE 4 WHITE/BLACK 1103451D121 Size 11.5,Brooks Men LEVITATE 4 WHITE/BLACK 1103451D121 Size 11.5,FBALYB Amazon,5,5,0,0,0,0
,Brooks Men LEVITATE 4 WHITE/BLACK 1103451D121 Size 12,Brooks Men LEVITATE 4 WHITE/BLACK 1103451D121 Size 12,FBALYB Amazon,3,3,0,0,0,0
,Brooks Men LEVITATE 4 WHITE/BLACK 1103451D121 Size 13,Brooks Men LEVITATE 4 WHITE/BLACK 1103451D121 Size 13,FBALYB Amazon,6,6,0,0,0,0
,Brooks Men LEVITATE 4 WHITE/BLACK 1103451D121 Size 8,Brooks Men LEVITATE 4 WHITE/BLACK 1103451D121 Size 8,FBALYB Amazon,6,6,0,0,0,0
,Brooks Men LEVITATE 4 WHITE/BLACK 1103451D121 Size 8.5,Brooks Men LEVITATE 4 WHITE/BLACK 1103451D121 Size 8.5,FBALYB Amazon,6,6,0,0,0,0
,Brooks Men LEVITATE 4 WHITE/BLACK 1103451D121 Size 9,Brooks Men LEVITATE 4 WHITE/BLACK 1103451D121 Size 9,FBALYB Amazon,6,6,0,0,0,0
,Brooks Men LEVITATE 4 WHITE/BLACK 1103451D121 Size 9.5,Brooks Men LEVITATE 4 WHITE/BLACK 1103451D121 Size 9.5,FBALYB Amazon,5,5,0,0,0,0
,Brooks Men's Addiction 14 Black/Charcoal/Black Size 11,Brooks Men's Addiction 14 Black/Charcoal/Black Size 11,FBALYB Amazon,-1,-1,0,0,0,0
,Brooks Men's Addiction 14 Black/Charcoal/Black Size 11.5,Brooks Men's Addiction 14 Black/Charcoal/Black Size 11.5,FBALYB Amazon,-1,-1,0,0,0,0
,Brooks Men's Addiction 14 Black/Charcoal/Black Size 8,Brooks Men's Addiction 14 Black/Charcoal/Black Size 8,FBALYB Amazon,-2,-2,0,0,0,0
,Brooks Men's Addiction 14 Black/Charcoal/Black Size 9.5,Brooks Men's Addiction 14 Black/Charcoal/Black Size 9.5,FBALYB Amazon,-2,-2,0,0,0,0
,Brooks Men's Adrenaline GTS 20 Black/Ebony/Ketchup Size 10,Brooks Men's Adrenaline GTS 20 Black/Ebony/Ketchup Size 10,FBALYB Amazon,-5,-5,0,0,0,0
,Brooks Men's Adrenaline GTS 20 Black/Ebony/Ketchup Size 10.5,Brooks Men's Adrenaline GTS 20 Black/Ebony/Ketchup Size 10.5,FBALYB Amazon,-4,-4,0,0,0,0
,Brooks Men's Adrenaline GTS 20 Black/Ebony/Ketchup Size 11.5,Brooks Men's Adrenaline GTS 20 Black/Ebony/Ketchup Size 11.5,Default Ridgefield,6,6,0,0,0,0
,Brooks Men's Adrenaline GTS 20 Black/Ebony/Ketchup Size 12,Brooks Men's Adrenaline GTS 20 Black/Ebony/Ketchup Size 12,FBALYB Amazon,0,0,0,2,0,0
,Brooks Men's Adrenaline GTS 20 Black/Ebony/Ketchup Size 13,Brooks Men's Adrenaline GTS 20 Black/Ebony/Ketchup Size 13,FBALYB Amazon,0,0,0,8,0,0
,Brooks Men's Adrenaline GTS 20 Black/Ebony/Ketchup Size 8,Brooks Men's Adrenaline GTS 20 Black/Ebony/Ketchup Size 8,FBALYB Amazon,0,0,0,6,0,0
,Brooks Men's Adrenaline GTS 20 Black/Ebony/Ketchup Size 8.5,Brooks Men's Adrenaline GTS 20 Black/Ebony/Ketchup Size 8.5,FBALYB Amazon,-1,-1,0,0,0,0
,Brooks Men's Adrenaline GTS 20 Black/Ebony/Ketchup Size 9,Brooks Men's Adrenaline GTS 20 Black/Ebony/Ketchup Size 9,FBALYB Amazon,-1,-1,0,0,0,0
,Brooks Men's Adrenaline GTS 20 Black/Ebony/Ketchup Size 9.5,Brooks Men's Adrenaline GTS 20 Black/Ebony/Ketchup Size 9.5,FBALYB Amazon,-1,-1,0,2,0,0
,Brooks Men's Adrenaline GTS 20 Black/Ebony Size 10,Brooks Men's Adrenaline GTS 20 Black/Ebony Size 10,FBALYB Amazon,-10,-10,0,1,0,0
,Brooks Men's Adrenaline GTS 20 Black/Ebony Size 10.5,Brooks Men's Adrenaline GTS 20 Black/Ebony Size 10.5,FBALYB Amazon,-5,-5,0,0,0,0
,Brooks Men's Adrenaline GTS 20 Black/Ebony Size 11,Brooks Men's Adrenaline GTS 20 Black/Ebony Size 11,FBALYB Amazon,-4,-4,0,0,0,0
,Brooks Men's Adrenaline GTS 20 Black/Ebony Size 11.5,Brooks Men's Adrenaline GTS 20 Black/Ebony Size 11.5,FBALYB Amazon,-4,-4,0,0,0,0
,Brooks Men's Adrenaline GTS 20 Black/Ebony Size 12,Brooks Men's Adrenaline GTS 20 Black/Ebony Size 12,FBALYB Amazon,-8,-8,0,0,0,0
,Brooks Men's Adrenaline GTS 20 Black/Ebony Size 13,Brooks Men's Adrenaline GTS 20 Black/Ebony Size 13,FBALYB Amazon,-1,-1,0,0,0,0
,Brooks Men's Adrenaline GTS 20 Black/Ebony Size 7.5,Brooks Men's Adrenaline GTS 20 Black/Ebony Size 7.5,FBALYB Amazon,-5,-5,0,0,0,0
,Brooks Men's Adrenaline GTS 20 Black/Ebony Size 8,Brooks Men's Adrenaline GTS 20 Black/Ebony Size 8,FBALYB Amazon,-9,-9,0,0,0,0
,Brooks Men's Adrenaline GTS 20 Black/Ebony Size 8.5,Brooks Men's Adrenaline GTS 20 Black/Ebony Size 8.5,FBALYB Amazon,-10,-10,0,0,0,0
,Brooks Men's Adrenaline GTS 20 Black/Ebony Size 9,Brooks Men's Adrenaline GTS 20 Black/Ebony Size 9,FBALYB Amazon,-7,-7,0,0,0,0
,Brooks Men's Adrenaline GTS 20 Black/Ebony Size 9.5,Brooks Men's Adrenaline GTS 20 Black/Ebony Size 9.5,FBALYB Amazon,-41,-41,0,27,0,0
,Brooks Men's Adrenaline GTS 20 Black/Grey/Ebony Size 10,Brooks Men's Adrenaline GTS 20 Black/Grey/Ebony Size 10,FBALYB Amazon,-2,-2,0,0,0,0
,Brooks Men's Adrenaline GTS 20 Black/Grey/Ebony Size 10.5,Brooks Men's Adrenaline GTS 20 Black/Grey/Ebony Size 10.5,FBALYB Amazon,-22,-22,0,18,0,0
,Brooks Men's Adrenaline GTS 20 Black/Grey/Ebony Size 11,Brooks Men's Adrenaline GTS 20 Black/Grey/Ebony Size 11,FBALYB Amazon,-3,-3,0,1,0,0
,Brooks Men's Adrenaline GTS 20 Black/Grey/Ebony Size 11.5,Brooks Men's Adrenaline GTS 20 Black/Grey/Ebony Size 11.5,FBALYB Amazon,-8,-8,0,6,0,0
,Brooks Men's Adrenaline GTS 20 Black/Grey/Ebony Size 12,Brooks Men's Adrenaline GTS 20 Black/Grey/Ebony Size 12,FBALYB Amazon,-2,-2,0,0,0,0
,Brooks Men's Adrenaline GTS 20 Black/Grey/Ebony Size 13,Brooks Men's Adrenaline GTS 20 Black/Grey/Ebony Size 13,FBALYB Amazon,-1,-1,0,0,0,0
,Brooks Men's Adrenaline GTS 20 Black/Grey/Ebony Size 7.5,Brooks Men's Adrenaline GTS 20 Black/Grey/Ebony Size 7.5,Default,1,1,0,0,0,0
,Brooks Men's Adrenaline GTS 20 Black/Grey/Ebony Size 7.5,Brooks Men's Adrenaline GTS 20 Black/Grey/Ebony Size 7.5,FBALYB Amazon,-12,-12,0,0,0,0
,Brooks Men's Adrenaline GTS 20 Black/Grey/Ebony Size 8,Brooks Men's Adrenaline GTS 20 Black/Grey/Ebony Size 8,FBALYB Amazon,-3,-3,0,0,0,0
,Brooks Men's Adrenaline GTS 20 Black/Grey/Ebony Size 8.5,Brooks Men's Adrenaline GTS 20 Black/Grey/Ebony Size 8.5,FBALYB Amazon,-3,-3,0,0,0,0
,Brooks Men's Adrenaline GTS 20 Black/Grey/Ebony Size 9,Brooks Men's Adrenaline GTS 20 Black/Grey/Ebony Size 9,FBALYB Amazon,-2,-2,0,0,0,0
,Brooks Men's Adrenaline GTS 20 Black/Grey/Ebony Size 9.5,Brooks Men's Adrenaline GTS 20 Black/Grey/Ebony Size 9.5,FBALYB Amazon,-22,-22,0,18,0,0
,Brooks Men's Adrenaline GTS 20 Black/Grey Size 10.5,Brooks Men's Adrenaline GTS 20 Black/Grey Size 10.5,FBALYB Amazon,-18,-18,0,18,0,0
,Brooks Men's Adrenaline GTS 20 Black/Grey Size 11.5,Brooks Men's Adrenaline GTS 20 Black/Grey Size 11.5,FBALYB Amazon,-6,-6,0,6,0,0
,Brooks Men's Adrenaline GTS 20 Black/Grey Size 12,Brooks Men's Adrenaline GTS 20 Black/Grey Size 12,Default Oxford,1,1,0,0,0,0
,Brooks Men's Adrenaline GTS 20 Black/Grey Size 13,Brooks Men's Adrenaline GTS 20 Black/Grey Size 13,FBALYB Amazon,-1,-1,0,0,0,0
,Brooks Men's Adrenaline GTS 20 Black/Grey Size 7.5,Brooks Men's Adrenaline GTS 20 Black/Grey Size 7.5,FBALYB Amazon,-7,-7,0,6,0,0
,Brooks Men's Adrenaline GTS 20 Black/Grey Size 8,Brooks Men's Adrenaline GTS 20 Black/Grey Size 8,Default Oxford,1,1,0,0,0,0
,Brooks Men's Adrenaline GTS 20 Black/Grey Size 8.5,Brooks Men's Adrenaline GTS 20 Black/Grey Size 8.5,FBALYB Amazon,-13,-13,0,12,0,0
,Brooks Men's Adrenaline GTS 20 Black/Grey Size 9,Brooks Men's Adrenaline GTS 20 Black/Grey Size 9,Default Ridgefield,18,18,0,0,0,0
,Brooks Men's Adrenaline GTS 20 Black/Grey Size 9.5,Brooks Men's Adrenaline GTS 20 Black/Grey Size 9.5,FBALYB Amazon,-18,-18,0,18,0,0
,Brooks Men's Adrenaline GTS 20 Black/Lime/Blue Grass Size 10,Brooks Men's Adrenaline GTS 20 Black/Lime/Blue Grass Size 10,FBALYB Amazon,22,22,0,0,0,0
,Brooks Men's Adrenaline GTS 20 Black/Lime/Blue Grass Size 10.5,Brooks Men's Adrenaline GTS 20 Black/Lime/Blue Grass Size 10.5,FBALYB Amazon,-1,-1,0,0,0,0
,Brooks Men's Adrenaline GTS 20 Black/Lime/Blue Grass Size 11,Brooks Men's Adrenaline GTS 20 Black/Lime/Blue Grass Size 11,FBALYB Amazon,-2,-2,0,0,0,0
,Brooks Men's Adrenaline GTS 20 Black/Lime/Blue Grass Size 11.5,Brooks Men's Adrenaline GTS 20 Black/Lime/Blue Grass Size 11.5,Default Ridgefield,2,2,0,0,0,0
,Brooks Men's Adrenaline GTS 20 Black/Lime/Blue Grass Size 13,Brooks Men's Adrenaline GTS 20 Black/Lime/Blue Grass Size 13,Default Oxford,1,1,0,0,0,0
,Brooks Men's Adrenaline GTS 20 Black/Lime/Blue Grass Size 7.5,Brooks Men's Adrenaline GTS 20 Black/Lime/Blue Grass Size 7.5,FBALYB Amazon,4,4,0,0,0,0
,Brooks Men's Adrenaline GTS 20 Black/Lime/Blue Grass Size 8,Brooks Men's Adrenaline GTS 20 Black/Lime/Blue Grass Size 8,FBALYB Amazon,8,8,0,0,0,0
,Brooks Men's Adrenaline GTS 20 Black/Lime/Blue Grass Size 8.5,Brooks Men's Adrenaline GTS 20 Black/Lime/Blue Grass Size 8.5,FBALYB Amazon,8,8,0,0,0,0
,Brooks Men's Adrenaline GTS 20 Black/Lime/Blue Grass Size 9,Brooks Men's Adrenaline GTS 20 Black/Lime/Blue Grass Size 9,Default Oxford,1,1,0,0,0,0
,Brooks Men's Adrenaline GTS 20 Black/Lime/Blue Grass Size 9,Brooks Men's Adrenaline GTS 20 Black/Lime/Blue Grass Size 9,FBALYB Amazon,9,9,0,0,0,0
,Brooks Men's Adrenaline GTS 20 Black/Lime/Blue Grass Size 9.5,Brooks Men's Adrenaline GTS 20 Black/Lime/Blue Grass Size 9.5,FBALYB Amazon,3,3,0,0,0,0
,Brooks Men's Adrenaline GTS 20 Blue/Black/Nightlife Size 10,Brooks Men's Adrenaline GTS 20 Blue/Black/Nightlife Size 10,Default Oxford,10,10,0,0,0,0
,Brooks Men's Adrenaline GTS 20 Blue/Black/Nightlife Size 10.5,Brooks Men's Adrenaline GTS 20 Blue/Black/Nightlife Size 10.5,Default Oxford,10,10,0,0,0,0
,Brooks Men's Adrenaline GTS 20 Blue/Black/Nightlife Size 11,Brooks Men's Adrenaline GTS 20 Blue/Black/Nightlife Size 11,Default Oxford,5,5,0,0,0,0
,Brooks Men's Adrenaline GTS 20 Blue/Black/Nightlife Size 11.5,Brooks Men's Adrenaline GTS 20 Blue/Black/Nightlife Size 11.5,Default Oxford,5,5,0,0,0,0
,Brooks Men's Adrenaline GTS 20 Blue/Black/Nightlife Size 12,Brooks Men's Adrenaline GTS 20 Blue/Black/Nightlife Size 12,Default Oxford,5,5,0,0,0,0
,Brooks Men's Adrenaline GTS 20 Blue/Black/Nightlife Size 13,Brooks Men's Adrenaline GTS 20 Blue/Black/Nightlife Size 13,Default Oxford,5,5,0,0,0,0
,Brooks Men's Adrenaline GTS 20 Blue/Black/Nightlife Size 8,Brooks Men's Adrenaline GTS 20 Blue/Black/Nightlife Size 8,Default Oxford,5,5,0,0,0,0
,Brooks Men's Adrenaline GTS 20 Blue/Black/Nightlife Size 8.5,Brooks Men's Adrenaline GTS 20 Blue/Black/Nightlife Size 8.5,Default Oxford,5,5,0,0,0,0
,Brooks Men's Adrenaline GTS 20 Blue/Black/Nightlife Size 9,Brooks Men's Adrenaline GTS 20 Blue/Black/Nightlife Size 9,Default Oxford,5,5,0,0,0,0
,Brooks Men's Adrenaline GTS 20 Blue/Black/Nightlife Size 9.5,Brooks Men's Adrenaline GTS 20 Blue/Black/Nightlife Size 9.5,Default Oxford,5,5,0,0,0,0
,Brooks Men's Adrenaline GTS 20 Grey/Blue/Navy Size 10.5,Brooks Men's Adrenaline GTS 20 Grey/Blue/Navy Size 10.5,FBALYB Amazon,3,3,0,0,0,0
,Brooks Men's Adrenaline GTS 20 Grey/Blue/Navy Size 11.5,Brooks Men's Adrenaline GTS 20 Grey/Blue/Navy Size 11.5,FBALYB Amazon,-6,-6,0,6,0,0
,Brooks Men's Adrenaline GTS 20 Grey/Blue/Navy Size 13,Brooks Men's Adrenaline GTS 20 Grey/Blue/Navy Size 13,FBALYB Amazon,0,0,0,1,0,0
,Brooks Men's Adrenaline GTS 20 Grey/Blue/Navy Size 8.5,Brooks Men's Adrenaline GTS 20 Grey/Blue/Navy Size 8.5,FBALYB Amazon,6,6,0,0,0,0
,Brooks Men's Adrenaline GTS 20 Poseidon/Peacoat/Grey Size 10,Brooks Men's Adrenaline GTS 20 Poseidon/Peacoat/Grey Size 10,FBALYB Amazon,-17,-17,0,12,0,0
,Brooks Men's Adrenaline GTS 20 Poseidon/Peacoat/Grey Size 10.5,Brooks Men's Adrenaline GTS 20 Poseidon/Peacoat/Grey Size 10.5,FBALYB Amazon,-11,-11,0,0,0,0
,Brooks Men's Adrenaline GTS 20 Poseidon/Peacoat/Grey Size 11,Brooks Men's Adrenaline GTS 20 Poseidon/Peacoat/Grey Size 11,FBALYB Amazon,-6,-6,0,6,0,0
,Brooks Men's Adrenaline GTS 20 Poseidon/Peacoat/Grey Size 11.5,Brooks Men's Adrenaline GTS 20 Poseidon/Peacoat/Grey Size 11.5,FBALYB Amazon,-10,-10,0,0,0,0
,Brooks Men's Adrenaline GTS 20 Poseidon/Peacoat/Grey Size 12,Brooks Men's Adrenaline GTS 20 Poseidon/Peacoat/Grey Size 12,FBALYB Amazon,-15,-15,0,6,0,0
,Brooks Men's Adrenaline GTS 20 Poseidon/Peacoat/Grey Size 13,Brooks Men's Adrenaline GTS 20 Poseidon/Peacoat/Grey Size 13,FBALYB Amazon,-12,-12,0,0,0,0
,Brooks Men's Adrenaline GTS 20 Poseidon/Peacoat/Grey Size 7.5,Brooks Men's Adrenaline GTS 20 Poseidon/Peacoat/Grey Size 7.5,FBALYB Amazon,-3,-3,0,0,0,0
,Brooks Men's Adrenaline GTS 20 Poseidon/Peacoat/Grey Size 8,Brooks Men's Adrenaline GTS 20 Poseidon/Peacoat/Grey Size 8,FBALYB Amazon,-8,-8,0,6,0,0
,Brooks Men's Adrenaline GTS 20 Poseidon/Peacoat/Grey Size 8.5,Brooks Men's Adrenaline GTS 20 Poseidon/Peacoat/Grey Size 8.5,FBALYB Amazon,-10,-10,0,6,0,0
,Brooks Men's Adrenaline GTS 20 Poseidon/Peacoat/Grey Size 9,Brooks Men's Adrenaline GTS 20 Poseidon/Peacoat/Grey Size 9,FBALYB Amazon,4,3,1,0,1,0
,Brooks Men's Adrenaline GTS 20 Poseidon/Peacoat/Grey Size 9.5,Brooks Men's Adrenaline GTS 20 Poseidon/Peacoat/Grey Size 9.5,FBALYB Amazon,-5,-5,0,0,0,0
,Brooks Men's Adrenaline GTS 20 Red/Black/Grey Size 10,Brooks Men's Adrenaline GTS 20 Red/Black/Grey Size 10,FBALYB Amazon,2,2,0,0,0,0
,Brooks Men's Adrenaline GTS 20 Red/Black/Grey Size 11.5,Brooks Men's Adrenaline GTS 20 Red/Black/Grey Size 11.5,FBALYB Amazon,-1,-1,0,0,0,0
,Brooks Men's Adrenaline GTS 20 Red/Black/Grey Size 12,Brooks Men's Adrenaline GTS 20 Red/Black/Grey Size 12,FBALYB Amazon,-2,-2,0,2,0,0
,Brooks Men's Adrenaline GTS 20 Red/Black/Grey Size 13,Brooks Men's Adrenaline GTS 20 Red/Black/Grey Size 13,FBALYB Amazon,-2,-2,0,2,0,0
,Brooks Men's Adrenaline GTS 20 Red/Black/Grey Size 8.5,Brooks Men's Adrenaline GTS 20 Red/Black/Grey Size 8.5,Default Oxford,6,6,0,0,0,0
,Brooks Men's Adrenaline GTS 20 Red/Black/Grey Size 9,Brooks Men's Adrenaline GTS 20 Red/Black/Grey Size 9,FBALYB Amazon,2,2,0,0,0,0
,Brooks Men's Adrenaline GTS 20 Red/Black/Grey Size 9.5,Brooks Men's Adrenaline GTS 20 Red/Black/Grey Size 9.5,Default Oxford,6,6,0,0,0,0
,Brooks Men's Adrenaline GTS 20 White/Black/Grey Size 10,Brooks Men's Adrenaline GTS 20 White/Black/Grey Size 10,FBALYB Amazon,-1,-1,0,0,0,0
,Brooks Men's Adrenaline GTS 20 White/Black/Grey Size 10.5,Brooks Men's Adrenaline GTS 20 White/Black/Grey Size 10.5,FBALYB Amazon,-7,-7,0,0,0,0
,Brooks Men's Adrenaline GTS 20 White/Black/Grey Size 11,Brooks Men's Adrenaline GTS 20 White/Black/Grey Size 11,FBALYB Amazon,-2,-2,0,0,0,0
,Brooks Men's Adrenaline GTS 20 White/Black/Grey Size 11.5,Brooks Men's Adrenaline GTS 20 White/Black/Grey Size 11.5,FBALYB Amazon,-2,-2,0,0,0,0
,Brooks Men's Adrenaline GTS 20 White/Black/Grey Size 12,Brooks Men's Adrenaline GTS 20 White/Black/Grey Size 12,FBALYB Amazon,-1,-1,0,1,0,0
,Brooks Men's Adrenaline GTS 20 White/Black/Grey Size 13,Brooks Men's Adrenaline GTS 20 White/Black/Grey Size 13,FBALYB Amazon,-2,-2,0,0,0,0
,Brooks Men's Adrenaline GTS 20 White/Black/Grey Size 8,Brooks Men's Adrenaline GTS 20 White/Black/Grey Size 8,FBALYB Amazon,-10,-10,0,0,0,0
,Brooks Men's Adrenaline GTS 20 White/Black/Grey Size 8.5,Brooks Men's Adrenaline GTS 20 White/Black/Grey Size 8.5,FBALYB Amazon,-2,-2,0,0,0,0
,Brooks Men's Adrenaline GTS 20 White/Black/Grey Size 9,Brooks Men's Adrenaline GTS 20 White/Black/Grey Size 9,FBALYB Amazon,-1,-1,0,0,0,0
,Brooks Men's Adrenaline GTS 20 White/Black/Grey Size 9.5,Brooks Men's Adrenaline GTS 20 White/Black/Grey Size 9.5,FBALYB Amazon,-4,-4,0,0,0,0
,Brooks Men's Adrenaline GTS 21 Black/Black Size 10,Brooks Men's Adrenaline GTS 21 Black/Black Size 10,FBALYB Amazon,-6,-6,0,0,0,0
,Brooks Men's Adrenaline GTS 21 Black/Black Size 10.5,Brooks Men's Adrenaline GTS 21 Black/Black Size 10.5,Default,0,-1,1,0,0,1
,Brooks Men's Adrenaline GTS 21 Black/Black Size 10.5,Brooks Men's Adrenaline GTS 21 Black/Black Size 10.5,FBALYB Amazon,-6,-6,0,0,0,0
,Brooks Men's Adrenaline GTS 21 Black/Black Size 11.5,Brooks Men's Adrenaline GTS 21 Black/Black Size 11.5,FBALYB Amazon,-2,-2,0,0,0,0
,Brooks Men's Adrenaline GTS 21 Black/Black Size 12,Brooks Men's Adrenaline GTS 21 Black/Black Size 12,FBALYB Amazon,-1,-1,0,0,0,0
,Brooks Men's Adrenaline GTS 21 Black/Black Size 13,Brooks Men's Adrenaline GTS 21 Black/Black Size 13,Default,0,-1,1,0,0,0
,Brooks Men's Adrenaline GTS 21 Black/Black Size 13,Brooks Men's Adrenaline GTS 21 Black/Black Size 13,FBALYB Amazon,-2,-2,0,0,0,0
,Brooks Men's Adrenaline GTS 21 Black/Black Size 7.5,Brooks Men's Adrenaline GTS 21 Black/Black Size 7.5,Default,0,-1,1,0,0,0
,Brooks Men's Adrenaline GTS 21 Black/Black Size 7.5,Brooks Men's Adrenaline GTS 21 Black/Black Size 7.5,FBALYB Amazon,0,0,0,1,0,0
,Brooks Men's Adrenaline GTS 21 Black/Black Size 8,Brooks Men's Adrenaline GTS 21 Black/Black Size 8,FBALYB Amazon,-2,-2,0,1,0,0
,Brooks Men's Adrenaline GTS 21 Black/Black Size 8.5,Brooks Men's Adrenaline GTS 21 Black/Black Size 8.5,FBALYB Amazon,-6,-6,0,0,0,0
,Brooks Men's Adrenaline GTS 21 Black/Black Size 9,Brooks Men's Adrenaline GTS 21 Black/Black Size 9,FBALYB Amazon,-3,-3,0,0,0,0
,Brooks Men's Adrenaline GTS 21 Black/Black Size 9.5,Brooks Men's Adrenaline GTS 21 Black/Black Size 9.5,FBALYB Amazon,-2,-2,0,0,0,0
,Brooks Men's Adrenaline GTS 21 Black/Blue Jewel/Nightlife Size 10,Brooks Men's Adrenaline GTS 21 Black/Blue Jewel/Nightlife Size 10,Default,0,-1,1,0,0,0
,Brooks Men's Adrenaline GTS 21 Black/Blue Jewel/Nightlife Size 10,Brooks Men's Adrenaline GTS 21 Black/Blue Jewel/Nightlife Size 10,FBALYB Amazon,-1,-1,0,0,0,0
,Brooks Men's Adrenaline GTS 21 Black/Blue Jewel/Nightlife Size 10.5,Brooks Men's Adrenaline GTS 21 Black/Blue Jewel/Nightlife Size 10.5,FBALYB Amazon,-2,-2,0,0,0,0
,Brooks Men's Adrenaline GTS 21 Black/Blue Jewel/Nightlife Size 11,Brooks Men's Adrenaline GTS 21 Black/Blue Jewel/Nightlife Size 11,FBALYB Amazon,-1,-1,0,0,0,0
,Brooks Men's Adrenaline GTS 21 Black/Blue Jewel/Nightlife Size 11.5,Brooks Men's Adrenaline GTS 21 Black/Blue Jewel/Nightlife Size 11.5,FBALYB Amazon,-1,-1,0,0,0,0
,Brooks Men's Adrenaline GTS 21 Black/Blue Jewel/Nightlife Size 13,Brooks Men's Adrenaline GTS 21 Black/Blue Jewel/Nightlife Size 13,Default,0,-1,1,0,0,0
,Brooks Men's Adrenaline GTS 21 Black/Blue Jewel/Nightlife Size 13,Brooks Men's Adrenaline GTS 21 Black/Blue Jewel/Nightlife Size 13,FBALYB Amazon,-1,-1,0,0,0,0
,Brooks Men's Adrenaline GTS 21 Black/Blue Jewel/Nightlife Size 7.5,Brooks Men's Adrenaline GTS 21 Black/Blue Jewel/Nightlife Size 7.5,Default,0,-1,1,0,0,0
,Brooks Men's Adrenaline GTS 21 Black/Blue Jewel/Nightlife Size 8,Brooks Men's Adrenaline GTS 21 Black/Blue Jewel/Nightlife Size 8,FBALYB Amazon,-6,-6,0,0,0,0
,Brooks Men's Adrenaline GTS 21 Black/Blue Jewel/Nightlife Size 8.5,Brooks Men's Adrenaline GTS 21 Black/Blue Jewel/Nightlife Size 8.5,FBALYB Amazon,-4,-4,0,0,0,0
,Brooks Men's Adrenaline GTS 21 Black/Blue Jewel/Nightlife Size 9,Brooks Men's Adrenaline GTS 21 Black/Blue Jewel/Nightlife Size 9,FBALYB Amazon,-3,-3,0,0,0,0
,Brooks Men's Adrenaline GTS 21 Black/Blue Jewel/Nightlife Size 9.5,Brooks Men's Adrenaline GTS 21 Black/Blue Jewel/Nightlife Size 9.5,FBALYB Amazon,-2,-2,0,0,0,0
,Brooks Men's Adrenaline GTS 21 Blackened Pearl/Black Grey Size 10,Brooks Men's Adrenaline GTS 21 Blackened Pearl/Black Grey Size 10,FBALYB Amazon,-3,-3,0,1,0,0
,Brooks Men's Adrenaline GTS 21 Blackened Pearl/Black Grey Size 10.5,Brooks Men's Adrenaline GTS 21 Blackened Pearl/Black Grey Size 10.5,Default,0,-1,1,0,0,0
,Brooks Men's Adrenaline GTS 21 Blackened Pearl/Black Grey Size 10.5,Brooks Men's Adrenaline GTS 21 Blackened Pearl/Black Grey Size 10.5,FBALYB Amazon,-1,-1,0,0,0,0
,Brooks Men's Adrenaline GTS 21 Blackened Pearl/Black Grey Size 11,Brooks Men's Adrenaline GTS 21 Blackened Pearl/Black Grey Size 11,FBALYB Amazon,-3,-3,0,0,0,0
,Brooks Men's Adrenaline GTS 21 Blackened Pearl/Black Grey Size 11.5,Brooks Men's Adrenaline GTS 21 Blackened Pearl/Black Grey Size 11.5,FBALYB Amazon,-1,-1,0,0,0,0
,Brooks Men's Adrenaline GTS 21 Blackened Pearl/Black Grey Size 12,Brooks Men's Adrenaline GTS 21 Blackened Pearl/Black Grey Size 12,FBALYB Amazon,-3,-3,0,0,0,0
,Brooks Men's Adrenaline GTS 21 Blackened Pearl/Black Grey Size 13,Brooks Men's Adrenaline GTS 21 Blackened Pearl/Black Grey Size 13,Default,0,-1,1,0,0,0
,Brooks Men's Adrenaline GTS 21 Blackened Pearl/Black Grey Size 13,Brooks Men's Adrenaline GTS 21 Blackened Pearl/Black Grey Size 13,FBALYB Amazon,-2,-2,0,0,0,0
,Brooks Men's Adrenaline GTS 21 Blackened Pearl/Black Grey Size 7.5,Brooks Men's Adrenaline GTS 21 Blackened Pearl/Black Grey Size 7.5,Default,0,-1,1,0,0,0
,Brooks Men's Adrenaline GTS 21 Blackened Pearl/Black Grey Size 7.5,Brooks Men's Adrenaline GTS 21 Blackened Pearl/Black Grey Size 7.5,FBALYB Amazon,-2,-2,0,0,0,0
,Brooks Men's Adrenaline GTS 21 Blackened Pearl/Black Grey Size 8,Brooks Men's Adrenaline GTS 21 Blackened Pearl/Black Grey Size 8,FBALYB Amazon,-1,-1,0,0,0,0
,Brooks Men's Adrenaline GTS 21 Blackened Pearl/Black Grey Size 8.5,Brooks Men's Adrenaline GTS 21 Blackened Pearl/Black Grey Size 8.5,FBALYB Amazon,-1,-1,0,0,0,0
,Brooks Men's Adrenaline GTS 21 Blackened Pearl/Black Grey Size 9.5,Brooks Men's Adrenaline GTS 21 Blackened Pearl/Black Grey Size 9.5,FBALYB Amazon,-1,-1,0,0,0,0
,Brooks Men's Adrenaline GTS 21 Grey/Tradewinds/Deep Cobalt Size 10,Brooks Men's Adrenaline GTS 21 Grey/Tradewinds/Deep Cobalt Size 10,FBALYB Amazon,-6,-6,0,0,0,0
,Brooks Men's Adrenaline GTS 21 Grey/Tradewinds/Deep Cobalt Size 10.5,Brooks Men's Adrenaline GTS 21 Grey/Tradewinds/Deep Cobalt Size 10.5,Default,0,-1,1,0,0,0
,Brooks Men's Adrenaline GTS 21 Grey/Tradewinds/Deep Cobalt Size 10.5,Brooks Men's Adrenaline GTS 21 Grey/Tradewinds/Deep Cobalt Size 10.5,FBALYB Amazon,-1,-1,0,0,0,0
,Brooks Men's Adrenaline GTS 21 Grey/Tradewinds/Deep Cobalt Size 11,Brooks Men's Adrenaline GTS 21 Grey/Tradewinds/Deep Cobalt Size 11,FBALYB Amazon,-3,-3,0,0,0,0
,Brooks Men's Adrenaline GTS 21 Grey/Tradewinds/Deep Cobalt Size 11.5,Brooks Men's Adrenaline GTS 21 Grey/Tradewinds/Deep Cobalt Size 11.5,FBALYB Amazon,-1,-1,0,0,0,0
,Brooks Men's Adrenaline GTS 21 Grey/Tradewinds/Deep Cobalt Size 12,Brooks Men's Adrenaline GTS 21 Grey/Tradewinds/Deep Cobalt Size 12,FBALYB Amazon,-3,-3,0,0,0,0
,Brooks Men's Adrenaline GTS 21 Grey/Tradewinds/Deep Cobalt Size 13,Brooks Men's Adrenaline GTS 21 Grey/Tradewinds/Deep Cobalt Size 13,Default,0,-1,1,0,0,0
,Brooks Men's Adrenaline GTS 21 Grey/Tradewinds/Deep Cobalt Size 13,Brooks Men's Adrenaline GTS 21 Grey/Tradewinds/Deep Cobalt Size 13,FBALYB Amazon,-2,-2,0,0,0,0
,Brooks Men's Adrenaline GTS 21 Grey/Tradewinds/Deep Cobalt Size 7.5,Brooks Men's Adrenaline GTS 21 Grey/Tradewinds/Deep Cobalt Size 7.5,Default,0,-1,1,0,0,0
,Brooks Men's Adrenaline GTS 21 Grey/Tradewinds/Deep Cobalt Size 7.5,Brooks Men's Adrenaline GTS 21 Grey/Tradewinds/Deep Cobalt Size 7.5,FBALYB Amazon,-2,-2,0,1,0,0
,Brooks Men's Adrenaline GTS 21 Grey/Tradewinds/Deep Cobalt Size 8,Brooks Men's Adrenaline GTS 21 Grey/Tradewinds/Deep Cobalt Size 8,FBALYB Amazon,-3,-3,0,0,0,0
,Brooks Men's Adrenaline GTS 21 Grey/Tradewinds/Deep Cobalt Size 8.5,Brooks Men's Adrenaline GTS 21 Grey/Tradewinds/Deep Cobalt Size 8.5,Default,0,0,0,0,0,1
,Brooks Men's Adrenaline GTS 21 Grey/Tradewinds/Deep Cobalt Size 8.5,Brooks Men's Adrenaline GTS 21 Grey/Tradewinds/Deep Cobalt Size 8.5,FBALYB Amazon,-6,-6,0,1,0,0
,Brooks Men's Adrenaline GTS 21 Grey/Tradewinds/Deep Cobalt Size 9,Brooks Men's Adrenaline GTS 21 Grey/Tradewinds/Deep Cobalt Size 9,FBALYB Amazon,-5,-5,0,0,0,0
,Brooks Men's Adrenaline GTS 21 Grey/Tradewinds/Deep Cobalt Size 9.5,Brooks Men's Adrenaline GTS 21 Grey/Tradewinds/Deep Cobalt Size 9.5,FBALYB Amazon,-1,-1,0,0,0,0
,Brooks Men's Adrenaline GTS 21 Jet Stream/Black Capri Size 10,Brooks Men's Adrenaline GTS 21 Jet Stream/Black Capri Size 10,Default,0,-1,1,0,0,0
,Brooks Men's Adrenaline GTS 21 Jet Stream/Black Capri Size 10,Brooks Men's Adrenaline GTS 21 Jet Stream/Black Capri Size 10,FBALYB Amazon,-4,-4,0,0,0,0
,Brooks Men's Adrenaline GTS 21 Jet Stream/Black Capri Size 10.5,Brooks Men's Adrenaline GTS 21 Jet Stream/Black Capri Size 10.5,FBALYB Amazon,-2,-2,0,0,0,0
,Brooks Men's Adrenaline GTS 21 Jet Stream/Black Capri Size 11,Brooks Men's Adrenaline GTS 21 Jet Stream/Black Capri Size 11,FBALYB Amazon,-4,-4,0,0,0,0
,Brooks Men's Adrenaline GTS 21 Jet Stream/Black Capri Size 11.5,Brooks Men's Adrenaline GTS 21 Jet Stream/Black Capri Size 11.5,FBALYB Amazon,-1,-1,0,0,0,0
,Brooks Men's Adrenaline GTS 21 Jet Stream/Black Capri Size 12,Brooks Men's Adrenaline GTS 21 Jet Stream/Black Capri Size 12,FBALYB Amazon,-4,-4,0,0,0,0
,Brooks Men's Adrenaline GTS 21 Jet Stream/Black Capri Size 13,Brooks Men's Adrenaline GTS 21 Jet Stream/Black Capri Size 13,Default,0,-1,1,0,0,0
,Brooks Men's Adrenaline GTS 21 Jet Stream/Black Capri Size 7.5,Brooks Men's Adrenaline GTS 21 Jet Stream/Black Capri Size 7.5,Default,0,-1,1,0,0,0
,Brooks Men's Adrenaline GTS 21 Jet Stream/Black Capri Size 7.5,Brooks Men's Adrenaline GTS 21 Jet Stream/Black Capri Size 7.5,FBALYB Amazon,-1,-1,0,0,0,0
,Brooks Men's Adrenaline GTS 21 Jet Stream/Black Capri Size 8,Brooks Men's Adrenaline GTS 21 Jet Stream/Black Capri Size 8,FBALYB Amazon,-1,-1,0,0,0,0
,Brooks Men's Adrenaline GTS 21 Jet Stream/Black Capri Size 8.5,Brooks Men's Adrenaline GTS 21 Jet Stream/Black Capri Size 8.5,Default,0,0,0,0,0,1
,Brooks Men's Adrenaline GTS 21 Jet Stream/Black Capri Size 9,Brooks Men's Adrenaline GTS 21 Jet Stream/Black Capri Size 9,FBALYB Amazon,-4,-4,0,0,0,0
,Brooks Men's Adrenaline GTS 21 Jet Stream/Black Capri Size 9.5,Brooks Men's Adrenaline GTS 21 Jet Stream/Black Capri Size 9.5,FBALYB Amazon,-2,-2,0,0,0,0
,Brooks Men's Bedlam 2 Ebony/Black/Grey Size 10,Brooks Men's Bedlam 2 Ebony/Black/Grey Size 10,Default Ridgefield,12,12,0,0,0,0
,Brooks Men's Bedlam 2 Ebony/Black/Grey Size 10.5,Brooks Men's Bedlam 2 Ebony/Black/Grey Size 10.5,Default Ridgefield,6,6,0,0,0,0
,Brooks Men's Bedlam 2 Ebony/Black/Grey Size 11,Brooks Men's Bedlam 2 Ebony/Black/Grey Size 11,Default Ridgefield,6,6,0,0,0,0
,Brooks Men's Bedlam 2 Ebony/Black/Grey Size 12,Brooks Men's Bedlam 2 Ebony/Black/Grey Size 12,Default Ridgefield,6,6,0,0,0,0
,Brooks Men's Bedlam 2 Ebony/Black/Grey Size 7.5,Brooks Men's Bedlam 2 Ebony/Black/Grey Size 7.5,Default Ridgefield,6,6,0,0,0,0
,Brooks Men's Bedlam 2 Ebony/Black/Grey Size 7.5,Brooks Men's Bedlam 2 Ebony/Black/Grey Size 7.5,FBALYB Amazon,1,1,0,0,0,0
,Brooks Men's Bedlam 2 Ebony/Black/Grey Size 8,Brooks Men's Bedlam 2 Ebony/Black/Grey Size 8,Default Ridgefield,6,6,0,0,0,0
,Brooks Men's Bedlam 2 Ebony/Black/Grey Size 8,Brooks Men's Bedlam 2 Ebony/Black/Grey Size 8,FBALYB Amazon,-3,-3,0,0,0,0
,Brooks Men's Bedlam 2 Ebony/Black/Grey Size 8.5,Brooks Men's Bedlam 2 Ebony/Black/Grey Size 8.5,Default Ridgefield,11,11,0,0,0,0
,Brooks Men's Bedlam 2 Ebony/Black/Grey Size 9,Brooks Men's Bedlam 2 Ebony/Black/Grey Size 9,Default Ridgefield,24,24,0,0,0,0
,Brooks Men's Bedlam 2 Ebony/Black/Grey Size 9.5,Brooks Men's Bedlam 2 Ebony/Black/Grey Size 9.5,Default Ridgefield,12,12,0,0,0,0
,Brooks Men's Bedlam 2 Ebony/Black/Grey Size 9.5,Brooks Men's Bedlam 2 Ebony/Black/Grey Size 9.5,FBALYB Amazon,9,9,0,0,0,0
,Brooks Men's Cascadia 14 Poseidon/Orange/Grey Size 10,Brooks Men's Cascadia 14 Poseidon/Orange/Grey Size 10,Default Ridgefield,4,4,0,0,0,0
,Brooks Men's Cascadia 14 Poseidon/Orange/Grey Size 10.5,Brooks Men's Cascadia 14 Poseidon/Orange/Grey Size 10.5,Default Ridgefield,2,2,0,0,0,0
,Brooks Men's Cascadia 14 Poseidon/Orange/Grey Size 11,Brooks Men's Cascadia 14 Poseidon/Orange/Grey Size 11,Default Ridgefield,2,2,0,0,0,0
,Brooks Men's Cascadia 14 Poseidon/Orange/Grey Size 12,Brooks Men's Cascadia 14 Poseidon/Orange/Grey Size 12,Default Ridgefield,2,2,0,0,0,0
,Brooks Men's Cascadia 14 Poseidon/Orange/Grey Size 7.5,Brooks Men's Cascadia 14 Poseidon/Orange/Grey Size 7.5,Default Ridgefield,2,2,0,0,0,0
,Brooks Men's Cascadia 14 Poseidon/Orange/Grey Size 8,Brooks Men's Cascadia 14 Poseidon/Orange/Grey Size 8,Default Ridgefield,2,2,0,0,0,0
,Brooks Men's Cascadia 14 Poseidon/Orange/Grey Size 8.5,Brooks Men's Cascadia 14 Poseidon/Orange/Grey Size 8.5,Default Ridgefield,2,2,0,0,0,0
,Brooks Men's Cascadia 14 Poseidon/Orange/Grey Size 9,Brooks Men's Cascadia 14 Poseidon/Orange/Grey Size 9,Default Ridgefield,4,4,0,0,0,0
,Brooks Men's Cascadia 14 Poseidon/Orange/Grey Size 9.5,Brooks Men's Cascadia 14 Poseidon/Orange/Grey Size 9.5,Default Ridgefield,4,4,0,0,0,0
,Brooks Men's Ghost 12 Black/Grey Size 10,Brooks Men's Ghost 12 Black/Grey Size 10,Default Oxford,1,1,0,0,0,0
,Brooks Men's Ghost 12 Black/Grey Size 10,Brooks Men's Ghost 12 Black/Grey Size 10,Default Ridgefield,1,1,0,0,0,0
,Brooks Men's Ghost 12 Black/Grey Size 10.5,Brooks Men's Ghost 12 Black/Grey Size 10.5,FBALYB Amazon,-19,-19,0,18,0,0
,Brooks Men's Ghost 12 Black/Grey Size 11,Brooks Men's Ghost 12 Black/Grey Size 11,Default Oxford,1,1,0,0,0,0
,Brooks Men's Ghost 12 Black/Grey Size 11.5,Brooks Men's Ghost 12 Black/Grey Size 11.5,FBALYB Amazon,-8,-8,0,6,0,0
,Brooks Men's Ghost 12 Black/Grey Size 12,Brooks Men's Ghost 12 Black/Grey Size 12,Default Oxford,1,1,0,0,0,0
,Brooks Men's Ghost 12 Black/Grey Size 7.5,Brooks Men's Ghost 12 Black/Grey Size 7.5,FBALYB Amazon,-7,-7,0,6,0,0
,Brooks Men's Ghost 12 Black/Grey Size 8,Brooks Men's Ghost 12 Black/Grey Size 8,Default Oxford,1,1,0,0,0,0
,Brooks Men's Ghost 12 Black/Grey Size 8.5,Brooks Men's Ghost 12 Black/Grey Size 8.5,FBALYB Amazon,-13,-13,0,12,0,0
,Brooks Men's Ghost 12 Black/Grey Size 9,Brooks Men's Ghost 12 Black/Grey Size 9,Default Oxford,2,2,0,0,0,0
,Brooks Men's Ghost 12 Black/Grey Size 9.5,Brooks Men's Ghost 12 Black/Grey Size 9.5,Default Oxford,18,18,0,0,0,0
,Brooks Men's Ghost 12 Black/Grey/Stellar Size 10,Brooks Men's Ghost 12 Black/Grey/Stellar Size 10,FBALYB Amazon,-2,-2,0,0,0,0
,Brooks Men's Ghost 12 Black/Grey/Stellar Size 10.5,Brooks Men's Ghost 12 Black/Grey/Stellar Size 10.5,FBALYB Amazon,-9,-9,0,9,0,0
,Brooks Men's Ghost 12 Black/Grey/Stellar Size 11,Brooks Men's Ghost 12 Black/Grey/Stellar Size 11,FBALYB Amazon,-6,-6,0,6,0,0
,Brooks Men's Ghost 12 Black/Grey/Stellar Size 11.5,Brooks Men's Ghost 12 Black/Grey/Stellar Size 11.5,FBALYB Amazon,-3,-3,0,3,0,0
,Brooks Men's Ghost 12 Black/Grey/Stellar Size 7.5,Brooks Men's Ghost 12 Black/Grey/Stellar Size 7.5,FBALYB Amazon,-1,-1,0,0,0,0
,Brooks Men's Ghost 12 Black/Grey/Stellar Size 8,Brooks Men's Ghost 12 Black/Grey/Stellar Size 8,FBALYB Amazon,1,1,0,0,0,0
,Brooks Men's Ghost 12 Black/Grey/Stellar Size 8.5,Brooks Men's Ghost 12 Black/Grey/Stellar Size 8.5,FBALYB Amazon,-7,-7,0,6,0,0
,Brooks Men's Ghost 12 Black/Grey/Stellar Size 9,Brooks Men's Ghost 12 Black/Grey/Stellar Size 9,FBALYB Amazon,-1,-1,0,0,0,0
,Brooks Men's Ghost 12 Black/Grey/Stellar Size 9.5,Brooks Men's Ghost 12 Black/Grey/Stellar Size 9.5,FBALYB Amazon,-11,-11,0,9,0,0
,Brooks Men's Ghost 12 Black/Lime/Blue Grass Size 10,Brooks Men's Ghost 12 Black/Lime/Blue Grass Size 10,Default Oxford,1,1,0,0,0,0
,Brooks Men's Ghost 12 Black/Lime/Blue Grass Size 10,Brooks Men's Ghost 12 Black/Lime/Blue Grass Size 10,Default Ridgefield,3,3,0,0,0,0
,Brooks Men's Ghost 12 Black/Lime/Blue Grass Size 10.5,Brooks Men's Ghost 12 Black/Lime/Blue Grass Size 10.5,FBALYB Amazon,-3,-3,0,0,0,0
,Brooks Men's Ghost 12 Black/Lime/Blue Grass Size 11,Brooks Men's Ghost 12 Black/Lime/Blue Grass Size 11,Default Ridgefield,2,2,0,0,0,0
,Brooks Men's Ghost 12 Black/Lime/Blue Grass Size 11,Brooks Men's Ghost 12 Black/Lime/Blue Grass Size 11,FBALYB Amazon,-1,-1,0,0,0,0
,Brooks Men's Ghost 12 Black/Lime/Blue Grass Size 12,Brooks Men's Ghost 12 Black/Lime/Blue Grass Size 12,Default,1,1,0,0,0,0
,Brooks Men's Ghost 12 Black/Lime/Blue Grass Size 12,Brooks Men's Ghost 12 Black/Lime/Blue Grass Size 12,FBALYB Amazon,-5,-5,0,0,0,0
,Brooks Men's Ghost 12 Black/Lime/Blue Grass Size 13,Brooks Men's Ghost 12 Black/Lime/Blue Grass Size 13,Default Oxford,1,1,0,0,0,0
,Brooks Men's Ghost 12 Black/Lime/Blue Grass Size 13,Brooks Men's Ghost 12 Black/Lime/Blue Grass Size 13,FBALYB Amazon,1,1,0,4,0,0
,Brooks Men's Ghost 12 Black/Lime/Blue Grass Size 8,Brooks Men's Ghost 12 Black/Lime/Blue Grass Size 8,FBALYB Amazon,1,1,0,0,0,0
,Brooks Men's Ghost 12 Black/Lime/Blue Grass Size 8.5,Brooks Men's Ghost 12 Black/Lime/Blue Grass Size 8.5,FBALYB Amazon,-2,-2,0,0,0,0
,Brooks Men's Ghost 12 Black/Lime/Blue Grass Size 9,Brooks Men's Ghost 12 Black/Lime/Blue Grass Size 9,Default Ridgefield,0,-176,176,0,0,0
,Brooks Men's Ghost 12 Black/Lime/Blue Grass Size 9,Brooks Men's Ghost 12 Black/Lime/Blue Grass Size 9,FBALYB Amazon,1,1,0,0,0,0
,Brooks Men's Ghost 12 Black/Lime/Blue Grass Size 9.5,Brooks Men's Ghost 12 Black/Lime/Blue Grass Size 9.5,FBALYB Amazon,2,2,0,0,0,0
,Brooks Men's Ghost 12 Black/Pearl/Oyster Size 10.5,Brooks Men's Ghost 12 Black/Pearl/Oyster Size 10.5,FBALYB Amazon,-2,-2,0,0,0,0
,Brooks Men's Ghost 12 Black/Pearl/Oyster Size 9.5,Brooks Men's Ghost 12 Black/Pearl/Oyster Size 9.5,FBALYB Amazon,-1,-1,0,0,0,0
,Brooks Men's Ghost 12 Black/True Blue/Black Size 10,Brooks Men's Ghost 12 Black/True Blue/Black Size 10,FBALYB Amazon,-4,-4,0,0,0,0
,Brooks Men's Ghost 12 Black/True Blue/Black Size 10.5,Brooks Men's Ghost 12 Black/True Blue/Black Size 10.5,FBALYB Amazon,-1,-1,0,0,0,0
,Brooks Men's Ghost 12 Black/True Blue/Black Size 11,Brooks Men's Ghost 12 Black/True Blue/Black Size 11,FBALYB Amazon,-1,-1,0,0,0,0
,Brooks Men's Ghost 12 Black/True Blue/Black Size 11.5,Brooks Men's Ghost 12 Black/True Blue/Black Size 11.5,FBALYB Amazon,0,0,0,1,0,0
,Brooks Men's Ghost 12 Black/True Blue/Black Size 12,Brooks Men's Ghost 12 Black/True Blue/Black Size 12,FBALYB Amazon,-1,-1,0,0,0,0
,Brooks Men's Ghost 12 Black/True Blue/Black Size 7.5,Brooks Men's Ghost 12 Black/True Blue/Black Size 7.5,FBALYB Amazon,-1,-1,0,0,0,0
,Brooks Men's Ghost 12 Black/True Blue/Black Size 8,Brooks Men's Ghost 12 Black/True Blue/Black Size 8,FBALYB Amazon,5,5,0,0,0,0
,Brooks Men's Ghost 12 Black/True Blue/Black Size 8.5,Brooks Men's Ghost 12 Black/True Blue/Black Size 8.5,Default,1,1,0,0,0,0
,Brooks Men's Ghost 12 Black/True Blue/Black Size 8.5,Brooks Men's Ghost 12 Black/True Blue/Black Size 8.5,FBALYB Amazon,-2,-2,0,0,0,0
,Brooks Men's Ghost 12 Black/True Blue/Black Size 9,Brooks Men's Ghost 12 Black/True Blue/Black Size 9,FBALYB Amazon,-2,-2,0,2,0,0
,Brooks Men's Ghost 12 Black/True Blue/Black Size 9.5,Brooks Men's Ghost 12 Black/True Blue/Black Size 9.5,FBALYB Amazon,-2,-2,0,0,0,0
,Brooks Men's Ghost 12 Grey/Alloy/Blue Size 10,Brooks Men's Ghost 12 Grey/Alloy/Blue Size 10,FBALYB Amazon,-2,-2,0,0,0,0
,Brooks Men's Ghost 12 Grey/Alloy/Blue Size 11,Brooks Men's Ghost 12 Grey/Alloy/Blue Size 11,FBALYB Amazon,-1,-1,0,0,0,0
,Brooks Men's Ghost 12 Grey/Alloy/Blue Size 11.5,Brooks Men's Ghost 12 Grey/Alloy/Blue Size 11.5,Default,3,3,0,0,0,0
,Brooks Men's Ghost 12 Grey/Alloy/Blue Size 11.5,Brooks Men's Ghost 12 Grey/Alloy/Blue Size 11.5,FBALYB Amazon,-3,-3,0,0,0,0
,Brooks Men's Ghost 12 Grey/Alloy/Blue Size 12,Brooks Men's Ghost 12 Grey/Alloy/Blue Size 12,FBALYB Amazon,-1,-1,0,0,0,0
,Brooks Men's Ghost 12 Grey/Alloy/Blue Size 8,Brooks Men's Ghost 12 Grey/Alloy/Blue Size 8,FBALYB Amazon,-1,-1,0,0,0,0
,Brooks Men's Ghost 12 Grey/Alloy/Blue Size 8.5,Brooks Men's Ghost 12 Grey/Alloy/Blue Size 8.5,FBALYB Amazon,-1,-1,0,0,0,0
,Brooks Men's Ghost 12 Grey/Alloy/Blue Size 9,Brooks Men's Ghost 12 Grey/Alloy/Blue Size 9,FBALYB Amazon,-2,-2,0,0,0,0
,Brooks Men's Ghost 12 Navy/Blue/Nightlife Size 10,Brooks Men's Ghost 12 Navy/Blue/Nightlife Size 10,FBALYB Amazon,-1,-1,0,0,0,0
,Brooks Men's Ghost 12 Navy/Blue/Nightlife Size 10.5,Brooks Men's Ghost 12 Navy/Blue/Nightlife Size 10.5,FBALYB Amazon,-2,-2,0,0,0,0
,Brooks Men's Ghost 12 Navy/Blue/Nightlife Size 8.5,Brooks Men's Ghost 12 Navy/Blue/Nightlife Size 8.5,FBALYB Amazon,-1,-1,0,0,0,0
,Brooks Men's Ghost 12 Navy/Blue/Nightlife Size 9,Brooks Men's Ghost 12 Navy/Blue/Nightlife Size 9,FBALYB Amazon,-2,-2,0,0,0,0
,Brooks Men's Ghost 12 Navy/Deep Water/Gold Size 10,Brooks Men's Ghost 12 Navy/Deep Water/Gold Size 10,Default Ridgefield,1,1,0,0,0,0
,Brooks Men's Ghost 12 Navy/Deep Water/Gold Size 10,Brooks Men's Ghost 12 Navy/Deep Water/Gold Size 10,FBALYB Amazon,9,8,1,0,1,0
,Brooks Men's Ghost 12 Navy/Deep Water/Gold Size 10.5,Brooks Men's Ghost 12 Navy/Deep Water/Gold Size 10.5,FBALYB Amazon,-1,-1,0,0,0,0
,Brooks Men's Ghost 12 Navy/Deep Water/Gold Size 11,Brooks Men's Ghost 12 Navy/Deep Water/Gold Size 11,Default Ridgefield,6,6,0,0,0,0
,Brooks Men's Ghost 12 Navy/Deep Water/Gold Size 11.5,Brooks Men's Ghost 12 Navy/Deep Water/Gold Size 11.5,FBALYB Amazon,-6,-6,0,6,0,0
,Brooks Men's Ghost 12 Navy/Deep Water/Gold Size 13,Brooks Men's Ghost 12 Navy/Deep Water/Gold Size 13,FBALYB Amazon,4,4,0,0,0,0
,Brooks Men's Ghost 12 Navy/Deep Water/Gold Size 8,Brooks Men's Ghost 12 Navy/Deep Water/Gold Size 8,FBALYB Amazon,6,6,0,0,0,0
,Brooks Men's Ghost 12 Navy/Deep Water/Gold Size 8.5,Brooks Men's Ghost 12 Navy/Deep Water/Gold Size 8.5,FBALYB Amazon,-7,-7,0,6,0,0
,Brooks Men's Ghost 12 Navy/Deep Water/Gold Size 9,Brooks Men's Ghost 12 Navy/Deep Water/Gold Size 9,FBALYB Amazon,4,4,0,0,0,0
,Brooks Men's Ghost 12 Navy/Deep Water/Gold Size 9.5,Brooks Men's Ghost 12 Navy/Deep Water/Gold Size 9.5,FBALYB Amazon,-6,-6,0,6,0,0
,Brooks Men's Ghost 12 Red/Biking Red/Black Size 10,Brooks Men's Ghost 12 Red/Biking Red/Black Size 10,FBALYB Amazon,-2,-2,0,0,0,0
,Brooks Men's Ghost 12 Red/Biking Red/Black Size 10.5,Brooks Men's Ghost 12 Red/Biking Red/Black Size 10.5,FBALYB Amazon,-2,-2,0,0,0,0
,Brooks Men's Ghost 12 Red/Biking Red/Black Size 11,Brooks Men's Ghost 12 Red/Biking Red/Black Size 11,FBALYB Amazon,-1,-1,0,0,0,0
,Brooks Men's Ghost 12 Red/Biking Red/Black Size 11.5,Brooks Men's Ghost 12 Red/Biking Red/Black Size 11.5,Default Oxford,6,6,0,0,0,0
,Brooks Men's Ghost 12 Red/Biking Red/Black Size 12,Brooks Men's Ghost 12 Red/Biking Red/Black Size 12,FBALYB Amazon,1,1,0,0,0,0
,Brooks Men's Ghost 12 Red/Biking Red/Black Size 8.5,Brooks Men's Ghost 12 Red/Biking Red/Black Size 8.5,FBALYB Amazon,-1,-1,0,0,0,0
,Brooks Men's Ghost 12 Red/Biking Red/Black Size 9,Brooks Men's Ghost 12 Red/Biking Red/Black Size 9,FBALYB Amazon,-1,-1,0,0,0,0
,Brooks Men's Ghost 12 White/Grey/Black Size 10,Brooks Men's Ghost 12 White/Grey/Black Size 10,Default Ridgefield,12,12,0,0,0,0
,Brooks Men's Ghost 12 White/Grey/Black Size 10,Brooks Men's Ghost 12 White/Grey/Black Size 10,FBALYB Amazon,18,18,0,20,0,0
,Brooks Men's Ghost 12 White/Grey/Black Size 10.5,Brooks Men's Ghost 12 White/Grey/Black Size 10.5,FBALYB Amazon,-2,-2,0,1,0,0
,Brooks Men's Ghost 12 White/Grey/Black Size 11,Brooks Men's Ghost 12 White/Grey/Black Size 11,FBALYB Amazon,-20,-20,0,16,0,0
,Brooks Men's Ghost 12 White/Grey/Black Size 12,Brooks Men's Ghost 12 White/Grey/Black Size 12,FBALYB Amazon,-17,-17,0,16,0,0
,Brooks Men's Ghost 12 White/Grey/Black Size 13,Brooks Men's Ghost 12 White/Grey/Black Size 13,FBALYB Amazon,-12,-12,0,10,0,0
,Brooks Men's Ghost 12 White/Grey/Black Size 7.5,Brooks Men's Ghost 12 White/Grey/Black Size 7.5,FBALYB Amazon,-3,-3,0,0,0,0
,Brooks Men's Ghost 12 White/Grey/Black Size 8,Brooks Men's Ghost 12 White/Grey/Black Size 8,Default Oxford,1,1,0,0,0,0
,Brooks Men's Ghost 12 White/Grey/Black Size 8,Brooks Men's Ghost 12 White/Grey/Black Size 8,FBALYB Amazon,-10,-10,0,12,0,0
,Brooks Men's Ghost 12 White/Grey/Black Size 8.5,Brooks Men's Ghost 12 White/Grey/Black Size 8.5,FBALYB Amazon,-4,-4,0,0,0,0
,Brooks Men's Ghost 12 White/Grey/Black Size 9,Brooks Men's Ghost 12 White/Grey/Black Size 9,Default Oxford,2,2,0,0,0,0
,Brooks Men's Ghost 12 White/Grey/Black Size 9,Brooks Men's Ghost 12 White/Grey/Black Size 9,FBALYB Amazon,15,15,0,0,0,0
,Brooks Men's Ghost 12 White/Grey/Black Size 9.5,Brooks Men's Ghost 12 White/Grey/Black Size 9.5,FBALYB Amazon,-4,-4,0,0,0,0
,Brooks Men's Ghost 13 Black/Grey/Blue Size 10,Brooks Men's Ghost 13 Black/Grey/Blue Size 10,Default,0,0,0,0,0,6
,Brooks Men's Ghost 13 Black/Grey/Blue Size 10,Brooks Men's Ghost 13 Black/Grey/Blue Size 10,FBALYB Amazon,-3,-3,0,0,0,0
,Brooks Men's Ghost 13 Black/Grey/Blue Size 10.5,Brooks Men's Ghost 13 Black/Grey/Blue Size 10.5,FBALYB Amazon,-3,-3,0,0,0,0
,Brooks Men's Ghost 13 Black/Grey/Blue Size 11,Brooks Men's Ghost 13 Black/Grey/Blue Size 11,FBALYB Amazon,-6,-6,0,0,0,0
,Brooks Men's Ghost 13 Black/Grey/Blue Size 11.5,Brooks Men's Ghost 13 Black/Grey/Blue Size 11.5,FBALYB Amazon,13,13,0,0,0,0
,Brooks Men's Ghost 13 Black/Grey/Blue Size 12,Brooks Men's Ghost 13 Black/Grey/Blue Size 12,Default,0,-1,1,0,0,18
,Brooks Men's Ghost 13 Black/Grey/Blue Size 7.5,Brooks Men's Ghost 13 Black/Grey/Blue Size 7.5,Default,0,-1,1,0,0,0
,Brooks Men's Ghost 13 Black/Grey/Blue Size 7.5,Brooks Men's Ghost 13 Black/Grey/Blue Size 7.5,FBALYB Amazon,-8,-8,0,0,0,0
,Brooks Men's Ghost 13 Black/Grey/Blue Size 8,Brooks Men's Ghost 13 Black/Grey/Blue Size 8,Default,0,0,0,0,0,1
,Brooks Men's Ghost 13 Black/Grey/Blue Size 8,Brooks Men's Ghost 13 Black/Grey/Blue Size 8,FBALYB Amazon,-2,-2,0,0,0,0
,Brooks Men's Ghost 13 Black/Grey/Blue Size 8.5,Brooks Men's Ghost 13 Black/Grey/Blue Size 8.5,FBALYB Amazon,-1,-1,0,0,0,0
,Brooks Men's Ghost 13 Black/Grey/Blue Size 9,Brooks Men's Ghost 13 Black/Grey/Blue Size 9,Default,0,0,0,0,0,6
,Brooks Men's Ghost 13 Black/Grey/Blue Size 9,Brooks Men's Ghost 13 Black/Grey/Blue Size 9,FBALYB Amazon,-2,-2,0,0,0,0
,Brooks Men's Ghost 13 Black/Grey/Blue Size 9.5,Brooks Men's Ghost 13 Black/Grey/Blue Size 9.5,Default,0,-1,1,0,0,6
,Brooks Men's Ghost 13 Black/Grey/Blue Size 9.5,Brooks Men's Ghost 13 Black/Grey/Blue Size 9.5,FBALYB Amazon,-6,-6,0,0,0,0
,Brooks Men's Ghost 13 Black/Nightlife/White Size 10,Brooks Men's Ghost 13 Black/Nightlife/White Size 10,Default,0,-1,1,0,0,0
,Brooks Men's Ghost 13 Black/Nightlife/White Size 10,Brooks Men's Ghost 13 Black/Nightlife/White Size 10,FBALYB Amazon,-5,-5,0,0,0,0
,Brooks Men's Ghost 13 Black/Nightlife/White Size 10.5,Brooks Men's Ghost 13 Black/Nightlife/White Size 10.5,FBALYB Amazon,-5,-5,0,0,0,0
,Brooks Men's Ghost 13 Black/Nightlife/White Size 11,Brooks Men's Ghost 13 Black/Nightlife/White Size 11,FBALYB Amazon,-2,-2,0,0,0,0
,Brooks Men's Ghost 13 Black/Nightlife/White Size 11.5,Brooks Men's Ghost 13 Black/Nightlife/White Size 11.5,Default Ridgefield,18,18,0,0,0,0
,Brooks Men's Ghost 13 Black/Nightlife/White Size 12,Brooks Men's Ghost 13 Black/Nightlife/White Size 12,Default,0,0,0,0,0,18
,Brooks Men's Ghost 13 Black/Nightlife/White Size 12,Brooks Men's Ghost 13 Black/Nightlife/White Size 12,FBALYB Amazon,-1,-1,0,0,0,0
,Brooks Men's Ghost 13 Black/Nightlife/White Size 13,Brooks Men's Ghost 13 Black/Nightlife/White Size 13,Default,0,-1,1,0,0,0
,Brooks Men's Ghost 13 Black/Nightlife/White Size 7.5,Brooks Men's Ghost 13 Black/Nightlife/White Size 7.5,FBALYB Amazon,-2,-2,0,0,0,0
,Brooks Men's Ghost 13 Black/Nightlife/White Size 8,Brooks Men's Ghost 13 Black/Nightlife/White Size 8,Default,0,-1,1,0,0,0
,Brooks Men's Ghost 13 Black/Nightlife/White Size 8,Brooks Men's Ghost 13 Black/Nightlife/White Size 8,FBALYB Amazon,-1,-1,0,0,0,0
,Brooks Men's Ghost 13 Black/Nightlife/White Size 8.5,Brooks Men's Ghost 13 Black/Nightlife/White Size 8.5,FBALYB Amazon,9,9,0,0,0,0
,Brooks Men's Ghost 13 Black/Nightlife/White Size 9,Brooks Men's Ghost 13 Black/Nightlife/White Size 9,FBALYB Amazon,-7,-7,0,0,0,0
,Brooks Men's Ghost 13 Black/Nightlife/White Size 9.5,Brooks Men's Ghost 13 Black/Nightlife/White Size 9.5,FBALYB Amazon,-1,-1,0,0,0,0
,Brooks Men's Ghost 13 Primer Grey/Pearl/Black Size 10,Brooks Men's Ghost 13 Primer Grey/Pearl/Black Size 10,FBALYB Amazon,-3,-3,0,0,0,0
,Brooks Men's Ghost 13 Primer Grey/Pearl/Black Size 10.5,Brooks Men's Ghost 13 Primer Grey/Pearl/Black Size 10.5,Default,0,-1,1,0,0,0
,Brooks Men's Ghost 13 Primer Grey/Pearl/Black Size 10.5,Brooks Men's Ghost 13 Primer Grey/Pearl/Black Size 10.5,FBALYB Amazon,-4,-4,0,0,0,0
,Brooks Men's Ghost 13 Primer Grey/Pearl/Black Size 11,Brooks Men's Ghost 13 Primer Grey/Pearl/Black Size 11,FBALYB Amazon,-3,-3,0,0,0,0
,Brooks Men's Ghost 13 Primer Grey/Pearl/Black Size 11.5,Brooks Men's Ghost 13 Primer Grey/Pearl/Black Size 11.5,Default Ridgefield,36,36,0,0,0,0
,Brooks Men's Ghost 13 Primer Grey/Pearl/Black Size 12,Brooks Men's Ghost 13 Primer Grey/Pearl/Black Size 12,Default,0,0,0,0,0,18
,Brooks Men's Ghost 13 Primer Grey/Pearl/Black Size 12,Brooks Men's Ghost 13 Primer Grey/Pearl/Black Size 12,FBALYB Amazon,-1,-1,0,0,0,0
,Brooks Men's Ghost 13 Primer Grey/Pearl/Black Size 13,Brooks Men's Ghost 13 Primer Grey/Pearl/Black Size 13,Default,0,-1,1,0,0,0
,Brooks Men's Ghost 13 Primer Grey/Pearl/Black Size 7.5,Brooks Men's Ghost 13 Primer Grey/Pearl/Black Size 7.5,Default,0,-1,1,0,0,0
,Brooks Men's Ghost 13 Primer Grey/Pearl/Black Size 7.5,Brooks Men's Ghost 13 Primer Grey/Pearl/Black Size 7.5,FBALYB Amazon,-6,-6,0,0,0,0
,Brooks Men's Ghost 13 Primer Grey/Pearl/Black Size 8,Brooks Men's Ghost 13 Primer Grey/Pearl/Black Size 8,FBALYB Amazon,-4,-4,0,0,0,0
,Brooks Men's Ghost 13 Primer Grey/Pearl/Black Size 8.5,Brooks Men's Ghost 13 Primer Grey/Pearl/Black Size 8.5,FBALYB Amazon,-7,-7,0,0,0,0
,Brooks Men's Ghost 13 Primer Grey/Pearl/Black Size 9,Brooks Men's Ghost 13 Primer Grey/Pearl/Black Size 9,FBALYB Amazon,-5,-5,0,0,0,0
,Brooks Men's Ghost 13 Primer Grey/Pearl/Black Size 9.5,Brooks Men's Ghost 13 Primer Grey/Pearl/Black Size 9.5,FBALYB Amazon,-6,-6,0,0,0,0
,Brooks Men's Ghost 13 White/Grey/Deep Cobalt Size 10,Brooks Men's Ghost 13 White/Grey/Deep Cobalt Size 10,Default,0,-1,1,0,0,0
,Brooks Men's Ghost 13 White/Grey/Deep Cobalt Size 10,Brooks Men's Ghost 13 White/Grey/Deep Cobalt Size 10,FBALYB Amazon,-5,-5,0,0,0,0
,Brooks Men's Ghost 13 White/Grey/Deep Cobalt Size 10.5,Brooks Men's Ghost 13 White/Grey/Deep Cobalt Size 10.5,FBALYB Amazon,-4,-4,0,0,0,0
,Brooks Men's Ghost 13 White/Grey/Deep Cobalt Size 11,Brooks Men's Ghost 13 White/Grey/Deep Cobalt Size 11,FBALYB Amazon,-4,-4,0,0,0,0
,Brooks Men's Ghost 13 White/Grey/Deep Cobalt Size 11.5,Brooks Men's Ghost 13 White/Grey/Deep Cobalt Size 11.5,FBALYB Amazon,-2,-2,0,0,0,0
,Brooks Men's Ghost 13 White/Grey/Deep Cobalt Size 12,Brooks Men's Ghost 13 White/Grey/Deep Cobalt Size 12,Default,0,0,0,0,0,18
,Brooks Men's Ghost 13 White/Grey/Deep Cobalt Size 13,Brooks Men's Ghost 13 White/Grey/Deep Cobalt Size 13,Default,0,-1,1,0,0,0
,Brooks Men's Ghost 13 White/Grey/Deep Cobalt Size 7.5,Brooks Men's Ghost 13 White/Grey/Deep Cobalt Size 7.5,Default,0,-1,1,0,0,0
,Brooks Men's Ghost 13 White/Grey/Deep Cobalt Size 7.5,Brooks Men's Ghost 13 White/Grey/Deep Cobalt Size 7.5,FBALYB Amazon,-6,-6,0,0,0,0
,Brooks Men's Ghost 13 White/Grey/Deep Cobalt Size 8,Brooks Men's Ghost 13 White/Grey/Deep Cobalt Size 8,FBALYB Amazon,-1,-1,0,0,0,0
,Brooks Men's Ghost 13 White/Grey/Deep Cobalt Size 8.5,Brooks Men's Ghost 13 White/Grey/Deep Cobalt Size 8.5,FBALYB Amazon,-2,-2,0,0,0,0
,Brooks Men's Ghost 13 White/Grey/Deep Cobalt Size 9,Brooks Men's Ghost 13 White/Grey/Deep Cobalt Size 9,FBALYB Amazon,-5,-5,0,0,0,0
,Brooks Men's Ghost 13 White/Grey/Deep Cobalt Size 9.5,Brooks Men's Ghost 13 White/Grey/Deep Cobalt Size 9.5,FBALYB Amazon,-4,-4,0,0,0,0
,Brooks Men's Glycerin 18 Black/Ebony/Blue Size 10,Brooks Men's Glycerin 18 Black/Ebony/Blue Size 10,Default,1,1,0,0,0,0
,Brooks Men's Glycerin 18 Black/Ebony/Blue Size 10,Brooks Men's Glycerin 18 Black/Ebony/Blue Size 10,FBALYB Amazon,-4,-4,0,0,0,0
,Brooks Men's Glycerin 18 Black/Ebony/Blue Size 11.5,Brooks Men's Glycerin 18 Black/Ebony/Blue Size 11.5,FBALYB Amazon,-2,-2,0,0,0,0
,Brooks Men's Glycerin 18 Black/Ebony/Blue Size 12,Brooks Men's Glycerin 18 Black/Ebony/Blue Size 12,FBALYB Amazon,-1,-1,0,0,0,0
,Brooks Men's Glycerin 18 Black/Ebony/Blue Size 7.5,Brooks Men's Glycerin 18 Black/Ebony/Blue Size 7.5,FBALYB Amazon,0,0,0,1,0,0
,Brooks Men's Glycerin 18 Black/Ebony/Blue Size 8,Brooks Men's Glycerin 18 Black/Ebony/Blue Size 8,FBALYB Amazon,-1,-1,0,0,0,0
,Brooks Men's Glycerin 18 Black/Ebony/Blue Size 8.5,Brooks Men's Glycerin 18 Black/Ebony/Blue Size 8.5,FBALYB Amazon,1,1,0,0,0,0
,Brooks Men's Glycerin 18 Black/Ebony/Blue Size 9,Brooks Men's Glycerin 18 Black/Ebony/Blue Size 9,FBALYB Amazon,-1,-1,0,0,0,0
,Brooks Men's Glycerin 18 Black/Ebony/Blue Size 9.5,Brooks Men's Glycerin 18 Black/Ebony/Blue Size 9.5,FBALYB Amazon,-3,-3,0,0,0,0
,Brooks Men's Glycerin 18 Black/Ebony Size 10,Brooks Men's Glycerin 18 Black/Ebony Size 10,Default Oxford,2,2,0,0,0,0
,Brooks Men's Glycerin 18 Black/Ebony Size 10.5,Brooks Men's Glycerin 18 Black/Ebony Size 10.5,Avrami - Ebay,2,2,0,0,0,0
,Brooks Men's Glycerin 18 Black/Ebony Size 10.5,Brooks Men's Glycerin 18 Black/Ebony Size 10.5,Default Oxford,1,1,0,0,0,0
,Brooks Men's Glycerin 18 Black/Ebony Size 11,Brooks Men's Glycerin 18 Black/Ebony Size 11,Default,1,1,0,0,0,0
,Brooks Men's Glycerin 18 Black/Ebony Size 11,Brooks Men's Glycerin 18 Black/Ebony Size 11,FBALYB Amazon,-2,-2,0,0,0,0
,Brooks Men's Glycerin 18 Black/Ebony Size 12,Brooks Men's Glycerin 18 Black/Ebony Size 12,Default Oxford,1,1,0,0,0,0
,Brooks Men's Glycerin 18 Black/Ebony Size 12,Brooks Men's Glycerin 18 Black/Ebony Size 12,FBALYB Amazon,-1,-1,0,2,0,0
,Brooks Men's Glycerin 18 Black/Ebony Size 7.5,Brooks Men's Glycerin 18 Black/Ebony Size 7.5,FBALYB Amazon,-6,-6,0,0,0,0
,Brooks Men's Glycerin 18 Black/Ebony Size 8,Brooks Men's Glycerin 18 Black/Ebony Size 8,Default Oxford,4,4,0,0,0,0
,Brooks Men's Glycerin 18 Black/Ebony Size 8,Brooks Men's Glycerin 18 Black/Ebony Size 8,FBALYB Amazon,-2,-2,0,0,0,0
,Brooks Men's Glycerin 18 Black/Ebony Size 8.5,Brooks Men's Glycerin 18 Black/Ebony Size 8.5,FBALYB Amazon,-2,-2,0,10,0,0
,Brooks Men's Glycerin 18 Black/Ebony Size 9,Brooks Men's Glycerin 18 Black/Ebony Size 9,Default Ridgefield,12,12,0,0,0,0
,Brooks Men's Glycerin 18 Black/Ebony Size 9,Brooks Men's Glycerin 18 Black/Ebony Size 9,FBALYB Amazon,-2,-2,0,0,0,0
,Brooks Men's Glycerin 18 Black/Ebony Size 9.5,Brooks Men's Glycerin 18 Black/Ebony Size 9.5,Default,3,3,0,0,0,0
,Brooks Men's Glycerin 18 Black/Ebony Size 9.5,Brooks Men's Glycerin 18 Black/Ebony Size 9.5,FBALYB Amazon,-4,-4,0,0,0,0
,Brooks Men's Glycerin 18 Blue/Mazarine/Gold Size 10,Brooks Men's Glycerin 18 Blue/Mazarine/Gold Size 10,FBALYB Amazon,-16,-16,0,0,0,0
,Brooks Men's Glycerin 18 Blue/Mazarine/Gold Size 10.5,Brooks Men's Glycerin 18 Blue/Mazarine/Gold Size 10.5,FBALYB Amazon,-1,-1,0,0,0,0
,Brooks Men's Glycerin 18 Blue/Mazarine/Gold Size 11.5,Brooks Men's Glycerin 18 Blue/Mazarine/Gold Size 11.5,FBALYB Amazon,-1,-1,0,0,0,0
,Brooks Men's Glycerin 18 Blue/Mazarine/Gold Size 12,Brooks Men's Glycerin 18 Blue/Mazarine/Gold Size 12,FBALYB Amazon,-1,-1,0,0,0,0
,Brooks Men's Glycerin 18 Blue/Mazarine/Gold Size 7.5,Brooks Men's Glycerin 18 Blue/Mazarine/Gold Size 7.5,FBALYB Amazon,-5,-5,0,0,0,0
,Brooks Men's Glycerin 18 Blue/Mazarine/Gold Size 8,Brooks Men's Glycerin 18 Blue/Mazarine/Gold Size 8,FBALYB Amazon,-3,-3,0,0,0,0
,Brooks Men's Glycerin 18 Blue/Mazarine/Gold Size 8.5,Brooks Men's Glycerin 18 Blue/Mazarine/Gold Size 8.5,FBALYB Amazon,-1,-1,0,0,0,0
,Brooks Men's Glycerin 18 Blue/Mazarine/Gold Size 9.5,Brooks Men's Glycerin 18 Blue/Mazarine/Gold Size 9.5,FBALYB Amazon,-2,-2,0,0,0,0
,Brooks Men's Glycerin 18 White/Grey/Poseidon Size 10,Brooks Men's Glycerin 18 White/Grey/Poseidon Size 10,Default,0,-1,1,0,0,0
,Brooks Men's Glycerin 18 White/Grey/Poseidon Size 10,Brooks Men's Glycerin 18 White/Grey/Poseidon Size 10,FBALYB Amazon,-3,-3,0,0,0,0
,Brooks Men's Glycerin 18 White/Grey/Poseidon Size 10.5,Brooks Men's Glycerin 18 White/Grey/Poseidon Size 10.5,FBALYB Amazon,-3,-3,0,0,0,0
,Brooks Men's Glycerin 18 White/Grey/Poseidon Size 12,Brooks Men's Glycerin 18 White/Grey/Poseidon Size 12,FBALYB Amazon,-7,-7,0,6,0,0
,Brooks Men's Glycerin 18 White/Grey/Poseidon Size 13,Brooks Men's Glycerin 18 White/Grey/Poseidon Size 13,FBALYB Amazon,-1,-1,0,0,0,0
,Brooks Men's Glycerin 18 White/Grey/Poseidon Size 7.5,Brooks Men's Glycerin 18 White/Grey/Poseidon Size 7.5,FBALYB Amazon,-2,-2,0,0,0,0
,Brooks Men's Glycerin 18 White/Grey/Poseidon Size 8,Brooks Men's Glycerin 18 White/Grey/Poseidon Size 8,FBALYB Amazon,-4,-4,0,0,0,0
,Brooks Men's Glycerin 18 White/Grey/Poseidon Size 8.5,Brooks Men's Glycerin 18 White/Grey/Poseidon Size 8.5,FBALYB Amazon,-1,-1,0,0,0,0
,Brooks Men's Glycerin 18 White/Grey/Poseidon Size 9,Brooks Men's Glycerin 18 White/Grey/Poseidon Size 9,FBALYB Amazon,-3,-3,0,0,0,0
,Brooks Men's Glycerin 18 White/Grey/Poseidon Size 9.5,Brooks Men's Glycerin 18 White/Grey/Poseidon Size 9.5,FBALYB Amazon,-3,-3,0,0,0,0
,Brooks Men's Launch 7 Antarctica/Black/Stellar Size 10,Brooks Men's Launch 7 Antarctica/Black/Stellar Size 10,FBALYB Amazon,-3,-3,0,0,0,0
,Brooks Men's Launch 7 Antarctica/Black/Stellar Size 10.5,Brooks Men's Launch 7 Antarctica/Black/Stellar Size 10.5,FBALYB Amazon,-1,-1,0,2,0,0
,Brooks Men's Launch 7 Antarctica/Black/Stellar Size 11,Brooks Men's Launch 7 Antarctica/Black/Stellar Size 11,FBALYB Amazon,-3,-3,0,0,0,0
,Brooks Men's Launch 7 Antarctica/Black/Stellar Size 12,Brooks Men's Launch 7 Antarctica/Black/Stellar Size 12,FBALYB Amazon,-1,-1,0,0,0,0
,Brooks Men's Launch 7 Antarctica/Black/Stellar Size 13,Brooks Men's Launch 7 Antarctica/Black/Stellar Size 13,FBALYB Amazon,2,2,0,0,0,0
,Brooks Men's Launch 7 Antarctica/Black/Stellar Size 8,Brooks Men's Launch 7 Antarctica/Black/Stellar Size 8,FBALYB Amazon,-2,-2,0,0,0,0
,Brooks Men's Launch 7 Antarctica/Black/Stellar Size 8.5,Brooks Men's Launch 7 Antarctica/Black/Stellar Size 8.5,FBALYB Amazon,-3,-3,0,0,0,0
,Brooks Men's Launch 7 Antarctica/Black/Stellar Size 9,Brooks Men's Launch 7 Antarctica/Black/Stellar Size 9,FBALYB Amazon,-2,-2,0,0,0,0
,Brooks Men's Launch 7 Antarctica/Black/Stellar Size 9.5,Brooks Men's Launch 7 Antarctica/Black/Stellar Size 9.5,FBALYB Amazon,-4,-4,0,0,0,0
,Brooks Men's Launch 7 Black/Ebony/Primer Size 10,Brooks Men's Launch 7 Black/Ebony/Primer Size 10,FBALYB Amazon,-1,-1,0,0,0,0
,Brooks Men's Launch 7 Black/Ebony/Primer Size 10.5,Brooks Men's Launch 7 Black/Ebony/Primer Size 10.5,FBALYB Amazon,-2,-2,0,0,0,0
,Brooks Men's Launch 7 Black/Ebony/Primer Size 9.5,Brooks Men's Launch 7 Black/Ebony/Primer Size 9.5,FBALYB Amazon,-1,-1,0,0,0,0
,Brooks Men's Launch 7 Blue Fog/Poseidon/Grey Size 11.5,Brooks Men's Launch 7 Blue Fog/Poseidon/Grey Size 11.5,FBALYB Amazon,-2,-2,0,0,0,0
,Brooks Men's Launch 7 Blue Fog/Poseidon/Grey Size 12,Brooks Men's Launch 7 Blue Fog/Poseidon/Grey Size 12,FBALYB Amazon,-1,-1,0,0,0,0
,Brooks Men's Launch 7 Blue Fog/Poseidon/Grey Size 8,Brooks Men's Launch 7 Blue Fog/Poseidon/Grey Size 8,FBALYB Amazon,-7,-7,0,6,0,0
,Brooks Men's Launch 7 Blue Fog/Poseidon/Grey Size 8.5,Brooks Men's Launch 7 Blue Fog/Poseidon/Grey Size 8.5,FBALYB Amazon,-7,-7,0,6,0,0
,Brooks Men's Launch 7 Blue Fog/Poseidon/Grey Size 9,Brooks Men's Launch 7 Blue Fog/Poseidon/Grey Size 9,FBALYB Amazon,-8,-8,0,6,0,0
,Brooks Men's Launch 7 Cherry/Red/Mazarine Size 10,Brooks Men's Launch 7 Cherry/Red/Mazarine Size 10,FBALYB Amazon,-1,-1,0,0,0,0
,Brooks Men's Launch 7 Cherry/Red/Mazarine Size 10.5,Brooks Men's Launch 7 Cherry/Red/Mazarine Size 10.5,FBALYB Amazon,6,6,0,0,0,0
,Brooks Men's Launch 7 Cherry/Red/Mazarine Size 11,Brooks Men's Launch 7 Cherry/Red/Mazarine Size 11,FBALYB Amazon,-8,-8,0,6,0,0
,Brooks Men's Launch 7 Cherry/Red/Mazarine Size 11.5,Brooks Men's Launch 7 Cherry/Red/Mazarine Size 11.5,FBALYB Amazon,0,0,0,6,0,0
,Brooks Men's Launch 7 Cherry/Red/Mazarine Size 12,Brooks Men's Launch 7 Cherry/Red/Mazarine Size 12,FBALYB Amazon,-2,-2,0,0,0,0
,Brooks Men's Launch 7 Cherry/Red/Mazarine Size 7.5,Brooks Men's Launch 7 Cherry/Red/Mazarine Size 7.5,FBALYB Amazon,-1,-1,0,0,0,0
,Brooks Men's Launch 7 Cherry/Red/Mazarine Size 8,Brooks Men's Launch 7 Cherry/Red/Mazarine Size 8,FBALYB Amazon,-1,-1,0,0,0,0
,Brooks Men's Launch 7 Cherry/Red/Mazarine Size 8.5,Brooks Men's Launch 7 Cherry/Red/Mazarine Size 8.5,Default Oxford,3,3,0,0,0,0
,Brooks Men's Launch 7 Cherry/Red/Mazarine Size 8.5,Brooks Men's Launch 7 Cherry/Red/Mazarine Size 8.5,FBALYB Amazon,6,6,0,0,0,0
,Brooks Men's Launch 7 Cherry/Red/Mazarine Size 9,Brooks Men's Launch 7 Cherry/Red/Mazarine Size 9,Default Ridgefield,2,2,0,0,0,0
,Brooks Men's Launch 7 Cherry/Red/Mazarine Size 9,Brooks Men's Launch 7 Cherry/Red/Mazarine Size 9,FBALYB Amazon,3,3,0,0,0,0
,Brooks Men's Launch 7 Cherry/Red/Mazarine Size 9.5,Brooks Men's Launch 7 Cherry/Red/Mazarine Size 9.5,FBALYB Amazon,5,5,0,0,0,0
,Brooks Men's Launch 7 Ebony/Black/Gold Size 10,Brooks Men's Launch 7 Ebony/Black/Gold Size 10,Default,0,-1,1,0,0,0
,Brooks Men's Launch 7 Ebony/Black/Gold Size 10,Brooks Men's Launch 7 Ebony/Black/Gold Size 10,FBALYB Amazon,-10,-10,0,4,0,0
,Brooks Men's Launch 7 Ebony/Black/Gold Size 10.5,Brooks Men's Launch 7 Ebony/Black/Gold Size 10.5,FBALYB Amazon,-1,-1,0,3,0,0
,Brooks Men's Launch 7 Ebony/Black/Gold Size 11.5,Brooks Men's Launch 7 Ebony/Black/Gold Size 11.5,Default Ridgefield,9,9,0,0,0,0
,Brooks Men's Launch 7 Ebony/Black/Gold Size 11.5,Brooks Men's Launch 7 Ebony/Black/Gold Size 11.5,FBALYB Amazon,-6,-6,0,0,0,0
,Brooks Men's Launch 7 Ebony/Black/Gold Size 12,Brooks Men's Launch 7 Ebony/Black/Gold Size 12,FBALYB Amazon,-2,-2,0,0,0,0
,Brooks Men's Launch 7 Ebony/Black/Gold Size 7.5,Brooks Men's Launch 7 Ebony/Black/Gold Size 7.5,FBALYB Amazon,-3,-3,0,0,0,0
,Brooks Men's Launch 7 Ebony/Black/Gold Size 8,Brooks Men's Launch 7 Ebony/Black/Gold Size 8,FBALYB Amazon,-5,-5,0,0,0,0
,Brooks Men's Launch 7 Ebony/Black/Gold Size 8.5,Brooks Men's Launch 7 Ebony/Black/Gold Size 8.5,FBALYB Amazon,-2,-2,0,0,0,0
,Brooks Men's Launch 7 Ebony/Black/Gold Size 9,Brooks Men's Launch 7 Ebony/Black/Gold Size 9,FBALYB Amazon,-10,-10,0,8,0,0
,Brooks Men's Launch 7 Ebony/Black/Gold Size 9.5,Brooks Men's Launch 7 Ebony/Black/Gold Size 9.5,FBALYB Amazon,-4,-4,0,4,0,0
,Brooks Men's Launch 7 Rock N Roll Tie Dye Size 10,Brooks Men's Launch 7 Rock N Roll Tie Dye Size 10,Default Oxford,8,8,0,0,0,0
,Brooks Men's Launch 7 Rock N Roll Tie Dye Size 10.5,Brooks Men's Launch 7 Rock N Roll Tie Dye Size 10.5,Default Oxford,4,4,0,0,0,0
,Brooks Men's Launch 7 Rock N Roll Tie Dye Size 11,Brooks Men's Launch 7 Rock N Roll Tie Dye Size 11,Default Oxford,4,4,0,0,0,0
,Brooks Men's Launch 7 Rock N Roll Tie Dye Size 12,Brooks Men's Launch 7 Rock N Roll Tie Dye Size 12,Default Oxford,4,4,0,0,0,0
,Brooks Men's Launch 7 Rock N Roll Tie Dye Size 7.5,Brooks Men's Launch 7 Rock N Roll Tie Dye Size 7.5,Default Oxford,4,4,0,0,0,0
,Brooks Men's Launch 7 Rock N Roll Tie Dye Size 8,Brooks Men's Launch 7 Rock N Roll Tie Dye Size 8,Default Oxford,4,4,0,0,0,0
,Brooks Men's Launch 7 Rock N Roll Tie Dye Size 8.5,Brooks Men's Launch 7 Rock N Roll Tie Dye Size 8.5,Default Oxford,4,4,0,0,0,0
,Brooks Men's Launch 7 Rock N Roll Tie Dye Size 9,Brooks Men's Launch 7 Rock N Roll Tie Dye Size 9,Default Oxford,8,8,0,0,0,0
,Brooks Men's Launch 7 Rock N Roll Tie Dye Size 9.5,Brooks Men's Launch 7 Rock N Roll Tie Dye Size 9.5,Default Oxford,8,8,0,0,0,0
,Brooks Men's Levitate 3 Black/Ebony/Silver Size 10,Brooks Men's Levitate 3 Black/Ebony/Silver Size 10,Default Ridgefield,24,24,0,0,0,0
,Brooks Men's Levitate 3 Black/Ebony/Silver Size 10.5,Brooks Men's Levitate 3 Black/Ebony/Silver Size 10.5,FBALYB Amazon,-4,-4,0,0,0,0
,Brooks Men's Levitate 3 Black/Ebony/Silver Size 11,Brooks Men's Levitate 3 Black/Ebony/Silver Size 11,FBALYB Amazon,-1,-1,0,0,0,0
,Brooks Men's Levitate 3 Black/Ebony/Silver Size 7.5,Brooks Men's Levitate 3 Black/Ebony/Silver Size 7.5,Default Ridgefield,12,12,0,0,0,0
,Brooks Men's Levitate 3 Black/Ebony/Silver Size 8,Brooks Men's Levitate 3 Black/Ebony/Silver Size 8,Default Ridgefield,12,12,0,0,0,0
,Brooks Men's Levitate 3 Black/Ebony/Silver Size 8.5,Brooks Men's Levitate 3 Black/Ebony/Silver Size 8.5,Default Ridgefield,11,11,0,0,0,0
,Brooks Men's Levitate 3 Black/Ebony/Silver Size 9,Brooks Men's Levitate 3 Black/Ebony/Silver Size 9,FBALYB Amazon,-5,-5,0,0,0,0
,Brooks Men's Levitate 3 Black/Ebony/Silver Size 9.5,Brooks Men's Levitate 3 Black/Ebony/Silver Size 9.5,Default Ridgefield,24,24,0,0,0,0
,Brooks Men's Levitate 3 Blue/Navy/Nightlife Size 10,Brooks Men's Levitate 3 Blue/Navy/Nightlife Size 10,FBALYB Amazon,-5,-5,0,0,0,0
,Brooks Men's Levitate 3 Blue/Navy/Nightlife Size 12,Brooks Men's Levitate 3 Blue/Navy/Nightlife Size 12,FBALYB Amazon,-2,-2,0,0,0,0
,Brooks Men's Levitate 3 Blue/Navy/Nightlife Size 7.5,Brooks Men's Levitate 3 Blue/Navy/Nightlife Size 7.5,FBALYB Amazon,2,2,0,0,0,0
,Brooks Men's Levitate 3 Blue/Navy/Nightlife Size 8,Brooks Men's Levitate 3 Blue/Navy/Nightlife Size 8,FBALYB Amazon,-2,-2,0,0,0,0
,Brooks Men's Levitate 3 Blue/Navy/Nightlife Size 8.5,Brooks Men's Levitate 3 Blue/Navy/Nightlife Size 8.5,Default Ridgefield,6,6,0,0,0,0
,Brooks Men's Levitate 3 Blue/Navy/Nightlife Size 9,Brooks Men's Levitate 3 Blue/Navy/Nightlife Size 9,FBALYB Amazon,-1,-1,0,0,0,0
,Brooks Men's Levitate 3 Blue/Navy/Nightlife Size 9.5,Brooks Men's Levitate 3 Blue/Navy/Nightlife Size 9.5,FBALYB Amazon,-1,-1,0,0,0,0
,Brooks Men's Levitate 3 LE Navy/Poseidon Size 10,Brooks Men's Levitate 3 LE Navy/Poseidon Size 10,FBALYB Amazon,-2,-2,0,0,0,0
,Brooks Men's Levitate 3 LE Navy/Poseidon Size 10.5,Brooks Men's Levitate 3 LE Navy/Poseidon Size 10.5,FBALYB Amazon,-6,-6,0,0,0,0
,Brooks Men's Levitate 3 LE Navy/Poseidon Size 11,Brooks Men's Levitate 3 LE Navy/Poseidon Size 11,FBALYB Amazon,-2,-2,0,0,0,0
,Brooks Men's Levitate 3 LE Navy/Poseidon Size 12,Brooks Men's Levitate 3 LE Navy/Poseidon Size 12,FBALYB Amazon,-4,-4,0,0,0,0
,Brooks Men's Levitate 3 LE Navy/Poseidon Size 7.5,Brooks Men's Levitate 3 LE Navy/Poseidon Size 7.5,FBALYB Amazon,11,11,0,0,0,0
,Brooks Men's Levitate 3 LE Navy/Poseidon Size 8,Brooks Men's Levitate 3 LE Navy/Poseidon Size 8,FBALYB Amazon,12,12,0,0,0,0
,Brooks Men's Levitate 3 LE Navy/Poseidon Size 8.5,Brooks Men's Levitate 3 LE Navy/Poseidon Size 8.5,FBALYB Amazon,6,6,0,0,0,0
,Brooks Men's Levitate 3 LE Navy/Poseidon Size 9,Brooks Men's Levitate 3 LE Navy/Poseidon Size 9,FBALYB Amazon,29,29,0,0,0,0
,Brooks Men's Levitate 3 LE Navy/Poseidon Size 9.5,Brooks Men's Levitate 3 LE Navy/Poseidon Size 9.5,Default Oxford,1,1,0,0,0,0
,Brooks Men's Levitate 3 LE Navy/Poseidon Size 9.5,Brooks Men's Levitate 3 LE Navy/Poseidon Size 9.5,FBALYB Amazon,11,11,0,0,0,0
,Brooks Men's Ravenna 11 Ebony/Black/Stellar Size 10,Brooks Men's Ravenna 11 Ebony/Black/Stellar Size 10,FBALYB Amazon,-14,-14,0,12,0,0
,Brooks Men's Ravenna 11 Ebony/Black/Stellar Size 10.5,Brooks Men's Ravenna 11 Ebony/Black/Stellar Size 10.5,FBALYB Amazon,-12,-12,0,10,0,0
,Brooks Men's Ravenna 11 Ebony/Black/Stellar Size 12,Brooks Men's Ravenna 11 Ebony/Black/Stellar Size 12,Default Oxford,12,12,0,0,0,0
,Brooks Men's Ravenna 11 Ebony/Black/Stellar Size 13,Brooks Men's Ravenna 11 Ebony/Black/Stellar Size 13,FBALYB Amazon,-1,-1,0,0,0,0
,Brooks Men's Ravenna 11 Ebony/Black/Stellar Size 7.5,Brooks Men's Ravenna 11 Ebony/Black/Stellar Size 7.5,FBALYB Amazon,-6,-6,0,1,0,0
,Brooks Men's Ravenna 11 Ebony/Black/Stellar Size 8,Brooks Men's Ravenna 11 Ebony/Black/Stellar Size 8,FBALYB Amazon,-4,-4,0,0,0,0
,Brooks Men's Ravenna 11 Ebony/Black/Stellar Size 8.5,Brooks Men's Ravenna 11 Ebony/Black/Stellar Size 8.5,FBALYB Amazon,-4,-4,0,0,0,0
,Brooks Men's Ravenna 11 Ebony/Black/Stellar Size 9,Brooks Men's Ravenna 11 Ebony/Black/Stellar Size 9,FBALYB Amazon,-1,-1,0,0,0,0
,Brooks Men's Ravenna 11 Ebony/Black/Stellar Size 9.5,Brooks Men's Ravenna 11 Ebony/Black/Stellar Size 9.5,FBALYB Amazon,-5,-5,0,0,0,0
,Brooks Men's Ravenna 11 Grey/Cherry/Mazarine Size 10,Brooks Men's Ravenna 11 Grey/Cherry/Mazarine Size 10,FBALYB Amazon,-5,-6,1,0,1,0
,Brooks Men's Ravenna 11 Grey/Cherry/Mazarine Size 10.5,Brooks Men's Ravenna 11 Grey/Cherry/Mazarine Size 10.5,FBALYB Amazon,-1,-1,0,0,0,0
,Brooks Men's Ravenna 11 Grey/Cherry/Mazarine Size 11.5,Brooks Men's Ravenna 11 Grey/Cherry/Mazarine Size 11.5,FBALYB Amazon,-1,-1,0,0,0,0
,Brooks Men's Ravenna 11 Grey/Cherry/Mazarine Size 7.5,Brooks Men's Ravenna 11 Grey/Cherry/Mazarine Size 7.5,FBALYB Amazon,-6,-6,0,0,0,0
,Brooks Men's Ravenna 11 Grey/Cherry/Mazarine Size 8,Brooks Men's Ravenna 11 Grey/Cherry/Mazarine Size 8,Default Oxford,5,5,0,0,0,0
,Brooks Men's Ravenna 11 Grey/Cherry/Mazarine Size 8,Brooks Men's Ravenna 11 Grey/Cherry/Mazarine Size 8,FBALYB Amazon,-5,-5,0,0,0,0
,Brooks Men's Ravenna 11 Grey/Cherry/Mazarine Size 8.5,Brooks Men's Ravenna 11 Grey/Cherry/Mazarine Size 8.5,FBALYB Amazon,-2,-2,0,0,0,0
,Brooks Men's Ravenna 11 Grey/Cherry/Mazarine Size 9,Brooks Men's Ravenna 11 Grey/Cherry/Mazarine Size 9,FBALYB Amazon,1,1,0,0,0,0
,Brooks Men's Ravenna 11 Grey/Cherry/Mazarine Size 9.5,Brooks Men's Ravenna 11 Grey/Cherry/Mazarine Size 9.5,FBALYB Amazon,-5,-5,0,1,0,0
,Brooks Men's Revel 3 Black/Blackened Pearl/White Size 10,Brooks Men's Revel 3 Black/Blackened Pearl/White Size 10,FBALYB Amazon,-2,-2,0,0,0,0
,Brooks Men's Revel 3 Black/Blackened Pearl/White Size 12,Brooks Men's Revel 3 Black/Blackened Pearl/White Size 12,Default Ridgefield,6,6,0,0,0,0
,Brooks Men's Revel 3 Black/Blackened Pearl/White Size 12,Brooks Men's Revel 3 Black/Blackened Pearl/White Size 12,FBALYB Amazon,0,0,0,6,0,0
,Brooks Men's Revel 3 Black/Blackened Pearl/White Size 8,Brooks Men's Revel 3 Black/Blackened Pearl/White Size 8,FBALYB Amazon,-3,-3,0,0,0,0
,Brooks Men's Revel 3 Black/Blackened Pearl/White Size 8.5,Brooks Men's Revel 3 Black/Blackened Pearl/White Size 8.5,FBALYB Amazon,-1,-1,0,0,0,0
,Brooks Men's Revel 3 Black/Pearl/Primer Size 10,Brooks Men's Revel 3 Black/Pearl/Primer Size 10,FBALYB Amazon,-2,-2,0,1,0,0
,Brooks Men's Revel 3 Black/Pearl/Primer Size 11,Brooks Men's Revel 3 Black/Pearl/Primer Size 11,FBALYB Amazon,5,5,0,0,0,0
,Brooks Men's Revel 3 Black/Pearl/Primer Size 12,Brooks Men's Revel 3 Black/Pearl/Primer Size 12,FBALYB Amazon,-1,-1,0,0,0,0
,Brooks Men's Revel 3 Black/Pearl/Primer Size 13,Brooks Men's Revel 3 Black/Pearl/Primer Size 13,Default Ridgefield,3,3,0,0,0,0
,Brooks Men's Revel 3 Black/Pearl/Primer Size 7,Brooks Men's Revel 3 Black/Pearl/Primer Size 7,FBALYB Amazon,-6,-6,0,0,0,0
,Brooks Men's Revel 3 Black/Pearl/Primer Size 7.5,Brooks Men's Revel 3 Black/Pearl/Primer Size 7.5,FBALYB Amazon,-2,-2,0,0,0,0
,Brooks Men's Revel 3 Black/Pearl/Primer Size 8,Brooks Men's Revel 3 Black/Pearl/Primer Size 8,FBALYB Amazon,-4,-4,0,0,0,0
,Brooks Men's Revel 3 Black/Pearl/Primer Size 8.5,Brooks Men's Revel 3 Black/Pearl/Primer Size 8.5,Default Oxford,1,1,0,0,0,0
,Brooks Men's Revel 3 Black/Pearl/Primer Size 8.5,Brooks Men's Revel 3 Black/Pearl/Primer Size 8.5,FBALYB Amazon,-5,-5,0,0,0,0
,Brooks Men's Revel 3 Black/Pearl/Primer Size 9,Brooks Men's Revel 3 Black/Pearl/Primer Size 9,FBALYB Amazon,-5,-5,0,0,0,0
,Brooks Men's Revel 3 Black/Pearl/Primer Size 9.5,Brooks Men's Revel 3 Black/Pearl/Primer Size 9.5,FBALYB Amazon,-2,-2,0,0,0,0
,Brooks Men's Revel 3 Navy/Flint Stone/Grey Size 10,Brooks Men's Revel 3 Navy/Flint Stone/Grey Size 10,FBALYB Amazon,-2,-2,0,0,0,0
,Brooks Men's Revel 3 Navy/Flint Stone/Grey Size 10.5,Brooks Men's Revel 3 Navy/Flint Stone/Grey Size 10.5,FBALYB Amazon,-1,-1,0,0,0,0
,Brooks Men's Revel 3 Navy/Flint Stone/Grey Size 11.5,Brooks Men's Revel 3 Navy/Flint Stone/Grey Size 11.5,Default Ridgefield,3,3,0,0,0,0
,Brooks Men's Revel 3 Navy/Flint Stone/Grey Size 12,Brooks Men's Revel 3 Navy/Flint Stone/Grey Size 12,FBALYB Amazon,-1,-1,0,0,0,0
,Brooks Men's Revel 3 Navy/Flint Stone/Grey Size 7.5,Brooks Men's Revel 3 Navy/Flint Stone/Grey Size 7.5,FBALYB Amazon,-3,-3,0,0,0,0
,Brooks Men's Revel 3 Navy/Flint Stone/Grey Size 9,Brooks Men's Revel 3 Navy/Flint Stone/Grey Size 9,FBALYB Amazon,-1,-1,0,0,0,0
,Brooks Men's Revel 3 Navy/Flint Stone/Grey Size 9.5,Brooks Men's Revel 3 Navy/Flint Stone/Grey Size 9.5,FBALYB Amazon,-1,-1,0,0,0,0
,Brooks Men's Revel 3 Primer/Ebony/Black Size 10,Brooks Men's Revel 3 Primer/Ebony/Black Size 10,FBALYB Amazon,0,0,0,12,0,0
,Brooks Men's Revel 3 Primer/Ebony/Black Size 10.5,Brooks Men's Revel 3 Primer/Ebony/Black Size 10.5,FBALYB Amazon,-3,-3,0,0,0,0
,Brooks Men's Revel 3 Primer/Ebony/Black Size 8,Brooks Men's Revel 3 Primer/Ebony/Black Size 8,FBALYB Amazon,-2,-2,0,0,0,0
,Brooks Men's Revel 3 Primer/Ebony/Black Size 9,Brooks Men's Revel 3 Primer/Ebony/Black Size 9,FBALYB Amazon,-3,-3,0,0,0,0
,Brooks Men's Ricochet 2 Grey/Navy Size 10,Brooks Men's Ricochet 2 Grey/Navy Size 10,FBALYB Amazon,-4,-4,0,0,0,0
,Brooks Men's Ricochet 2 Grey/Navy Size 10.5,Brooks Men's Ricochet 2 Grey/Navy Size 10.5,FBALYB Amazon,-1,-1,0,0,0,0
,Brooks Men's Ricochet 2 Grey/Navy Size 11,Brooks Men's Ricochet 2 Grey/Navy Size 11,FBALYB Amazon,-2,-2,0,0,0,0
,Brooks Men's Ricochet 2 Grey/Navy Size 12,Brooks Men's Ricochet 2 Grey/Navy Size 12,FBALYB Amazon,-2,-2,0,0,0,0
,Brooks Men's Ricochet 2 Grey/Navy Size 7.5,Brooks Men's Ricochet 2 Grey/Navy Size 7.5,FBALYB Amazon,3,3,0,0,0,0
,Brooks Men's Ricochet 2 Grey/Navy Size 8,Brooks Men's Ricochet 2 Grey/Navy Size 8,Default Oxford,1,1,0,0,0,0
,Brooks Men's Ricochet 2 Grey/Navy Size 8.5,Brooks Men's Ricochet 2 Grey/Navy Size 8.5,FBALYB Amazon,-3,-3,0,0,0,0
,Brooks Men's Ricochet 2 Grey/Navy Size 9,Brooks Men's Ricochet 2 Grey/Navy Size 9,FBALYB Amazon,-4,-4,0,0,0,0
,Brooks Men's Ricochet 2 Grey/Navy Size 9.5,Brooks Men's Ricochet 2 Grey/Navy Size 9.5,FBALYB Amazon,-7,-7,0,0,0,0
,Brooks Men's Transcend 7 Black/Ebony/Grey Size 10,Brooks Men's Transcend 7 Black/Ebony/Grey Size 10,FBALYB Amazon,-2,-2,0,0,0,0
,Brooks Men's Transcend 7 Black/Ebony/Grey Size 10.5,Brooks Men's Transcend 7 Black/Ebony/Grey Size 10.5,FBALYB Amazon,-1,-1,0,0,0,0
,Brooks Men's Transcend 7 Black/Ebony/Grey Size 12,Brooks Men's Transcend 7 Black/Ebony/Grey Size 12,FBALYB Amazon,-1,-1,0,0,0,0
,Brooks Men's Transcend 7 Black/Ebony/Grey Size 7.5,Brooks Men's Transcend 7 Black/Ebony/Grey Size 7.5,FBALYB Amazon,-1,-1,0,0,0,0
,Brooks Men's Transcend 7 Black/Ebony/Grey Size 8,Brooks Men's Transcend 7 Black/Ebony/Grey Size 8,FBALYB Amazon,-1,-1,0,0,0,0
,Brooks Men's Transcend 7 Black/Ebony/Grey Size 8.5,Brooks Men's Transcend 7 Black/Ebony/Grey Size 8.5,FBALYB Amazon,-2,-2,0,0,0,0
,Brooks Men's Transcend 7 Black/Ebony/Grey Size 9,Brooks Men's Transcend 7 Black/Ebony/Grey Size 9,Default Oxford,1,1,0,0,0,0
,Brooks Men's Transcend 7 Black/Ebony/Grey Size 9,Brooks Men's Transcend 7 Black/Ebony/Grey Size 9,FBALYB Amazon,-1,-1,0,0,0,0
,Brooks Men's Transcend 7 Black/Ebony/Grey Size 9.5,Brooks Men's Transcend 7 Black/Ebony/Grey Size 9.5,FBALYB Amazon,-2,-2,0,0,0,0
,Brooks Men's Transcend 7 Mazarine/Black/Red Size 10,Brooks Men's Transcend 7 Mazarine/Black/Red Size 10,FBALYB Amazon,-2,-2,0,1,0,0
,Brooks Men's Transcend 7 Mazarine/Black/Red Size 10.5,Brooks Men's Transcend 7 Mazarine/Black/Red Size 10.5,Default Ridgefield,9,9,0,0,0,0
,Brooks Men's Transcend 7 Mazarine/Black/Red Size 7,Brooks Men's Transcend 7 Mazarine/Black/Red Size 7,FBALYB Amazon,-1,-1,0,0,0,0
,Brooks Men's Transcend 7 Mazarine/Black/Red Size 7.5,Brooks Men's Transcend 7 Mazarine/Black/Red Size 7.5,FBALYB Amazon,7,7,0,0,0,0
,Brooks Men's Transcend 7 Mazarine/Black/Red Size 8,Brooks Men's Transcend 7 Mazarine/Black/Red Size 8,Default Ridgefield,9,9,0,0,0,0
,Brooks Men's Transcend 7 Mazarine/Black/Red Size 8.5,Brooks Men's Transcend 7 Mazarine/Black/Red Size 8.5,Default Oxford,1,1,0,0,0,0
,Brooks Men's Transcend 7 Mazarine/Black/Red Size 8.5,Brooks Men's Transcend 7 Mazarine/Black/Red Size 8.5,FBALYB Amazon,-1,-1,0,0,0,0
,Brooks Men's Transcend 7 Mazarine/Black/Red Size 9,Brooks Men's Transcend 7 Mazarine/Black/Red Size 9,FBALYB Amazon,13,13,0,0,0,0
,Brooks Men's Transcend 7 Mazarine/Black/Red Size 9.5,Brooks Men's Transcend 7 Mazarine/Black/Red Size 9.5,FBALYB Amazon,-2,-2,0,0,0,0
,Brooks M'S REVEL 4 BLACK/OYSTER/SILVER 1103471D063 Size 10,Brooks M'S REVEL 4 BLACK/OYSTER/SILVER 1103471D063 Size 10,FBALYB Amazon,10,10,0,0,0,0
,Brooks M'S REVEL 4 BLACK/OYSTER/SILVER 1103471D063 Size 10.5,Brooks M'S REVEL 4 BLACK/OYSTER/SILVER 1103471D063 Size 10.5,FBALYB Amazon,10,10,0,0,0,0
,Brooks M'S REVEL 4 BLACK/OYSTER/SILVER 1103471D063 Size 11.5,Brooks M'S REVEL 4 BLACK/OYSTER/SILVER 1103471D063 Size 11.5,FBALYB Amazon,6,6,0,0,0,0
,Brooks M'S REVEL 4 BLACK/OYSTER/SILVER 1103471D063 Size 12,Brooks M'S REVEL 4 BLACK/OYSTER/SILVER 1103471D063 Size 12,FBALYB Amazon,6,6,0,0,0,0
,Brooks M'S REVEL 4 BLACK/OYSTER/SILVER 1103471D063 Size 13,Brooks M'S REVEL 4 BLACK/OYSTER/SILVER 1103471D063 Size 13,FBALYB Amazon,8,8,0,0,0,0
,Brooks M'S REVEL 4 BLACK/OYSTER/SILVER 1103471D063 Size 8,Brooks M'S REVEL 4 BLACK/OYSTER/SILVER 1103471D063 Size 8,FBALYB Amazon,7,7,0,0,0,0
,Brooks M'S REVEL 4 BLACK/OYSTER/SILVER 1103471D063 Size 8.5,Brooks M'S REVEL 4 BLACK/OYSTER/SILVER 1103471D063 Size 8.5,FBALYB Amazon,3,2,1,0,1,0
,Brooks M'S REVEL 4 BLACK/OYSTER/SILVER 1103471D063 Size 9,Brooks M'S REVEL 4 BLACK/OYSTER/SILVER 1103471D063 Size 9,FBALYB Amazon,8,8,0,0,0,0
,Brooks M'S REVEL 4 BLACK/OYSTER/SILVER 1103471D063 Size 9.5,Brooks M'S REVEL 4 BLACK/OYSTER/SILVER 1103471D063 Size 9.5,FBALYB Amazon,5,5,0,0,0,0
,Brooks M'S REVEL 4 BLACK/WHITE/NIGHTLIFE 1103471D024 Size 10.5,Brooks M'S REVEL 4 BLACK/WHITE/NIGHTLIFE 1103471D024 Size 10.5,Default Ridgefield,16,16,0,0,0,0
,Brooks M'S REVEL 4 BLACK/WHITE/NIGHTLIFE 1103471D024 Size 11,Brooks M'S REVEL 4 BLACK/WHITE/NIGHTLIFE 1103471D024 Size 11,FBALYB Amazon,6,4,2,0,2,0
,Brooks M'S REVEL 4 BLACK/WHITE/NIGHTLIFE 1103471D024 Size 11.5,Brooks M'S REVEL 4 BLACK/WHITE/NIGHTLIFE 1103471D024 Size 11.5,Default Ridgefield,8,8,0,0,0,0
,Brooks M'S REVEL 4 BLACK/WHITE/NIGHTLIFE 1103471D024 Size 12,Brooks M'S REVEL 4 BLACK/WHITE/NIGHTLIFE 1103471D024 Size 12,Default Ridgefield,8,8,0,0,0,0
,Brooks M'S REVEL 4 BLACK/WHITE/NIGHTLIFE 1103471D024 Size 8,Brooks M'S REVEL 4 BLACK/WHITE/NIGHTLIFE 1103471D024 Size 8,FBALYB Amazon,6,6,0,0,0,0
,Brooks M'S REVEL 4 BLACK/WHITE/NIGHTLIFE 1103471D024 Size 8.5,Brooks M'S REVEL 4 BLACK/WHITE/NIGHTLIFE 1103471D024 Size 8.5,FBALYB Amazon,3,3,0,0,0,0
,Brooks M'S REVEL 4 BLACK/WHITE/NIGHTLIFE 1103471D024 Size 9.5,Brooks M'S REVEL 4 BLACK/WHITE/NIGHTLIFE 1103471D024 Size 9.5,FBALYB Amazon,1,1,0,0,0,0
,Brooks Woman ADRENALINE GTS21 IRIS/LILACSCACHET/OMBREBLUE 1203291B675 Size 10,Brooks Woman ADRENALINE GTS21 IRIS/LILACSCACHET/OMBREBLUE 1203291B675 Size 10,FBALYB Amazon,1,-1,2,0,2,0
,Brooks Woman ADRENALINE GTS21 IRIS/LILACSCACHET/OMBREBLUE 1203291B675 Size 6,Brooks Woman ADRENALINE GTS21 IRIS/LILACSCACHET/OMBREBLUE 1203291B675 Size 6,FBALYB Amazon,63,61,2,0,2,0
,Brooks Woman ADRENALINE GTS21 IRIS/LILACSCACHET/OMBREBLUE 1203291B675 Size 6.5,Brooks Woman ADRENALINE GTS21 IRIS/LILACSCACHET/OMBREBLUE 1203291B675 Size 6.5,FBALYB Amazon,27,25,2,0,2,0
,Brooks Woman ADRENALINE GTS21 IRIS/LILACSCACHET/OMBREBLUE 1203291B675 Size 7,Brooks Woman ADRENALINE GTS21 IRIS/LILACSCACHET/OMBREBLUE 1203291B675 Size 7,FBALYB Amazon,-5,-6,1,0,1,0
,Brooks Woman ADRENALINE GTS21 IRIS/LILACSCACHET/OMBREBLUE 1203291B675 Size 7.5,Brooks Woman ADRENALINE GTS21 IRIS/LILACSCACHET/OMBREBLUE 1203291B675 Size 7.5,FBALYB Amazon,1,0,1,0,1,0
,Brooks Woman ADRENALINE GTS21 IRIS/LILACSCACHET/OMBREBLUE 1203291B675 Size 8,Brooks Woman ADRENALINE GTS21 IRIS/LILACSCACHET/OMBREBLUE 1203291B675 Size 8,FBALYB Amazon,-5,-6,1,0,1,0
,Brooks Woman ADRENALINE GTS21 IRIS/LILACSCACHET/OMBREBLUE 1203291B675 Size 8.5,Brooks Woman ADRENALINE GTS21 IRIS/LILACSCACHET/OMBREBLUE 1203291B675 Size 8.5,FBALYB Amazon,-7,-7,0,0,0,0
,Brooks Woman ADRENALINE GTS21 IRIS/LILACSCACHET/OMBREBLUE 1203291B675 Size 9,Brooks Woman ADRENALINE GTS21 IRIS/LILACSCACHET/OMBREBLUE 1203291B675 Size 9,FBALYB Amazon,-8,-8,0,0,0,0
,Brooks Woman ADRENALINE GTS21 IRIS/LILACSCACHET/OMBREBLUE 1203291B675 Size 9.5,Brooks Woman ADRENALINE GTS21 IRIS/LILACSCACHET/OMBREBLUE 1203291B675 Size 9.5,FBALYB Amazon,-2,-2,0,0,0,0
,Brooks Woman ADRENALINE GTS21 RASPBERRY/PINK/SULPHUR 1203291B664 Size 10,Brooks Woman ADRENALINE GTS21 RASPBERRY/PINK/SULPHUR 1203291B664 Size 10,Default Ridgefield,12,12,0,0,0,0
,Brooks Woman ADRENALINE GTS21 RASPBERRY/PINK/SULPHUR 1203291B664 Size 6,Brooks Woman ADRENALINE GTS21 RASPBERRY/PINK/SULPHUR 1203291B664 Size 6,Default Ridgefield,36,36,0,0,0,0
,Brooks Woman ADRENALINE GTS21 RASPBERRY/PINK/SULPHUR 1203291B664 Size 6.5,Brooks Woman ADRENALINE GTS21 RASPBERRY/PINK/SULPHUR 1203291B664 Size 6.5,FBALYB Amazon,-4,-4,0,0,0,0
,Brooks Woman ADRENALINE GTS21 RASPBERRY/PINK/SULPHUR 1203291B664 Size 7,Brooks Woman ADRENALINE GTS21 RASPBERRY/PINK/SULPHUR 1203291B664 Size 7,FBALYB Amazon,1,-1,2,0,2,0
,Brooks Woman ADRENALINE GTS21 RASPBERRY/PINK/SULPHUR 1203291B664 Size 7.5,Brooks Woman ADRENALINE GTS21 RASPBERRY/PINK/SULPHUR 1203291B664 Size 7.5,FBALYB Amazon,-5,-5,0,0,0,0
,Brooks Woman ADRENALINE GTS21 RASPBERRY/PINK/SULPHUR 1203291B664 Size 8,Brooks Woman ADRENALINE GTS21 RASPBERRY/PINK/SULPHUR 1203291B664 Size 8,Default Ridgefield,1,1,0,0,0,0
,Brooks Woman ADRENALINE GTS21 RASPBERRY/PINK/SULPHUR 1203291B664 Size 8,Brooks Woman ADRENALINE GTS21 RASPBERRY/PINK/SULPHUR 1203291B664 Size 8,FBALYB Amazon,27,27,0,0,0,0
,Brooks Woman ADRENALINE GTS21 RASPBERRY/PINK/SULPHUR 1203291B664 Size 8.5,Brooks Woman ADRENALINE GTS21 RASPBERRY/PINK/SULPHUR 1203291B664 Size 8.5,Default Ridgefield,36,36,0,0,0,0
,Brooks Woman ADRENALINE GTS21 RASPBERRY/PINK/SULPHUR 1203291B664 Size 9,Brooks Woman ADRENALINE GTS21 RASPBERRY/PINK/SULPHUR 1203291B664 Size 9,Default Ridgefield,24,24,0,0,0,0
,Brooks Woman ADRENALINE GTS21 RASPBERRY/PINK/SULPHUR 1203291B664 Size 9.5,Brooks Woman ADRENALINE GTS21 RASPBERRY/PINK/SULPHUR 1203291B664 Size 9.5,Default Ridgefield,12,12,0,0,0,0
,Brooks Woman GHOST 13 BLACK/BLACK 1203381B072 Size 10,Brooks Woman GHOST 13 BLACK/BLACK 1203381B072 Size 10,FBALYB Amazon,-1,-1,0,0,0,0
,Brooks Woman GHOST 13 BLACK/BLACK 1203381B072 Size 6,Brooks Woman GHOST 13 BLACK/BLACK 1203381B072 Size 6,Default Ridgefield,1,1,0,0,0,0
,Brooks Woman GHOST 13 BLACK/BLACK 1203381B072 Size 6,Brooks Woman GHOST 13 BLACK/BLACK 1203381B072 Size 6,FBALYB Amazon,-4,-5,1,0,1,0
,Brooks Woman GHOST 13 BLACK/BLACK 1203381B072 Size 6.5,Brooks Woman GHOST 13 BLACK/BLACK 1203381B072 Size 6.5,FBALYB Amazon,-4,-5,1,0,1,0
,Brooks Woman GHOST 13 BLACK/BLACK 1203381B072 Size 7,Brooks Woman GHOST 13 BLACK/BLACK 1203381B072 Size 7,FBALYB Amazon,-9,-9,0,0,0,0
,Brooks Woman GHOST 13 BLACK/BLACK 1203381B072 Size 7.5,Brooks Woman GHOST 13 BLACK/BLACK 1203381B072 Size 7.5,FBALYB Amazon,-6,-6,0,0,0,0
,Brooks Woman GHOST 13 BLACK/BLACK 1203381B072 Size 8,Brooks Woman GHOST 13 BLACK/BLACK 1203381B072 Size 8,Default Ridgefield,1,1,0,0,0,0
,Brooks Woman GHOST 13 BLACK/BLACK 1203381B072 Size 8,Brooks Woman GHOST 13 BLACK/BLACK 1203381B072 Size 8,FBALYB Amazon,-8,-8,0,0,0,0
,Brooks Woman GHOST 13 BLACK/BLACK 1203381B072 Size 8.5,Brooks Woman GHOST 13 BLACK/BLACK 1203381B072 Size 8.5,FBALYB Amazon,-7,-7,0,0,0,0
,Brooks Woman GHOST 13 BLACK/BLACK 1203381B072 Size 9,Brooks Woman GHOST 13 BLACK/BLACK 1203381B072 Size 9,FBALYB Amazon,-3,-3,0,0,0,0
,Brooks Woman GHOST 13 BLACK/EBONY/CORAL 1203381B061 Size 10,Brooks Woman GHOST 13 BLACK/EBONY/CORAL 1203381B061 Size 10,Default Ridgefield,2,2,0,0,0,0
,Brooks Woman GHOST 13 BLACK/EBONY/CORAL 1203381B061 Size 10,Brooks Woman GHOST 13 BLACK/EBONY/CORAL 1203381B061 Size 10,FBALYB Amazon,-2,-2,0,0,0,0
,Brooks Woman GHOST 13 BLACK/EBONY/CORAL 1203381B061 Size 6,Brooks Woman GHOST 13 BLACK/EBONY/CORAL 1203381B061 Size 6,FBALYB Amazon,2,2,0,0,0,0
,Brooks Woman GHOST 13 BLACK/EBONY/CORAL 1203381B061 Size 6.5,Brooks Woman GHOST 13 BLACK/EBONY/CORAL 1203381B061 Size 6.5,FBALYB Amazon,-4,-4,0,0,0,0
,Brooks Woman GHOST 13 BLACK/EBONY/CORAL 1203381B061 Size 7,Brooks Woman GHOST 13 BLACK/EBONY/CORAL 1203381B061 Size 7,FBALYB Amazon,-3,-3,0,0,0,0
,Brooks Woman GHOST 13 BLACK/EBONY/CORAL 1203381B061 Size 7.5,Brooks Woman GHOST 13 BLACK/EBONY/CORAL 1203381B061 Size 7.5,FBALYB Amazon,-3,-3,0,0,0,0
,Brooks Woman GHOST 13 BLACK/EBONY/CORAL 1203381B061 Size 8,Brooks Woman GHOST 13 BLACK/EBONY/CORAL 1203381B061 Size 8,FBALYB Amazon,-7,-9,2,0,2,0
,Brooks Woman GHOST 13 BLACK/EBONY/CORAL 1203381B061 Size 8.5,Brooks Woman GHOST 13 BLACK/EBONY/CORAL 1203381B061 Size 8.5,FBALYB Amazon,-4,-4,0,0,0,0
,Brooks Woman GHOST 13 BLACK/EBONY/CORAL 1203381B061 Size 9,Brooks Woman GHOST 13 BLACK/EBONY/CORAL 1203381B061 Size 9,FBALYB Amazon,-3,-3,0,0,0,0
,Brooks Woman GHOST 13 BLACK/EBONY/CORAL 1203381B061 Size 9.5,Brooks Woman GHOST 13 BLACK/EBONY/CORAL 1203381B061 Size 9.5,FBALYB Amazon,-19,-19,0,16,0,0
,Brooks Woman GHOST 13 REFLECTIVEPOND/PINK/ICE 1203381B391 Size 10,Brooks Woman GHOST 13 REFLECTIVEPOND/PINK/ICE 1203381B391 Size 10,FBALYB Amazon,42,39,3,0,3,0
,Brooks Woman GHOST 13 REFLECTIVEPOND/PINK/ICE 1203381B391 Size 6,Brooks Woman GHOST 13 REFLECTIVEPOND/PINK/ICE 1203381B391 Size 6,FBALYB Amazon,84,84,0,0,0,0
,Brooks Woman GHOST 13 REFLECTIVEPOND/PINK/ICE 1203381B391 Size 6.5,Brooks Woman GHOST 13 REFLECTIVEPOND/PINK/ICE 1203381B391 Size 6.5,FBALYB Amazon,32,29,3,0,3,0
,Brooks Woman GHOST 13 REFLECTIVEPOND/PINK/ICE 1203381B391 Size 7,Brooks Woman GHOST 13 REFLECTIVEPOND/PINK/ICE 1203381B391 Size 7,FBALYB Amazon,-3,-6,3,0,3,0
,Brooks Woman GHOST 13 REFLECTIVEPOND/PINK/ICE 1203381B391 Size 7.5,Brooks Woman GHOST 13 REFLECTIVEPOND/PINK/ICE 1203381B391 Size 7.5,FBALYB Amazon,10,3,7,1,7,0
,Brooks Woman GHOST 13 REFLECTIVEPOND/PINK/ICE 1203381B391 Size 8,Brooks Woman GHOST 13 REFLECTIVEPOND/PINK/ICE 1203381B391 Size 8,FBALYB Amazon,49,41,8,0,8,0
,Brooks Woman GHOST 13 REFLECTIVEPOND/PINK/ICE 1203381B391 Size 8.5,Brooks Woman GHOST 13 REFLECTIVEPOND/PINK/ICE 1203381B391 Size 8.5,FBALYB Amazon,-22,-25,3,0,3,0
,Brooks Woman GHOST 13 REFLECTIVEPOND/PINK/ICE 1203381B391 Size 9,Brooks Woman GHOST 13 REFLECTIVEPOND/PINK/ICE 1203381B391 Size 9,FBALYB Amazon,-13,-13,0,0,0,0
,Brooks Woman GHOST 13 REFLECTIVEPOND/PINK/ICE 1203381B391 Size 9.5,Brooks Woman GHOST 13 REFLECTIVEPOND/PINK/ICE 1203381B391 Size 9.5,FBALYB Amazon,-4,-5,1,0,1,0
,Brooks Woman GLYCERIN 19 BLACK/OMBRE/PIMROSE 1203431B086 Size 10,Brooks Woman GLYCERIN 19 BLACK/OMBRE/PIMROSE 1203431B086 Size 10,FBALYB Amazon,11,11,0,0,0,0
,Brooks Woman GLYCERIN 19 BLACK/OMBRE/PIMROSE 1203431B086 Size 6,Brooks Woman GLYCERIN 19 BLACK/OMBRE/PIMROSE 1203431B086 Size 6,FBALYB Amazon,13,13,0,0,0,0
,Brooks Woman GLYCERIN 19 BLACK/OMBRE/PIMROSE 1203431B086 Size 6.5,Brooks Woman GLYCERIN 19 BLACK/OMBRE/PIMROSE 1203431B086 Size 6.5,Default Ridgefield,33,33,0,0,0,0
,Brooks Woman GLYCERIN 19 BLACK/OMBRE/PIMROSE 1203431B086 Size 7,Brooks Woman GLYCERIN 19 BLACK/OMBRE/PIMROSE 1203431B086 Size 7,FBALYB Amazon,-3,-3,0,0,0,0
,Brooks Woman GLYCERIN 19 BLACK/OMBRE/PIMROSE 1203431B086 Size 7.5,Brooks Woman GLYCERIN 19 BLACK/OMBRE/PIMROSE 1203431B086 Size 7.5,Default Ridgefield,44,44,0,0,0,0
,Brooks Woman GLYCERIN 19 BLACK/OMBRE/PIMROSE 1203431B086 Size 8,Brooks Woman GLYCERIN 19 BLACK/OMBRE/PIMROSE 1203431B086 Size 8,FBALYB Amazon,-2,-2,0,0,0,0
,Brooks Woman GLYCERIN 19 BLACK/OMBRE/PIMROSE 1203431B086 Size 8.5,Brooks Woman GLYCERIN 19 BLACK/OMBRE/PIMROSE 1203431B086 Size 8.5,FBALYB Amazon,-3,-5,2,0,2,0
,Brooks Woman GLYCERIN 19 BLACK/OMBRE/PIMROSE 1203431B086 Size 9,Brooks Woman GLYCERIN 19 BLACK/OMBRE/PIMROSE 1203431B086 Size 9,FBALYB Amazon,-4,-4,0,0,0,0
,Brooks Woman GLYCERIN 19 BLACK/OMBRE/PIMROSE 1203431B086 Size 9.5,Brooks Woman GLYCERIN 19 BLACK/OMBRE/PIMROSE 1203431B086 Size 9.5,FBALYB Amazon,4,4,0,0,0,0
,Brooks Woman LAUNCH 8 ICE FLAW/NAVY/PINK 1203451B110 Size 10,Brooks Woman LAUNCH 8 ICE FLAW/NAVY/PINK 1203451B110 Size 10,FBALYB Amazon,-1,-1,0,0,0,0
,Brooks Woman LAUNCH 8 ICE FLAW/NAVY/PINK 1203451B110 Size 6,Brooks Woman LAUNCH 8 ICE FLAW/NAVY/PINK 1203451B110 Size 6,FBALYB Amazon,17,16,1,0,1,0
,Brooks WomanLAUNCH 8 ICE FLAW/NAVY/PINK 1203451B110 Size 6.5,Brooks WomanLAUNCH 8 ICE FLAW/NAVY/PINK 1203451B110 Size 6.5,FBALYB Amazon,-1,-2,1,0,1,0
,Brooks Woman LAUNCH 8 ICE FLAW/NAVY/PINK 1203451B110 Size 7,Brooks Woman LAUNCH 8 ICE FLAW/NAVY/PINK 1203451B110 Size 7,FBALYB Amazon,30,30,0,0,0,0
,Brooks Woman LAUNCH 8 ICE FLAW/NAVY/PINK 1203451B110 Size 7.5,Brooks Woman LAUNCH 8 ICE FLAW/NAVY/PINK 1203451B110 Size 7.5,Default Ridgefield,40,40,0,0,0,0
,Brooks Woman LAUNCH 8 ICE FLAW/NAVY/PINK 1203451B110 Size 8,Brooks Woman LAUNCH 8 ICE FLAW/NAVY/PINK 1203451B110 Size 8,FBALYB Amazon,-3,-3,0,0,0,0
,Brooks Woman LAUNCH 8 ICE FLAW/NAVY/PINK 1203451B110 Size 8.5,Brooks Woman LAUNCH 8 ICE FLAW/NAVY/PINK 1203451B110 Size 8.5,FBALYB Amazon,-1,-1,0,0,0,0
,Brooks Woman LAUNCH 8 ICE FLAW/NAVY/PINK 1203451B110 Size 9,Brooks Woman LAUNCH 8 ICE FLAW/NAVY/PINK 1203451B110 Size 9,FBALYB Amazon,-4,-5,1,0,1,0
,Brooks Woman LAUNCH 8 ICE FLAW/NAVY/PINK 1203451B110 Size 9.5,Brooks Woman LAUNCH 8 ICE FLAW/NAVY/PINK 1203451B110 Size 9.5,FBALYB Amazon,-2,-2,0,0,0,0
,Brooks Woman LEVITATE 4 NAVY/BLACK/PINK 1203351B419  Size 10,Brooks Woman LEVITATE 4 NAVY/BLACK/PINK 1203351B419  Size 10,FBALYB Amazon,10,10,0,0,0,0
,Brooks Woman LEVITATE 4 NAVY/BLACK/PINK 1203351B419  Size 6,Brooks Woman LEVITATE 4 NAVY/BLACK/PINK 1203351B419  Size 6,Default Ridgefield,36,36,0,0,0,0
,Brooks Woman LEVITATE 4 NAVY/BLACK/PINK 1203351B419  Size 6.5,Brooks Woman LEVITATE 4 NAVY/BLACK/PINK 1203351B419  Size 6.5,FBALYB Amazon,35,35,0,0,0,0
,Brooks Woman LEVITATE 4 NAVY/BLACK/PINK 1203351B419  Size 7,Brooks Woman LEVITATE 4 NAVY/BLACK/PINK 1203351B419  Size 7,FBALYB Amazon,33,33,0,0,0,0
,Brooks Woman LEVITATE 4 NAVY/BLACK/PINK 1203351B419  Size 7.5,Brooks Woman LEVITATE 4 NAVY/BLACK/PINK 1203351B419  Size 7.5,FBALYB Amazon,40,40,0,0,0,0
,Brooks Woman LEVITATE 4 NAVY/BLACK/PINK 1203351B419  Size 8,Brooks Woman LEVITATE 4 NAVY/BLACK/PINK 1203351B419  Size 8,FBALYB Amazon,43,42,1,0,1,0
,Brooks Woman LEVITATE 4 NAVY/BLACK/PINK 1203351B419  Size 8.5,Brooks Woman LEVITATE 4 NAVY/BLACK/PINK 1203351B419  Size 8.5,FBALYB Amazon,34,34,0,0,0,0
,Brooks Woman LEVITATE 4 NAVY/BLACK/PINK 1203351B419  Size 9,Brooks Woman LEVITATE 4 NAVY/BLACK/PINK 1203351B419  Size 9,FBALYB Amazon,14,14,0,0,0,0
,Brooks Woman LEVITATE 4 NAVY/BLACK/PINK 1203351B419  Size 9.5,Brooks Woman LEVITATE 4 NAVY/BLACK/PINK 1203351B419  Size 9.5,Default Ridgefield,12,12,0,0,0,0
,Brooks Women's Addiction 14 Black/Hot Pink/Silver Size 10,Brooks Women's Addiction 14 Black/Hot Pink/Silver Size 10,FBALYB Amazon,-8,-8,0,6,0,0
,Brooks Women's Addiction 14 Black/Hot Pink/Silver Size 6,Brooks Women's Addiction 14 Black/Hot Pink/Silver Size 6,FBALYB Amazon,-2,-2,0,0,0,0
,Brooks Women's Addiction 14 Black/Hot Pink/Silver Size 7.5,Brooks Women's Addiction 14 Black/Hot Pink/Silver Size 7.5,FBALYB Amazon,-6,-6,0,0,0,0
,Brooks Women's Addiction 14 Black/Hot Pink/Silver Size 8,Brooks Women's Addiction 14 Black/Hot Pink/Silver Size 8,FBALYB Amazon,-2,-2,0,0,0,0
,Brooks Women's Adrenaline GTS 20 Alloy/Rose Gold/Blackened Pear Size 6,Brooks Women's Adrenaline GTS 20 Alloy/Rose Gold/Blackened Pear Size 6,FBALYB Amazon,-1,-1,0,0,0,0
,Brooks Women's Adrenaline GTS 20 Alloy/Rose Gold/Blackened Pear Size 7,Brooks Women's Adrenaline GTS 20 Alloy/Rose Gold/Blackened Pear Size 7,FBALYB Amazon,-1,-1,0,0,0,0
,Brooks Women's Adrenaline GTS 20 Alloy/Rose Gold/Blackened Pear Size 7.5,Brooks Women's Adrenaline GTS 20 Alloy/Rose Gold/Blackened Pear Size 7.5,FBALYB Amazon,-2,-2,0,0,0,0
,Brooks Women's Adrenaline GTS 20 Alloy/Rose Gold/Blackened Pear Size 8,Brooks Women's Adrenaline GTS 20 Alloy/Rose Gold/Blackened Pear Size 8,FBALYB Amazon,-2,-2,0,0,0,0
,Brooks Women's Adrenaline GTS 20 Alloy/Rose Gold/Blackened Pear Size 8.5,Brooks Women's Adrenaline GTS 20 Alloy/Rose Gold/Blackened Pear Size 8.5,FBALYB Amazon,-1,-1,0,0,0,0
,Brooks Women's Adrenaline GTS 20 Alloy/Rose Gold/Blackened Pear Size 9,Brooks Women's Adrenaline GTS 20 Alloy/Rose Gold/Blackened Pear Size 9,FBALYB Amazon,-2,-2,0,0,0,0
,Brooks Women's Adrenaline GTS 20 Black/Grey Size 6.5,Brooks Women's Adrenaline GTS 20 Black/Grey Size 6.5,FBALYB Amazon,-3,-3,0,0,0,0
,Brooks Women's Adrenaline GTS 20 Black/Grey Size 7.5,Brooks Women's Adrenaline GTS 20 Black/Grey Size 7.5,FBALYB Amazon,-3,-3,0,0,0,0
,Brooks Women's Adrenaline GTS 20 Black/Grey Size 8.5,Brooks Women's Adrenaline GTS 20 Black/Grey Size 8.5,FBALYB Amazon,-3,-3,0,0,0,0
,Brooks Women's Adrenaline GTS 20 Black/Grey Size 9.5,Brooks Women's Adrenaline GTS 20 Black/Grey Size 9.5,FBALYB Amazon,-1,-1,0,0,0,0
,Brooks Women's Adrenaline GTS 20 Ebony/Black/Hollyhock Size 10,Brooks Women's Adrenaline GTS 20 Ebony/Black/Hollyhock Size 10,FBALYB Amazon,-5,-5,0,5,0,0
,Brooks Women's Adrenaline GTS 20 Ebony/Black/Hollyhock Size 6,Brooks Women's Adrenaline GTS 20 Ebony/Black/Hollyhock Size 6,FBALYB Amazon,-7,-7,0,5,0,0
,Brooks Women's Adrenaline GTS 20 Ebony/Black/Hollyhock Size 6.5,Brooks Women's Adrenaline GTS 20 Ebony/Black/Hollyhock Size 6.5,FBALYB Amazon,-7,-7,0,6,0,0
,Brooks Women's Adrenaline GTS 20 Ebony/Black/Hollyhock Size 7,Brooks Women's Adrenaline GTS 20 Ebony/Black/Hollyhock Size 7,FBALYB Amazon,-6,-6,0,5,0,0
,Brooks Women's Adrenaline GTS 20 Ebony/Black/Hollyhock Size 8,Brooks Women's Adrenaline GTS 20 Ebony/Black/Hollyhock Size 8,FBALYB Amazon,-10,-10,0,10,0,0
,Brooks Women's Adrenaline GTS 20 Ebony/Black/Hollyhock Size 9,Brooks Women's Adrenaline GTS 20 Ebony/Black/Hollyhock Size 9,FBALYB Amazon,-6,-6,0,5,0,0
,Brooks Women's Adrenaline GTS 20 Grape/Jewel/Cantaloupe Size 10,Brooks Women's Adrenaline GTS 20 Grape/Jewel/Cantaloupe Size 10,FBALYB Amazon,-4,-4,0,0,0,0
,Brooks Women's Adrenaline GTS 20 Grape/Jewel/Cantaloupe Size 6,Brooks Women's Adrenaline GTS 20 Grape/Jewel/Cantaloupe Size 6,FBALYB Amazon,6,6,0,0,0,0
,Brooks Women's Adrenaline GTS 20 Grape/Jewel/Cantaloupe Size 6,Brooks Women's Adrenaline GTS 20 Grape/Jewel/Cantaloupe Size 6,WFS,-3,-3,0,0,0,0
,Brooks Women's Adrenaline GTS 20 Grape/Jewel/Cantaloupe Size 6.5,Brooks Women's Adrenaline GTS 20 Grape/Jewel/Cantaloupe Size 6.5,FBALYB Amazon,-2,-2,0,0,0,0
,Brooks Women's Adrenaline GTS 20 Grape/Jewel/Cantaloupe Size 7,Brooks Women's Adrenaline GTS 20 Grape/Jewel/Cantaloupe Size 7,Default Oxford,1,1,0,0,0,0
,Brooks Women's Adrenaline GTS 20 Grape/Jewel/Cantaloupe Size 7,Brooks Women's Adrenaline GTS 20 Grape/Jewel/Cantaloupe Size 7,FBALYB Amazon,3,3,0,0,0,0
,Brooks Women's Adrenaline GTS 20 Grape/Jewel/Cantaloupe Size 7.5,Brooks Women's Adrenaline GTS 20 Grape/Jewel/Cantaloupe Size 7.5,FBALYB Amazon,-2,-2,0,0,0,0
,Brooks Women's Adrenaline GTS 20 Grape/Jewel/Cantaloupe Size 8,Brooks Women's Adrenaline GTS 20 Grape/Jewel/Cantaloupe Size 8,FBALYB Amazon,-6,-6,0,0,0,0
,Brooks Women's Adrenaline GTS 20 Grape/Jewel/Cantaloupe Size 8.5,Brooks Women's Adrenaline GTS 20 Grape/Jewel/Cantaloupe Size 8.5,FBALYB Amazon,-4,-4,0,0,0,0
,Brooks Women's Adrenaline GTS 20 Grape/Jewel/Cantaloupe Size 9,Brooks Women's Adrenaline GTS 20 Grape/Jewel/Cantaloupe Size 9,FBALYB Amazon,-1,-1,0,0,0,0
,Brooks Women's Adrenaline GTS 20 Grey/Pale Peach/White Size 10,Brooks Women's Adrenaline GTS 20 Grey/Pale Peach/White Size 10,FBALYB Amazon,0,0,0,6,0,0
,Brooks Women's Adrenaline GTS 20 Grey/Pale Peach/White Size 6,Brooks Women's Adrenaline GTS 20 Grey/Pale Peach/White Size 6,FBALYB Amazon,-6,-6,0,6,0,0
,Brooks Women's Adrenaline GTS 20 Grey/Pale Peach/White Size 6.5,Brooks Women's Adrenaline GTS 20 Grey/Pale Peach/White Size 6.5,FBALYB Amazon,-1,-1,0,0,0,0
,Brooks Women's Adrenaline GTS 20 Grey/Pale Peach/White Size 7,Brooks Women's Adrenaline GTS 20 Grey/Pale Peach/White Size 7,Default Oxford,1,1,0,0,0,0
,Brooks Women's Adrenaline GTS 20 Grey/Pale Peach/White Size 7,Brooks Women's Adrenaline GTS 20 Grey/Pale Peach/White Size 7,FBALYB Amazon,-4,-4,0,4,0,0
,Brooks Women's Adrenaline GTS 20 Grey/Pale Peach/White Size 8,Brooks Women's Adrenaline GTS 20 Grey/Pale Peach/White Size 8,FBALYB Amazon,-2,-2,0,6,0,0
,Brooks Women's Adrenaline GTS 20 Grey/Pale Peach/White Size 9,Brooks Women's Adrenaline GTS 20 Grey/Pale Peach/White Size 9,FBALYB Amazon,-4,-4,0,4,0,0
,Brooks Women's Adrenaline GTS 20 Grey/White/Valerian Size 10,Brooks Women's Adrenaline GTS 20 Grey/White/Valerian Size 10,FBALYB Amazon,-4,-4,0,0,0,0
,Brooks Women's Adrenaline GTS 20 Grey/White/Valerian Size 6,Brooks Women's Adrenaline GTS 20 Grey/White/Valerian Size 6,FBALYB Amazon,-2,-2,0,0,0,0
,Brooks Women's Adrenaline GTS 20 Grey/White/Valerian Size 6.5,Brooks Women's Adrenaline GTS 20 Grey/White/Valerian Size 6.5,FBALYB Amazon,-2,-2,0,0,0,0
,Brooks Women's Adrenaline GTS 20 Grey/White/Valerian Size 7,Brooks Women's Adrenaline GTS 20 Grey/White/Valerian Size 7,FBALYB Amazon,-4,-4,0,0,0,0
,Brooks Women's Adrenaline GTS 20 Grey/White/Valerian Size 7.5,Brooks Women's Adrenaline GTS 20 Grey/White/Valerian Size 7.5,FBALYB Amazon,-5,-5,0,2,0,0
,Brooks Women's Adrenaline GTS 20 Grey/White/Valerian Size 8,Brooks Women's Adrenaline GTS 20 Grey/White/Valerian Size 8,FBALYB Amazon,-7,-7,0,1,0,0
,Brooks Women's Adrenaline GTS 20 Grey/White/Valerian Size 8.5,Brooks Women's Adrenaline GTS 20 Grey/White/Valerian Size 8.5,FBALYB Amazon,-19,-19,0,6,0,0
,Brooks Women's Adrenaline GTS 20 Grey/White/Valerian Size 9,Brooks Women's Adrenaline GTS 20 Grey/White/Valerian Size 9,FBALYB Amazon,-4,-4,0,6,0,0
,Brooks Women's Adrenaline GTS 20 Grey/White/Valerian Size 9.5,Brooks Women's Adrenaline GTS 20 Grey/White/Valerian Size 9.5,FBALYB Amazon,-3,-3,0,0,0,0
,Brooks Women's Adrenaline GTS 20 Red/Gold/Ebony Size 10,Brooks Women's Adrenaline GTS 20 Red/Gold/Ebony Size 10,FBALYB Amazon,-1,-1,0,0,0,0
,Brooks Women's Adrenaline GTS 20 Red/Gold/Ebony Size 8,Brooks Women's Adrenaline GTS 20 Red/Gold/Ebony Size 8,FBALYB Amazon,-1,-1,0,0,0,0
,Brooks Women's Adrenaline GTS 20 Red/Gold/Ebony Size 8.5,Brooks Women's Adrenaline GTS 20 Red/Gold/Ebony Size 8.5,FBALYB Amazon,-1,-1,0,0,0,0
,Brooks Women's Adrenaline GTS 20 Red/Gold/Ebony Size 9,Brooks Women's Adrenaline GTS 20 Red/Gold/Ebony Size 9,FBALYB Amazon,-1,-1,0,0,0,0
,Brooks Women's Adrenaline GTS 20 White/Black/Oyster Size 6,Brooks Women's Adrenaline GTS 20 White/Black/Oyster Size 6,FBALYB Amazon,-2,-2,0,0,0,0
,Brooks Women's Adrenaline GTS 20 White/Black/Oyster Size 6.5,Brooks Women's Adrenaline GTS 20 White/Black/Oyster Size 6.5,FBALYB Amazon,-3,-3,0,0,0,0
,Brooks Women's Adrenaline GTS 20 White/Black/Oyster Size 7,Brooks Women's Adrenaline GTS 20 White/Black/Oyster Size 7,FBALYB Amazon,-2,-2,0,0,0,0
,Brooks Women's Adrenaline GTS 20 White/Black/Oyster Size 8.5,Brooks Women's Adrenaline GTS 20 White/Black/Oyster Size 8.5,FBALYB Amazon,-1,-1,0,0,0,0
,Brooks Women's Adrenaline GTS 20 White/Black/Oyster Size 9,Brooks Women's Adrenaline GTS 20 White/Black/Oyster Size 9,FBALYB Amazon,-1,-1,0,0,0,0
,Brooks Women's Adrenaline GTS 20 White/Grey/Gold Size 10,Brooks Women's Adrenaline GTS 20 White/Grey/Gold Size 10,FBALYB Amazon,-1,-1,0,0,0,0
,Brooks Women's Adrenaline GTS 20 White/Grey/Gold Size 6,Brooks Women's Adrenaline GTS 20 White/Grey/Gold Size 6,FBALYB Amazon,-21,-21,0,18,0,0
,Brooks Women's Adrenaline GTS 20 White/Grey/Gold Size 6.5,Brooks Women's Adrenaline GTS 20 White/Grey/Gold Size 6.5,FBALYB Amazon,-3,-3,0,0,0,0
,Brooks Women's Adrenaline GTS 20 White/Grey/Gold Size 7,Brooks Women's Adrenaline GTS 20 White/Grey/Gold Size 7,FBALYB Amazon,-21,-21,0,18,0,0
,Brooks Women's Adrenaline GTS 20 White/Grey/Gold Size 7.5,Brooks Women's Adrenaline GTS 20 White/Grey/Gold Size 7.5,FBALYB Amazon,-1,-1,0,0,0,0
,Brooks Women's Adrenaline GTS 20 White/Grey/Gold Size 8,Brooks Women's Adrenaline GTS 20 White/Grey/Gold Size 8,FBALYB Amazon,-9,-9,0,6,0,0
,Brooks Women's Adrenaline GTS 20 White/Grey/Gold Size 8.5,Brooks Women's Adrenaline GTS 20 White/Grey/Gold Size 8.5,FBALYB Amazon,-6,-6,0,0,0,0
,Brooks Women's Adrenaline GTS 20 White/Grey/Gold Size 9,Brooks Women's Adrenaline GTS 20 White/Grey/Gold Size 9,FBALYB Amazon,-20,-20,0,18,0,0
,Brooks Women's Adrenaline GTS 20 White/Grey/Gold Size 9.5,Brooks Women's Adrenaline GTS 20 White/Grey/Gold Size 9.5,FBALYB Amazon,-1,-1,0,0,0,0
,Brooks Women's Adrenaline GTS 20 White/Grey/Silver Size 6,Brooks Women's Adrenaline GTS 20 White/Grey/Silver Size 6,FBALYB Amazon,0,0,0,3,0,0
,Brooks Women's Adrenaline GTS 20 White/Grey/Silver Size 6.5,Brooks Women's Adrenaline GTS 20 White/Grey/Silver Size 6.5,FBALYB Amazon,-4,-4,0,0,0,0
,Brooks Women's Adrenaline GTS 20 White/Grey/Silver Size 7.5,Brooks Women's Adrenaline GTS 20 White/Grey/Silver Size 7.5,FBALYB Amazon,-2,-2,0,0,0,0
,Brooks Women's Adrenaline GTS 20 White/Grey/Silver Size 8,Brooks Women's Adrenaline GTS 20 White/Grey/Silver Size 8,FBALYB Amazon,-2,-2,0,0,0,0
,Brooks Women's Adrenaline GTS 20 White/Grey/Silver Size 8.5,Brooks Women's Adrenaline GTS 20 White/Grey/Silver Size 8.5,FBALYB Amazon,-2,-2,0,0,0,0
,Brooks Women's Adrenaline GTS 20 White/Grey/Silver Size 9,Brooks Women's Adrenaline GTS 20 White/Grey/Silver Size 9,FBALYB Amazon,-2,-2,0,0,0,0
,Brooks Women's Adrenaline GTS 20 White/Grey/Silver Size 9.5,Brooks Women's Adrenaline GTS 20 White/Grey/Silver Size 9.5,FBALYB Amazon,16,16,0,0,0,0
,Brooks Women's Adrenaline GTS 21 Black/Black/Ebony Size 10,Brooks Women's Adrenaline GTS 21 Black/Black/Ebony Size 10,Default,0,-1,1,0,0,0
,Brooks Women's Adrenaline GTS 21 Black/Black/Ebony Size 6,Brooks Women's Adrenaline GTS 21 Black/Black/Ebony Size 6,Default,0,-1,1,0,0,0
,Brooks Women's Adrenaline GTS 21 Black/Black/Ebony Size 6,Brooks Women's Adrenaline GTS 21 Black/Black/Ebony Size 6,FBALYB Amazon,-4,-4,0,0,0,0
,Brooks Women's Adrenaline GTS 21 Black/Black/Ebony Size 6.5,Brooks Women's Adrenaline GTS 21 Black/Black/Ebony Size 6.5,FBALYB Amazon,-3,-3,0,0,0,0
,Brooks Women's Adrenaline GTS 21 Black/Black/Ebony Size 7,Brooks Women's Adrenaline GTS 21 Black/Black/Ebony Size 7,FBALYB Amazon,-4,-4,0,0,0,0
,Brooks Women's Adrenaline GTS 21 Black/Black/Ebony Size 7.5,Brooks Women's Adrenaline GTS 21 Black/Black/Ebony Size 7.5,FBALYB Amazon,-5,-5,0,0,0,0
,Brooks Women's Adrenaline GTS 21 Black/Black/Ebony Size 8,Brooks Women's Adrenaline GTS 21 Black/Black/Ebony Size 8,Default,0,-1,1,0,0,0
,Brooks Women's Adrenaline GTS 21 Black/Black/Ebony Size 8,Brooks Women's Adrenaline GTS 21 Black/Black/Ebony Size 8,FBALYB Amazon,-5,-5,0,0,0,0
,Brooks Women's Adrenaline GTS 21 Black/Black/Ebony Size 8.5,Brooks Women's Adrenaline GTS 21 Black/Black/Ebony Size 8.5,FBALYB Amazon,-2,-2,0,0,0,0
,Brooks Women's Adrenaline GTS 21 Black/Black/Ebony Size 9,Brooks Women's Adrenaline GTS 21 Black/Black/Ebony Size 9,FBALYB Amazon,-3,-3,0,0,0,0
,Brooks Women's Adrenaline GTS 21 Black/Black/Ebony Size 9.5,Brooks Women's Adrenaline GTS 21 Black/Black/Ebony Size 9.5,FBALYB Amazon,-2,-2,0,0,0,0
,Brooks Women's Adrenaline GTS 21 Black/Blackened Pearl/Nocturne Size 10,Brooks Women's Adrenaline GTS 21 Black/Blackened Pearl/Nocturne Size 10,Default,0,-1,1,0,0,0
,Brooks Women's Adrenaline GTS 21 Black/Blackened Pearl/Nocturne Size 10,Brooks Women's Adrenaline GTS 21 Black/Blackened Pearl/Nocturne Size 10,FBALYB Amazon,-3,-3,0,0,0,0
,Brooks Women's Adrenaline GTS 21 Black/Blackened Pearl/Nocturne Size 6,Brooks Women's Adrenaline GTS 21 Black/Blackened Pearl/Nocturne Size 6,Default,0,-1,1,0,0,0
,Brooks Women's Adrenaline GTS 21 Black/Blackened Pearl/Nocturne Size 6,Brooks Women's Adrenaline GTS 21 Black/Blackened Pearl/Nocturne Size 6,FBALYB Amazon,-6,-6,0,0,0,0
,Brooks Women's Adrenaline GTS 21 Black/Blackened Pearl/Nocturne Size 6.5,Brooks Women's Adrenaline GTS 21 Black/Blackened Pearl/Nocturne Size 6.5,FBALYB Amazon,-5,-5,0,0,0,0
,Brooks Women's Adrenaline GTS 21 Black/Blackened Pearl/Nocturne Size 7,Brooks Women's Adrenaline GTS 21 Black/Blackened Pearl/Nocturne Size 7,FBALYB Amazon,-3,-3,0,0,0,0
,Brooks Women's Adrenaline GTS 21 Black/Blackened Pearl/Nocturne Size 7.5,Brooks Women's Adrenaline GTS 21 Black/Blackened Pearl/Nocturne Size 7.5,FBALYB Amazon,-3,-3,0,0,0,0
,Brooks Women's Adrenaline GTS 21 Black/Blackened Pearl/Nocturne Size 8,Brooks Women's Adrenaline GTS 21 Black/Blackened Pearl/Nocturne Size 8,FBALYB Amazon,-7,-7,0,0,0,0
,Brooks Women's Adrenaline GTS 21 Black/Blackened Pearl/Nocturne Size 8.5,Brooks Women's Adrenaline GTS 21 Black/Blackened Pearl/Nocturne Size 8.5,Default,0,-1,1,0,0,0
,Brooks Women's Adrenaline GTS 21 Black/Blackened Pearl/Nocturne Size 9,Brooks Women's Adrenaline GTS 21 Black/Blackened Pearl/Nocturne Size 9,FBALYB Amazon,-1,-1,0,0,0,0
,Brooks Women's Adrenaline GTS 21 Hushed Violet/Alloy/Copper Size 10,Brooks Women's Adrenaline GTS 21 Hushed Violet/Alloy/Copper Size 10,Default,0,-1,1,0,0,0
,Brooks Women's Adrenaline GTS 21 Hushed Violet/Alloy/Copper Size 10,Brooks Women's Adrenaline GTS 21 Hushed Violet/Alloy/Copper Size 10,FBALYB Amazon,-1,-1,0,0,0,0
,Brooks Women's Adrenaline GTS 21 Hushed Violet/Alloy/Copper Size 6,Brooks Women's Adrenaline GTS 21 Hushed Violet/Alloy/Copper Size 6,Default,0,-1,1,0,0,0
,Brooks Women's Adrenaline GTS 21 Hushed Violet/Alloy/Copper Size 6,Brooks Women's Adrenaline GTS 21 Hushed Violet/Alloy/Copper Size 6,FBALYB Amazon,-7,-7,0,0,0,0
,Brooks Women's Adrenaline GTS 21 Hushed Violet/Alloy/Copper Size 6.5,Brooks Women's Adrenaline GTS 21 Hushed Violet/Alloy/Copper Size 6.5,FBALYB Amazon,-2,-2,0,0,0,0
,Brooks Women's Adrenaline GTS 21 Hushed Violet/Alloy/Copper Size 7,Brooks Women's Adrenaline GTS 21 Hushed Violet/Alloy/Copper Size 7,FBALYB Amazon,-7,-7,0,0,0,0
,Brooks Women's Adrenaline GTS 21 Hushed Violet/Alloy/Copper Size 7.5,Brooks Women's Adrenaline GTS 21 Hushed Violet/Alloy/Copper Size 7.5,Default,0,0,0,0,0,1
,Brooks Women's Adrenaline GTS 21 Hushed Violet/Alloy/Copper Size 7.5,Brooks Women's Adrenaline GTS 21 Hushed Violet/Alloy/Copper Size 7.5,FBALYB Amazon,-4,-4,0,0,0,0
,Brooks Women's Adrenaline GTS 21 Hushed Violet/Alloy/Copper Size 8,Brooks Women's Adrenaline GTS 21 Hushed Violet/Alloy/Copper Size 8,Default,0,-1,1,0,0,0
,Brooks Women's Adrenaline GTS 21 Hushed Violet/Alloy/Copper Size 8,Brooks Women's Adrenaline GTS 21 Hushed Violet/Alloy/Copper Size 8,FBALYB Amazon,-5,-5,0,0,0,0
,Brooks Women's Adrenaline GTS 21 Hushed Violet/Alloy/Copper Size 8.5,Brooks Women's Adrenaline GTS 21 Hushed Violet/Alloy/Copper Size 8.5,FBALYB Amazon,-4,-4,0,0,0,0
,Brooks Women's Adrenaline GTS 21 Hushed Violet/Alloy/Copper Size 9,Brooks Women's Adrenaline GTS 21 Hushed Violet/Alloy/Copper Size 9,Default,0,0,0,0,0,22
,Brooks Women's Adrenaline GTS 21 Hushed Violet/Alloy/Copper Size 9,Brooks Women's Adrenaline GTS 21 Hushed Violet/Alloy/Copper Size 9,FBALYB Amazon,-23,-23,0,0,0,0
,Brooks Women's Adrenaline GTS 21 White/Alloy/Light Blue Size 10,Brooks Women's Adrenaline GTS 21 White/Alloy/Light Blue Size 10,Default,0,-1,1,0,0,0
,Brooks Women's Adrenaline GTS 21 White/Alloy/Light Blue Size 10,Brooks Women's Adrenaline GTS 21 White/Alloy/Light Blue Size 10,FBALYB Amazon,-1,-1,0,0,0,0
,Brooks Women's Adrenaline GTS 21 White/Alloy/Light Blue Size 6,Brooks Women's Adrenaline GTS 21 White/Alloy/Light Blue Size 6,Default,0,-1,1,0,0,0
,Brooks Women's Adrenaline GTS 21 White/Alloy/Light Blue Size 6,Brooks Women's Adrenaline GTS 21 White/Alloy/Light Blue Size 6,FBALYB Amazon,-2,-2,0,0,0,0
,Brooks Women's Adrenaline GTS 21 White/Alloy/Light Blue Size 6.5,Brooks Women's Adrenaline GTS 21 White/Alloy/Light Blue Size 6.5,FBALYB Amazon,-2,-2,0,0,0,0
,Brooks Women's Adrenaline GTS 21 White/Alloy/Light Blue Size 7,Brooks Women's Adrenaline GTS 21 White/Alloy/Light Blue Size 7,FBALYB Amazon,-2,-2,0,0,0,0
,Brooks Women's Adrenaline GTS 21 White/Alloy/Light Blue Size 7.5,Brooks Women's Adrenaline GTS 21 White/Alloy/Light Blue Size 7.5,FBALYB Amazon,-4,-4,0,0,0,0
,Brooks Women's Adrenaline GTS 21 White/Alloy/Light Blue Size 8,Brooks Women's Adrenaline GTS 21 White/Alloy/Light Blue Size 8,Default,0,-1,1,0,0,0
,Brooks Women's Adrenaline GTS 21 White/Alloy/Light Blue Size 8,Brooks Women's Adrenaline GTS 21 White/Alloy/Light Blue Size 8,FBALYB Amazon,-6,-6,0,0,0,0
,Brooks Women's Adrenaline GTS 21 White/Alloy/Light Blue Size 8.5,Brooks Women's Adrenaline GTS 21 White/Alloy/Light Blue Size 8.5,FBALYB Amazon,-3,-3,0,0,0,0
,Brooks Women's Adrenaline GTS 21 White/Alloy/Light Blue Size 9,Brooks Women's Adrenaline GTS 21 White/Alloy/Light Blue Size 9,FBALYB Amazon,-1,-1,0,0,0,0
,Brooks Women's Bedlam 2 Black/Grey/Kentucky Blue Size 10,Brooks Women's Bedlam 2 Black/Grey/Kentucky Blue Size 10,FBALYB Amazon,-1,-1,0,0,0,0
,Brooks Women's Bedlam 2 Black/Grey/Kentucky Blue Size 6,Brooks Women's Bedlam 2 Black/Grey/Kentucky Blue Size 6,FBALYB Amazon,-1,-1,0,0,0,0
,Brooks Women's Bedlam 2 Black/Grey/Kentucky Blue Size 6.5,Brooks Women's Bedlam 2 Black/Grey/Kentucky Blue Size 6.5,FBALYB Amazon,-1,-1,0,0,0,0
,Brooks Women's Bedlam 2 Black/Grey/Kentucky Blue Size 7,Brooks Women's Bedlam 2 Black/Grey/Kentucky Blue Size 7,FBALYB Amazon,-3,-3,0,0,0,0
,Brooks Women's Bedlam 2 Black/Grey/Kentucky Blue Size 8,Brooks Women's Bedlam 2 Black/Grey/Kentucky Blue Size 8,FBALYB Amazon,-2,-2,0,0,0,0
,Brooks Women's Bedlam 2 Black/Grey/Kentucky Blue Size 8.5,Brooks Women's Bedlam 2 Black/Grey/Kentucky Blue Size 8.5,FBALYB Amazon,-1,-1,0,0,0,0
,Brooks Women's Bedlam 2 Black/Grey/Kentucky Blue Size 9,Brooks Women's Bedlam 2 Black/Grey/Kentucky Blue Size 9,FBALYB Amazon,-3,-3,0,0,0,0
,Brooks Women's Bedlam 2 White/Grey/Gold Size 6,Brooks Women's Bedlam 2 White/Grey/Gold Size 6,FBALYB Amazon,-4,-4,0,0,0,0
,Brooks Women's Bedlam 2 White/Grey/Gold Size 6.5,Brooks Women's Bedlam 2 White/Grey/Gold Size 6.5,FBALYB Amazon,-4,-4,0,0,0,0
,Brooks Women's Bedlam 2 White/Grey/Gold Size 7,Brooks Women's Bedlam 2 White/Grey/Gold Size 7,FBALYB Amazon,-14,-14,0,12,0,0
,Brooks Women's Bedlam 2 White/Grey/Gold Size 7.5,Brooks Women's Bedlam 2 White/Grey/Gold Size 7.5,FBALYB Amazon,-3,-3,0,0,0,0
,Brooks Women's Bedlam 2 White/Grey/Gold Size 8,Brooks Women's Bedlam 2 White/Grey/Gold Size 8,FBALYB Amazon,9,9,0,0,0,0
,Brooks Women's Bedlam 2 White/Grey/Gold Size 8.5,Brooks Women's Bedlam 2 White/Grey/Gold Size 8.5,FBALYB Amazon,-8,-8,0,6,0,0
,Brooks Women's Bedlam 2 White/Grey/Gold Size 9,Brooks Women's Bedlam 2 White/Grey/Gold Size 9,FBALYB Amazon,-1,-1,0,0,0,0
,Brooks Women's Cascadia 14 Desert Flower/Navy/Grey Size 10,Brooks Women's Cascadia 14 Desert Flower/Navy/Grey Size 10,Avrami - Ebay,7,7,0,0,0,0
,Brooks Women's Cascadia 14 Desert Flower/Navy/Grey Size 6,Brooks Women's Cascadia 14 Desert Flower/Navy/Grey Size 6,Avrami - Ebay,7,7,0,0,0,0
,Brooks Women's Cascadia 14 Desert Flower/Navy/Grey Size 6.5,Brooks Women's Cascadia 14 Desert Flower/Navy/Grey Size 6.5,Avrami - Ebay,7,7,0,0,0,0
,Brooks Women's Cascadia 14 Desert Flower/Navy/Grey Size 7,Brooks Women's Cascadia 14 Desert Flower/Navy/Grey Size 7,Avrami - Ebay,7,7,0,0,0,0
,Brooks Women's Cascadia 14 Desert Flower/Navy/Grey Size 7.5,Brooks Women's Cascadia 14 Desert Flower/Navy/Grey Size 7.5,Avrami - Ebay,13,13,0,0,0,0
,Brooks Women's Cascadia 14 Desert Flower/Navy/Grey Size 7.5,Brooks Women's Cascadia 14 Desert Flower/Navy/Grey Size 7.5,Default Oxford,1,1,0,0,0,0
,Brooks Women's Cascadia 14 Desert Flower/Navy/Grey Size 8,Brooks Women's Cascadia 14 Desert Flower/Navy/Grey Size 8,Avrami - Ebay,14,14,0,0,0,0
,Brooks Women's Cascadia 14 Desert Flower/Navy/Grey Size 8.5,Brooks Women's Cascadia 14 Desert Flower/Navy/Grey Size 8.5,Avrami - Ebay,13,13,0,0,0,0
,Brooks Women's Cascadia 14 Desert Flower/Navy/Grey Size 8.5,Brooks Women's Cascadia 14 Desert Flower/Navy/Grey Size 8.5,Default Oxford,1,1,0,0,0,0
,Brooks Women's Cascadia 14 Desert Flower/Navy/Grey Size 9,Brooks Women's Cascadia 14 Desert Flower/Navy/Grey Size 9,Avrami - Ebay,7,7,0,0,0,0
,Brooks Women's Cascadia 14 Desert Flower/Navy/Grey Size 9.5,Brooks Women's Cascadia 14 Desert Flower/Navy/Grey Size 9.5,Avrami - Ebay,7,7,0,0,0,0
,Brooks Women's Ghost 12 Black/Grey Size 10,Brooks Women's Ghost 12 Black/Grey Size 10,FBALYB Amazon,-3,-3,0,0,0,0
,Brooks Women's Ghost 12 Black/Grey Size 6,Brooks Women's Ghost 12 Black/Grey Size 6,FBALYB Amazon,-4,-4,0,0,0,0
,Brooks Women's Ghost 12 Black/Grey Size 6.5,Brooks Women's Ghost 12 Black/Grey Size 6.5,FBALYB Amazon,-4,-4,0,0,0,0
,Brooks Women's Ghost 12 Black/Grey Size 7,Brooks Women's Ghost 12 Black/Grey Size 7,FBALYB Amazon,-1,-1,0,0,0,0
,Brooks Women's Ghost 12 Black/Grey Size 7.5,Brooks Women's Ghost 12 Black/Grey Size 7.5,FBALYB Amazon,-7,-7,0,0,0,0
,Brooks Women's Ghost 12 Black/Grey Size 8,Brooks Women's Ghost 12 Black/Grey Size 8,FBALYB Amazon,34,34,0,0,0,0
,Brooks Women's Ghost 12 Black/Grey Size 8.5,Brooks Women's Ghost 12 Black/Grey Size 8.5,FBALYB Amazon,-57,-57,0,48,0,0
,Brooks Women's Ghost 12 Black/Grey Size 9,Brooks Women's Ghost 12 Black/Grey Size 9,Default Oxford,24,24,0,0,0,0
,Brooks Women's Ghost 12 Black/Grey Size 9.5,Brooks Women's Ghost 12 Black/Grey Size 9.5,FBALYB Amazon,-4,-4,0,0,0,0
,Brooks Women's Ghost 12 Black/Hollyhock/Pink Size 10,Brooks Women's Ghost 12 Black/Hollyhock/Pink Size 10,FBALYB Amazon,-6,-6,0,6,0,0
,Brooks Women's Ghost 12 Black/Hollyhock/Pink Size 6,Brooks Women's Ghost 12 Black/Hollyhock/Pink Size 6,FBALYB Amazon,-9,-9,0,6,0,0
,Brooks Women's Ghost 12 Black/Hollyhock/Pink Size 6.5,Brooks Women's Ghost 12 Black/Hollyhock/Pink Size 6.5,FBALYB Amazon,-6,-6,0,6,0,0
,Brooks Women's Ghost 12 Black/Hollyhock/Pink Size 7.5,Brooks Women's Ghost 12 Black/Hollyhock/Pink Size 7.5,FBALYB Amazon,-3,-3,0,0,0,0
,Brooks Women's Ghost 12 Black/Hollyhock/Pink Size 9.5,Brooks Women's Ghost 12 Black/Hollyhock/Pink Size 9.5,FBALYB Amazon,-2,-2,0,3,0,0
,Brooks Women's Ghost 12 Granite/Peacoat/Peach Size 10,Brooks Women's Ghost 12 Granite/Peacoat/Peach Size 10,FBALYB Amazon,-2,-2,0,0,0,0
,Brooks Women's Ghost 12 Granite/Peacoat/Peach Size 6,Brooks Women's Ghost 12 Granite/Peacoat/Peach Size 6,Default,1,1,0,0,0,0
,Brooks Women's Ghost 12 Granite/Peacoat/Peach Size 6,Brooks Women's Ghost 12 Granite/Peacoat/Peach Size 6,FBALYB Amazon,-1,-1,0,0,0,0
,Brooks Women's Ghost 12 Granite/Peacoat/Peach Size 6.5,Brooks Women's Ghost 12 Granite/Peacoat/Peach Size 6.5,FBALYB Amazon,-5,-5,0,6,0,0
,Brooks Women's Ghost 12 Granite/Peacoat/Peach Size 7,Brooks Women's Ghost 12 Granite/Peacoat/Peach Size 7,FBALYB Amazon,-2,-2,0,0,0,0
,Brooks Women's Ghost 12 Granite/Peacoat/Peach Size 7.5,Brooks Women's Ghost 12 Granite/Peacoat/Peach Size 7.5,FBALYB Amazon,-4,-4,0,0,0,0
,Brooks Women's Ghost 12 Granite/Peacoat/Peach Size 8,Brooks Women's Ghost 12 Granite/Peacoat/Peach Size 8,Avrami - Ebay,1,1,0,0,0,0
,Brooks Women's Ghost 12 Granite/Peacoat/Peach Size 8,Brooks Women's Ghost 12 Granite/Peacoat/Peach Size 8,Default Oxford,3,3,0,0,0,0
,Brooks Women's Ghost 12 Granite/Peacoat/Peach Size 8,Brooks Women's Ghost 12 Granite/Peacoat/Peach Size 8,Default Ridgefield,8,8,0,0,0,0
,Brooks Women's Ghost 12 Granite/Peacoat/Peach Size 9,Brooks Women's Ghost 12 Granite/Peacoat/Peach Size 9,FBALYB Amazon,-8,-8,0,0,0,0
,Brooks Women's Ghost 12 Granite/Peacoat/Peach Size 9.5,Brooks Women's Ghost 12 Granite/Peacoat/Peach Size 9.5,FBALYB Amazon,-1,-1,0,0,0,0
,Brooks Women's Ghost 12 Jewel/Grape/Cantaloupe Size 10,Brooks Women's Ghost 12 Jewel/Grape/Cantaloupe Size 10,FBALYB Amazon,-1,-1,0,0,0,0
,Brooks Women's Ghost 12 Jewel/Grape/Cantaloupe Size 6,Brooks Women's Ghost 12 Jewel/Grape/Cantaloupe Size 6,FBALYB Amazon,-4,-4,0,0,0,0
,Brooks Women's Ghost 12 Jewel/Grape/Cantaloupe Size 6.5,Brooks Women's Ghost 12 Jewel/Grape/Cantaloupe Size 6.5,FBALYB Amazon,-2,-2,0,0,0,0
,Brooks Women's Ghost 12 Jewel/Grape/Cantaloupe Size 7,Brooks Women's Ghost 12 Jewel/Grape/Cantaloupe Size 7,FBALYB Amazon,7,7,0,0,0,0
,Brooks Women's Ghost 12 Jewel/Grape/Cantaloupe Size 7.5,Brooks Women's Ghost 12 Jewel/Grape/Cantaloupe Size 7.5,FBALYB Amazon,10,10,0,0,0,0
,Brooks Women's Ghost 12 Jewel/Grape/Cantaloupe Size 8,Brooks Women's Ghost 12 Jewel/Grape/Cantaloupe Size 8,FBALYB Amazon,12,12,0,0,0,0
,Brooks Women's Ghost 12 Jewel/Grape/Cantaloupe Size 8.5,Brooks Women's Ghost 12 Jewel/Grape/Cantaloupe Size 8.5,FBALYB Amazon,-4,-4,0,0,0,0
,Brooks Women's Ghost 12 Jewel/Grape/Cantaloupe Size 9,Brooks Women's Ghost 12 Jewel/Grape/Cantaloupe Size 9,FBALYB Amazon,-3,-3,0,0,0,0
,Brooks Women's Ghost 12 Jewel/Grape/Cantaloupe Size 9.5,Brooks Women's Ghost 12 Jewel/Grape/Cantaloupe Size 9.5,FBALYB Amazon,-4,-4,0,0,0,0
,Brooks Women's Ghost 12 Navy/Blue/Nightlife Size 7,Brooks Women's Ghost 12 Navy/Blue/Nightlife Size 7,FBALYB Amazon,-1,-1,0,0,0,0
,Brooks Women's Ghost 12 Navy/Blue/Nightlife Size 7.5,Brooks Women's Ghost 12 Navy/Blue/Nightlife Size 7.5,FBALYB Amazon,-1,-1,0,0,0,0
,Brooks Women's Ghost 12 Navy/Blue/Nightlife Size 9,Brooks Women's Ghost 12 Navy/Blue/Nightlife Size 9,FBALYB Amazon,-1,-1,0,0,0,0
,Brooks Women's Ghost 12 Navy/Majolica/Beetroot Size 10,Brooks Women's Ghost 12 Navy/Majolica/Beetroot Size 10,FBALYB Amazon,-1,-1,0,0,0,0
,Brooks Women's Ghost 12 Navy/Majolica/Beetroot Size 6.5,Brooks Women's Ghost 12 Navy/Majolica/Beetroot Size 6.5,FBALYB Amazon,-2,-2,0,0,0,0
,Brooks Women's Ghost 12 Navy/Majolica/Beetroot Size 7.5,Brooks Women's Ghost 12 Navy/Majolica/Beetroot Size 7.5,FBALYB Amazon,-2,-2,0,0,0,0
,Brooks Women's Ghost 12 Navy/Majolica/Beetroot Size 8,Brooks Women's Ghost 12 Navy/Majolica/Beetroot Size 8,FBALYB Amazon,-2,-2,0,0,0,0
,Brooks Women's Ghost 12 Navy/Majolica/Beetroot Size 8.5,Brooks Women's Ghost 12 Navy/Majolica/Beetroot Size 8.5,FBALYB Amazon,-1,-1,0,0,0,0
,Brooks Women's Ghost 12 Navy/Majolica/Beetroot Size 9,Brooks Women's Ghost 12 Navy/Majolica/Beetroot Size 9,FBALYB Amazon,-1,-1,0,0,0,0
,Brooks Women's Ghost 12 Navy/Majolica/Beetroot Size 9.5,Brooks Women's Ghost 12 Navy/Majolica/Beetroot Size 9.5,FBALYB Amazon,-2,-2,0,0,0,0
,Brooks Women's Ghost 12 Oyster/Alloy/White Size 10,Brooks Women's Ghost 12 Oyster/Alloy/White Size 10,FBALYB Amazon,-12,-12,0,12,0,0
,Brooks Women's Ghost 12 Oyster/Alloy/White Size 6,Brooks Women's Ghost 12 Oyster/Alloy/White Size 6,FBALYB Amazon,-14,-14,0,12,0,0
,Brooks Women's Ghost 12 Oyster/Alloy/White Size 7,Brooks Women's Ghost 12 Oyster/Alloy/White Size 7,FBALYB Amazon,-12,-12,0,12,0,0
,Brooks Women's Ghost 12 Oyster/Alloy/White Size 7.5,Brooks Women's Ghost 12 Oyster/Alloy/White Size 7.5,Default Oxford,1,1,0,0,0,0
,Brooks Women's Ghost 12 Oyster/Alloy/White Size 7.5,Brooks Women's Ghost 12 Oyster/Alloy/White Size 7.5,FBALYB Amazon,22,22,0,0,0,0
,Brooks Women's Ghost 12 Oyster/Alloy/White Size 8,Brooks Women's Ghost 12 Oyster/Alloy/White Size 8,FBALYB Amazon,-27,-27,0,24,0,0
,Brooks Women's Ghost 12 Oyster/Alloy/White Size 8.5,Brooks Women's Ghost 12 Oyster/Alloy/White Size 8.5,FBALYB Amazon,-26,-26,0,24,0,0
,Brooks Women's Ghost 12 Oyster/Alloy/White Size 9,Brooks Women's Ghost 12 Oyster/Alloy/White Size 9,FBALYB Amazon,-3,-3,0,0,0,0
,Brooks Women's Ghost 12 Oyster/Alloy/White Size 9.5,Brooks Women's Ghost 12 Oyster/Alloy/White Size 9.5,FBALYB Amazon,-12,-12,0,12,0,0
,Brooks Women's Ghost 12 Peacoat/Blue/Aqua Size 10,Brooks Women's Ghost 12 Peacoat/Blue/Aqua Size 10,FBALYB Amazon,-1,-1,0,0,0,0
,Brooks Women's Ghost 12 Peacoat/Blue/Aqua Size 6,Brooks Women's Ghost 12 Peacoat/Blue/Aqua Size 6,FBALYB Amazon,-3,-3,0,0,0,0
,Brooks Women's Ghost 12 Peacoat/Blue/Aqua Size 6.5,Brooks Women's Ghost 12 Peacoat/Blue/Aqua Size 6.5,FBALYB Amazon,-2,-3,1,0,1,0
,Brooks Women's Ghost 12 Peacoat/Blue/Aqua Size 7,Brooks Women's Ghost 12 Peacoat/Blue/Aqua Size 7,FBALYB Amazon,-4,-4,0,6,0,0
,Brooks Women's Ghost 12 Peacoat/Blue/Aqua Size 7.5,Brooks Women's Ghost 12 Peacoat/Blue/Aqua Size 7.5,FBALYB Amazon,-4,-4,0,0,0,0
,Brooks Women's Ghost 12 Peacoat/Blue/Aqua Size 8,Brooks Women's Ghost 12 Peacoat/Blue/Aqua Size 8,FBALYB Amazon,-1,-1,0,0,0,0
,Brooks Women's Ghost 12 Peacoat/Blue/Aqua Size 8.5,Brooks Women's Ghost 12 Peacoat/Blue/Aqua Size 8.5,FBALYB Amazon,-2,-2,0,0,0,0
,Brooks Women's Ghost 12 Peacoat/Blue/Aqua Size 9,Brooks Women's Ghost 12 Peacoat/Blue/Aqua Size 9,Default,0,-10,10,0,0,0
,Brooks Women's Ghost 12 Peacoat/Blue/Aqua Size 9,Brooks Women's Ghost 12 Peacoat/Blue/Aqua Size 9,FBALYB Amazon,-11,-11,0,12,0,0
,Brooks Women's Ghost 12 Peacoat/Blue/Aqua Size 9.5,Brooks Women's Ghost 12 Peacoat/Blue/Aqua Size 9.5,FBALYB Amazon,-13,-13,0,12,0,0
,Brooks Women's Ghost 12 Tempest/Kentucky Size 10,Brooks Women's Ghost 12 Tempest/Kentucky Size 10,FBALYB Amazon,-4,-4,0,0,0,0
,Brooks Women's Ghost 12 Tempest/Kentucky Size 6,Brooks Women's Ghost 12 Tempest/Kentucky Size 6,FBALYB Amazon,-7,-7,0,0,0,0
,Brooks Women's Ghost 12 Tempest/Kentucky Size 6.5,Brooks Women's Ghost 12 Tempest/Kentucky Size 6.5,FBALYB Amazon,-9,-9,0,7,0,0
,Brooks Women's Ghost 12 Tempest/Kentucky Size 7,Brooks Women's Ghost 12 Tempest/Kentucky Size 7,FBALYB Amazon,-14,-14,0,6,0,0
,Brooks Women's Ghost 12 Tempest/Kentucky Size 7.5,Brooks Women's Ghost 12 Tempest/Kentucky Size 7.5,FBALYB Amazon,-14,-14,0,12,0,0
,Brooks Women's Ghost 12 Tempest/Kentucky Size 8,Brooks Women's Ghost 12 Tempest/Kentucky Size 8,FBALYB Amazon,-26,-26,0,12,0,0
,Brooks Women's Ghost 12 Tempest/Kentucky Size 8.5,Brooks Women's Ghost 12 Tempest/Kentucky Size 8.5,FBALYB Amazon,-26,-26,0,12,0,0
,Brooks Women's Ghost 12 Tempest/Kentucky Size 9,Brooks Women's Ghost 12 Tempest/Kentucky Size 9,FBALYB Amazon,-10,-10,0,6,0,0
,Brooks Women's Ghost 12 Tempest/Kentucky Size 9.5,Brooks Women's Ghost 12 Tempest/Kentucky Size 9.5,FBALYB Amazon,-6,-6,0,6,0,0
,Brooks Women's Ghost 12 White/Grey/Hollyhock Size 10,Brooks Women's Ghost 12 White/Grey/Hollyhock Size 10,FBALYB Amazon,-3,-3,0,3,0,0
,Brooks Women's Ghost 12 White/Grey/Hollyhock Size 7,Brooks Women's Ghost 12 White/Grey/Hollyhock Size 7,FBALYB Amazon,-1,-1,0,0,0,0
,Brooks Women's Ghost 12 White/Grey/Hollyhock Size 7.5,Brooks Women's Ghost 12 White/Grey/Hollyhock Size 7.5,FBALYB Amazon,-3,-3,0,0,0,0
,Brooks Women's Ghost 12 White/Grey/Hollyhock Size 8,Brooks Women's Ghost 12 White/Grey/Hollyhock Size 8,FBALYB Amazon,-3,-3,0,0,0,0
,Brooks Women's Ghost 12 White/Grey/Hollyhock Size 8.5,Brooks Women's Ghost 12 White/Grey/Hollyhock Size 8.5,FBALYB Amazon,-1,-1,0,0,0,0
,Brooks Women's Ghost 13 Alloy/Oyster/White Size 10,Brooks Women's Ghost 13 Alloy/Oyster/White Size 10,Default,0,-1,1,0,0,1
,Brooks Women's Ghost 13 Alloy/Oyster/White Size 10,Brooks Women's Ghost 13 Alloy/Oyster/White Size 10,FBALYB Amazon,-2,-2,0,0,0,0
,Brooks Women's Ghost 13 Alloy/Oyster/White Size 6,Brooks Women's Ghost 13 Alloy/Oyster/White Size 6,Default,0,-1,1,0,0,0
,Brooks Women's Ghost 13 Alloy/Oyster/White Size 6,Brooks Women's Ghost 13 Alloy/Oyster/White Size 6,FBALYB Amazon,-3,-3,0,0,0,0
,Brooks Women's Ghost 13 Alloy/Oyster/White Size 6.5,Brooks Women's Ghost 13 Alloy/Oyster/White Size 6.5,Default,0,0,0,0,0,2
,Brooks Women's Ghost 13 Alloy/Oyster/White Size 6.5,Brooks Women's Ghost 13 Alloy/Oyster/White Size 6.5,FBALYB Amazon,-4,-4,0,0,0,0
,Brooks Women's Ghost 13 Alloy/Oyster/White Size 7,Brooks Women's Ghost 13 Alloy/Oyster/White Size 7,FBALYB Amazon,-3,-3,0,0,0,0
,Brooks Women's Ghost 13 Alloy/Oyster/White Size 7.5,Brooks Women's Ghost 13 Alloy/Oyster/White Size 7.5,Default,0,-1,1,0,0,0
,Brooks Women's Ghost 13 Alloy/Oyster/White Size 8,Brooks Women's Ghost 13 Alloy/Oyster/White Size 8,Default,0,0,0,0,0,1
,Brooks Women's Ghost 13 Alloy/Oyster/White Size 8,Brooks Women's Ghost 13 Alloy/Oyster/White Size 8,FBALYB Amazon,-2,-2,0,0,0,0
,Brooks Women's Ghost 13 Alloy/Oyster/White Size 8.5,Brooks Women's Ghost 13 Alloy/Oyster/White Size 8.5,FBALYB Amazon,-3,-3,0,0,0,0
,Brooks Women's Ghost 13 Alloy/Oyster/White Size 9.5,Brooks Women's Ghost 13 Alloy/Oyster/White Size 9.5,FBALYB Amazon,-1,-1,0,0,0,0
,Brooks Women's Ghost 13 Black/Blackened Pearl/White Size 10,Brooks Women's Ghost 13 Black/Blackened Pearl/White Size 10,Default,0,-1,1,0,0,0
,Brooks Women's Ghost 13 Black/Blackened Pearl/White Size 10,Brooks Women's Ghost 13 Black/Blackened Pearl/White Size 10,FBALYB Amazon,-2,-2,0,0,0,0
,Brooks Women's Ghost 13 Black/Blackened Pearl/White Size 6,Brooks Women's Ghost 13 Black/Blackened Pearl/White Size 6,Default,0,-1,1,0,0,0
,Brooks Women's Ghost 13 Black/Blackened Pearl/White Size 6,Brooks Women's Ghost 13 Black/Blackened Pearl/White Size 6,FBALYB Amazon,-2,-2,0,0,0,0
,Brooks Women's Ghost 13 Black/Blackened Pearl/White Size 6.5,Brooks Women's Ghost 13 Black/Blackened Pearl/White Size 6.5,FBALYB Amazon,-7,-7,0,0,0,0
,Brooks Women's Ghost 13 Black/Blackened Pearl/White Size 7,Brooks Women's Ghost 13 Black/Blackened Pearl/White Size 7,FBALYB Amazon,-2,-2,0,0,0,0
,Brooks Women's Ghost 13 Black/Blackened Pearl/White Size 7.5,Brooks Women's Ghost 13 Black/Blackened Pearl/White Size 7.5,FBALYB Amazon,-6,-6,0,0,0,0
,Brooks Women's Ghost 13 Black/Blackened Pearl/White Size 8,Brooks Women's Ghost 13 Black/Blackened Pearl/White Size 8,Default,0,0,0,0,0,2
,Brooks Women's Ghost 13 Black/Blackened Pearl/White Size 8,Brooks Women's Ghost 13 Black/Blackened Pearl/White Size 8,FBALYB Amazon,-2,-2,0,0,0,0
,Brooks Women's Ghost 13 Black/Blackened Pearl/White Size 8.5,Brooks Women's Ghost 13 Black/Blackened Pearl/White Size 8.5,Default,0,-1,1,0,0,0
,Brooks Women's Ghost 13 Black/Blackened Pearl/White Size 8.5,Brooks Women's Ghost 13 Black/Blackened Pearl/White Size 8.5,FBALYB Amazon,-2,-2,0,0,0,0
,Brooks Women's Ghost 13 Black/Blackened Pearl/White Size 9,Brooks Women's Ghost 13 Black/Blackened Pearl/White Size 9,FBALYB Amazon,-2,-2,0,0,0,0
,Brooks Women's Ghost 13 Black/Pearl/Hushed Violet Size 10,Brooks Women's Ghost 13 Black/Pearl/Hushed Violet Size 10,Default,0,-1,1,0,0,0
,Brooks Women's Ghost 13 Black/Pearl/Hushed Violet Size 10,Brooks Women's Ghost 13 Black/Pearl/Hushed Violet Size 10,FBALYB Amazon,-1,-1,0,0,0,0
,Brooks Women's Ghost 13 Black/Pearl/Hushed Violet Size 6,Brooks Women's Ghost 13 Black/Pearl/Hushed Violet Size 6,Default,0,-1,1,0,0,2
,Brooks Women's Ghost 13 Black/Pearl/Hushed Violet Size 6,Brooks Women's Ghost 13 Black/Pearl/Hushed Violet Size 6,FBALYB Amazon,-5,-5,0,0,0,0
,Brooks Women's Ghost 13 Black/Pearl/Hushed Violet Size 6.5,Brooks Women's Ghost 13 Black/Pearl/Hushed Violet Size 6.5,FBALYB Amazon,-4,-4,0,0,0,0
,Brooks Women's Ghost 13 Black/Pearl/Hushed Violet Size 7,Brooks Women's Ghost 13 Black/Pearl/Hushed Violet Size 7,Default,0,0,0,0,0,3
,Brooks Women's Ghost 13 Black/Pearl/Hushed Violet Size 7,Brooks Women's Ghost 13 Black/Pearl/Hushed Violet Size 7,FBALYB Amazon,-2,-2,0,0,0,0
,Brooks Women's Ghost 13 Black/Pearl/Hushed Violet Size 7.5,Brooks Women's Ghost 13 Black/Pearl/Hushed Violet Size 7.5,FBALYB Amazon,-1,-1,0,0,0,0
,Brooks Women's Ghost 13 Black/Pearl/Hushed Violet Size 8,Brooks Women's Ghost 13 Black/Pearl/Hushed Violet Size 8,Default,0,-1,1,0,0,0
,Brooks Women's Ghost 13 Black/Pearl/Hushed Violet Size 8,Brooks Women's Ghost 13 Black/Pearl/Hushed Violet Size 8,Default Ridgefield,6,6,0,0,0,0
,Brooks Women's Ghost 13 Black/Pearl/Hushed Violet Size 8,Brooks Women's Ghost 13 Black/Pearl/Hushed Violet Size 8,FBALYB Amazon,-2,-2,0,0,0,0
,Brooks Women's Ghost 13 Black/Pearl/Hushed Violet Size 8.5,Brooks Women's Ghost 13 Black/Pearl/Hushed Violet Size 8.5,Default Ridgefield,2,2,0,0,0,0
,Brooks Women's Ghost 13 Black/Pearl/Hushed Violet Size 8.5,Brooks Women's Ghost 13 Black/Pearl/Hushed Violet Size 8.5,FBALYB Amazon,-3,-3,0,0,0,0
,Brooks Women's Ghost 13 Black/Pearl/Hushed Violet Size 9,Brooks Women's Ghost 13 Black/Pearl/Hushed Violet Size 9,Default,0,0,0,0,0,2
,Brooks Women's Ghost 13 Black/Pearl/Hushed Violet Size 9,Brooks Women's Ghost 13 Black/Pearl/Hushed Violet Size 9,FBALYB Amazon,-1,-1,0,0,0,0
,Brooks Women's Ghost 13 Black/Pearl/Hushed Violet Size 9.5,Brooks Women's Ghost 13 Black/Pearl/Hushed Violet Size 9.5,Default,0,0,0,0,0,3
,Brooks Women's Ghost 13 Black/Pearl/Hushed Violet Size 9.5,Brooks Women's Ghost 13 Black/Pearl/Hushed Violet Size 9.5,FBALYB Amazon,-1,-1,0,0,0,0
,Brooks Women's Ghost 13 Light Blue/Blackened Pearl/White Size 10,Brooks Women's Ghost 13 Light Blue/Blackened Pearl/White Size 10,Default,0,-1,1,0,0,2
,Brooks Women's Ghost 13 Light Blue/Blackened Pearl/White Size 6,Brooks Women's Ghost 13 Light Blue/Blackened Pearl/White Size 6,Default,0,-1,1,0,0,2
,Brooks Women's Ghost 13 Light Blue/Blackened Pearl/White Size 6,Brooks Women's Ghost 13 Light Blue/Blackened Pearl/White Size 6,FBALYB Amazon,-3,-3,0,0,0,0
,Brooks Women's Ghost 13 Light Blue/Blackened Pearl/White Size 6.5,Brooks Women's Ghost 13 Light Blue/Blackened Pearl/White Size 6.5,Default,0,0,0,0,0,1
,Brooks Women's Ghost 13 Light Blue/Blackened Pearl/White Size 6.5,Brooks Women's Ghost 13 Light Blue/Blackened Pearl/White Size 6.5,FBALYB Amazon,-2,-2,0,0,0,0
,Brooks Women's Ghost 13 Light Blue/Blackened Pearl/White Size 7,Brooks Women's Ghost 13 Light Blue/Blackened Pearl/White Size 7,Default,0,0,0,0,0,2
,Brooks Women's Ghost 13 Light Blue/Blackened Pearl/White Size 7,Brooks Women's Ghost 13 Light Blue/Blackened Pearl/White Size 7,FBALYB Amazon,-2,-2,0,0,0,0
,Brooks Women's Ghost 13 Light Blue/Blackened Pearl/White Size 7.5,Brooks Women's Ghost 13 Light Blue/Blackened Pearl/White Size 7.5,FBALYB Amazon,-7,-7,0,0,0,0
,Brooks Women's Ghost 13 Light Blue/Blackened Pearl/White Size 8,Brooks Women's Ghost 13 Light Blue/Blackened Pearl/White Size 8,Default,0,-1,1,0,0,0
,Brooks Women's Ghost 13 Light Blue/Blackened Pearl/White Size 8,Brooks Women's Ghost 13 Light Blue/Blackened Pearl/White Size 8,FBALYB Amazon,-4,-4,0,0,0,0
,Brooks Women's Ghost 13 Light Blue/Blackened Pearl/White Size 8.5,Brooks Women's Ghost 13 Light Blue/Blackened Pearl/White Size 8.5,Default Ridgefield,4,4,0,0,0,0
,Brooks Women's Ghost 13 Light Blue/Blackened Pearl/White Size 8.5,Brooks Women's Ghost 13 Light Blue/Blackened Pearl/White Size 8.5,FBALYB Amazon,-6,-6,0,0,0,0
,Brooks Women's Ghost 13 Light Blue/Blackened Pearl/White Size 9,Brooks Women's Ghost 13 Light Blue/Blackened Pearl/White Size 9,Default,0,0,0,0,0,1
,Brooks Women's Ghost 13 Light Blue/Blackened Pearl/White Size 9,Brooks Women's Ghost 13 Light Blue/Blackened Pearl/White Size 9,FBALYB Amazon,-1,-1,0,0,0,0
,Brooks Women's Ghost 13 Light Blue/Blackened Pearl/White Size 9.5,Brooks Women's Ghost 13 Light Blue/Blackened Pearl/White Size 9.5,Default,0,0,0,0,0,2
,Brooks Women's Ghost 13 White/Pink/Black Size 10,Brooks Women's Ghost 13 White/Pink/Black Size 10,Default,0,-1,1,0,0,0
,Brooks Women's Ghost 13 White/Pink/Black Size 6,Brooks Women's Ghost 13 White/Pink/Black Size 6,Default,0,-1,1,0,0,0
,Brooks Women's Ghost 13 White/Pink/Black Size 6,Brooks Women's Ghost 13 White/Pink/Black Size 6,FBALYB Amazon,-3,-3,0,0,0,0
,Brooks Women's Ghost 13 White/Pink/Black Size 6.5,Brooks Women's Ghost 13 White/Pink/Black Size 6.5,Default,0,0,0,0,0,1
,Brooks Women's Ghost 13 White/Pink/Black Size 6.5,Brooks Women's Ghost 13 White/Pink/Black Size 6.5,FBALYB Amazon,-7,-7,0,0,0,0
,Brooks Women's Ghost 13 White/Pink/Black Size 7,Brooks Women's Ghost 13 White/Pink/Black Size 7,FBALYB Amazon,-1,-1,0,0,0,0
,Brooks Women's Ghost 13 White/Pink/Black Size 7.5,Brooks Women's Ghost 13 White/Pink/Black Size 7.5,FBALYB Amazon,-1,-1,0,0,0,0
,Brooks Women's Ghost 13 White/Pink/Black Size 8,Brooks Women's Ghost 13 White/Pink/Black Size 8,Default,0,-1,1,0,0,0
,Brooks Women's Ghost 13 White/Pink/Black Size 8,Brooks Women's Ghost 13 White/Pink/Black Size 8,FBALYB Amazon,-1,-1,0,0,0,0
,Brooks Women's Ghost 13 White/Pink/Black Size 8.5,Brooks Women's Ghost 13 White/Pink/Black Size 8.5,FBALYB Amazon,-2,-2,0,0,0,0
,Brooks Women's Ghost 13 White/Pink/Black Size 9,Brooks Women's Ghost 13 White/Pink/Black Size 9,Default,0,0,0,0,0,1
,Brooks Women's Ghost 13 White/Pink/Black Size 9,Brooks Women's Ghost 13 White/Pink/Black Size 9,FBALYB Amazon,-2,-2,0,0,0,0
,Brooks Women's Ghost 13 White/Pink/Black Size 9.5,Brooks Women's Ghost 13 White/Pink/Black Size 9.5,FBALYB Amazon,-1,-1,0,0,0,0
,Brooks Women's Glycerin 18 Black/Ebony/Cornflower Size 6,Brooks Women's Glycerin 18 Black/Ebony/Cornflower Size 6,Default,2,2,0,0,0,0
,Brooks Women's Glycerin 18 Black/Ebony/Cornflower Size 6,Brooks Women's Glycerin 18 Black/Ebony/Cornflower Size 6,FBALYB Amazon,-4,-4,0,0,0,0
,Brooks Women's Glycerin 18 Black/Ebony/Cornflower Size 6.5,Brooks Women's Glycerin 18 Black/Ebony/Cornflower Size 6.5,Default,2,2,0,0,0,0
,Brooks Women's Glycerin 18 Black/Ebony/Cornflower Size 6.5,Brooks Women's Glycerin 18 Black/Ebony/Cornflower Size 6.5,FBALYB Amazon,-3,-3,0,0,0,0
,Brooks Women's Glycerin 18 Black/Ebony/Cornflower Size 7,Brooks Women's Glycerin 18 Black/Ebony/Cornflower Size 7,Default,2,2,0,0,0,0
,Brooks Women's Glycerin 18 Black/Ebony/Cornflower Size 7,Brooks Women's Glycerin 18 Black/Ebony/Cornflower Size 7,FBALYB Amazon,-2,-2,0,0,0,0
,Brooks Women's Glycerin 18 Black/Ebony/Cornflower Size 7.5,Brooks Women's Glycerin 18 Black/Ebony/Cornflower Size 7.5,Default Oxford,2,2,0,0,0,0
,Brooks Women's Glycerin 18 Black/Ebony/Cornflower Size 7.5,Brooks Women's Glycerin 18 Black/Ebony/Cornflower Size 7.5,FBALYB Amazon,-1,-1,0,0,0,0
,Brooks Women's Glycerin 18 Black/Ebony/Cornflower Size 8,Brooks Women's Glycerin 18 Black/Ebony/Cornflower Size 8,Default,2,2,0,0,0,0
,Brooks Women's Glycerin 18 Black/Ebony/Cornflower Size 8,Brooks Women's Glycerin 18 Black/Ebony/Cornflower Size 8,FBALYB Amazon,-4,-4,0,0,0,0
,Brooks Women's Glycerin 18 Black/Ebony/Cornflower Size 8.5,Brooks Women's Glycerin 18 Black/Ebony/Cornflower Size 8.5,Default Ridgefield,1,1,0,0,0,0
,Brooks Women's Glycerin 18 Black/Ebony/Cornflower Size 8.5,Brooks Women's Glycerin 18 Black/Ebony/Cornflower Size 8.5,FBALYB Amazon,-1,-1,0,0,0,0
,Brooks Women's Glycerin 18 Black/Ebony/Cornflower Size 9,Brooks Women's Glycerin 18 Black/Ebony/Cornflower Size 9,Default,1,1,0,0,0,0
,Brooks Women's Glycerin 18 Black/Ebony/Cornflower Size 9,Brooks Women's Glycerin 18 Black/Ebony/Cornflower Size 9,FBALYB Amazon,-1,-1,0,0,0,0
,Brooks Women's Glycerin 18 Black/Rose Gold/Grey Size 6.5,Brooks Women's Glycerin 18 Black/Rose Gold/Grey Size 6.5,FBALYB Amazon,-1,-1,0,0,0,0
,Brooks Women's Glycerin 18 Black/Rose Gold/Grey Size 7,Brooks Women's Glycerin 18 Black/Rose Gold/Grey Size 7,FBALYB Amazon,-1,-1,0,0,0,0
,Brooks Women's Glycerin 18 Black/Rose Gold/Grey Size 7.5,Brooks Women's Glycerin 18 Black/Rose Gold/Grey Size 7.5,FBALYB Amazon,-2,-2,0,0,0,0
,Brooks Women's Glycerin 18 Black/Rose Gold/Grey Size 8,Brooks Women's Glycerin 18 Black/Rose Gold/Grey Size 8,FBALYB Amazon,-3,-3,0,0,0,0
,Brooks Women's Glycerin 18 Black/Rose Gold/Grey Size 8.5,Brooks Women's Glycerin 18 Black/Rose Gold/Grey Size 8.5,FBALYB Amazon,-4,-4,0,0,0,0
,Brooks Women's Glycerin 18 Black/Rose Gold/Grey Size 9.5,Brooks Women's Glycerin 18 Black/Rose Gold/Grey Size 9.5,FBALYB Amazon,1,1,0,0,0,0
,Brooks Women's Glycerin 18 Cornflower/Blue/Gold Size 10,Brooks Women's Glycerin 18 Cornflower/Blue/Gold Size 10,Default Ridgefield,2,2,0,0,0,0
,Brooks Women's Glycerin 18 Cornflower/Blue/Gold Size 10,Brooks Women's Glycerin 18 Cornflower/Blue/Gold Size 10,FBALYB Amazon,1,1,0,0,0,0
,Brooks Women's Glycerin 18 Cornflower/Blue/Gold Size 10.5,Brooks Women's Glycerin 18 Cornflower/Blue/Gold Size 10.5,Default Ridgefield,1,1,0,0,0,0
,Brooks Women's Glycerin 18 Cornflower/Blue/Gold Size 6,Brooks Women's Glycerin 18 Cornflower/Blue/Gold Size 6,Default Oxford,13,13,0,0,0,0
,Brooks Women's Glycerin 18 Cornflower/Blue/Gold Size 6,Brooks Women's Glycerin 18 Cornflower/Blue/Gold Size 6,Default Ridgefield,4,4,0,0,0,0
,Brooks Women's Glycerin 18 Cornflower/Blue/Gold Size 6,Brooks Women's Glycerin 18 Cornflower/Blue/Gold Size 6,FBALYB Amazon,-1,-1,0,0,0,0
,Brooks Women's Glycerin 18 Cornflower/Blue/Gold Size 6.5,Brooks Women's Glycerin 18 Cornflower/Blue/Gold Size 6.5,Default Oxford,3,3,0,0,0,0
,Brooks Women's Glycerin 18 Cornflower/Blue/Gold Size 6.5,Brooks Women's Glycerin 18 Cornflower/Blue/Gold Size 6.5,FBALYB Amazon,-1,-1,0,0,0,0
,Brooks Women's Glycerin 18 Cornflower/Blue/Gold Size 7,Brooks Women's Glycerin 18 Cornflower/Blue/Gold Size 7,Default Oxford,3,3,0,0,0,0
,Brooks Women's Glycerin 18 Cornflower/Blue/Gold Size 7,Brooks Women's Glycerin 18 Cornflower/Blue/Gold Size 7,Default Ridgefield,2,2,0,0,0,0
,Brooks Women's Glycerin 18 Cornflower/Blue/Gold Size 7,Brooks Women's Glycerin 18 Cornflower/Blue/Gold Size 7,FBALYB Amazon,-1,-1,0,0,0,0
,Brooks Women's Glycerin 18 Cornflower/Blue/Gold Size 7.5,Brooks Women's Glycerin 18 Cornflower/Blue/Gold Size 7.5,Avrami - Ebay,2,2,0,0,0,0
,Brooks Women's Glycerin 18 Cornflower/Blue/Gold Size 8,Brooks Women's Glycerin 18 Cornflower/Blue/Gold Size 8,Default Oxford,1,1,0,0,0,0
,Brooks Women's Glycerin 18 Cornflower/Blue/Gold Size 8,Brooks Women's Glycerin 18 Cornflower/Blue/Gold Size 8,Default Ridgefield,5,5,0,0,0,0
,Brooks Women's Glycerin 18 Cornflower/Blue/Gold Size 8,Brooks Women's Glycerin 18 Cornflower/Blue/Gold Size 8,FBALYB Amazon,-2,-2,0,0,0,0
,Brooks Women's Glycerin 18 Cornflower/Blue/Gold Size 8.5,Brooks Women's Glycerin 18 Cornflower/Blue/Gold Size 8.5,Default Oxford,2,2,0,0,0,0
,Brooks Women's Glycerin 18 Cornflower/Blue/Gold Size 8.5,Brooks Women's Glycerin 18 Cornflower/Blue/Gold Size 8.5,FBALYB Amazon,-2,-2,0,0,0,0
,Brooks Women's Glycerin 18 Cornflower/Blue/Gold Size 9.5,Brooks Women's Glycerin 18 Cornflower/Blue/Gold Size 9.5,Default Ridgefield,2,2,0,0,0,0
,Brooks Women's Glycerin 18 Cornflower/Blue/Gold Size 9.5,Brooks Women's Glycerin 18 Cornflower/Blue/Gold Size 9.5,FBALYB Amazon,-3,-3,0,0,0,0
,Brooks Women's Glycerin 18 Kentucky/Turbulence/Grey Size 10,Brooks Women's Glycerin 18 Kentucky/Turbulence/Grey Size 10,FBALYB Amazon,-9,-9,0,6,0,0
,Brooks Women's Glycerin 18 Kentucky/Turbulence/Grey Size 6,Brooks Women's Glycerin 18 Kentucky/Turbulence/Grey Size 6,FBALYB Amazon,-11,-11,0,6,0,0
,Brooks Women's Glycerin 18 Kentucky/Turbulence/Grey Size 6.5,Brooks Women's Glycerin 18 Kentucky/Turbulence/Grey Size 6.5,FBALYB Amazon,-3,-3,0,3,0,0
,Brooks Women's Glycerin 18 Kentucky/Turbulence/Grey Size 7,Brooks Women's Glycerin 18 Kentucky/Turbulence/Grey Size 7,FBALYB Amazon,-3,-3,0,0,0,0
,Brooks Women's Glycerin 18 Kentucky/Turbulence/Grey Size 7.5,Brooks Women's Glycerin 18 Kentucky/Turbulence/Grey Size 7.5,FBALYB Amazon,-11,-11,0,6,0,0
,Brooks Women's Glycerin 18 Kentucky/Turbulence/Grey Size 8,Brooks Women's Glycerin 18 Kentucky/Turbulence/Grey Size 8,FBALYB Amazon,-4,-4,0,1,0,0
,Brooks Women's Glycerin 18 Kentucky/Turbulence/Grey Size 8.5,Brooks Women's Glycerin 18 Kentucky/Turbulence/Grey Size 8.5,FBALYB Amazon,-2,-2,0,0,0,0
,Brooks Women's Glycerin 18 Kentucky/Turbulence/Grey Size 9,Brooks Women's Glycerin 18 Kentucky/Turbulence/Grey Size 9,FBALYB Amazon,-3,-3,0,0,0,0
,Brooks Women's Glycerin 18 Valerian/Jewel Size 10,Brooks Women's Glycerin 18 Valerian/Jewel Size 10,FBALYB Amazon,-1,-1,0,0,0,0
,Brooks Women's Glycerin 18 Valerian/Jewel Size 6.5,Brooks Women's Glycerin 18 Valerian/Jewel Size 6.5,FBALYB Amazon,-1,-1,0,0,0,0
,Brooks Women's Glycerin 18 Valerian/Jewel Size 7.5,Brooks Women's Glycerin 18 Valerian/Jewel Size 7.5,FBALYB Amazon,-2,-2,0,1,0,0
,Brooks Women's Glycerin 18 Valerian/Jewel Size 8,Brooks Women's Glycerin 18 Valerian/Jewel Size 8,FBALYB Amazon,-2,-2,0,1,0,0
,Brooks Women's Glycerin 18 Valerian/Jewel Size 8.5,Brooks Women's Glycerin 18 Valerian/Jewel Size 8.5,FBALYB Amazon,-9,-9,0,0,0,0
,Brooks Women's Glycerin 18 Valerian/Jewel Size 9,Brooks Women's Glycerin 18 Valerian/Jewel Size 9,FBALYB Amazon,-2,-2,0,0,0,0
,Brooks Women's Glycerin 18 Valerian/Jewel Size 9.5,Brooks Women's Glycerin 18 Valerian/Jewel Size 9.5,FBALYB Amazon,-1,-1,0,0,0,0
,Brooks Women's Glycerin 18 White/Grey/Primer Size 6.5,Brooks Women's Glycerin 18 White/Grey/Primer Size 6.5,FBALYB Amazon,-1,-1,0,0,0,0
,Brooks Women's Glycerin 18 White/Grey/Primer Size 7,Brooks Women's Glycerin 18 White/Grey/Primer Size 7,FBALYB Amazon,-1,-1,0,0,0,0
,Brooks Women's Glycerin 18 White/Grey/Primer Size 7.5,Brooks Women's Glycerin 18 White/Grey/Primer Size 7.5,FBALYB Amazon,-3,-3,0,0,0,0
,Brooks Women's Launch 7 Antarctica/Lead/Grape Size 10,Brooks Women's Launch 7 Antarctica/Lead/Grape Size 10,FBALYB Amazon,-3,-3,0,0,0,0
,Brooks Women's Launch 7 Antarctica/Lead/Grape Size 6,Brooks Women's Launch 7 Antarctica/Lead/Grape Size 6,Default Oxford,5,5,0,0,0,0
,Brooks Women's Launch 7 Antarctica/Lead/Grape Size 6,Brooks Women's Launch 7 Antarctica/Lead/Grape Size 6,FBALYB Amazon,-6,-6,0,6,0,0
,Brooks Women's Launch 7 Antarctica/Lead/Grape Size 6.5,Brooks Women's Launch 7 Antarctica/Lead/Grape Size 6.5,Default Oxford,5,5,0,0,0,0
,Brooks Women's Launch 7 Antarctica/Lead/Grape Size 6.5,Brooks Women's Launch 7 Antarctica/Lead/Grape Size 6.5,FBALYB Amazon,-7,-7,0,6,0,0
,Brooks Women's Launch 7 Antarctica/Lead/Grape Size 7,Brooks Women's Launch 7 Antarctica/Lead/Grape Size 7,Default Oxford,5,5,0,0,0,0
,Brooks Women's Launch 7 Antarctica/Lead/Grape Size 7,Brooks Women's Launch 7 Antarctica/Lead/Grape Size 7,FBALYB Amazon,-2,-2,0,0,0,0
,Brooks Women's Launch 7 Antarctica/Lead/Grape Size 7.5,Brooks Women's Launch 7 Antarctica/Lead/Grape Size 7.5,FBALYB Amazon,-4,-4,0,0,0,0
,Brooks Women's Launch 7 Antarctica/Lead/Grape Size 8,Brooks Women's Launch 7 Antarctica/Lead/Grape Size 8,Default Oxford,10,10,0,0,0,0
,Brooks Women's Launch 7 Antarctica/Lead/Grape Size 8,Brooks Women's Launch 7 Antarctica/Lead/Grape Size 8,FBALYB Amazon,-2,-2,0,0,0,0
,Brooks Women's Launch 7 Antarctica/Lead/Grape Size 8.5,Brooks Women's Launch 7 Antarctica/Lead/Grape Size 8.5,FBALYB Amazon,-1,-1,0,0,0,0
,Brooks Women's Launch 7 Antarctica/Lead/Grape Size 9,Brooks Women's Launch 7 Antarctica/Lead/Grape Size 9,FBALYB Amazon,-2,-2,0,0,0,0
,Brooks Women's Launch 7 Antarctica/Lead/Grape Size 9.5,Brooks Women's Launch 7 Antarctica/Lead/Grape Size 9.5,FBALYB Amazon,-1,-1,0,0,0,0
,Brooks Women's Launch 7 Black/Ebony/Valerian Size 10,Brooks Women's Launch 7 Black/Ebony/Valerian Size 10,Default Oxford,5,5,0,0,0,0
,Brooks Women's Launch 7 Black/Ebony/Valerian Size 10,Brooks Women's Launch 7 Black/Ebony/Valerian Size 10,FBALYB Amazon,-1,-1,0,0,0,0
,Brooks Women's Launch 7 Black/Ebony/Valerian Size 6,Brooks Women's Launch 7 Black/Ebony/Valerian Size 6,Default Oxford,5,5,0,0,0,0
,Brooks Women's Launch 7 Black/Ebony/Valerian Size 6,Brooks Women's Launch 7 Black/Ebony/Valerian Size 6,FBALYB Amazon,-8,-8,0,6,0,0
,Brooks Women's Launch 7 Black/Ebony/Valerian Size 6.5,Brooks Women's Launch 7 Black/Ebony/Valerian Size 6.5,Default Oxford,5,5,0,0,0,0
,Brooks Women's Launch 7 Black/Ebony/Valerian Size 7,Brooks Women's Launch 7 Black/Ebony/Valerian Size 7,Default Oxford,5,5,0,0,0,0
,Brooks Women's Launch 7 Black/Ebony/Valerian Size 7.5,Brooks Women's Launch 7 Black/Ebony/Valerian Size 7.5,Default Ridgefield,1,1,0,0,0,0
,Brooks Women's Launch 7 Black/Ebony/Valerian Size 7.5,Brooks Women's Launch 7 Black/Ebony/Valerian Size 7.5,FBALYB Amazon,-1,-1,0,9,0,0
,Brooks Women's Launch 7 Black/Ebony/Valerian Size 8,Brooks Women's Launch 7 Black/Ebony/Valerian Size 8,Default Oxford,10,10,0,0,0,0
,Brooks Women's Launch 7 Black/Ebony/Valerian Size 8,Brooks Women's Launch 7 Black/Ebony/Valerian Size 8,FBALYB Amazon,-2,-2,0,0,0,0
,Brooks Women's Launch 7 Black/Ebony/Valerian Size 8.5,Brooks Women's Launch 7 Black/Ebony/Valerian Size 8.5,Default Oxford,10,10,0,0,0,0
,Brooks Women's Launch 7 Black/Ebony/Valerian Size 9,Brooks Women's Launch 7 Black/Ebony/Valerian Size 9,Default Oxford,5,5,0,0,0,0
,Brooks Women's Launch 7 Black/Ebony/Valerian Size 9,Brooks Women's Launch 7 Black/Ebony/Valerian Size 9,FBALYB Amazon,-1,-1,0,0,0,0
,Brooks Women's Launch 7 Black/Ebony/Valerian Size 9.5,Brooks Women's Launch 7 Black/Ebony/Valerian Size 9.5,Default Oxford,5,5,0,0,0,0
,Brooks Women's Launch 7 Coral/Claret/Blue Size 10,Brooks Women's Launch 7 Coral/Claret/Blue Size 10,FBALYB Amazon,-6,-6,0,0,0,0
,Brooks Women's Launch 7 Coral/Claret/Blue Size 6.5,Brooks Women's Launch 7 Coral/Claret/Blue Size 6.5,FBALYB Amazon,-2,-2,0,0,0,0
,Brooks Women's Launch 7 Coral/Claret/Blue Size 7,Brooks Women's Launch 7 Coral/Claret/Blue Size 7,FBALYB Amazon,-1,-1,0,0,0,0
,Brooks Women's Launch 7 Coral/Claret/Blue Size 7.5,Brooks Women's Launch 7 Coral/Claret/Blue Size 7.5,FBALYB Amazon,-7,-7,0,0,0,0
,Brooks Women's Launch 7 Coral/Claret/Blue Size 8,Brooks Women's Launch 7 Coral/Claret/Blue Size 8,FBALYB Amazon,-3,-3,0,0,0,0
,Brooks Women's Launch 7 Coral/Claret/Blue Size 8.5,Brooks Women's Launch 7 Coral/Claret/Blue Size 8.5,FBALYB Amazon,-4,-4,0,0,0,0
,Brooks Women's Launch 7 Coral/Claret/Blue Size 9,Brooks Women's Launch 7 Coral/Claret/Blue Size 9,Default Oxford,4,4,0,0,0,0
,Brooks Women's Launch 7 Coral/Claret/Blue Size 9,Brooks Women's Launch 7 Coral/Claret/Blue Size 9,FBALYB Amazon,2,2,0,0,0,0
,Brooks Women's Launch 7 Coral/Claret/Blue Size 9.5,Brooks Women's Launch 7 Coral/Claret/Blue Size 9.5,Default Oxford,4,4,0,0,0,0
,Brooks Women's Launch 7 Coral/Claret/Blue Size 9.5,Brooks Women's Launch 7 Coral/Claret/Blue Size 9.5,FBALYB Amazon,2,2,0,0,0,0
,Brooks Women's Launch 7 Ebony/Black/Cantaloupe Size 6,Brooks Women's Launch 7 Ebony/Black/Cantaloupe Size 6,FBALYB Amazon,-4,-4,0,0,0,0
,Brooks Women's Launch 7 Ebony/Black/Cantaloupe Size 6.5,Brooks Women's Launch 7 Ebony/Black/Cantaloupe Size 6.5,FBALYB Amazon,-2,-2,0,0,0,0
,Brooks Women's Launch 7 Ebony/Black/Cantaloupe Size 7,Brooks Women's Launch 7 Ebony/Black/Cantaloupe Size 7,FBALYB Amazon,-4,-4,0,0,0,0
,Brooks Women's Launch 7 Ebony/Black/Cantaloupe Size 7.5,Brooks Women's Launch 7 Ebony/Black/Cantaloupe Size 7.5,FBALYB Amazon,-1,-1,0,0,0,0
,Brooks Women's Launch 7 Ebony/Black/Cantaloupe Size 8,Brooks Women's Launch 7 Ebony/Black/Cantaloupe Size 8,FBALYB Amazon,-1,-1,0,0,0,0
,Brooks Women's Launch 7 Ebony/Black/Cantaloupe Size 8.5,Brooks Women's Launch 7 Ebony/Black/Cantaloupe Size 8.5,FBALYB Amazon,-2,-2,0,0,0,0
,Brooks Women's Launch 7 Ebony/Black/Cantaloupe Size 9,Brooks Women's Launch 7 Ebony/Black/Cantaloupe Size 9,FBALYB Amazon,-2,-2,0,0,0,0
,Brooks Women's Launch 7 Turbulence/Grey/Blue Size 6.5,Brooks Women's Launch 7 Turbulence/Grey/Blue Size 6.5,FBALYB Amazon,-2,-2,0,0,0,0
,Brooks Women's Launch 7 Turbulence/Grey/Blue Size 7,Brooks Women's Launch 7 Turbulence/Grey/Blue Size 7,FBALYB Amazon,-1,-1,0,0,0,0
,Brooks Women's Launch 7 Turbulence/Grey/Blue Size 7.5,Brooks Women's Launch 7 Turbulence/Grey/Blue Size 7.5,FBALYB Amazon,-1,-1,0,0,0,0
,Brooks Women's Launch 7 Turbulence/Grey/Blue Size 8,Brooks Women's Launch 7 Turbulence/Grey/Blue Size 8,FBALYB Amazon,-10,-10,0,10,0,0
,Brooks Women's Launch 7 Turbulence/Grey/Blue Size 8.5,Brooks Women's Launch 7 Turbulence/Grey/Blue Size 8.5,FBALYB Amazon,-10,-10,0,10,0,0
,Brooks Women's Launch 7 Turbulence/Grey/Blue Size 9,Brooks Women's Launch 7 Turbulence/Grey/Blue Size 9,FBALYB Amazon,-1,-1,0,0,0,0
,Brooks Women's Levitate 3 Kentucky Blue/Mint/Grey Size 10,Brooks Women's Levitate 3 Kentucky Blue/Mint/Grey Size 10,FBALYB Amazon,-1,-1,0,0,0,0
,Brooks Women's Levitate 3 Kentucky Blue/Mint/Grey Size 6,Brooks Women's Levitate 3 Kentucky Blue/Mint/Grey Size 6,FBALYB Amazon,-2,-2,0,0,0,0
,Brooks Women's Levitate 3 Kentucky Blue/Mint/Grey Size 6.5,Brooks Women's Levitate 3 Kentucky Blue/Mint/Grey Size 6.5,FBALYB Amazon,-2,-2,0,0,0,0
,Brooks Women's Levitate 3 Kentucky Blue/Mint/Grey Size 7.5,Brooks Women's Levitate 3 Kentucky Blue/Mint/Grey Size 7.5,FBALYB Amazon,-11,-11,0,12,0,0
,Brooks Women's Levitate 3 Kentucky Blue/Mint/Grey Size 8,Brooks Women's Levitate 3 Kentucky Blue/Mint/Grey Size 8,Default Ridgefield,1,1,0,0,0,0
,Brooks Women's Levitate 3 Kentucky Blue/Mint/Grey Size 8,Brooks Women's Levitate 3 Kentucky Blue/Mint/Grey Size 8,FBALYB Amazon,-4,-4,0,0,0,0
,Brooks Women's Levitate 3 Kentucky Blue/Mint/Grey Size 8.5,Brooks Women's Levitate 3 Kentucky Blue/Mint/Grey Size 8.5,FBALYB Amazon,-12,-12,0,12,0,0
,Brooks Women's Levitate 3 Kentucky Blue/Mint/Grey Size 9,Brooks Women's Levitate 3 Kentucky Blue/Mint/Grey Size 9,FBALYB Amazon,-1,-1,0,0,0,0
,Brooks Women's Levitate 3 Kentucky Blue/Mint/Grey Size 9.5,Brooks Women's Levitate 3 Kentucky Blue/Mint/Grey Size 9.5,FBALYB Amazon,-3,-3,0,0,0,0
,Brooks Women's Levitate 3 LE Black/Ebony Size 6,Brooks Women's Levitate 3 LE Black/Ebony Size 6,FBALYB Amazon,-2,-2,0,0,0,0
,Brooks Women's Levitate 3 LE Black/Ebony Size 7.5,Brooks Women's Levitate 3 LE Black/Ebony Size 7.5,FBALYB Amazon,-1,-1,0,0,0,0
,Brooks Women's Levitate 3 LE Black/Ebony Size 8,Brooks Women's Levitate 3 LE Black/Ebony Size 8,FBALYB Amazon,-3,-3,0,0,0,0
,Brooks Women's Levitate 3 LE Black/Ebony Size 8.5,Brooks Women's Levitate 3 LE Black/Ebony Size 8.5,FBALYB Amazon,-4,-4,0,0,0,0
,Brooks Women's Levitate 3 LE Black/Ebony Size 9,Brooks Women's Levitate 3 LE Black/Ebony Size 9,FBALYB Amazon,-4,-4,0,0,0,0
,Brooks Women's Levitate 3 LE Grey/Kentucky Blue Size 6,Brooks Women's Levitate 3 LE Grey/Kentucky Blue Size 6,FBALYB Amazon,1,1,0,0,0,0
,Brooks Women's Levitate 3 LE Grey/Kentucky Blue Size 7,Brooks Women's Levitate 3 LE Grey/Kentucky Blue Size 7,FBALYB Amazon,-2,-2,0,0,0,0
,Brooks Women's Levitate 3 LE Grey/Kentucky Blue Size 7.5,Brooks Women's Levitate 3 LE Grey/Kentucky Blue Size 7.5,FBALYB Amazon,-7,-7,0,0,0,0
,Brooks Women's Levitate 3 LE Grey/Kentucky Blue Size 8,Brooks Women's Levitate 3 LE Grey/Kentucky Blue Size 8,FBALYB Amazon,-1,-1,0,0,0,0
,Brooks Women's Levitate 3 LE Grey/Kentucky Blue Size 8.5,Brooks Women's Levitate 3 LE Grey/Kentucky Blue Size 8.5,FBALYB Amazon,-2,-2,0,0,0,0
,Brooks Women's Levitate 3 LE Grey/Kentucky Blue Size 9,Brooks Women's Levitate 3 LE Grey/Kentucky Blue Size 9,FBALYB Amazon,-3,-3,0,0,0,0
,Brooks Women's Levitate 3 LE Majolica/Cantaloupe Size 6,Brooks Women's Levitate 3 LE Majolica/Cantaloupe Size 6,FBALYB Amazon,8,8,0,0,0,0
,Brooks Women's Levitate 3 LE Majolica/Cantaloupe Size 7,Brooks Women's Levitate 3 LE Majolica/Cantaloupe Size 7,FBALYB Amazon,-2,-2,0,0,0,0
,Brooks Women's Levitate 3 LE Majolica/Cantaloupe Size 7.5,Brooks Women's Levitate 3 LE Majolica/Cantaloupe Size 7.5,FBALYB Amazon,-1,-1,0,0,0,0
,Brooks Women's Levitate 3 LE Majolica/Cantaloupe Size 8,Brooks Women's Levitate 3 LE Majolica/Cantaloupe Size 8,FBALYB Amazon,-5,-5,0,0,0,0
,Brooks Women's Levitate 3 LE Majolica/Cantaloupe Size 9,Brooks Women's Levitate 3 LE Majolica/Cantaloupe Size 9,FBALYB Amazon,-1,-1,0,0,0,0
,Brooks Women's Levitate 3 White/Purple/Cantaloupe Size 6,Brooks Women's Levitate 3 White/Purple/Cantaloupe Size 6,FBALYB Amazon,-4,-4,0,0,0,0
,Brooks Women's Levitate 3 White/Purple/Cantaloupe Size 6.5,Brooks Women's Levitate 3 White/Purple/Cantaloupe Size 6.5,FBALYB Amazon,-2,-2,0,0,0,0
,Brooks Women's Levitate 3 White/Purple/Cantaloupe Size 7,Brooks Women's Levitate 3 White/Purple/Cantaloupe Size 7,FBALYB Amazon,-5,-5,0,0,0,0
,Brooks Women's Levitate 3 White/Purple/Cantaloupe Size 7.5,Brooks Women's Levitate 3 White/Purple/Cantaloupe Size 7.5,Default Oxford,12,12,0,0,0,0
,Brooks Women's Levitate 3 White/Purple/Cantaloupe Size 8,Brooks Women's Levitate 3 White/Purple/Cantaloupe Size 8,FBALYB Amazon,-1,-1,0,0,0,0
,Brooks Women's Levitate 3 White/Purple/Cantaloupe Size 8.5,Brooks Women's Levitate 3 White/Purple/Cantaloupe Size 8.5,FBALYB Amazon,-5,-5,0,0,0,0
,Brooks Women's Levitate 3 White/Purple/Cantaloupe Size 9,Brooks Women's Levitate 3 White/Purple/Cantaloupe Size 9,FBALYB Amazon,-2,-2,0,0,0,0
,Brooks Women's Ravenna 11 Cornflower/Blue/Coral Size 10,Brooks Women's Ravenna 11 Cornflower/Blue/Coral Size 10,FBALYB Amazon,-7,-7,0,6,0,0
,Brooks Women's Ravenna 11 Cornflower/Blue/Coral Size 6.5,Brooks Women's Ravenna 11 Cornflower/Blue/Coral Size 6.5,FBALYB Amazon,-11,-11,0,6,0,0
,Brooks Women's Ravenna 11 Cornflower/Blue/Coral Size 7.5,Brooks Women's Ravenna 11 Cornflower/Blue/Coral Size 7.5,FBALYB Amazon,-1,-1,0,0,0,0
,Brooks Women's Ravenna 11 Cornflower/Blue/Coral Size 8,Brooks Women's Ravenna 11 Cornflower/Blue/Coral Size 8,FBALYB Amazon,0,0,0,1,0,0
,Brooks Women's Ravenna 11 Cornflower/Blue/Coral Size 8.5,Brooks Women's Ravenna 11 Cornflower/Blue/Coral Size 8.5,FBALYB Amazon,-2,-2,0,0,0,0
,Brooks Women's Ravenna 11 Cornflower/Blue/Coral Size 9.5,Brooks Women's Ravenna 11 Cornflower/Blue/Coral Size 9.5,FBALYB Amazon,-3,-3,0,0,0,0
,Brooks Women's Ravenna 11 Majolica/Navy/Desert Size 10,Brooks Women's Ravenna 11 Majolica/Navy/Desert Size 10,FBALYB Amazon,-7,-7,0,6,0,0
,Brooks Women's Ravenna 11 Majolica/Navy/Desert Size 6,Brooks Women's Ravenna 11 Majolica/Navy/Desert Size 6,FBALYB Amazon,-19,-19,0,6,0,0
,Brooks Women's Ravenna 11 Majolica/Navy/Desert Size 6.5,Brooks Women's Ravenna 11 Majolica/Navy/Desert Size 6.5,Default Oxford,24,24,0,0,0,0
,Brooks Women's Ravenna 11 Majolica/Navy/Desert Size 6.5,Brooks Women's Ravenna 11 Majolica/Navy/Desert Size 6.5,FBALYB Amazon,-14,-14,0,6,0,0
,Brooks Women's Ravenna 11 Majolica/Navy/Desert Size 7,Brooks Women's Ravenna 11 Majolica/Navy/Desert Size 7,FBALYB Amazon,-13,-13,0,6,0,0
,Brooks Women's Ravenna 11 Majolica/Navy/Desert Size 7.5,Brooks Women's Ravenna 11 Majolica/Navy/Desert Size 7.5,FBALYB Amazon,-17,-17,0,12,0,0
,Brooks Women's Ravenna 11 Majolica/Navy/Desert Size 8,Brooks Women's Ravenna 11 Majolica/Navy/Desert Size 8,FBALYB Amazon,-16,-16,0,12,0,0
,Brooks Women's Ravenna 11 Majolica/Navy/Desert Size 8.5,Brooks Women's Ravenna 11 Majolica/Navy/Desert Size 8.5,FBALYB Amazon,-18,-18,0,12,0,0
,Brooks Women's Ravenna 11 Majolica/Navy/Desert Size 9,Brooks Women's Ravenna 11 Majolica/Navy/Desert Size 9,FBALYB Amazon,-5,-5,0,0,0,0
,Brooks Women's Ravenna 11 Majolica/Navy/Desert Size 9.5,Brooks Women's Ravenna 11 Majolica/Navy/Desert Size 9.5,FBALYB Amazon,-6,-6,0,6,0,0
,Brooks Women's Revel 3 Black/Blackened Pearl/White Size 10,Brooks Women's Revel 3 Black/Blackened Pearl/White Size 10,Default Ridgefield,5,5,0,0,0,0
,Brooks Women's Revel 3 Black/Blackened Pearl/White Size 10,Brooks Women's Revel 3 Black/Blackened Pearl/White Size 10,FBALYB Amazon,1,0,1,0,1,0
,Brooks Women's Revel 3 Black/Blackened Pearl/White Size 7,Brooks Women's Revel 3 Black/Blackened Pearl/White Size 7,FBALYB Amazon,-13,-13,0,0,0,0
,Brooks Women's Revel 3 Black/Blackened Pearl/White Size 7.5,Brooks Women's Revel 3 Black/Blackened Pearl/White Size 7.5,Default Oxford,12,12,0,0,0,0
,Brooks Women's Revel 3 Black/Blackened Pearl/White Size 8.5,Brooks Women's Revel 3 Black/Blackened Pearl/White Size 8.5,FBALYB Amazon,5,5,0,0,0,0
,Brooks Women's Revel 3 Black/Blackened Pearl/White Size 9,Brooks Women's Revel 3 Black/Blackened Pearl/White Size 9,FBALYB Amazon,-7,-7,0,6,0,0
,Brooks Women's Revel 3 Black/Blackened Pearl/White Size 9.5,Brooks Women's Revel 3 Black/Blackened Pearl/White Size 9.5,Default Oxford,6,6,0,0,0,0
,Brooks Women's Revel 3 Blue/Navy/Beetroot Size 10,Brooks Women's Revel 3 Blue/Navy/Beetroot Size 10,FBALYB Amazon,-2,-2,0,0,0,0
,Brooks Women's Revel 3 Blue/Navy/Beetroot Size 6,Brooks Women's Revel 3 Blue/Navy/Beetroot Size 6,FBALYB Amazon,-9,-9,0,6,0,0
,Brooks Women's Revel 3 Blue/Navy/Beetroot Size 6.5,Brooks Women's Revel 3 Blue/Navy/Beetroot Size 6.5,FBALYB Amazon,-2,-2,0,0,0,0
,Brooks Women's Revel 3 Blue/Navy/Beetroot Size 7,Brooks Women's Revel 3 Blue/Navy/Beetroot Size 7,FBALYB Amazon,-6,-6,0,6,0,0
,Brooks Women's Revel 3 Blue/Navy/Beetroot Size 7.5,Brooks Women's Revel 3 Blue/Navy/Beetroot Size 7.5,FBALYB Amazon,0,0,0,4,0,0
,Brooks Women's Revel 3 Blue/Navy/Beetroot Size 8,Brooks Women's Revel 3 Blue/Navy/Beetroot Size 8,FBALYB Amazon,-6,-6,0,0,0,0
,Brooks Women's Revel 3 Blue/Navy/Beetroot Size 8.5,Brooks Women's Revel 3 Blue/Navy/Beetroot Size 8.5,FBALYB Amazon,-1,-1,0,0,0,0
,Brooks Women's Revel 3 Blue/Navy/Beetroot Size 9,Brooks Women's Revel 3 Blue/Navy/Beetroot Size 9,FBALYB Amazon,-6,-6,0,6,0,0
,Brooks Women's Revel 3 Blue/Navy/Beetroot Size 9.5,Brooks Women's Revel 3 Blue/Navy/Beetroot Size 9.5,FBALYB Amazon,-8,-8,0,6,0,0
,Brooks Women's Revel 3 Pearl Blue/Primer/Ebony Size 10,Brooks Women's Revel 3 Pearl Blue/Primer/Ebony Size 10,FBALYB Amazon,-6,-6,0,6,0,0
,Brooks Women's Revel 3 Pearl Blue/Primer/Ebony Size 6,Brooks Women's Revel 3 Pearl Blue/Primer/Ebony Size 6,FBALYB Amazon,-2,-2,0,0,0,0
,Brooks Women's Revel 3 Pearl Blue/Primer/Ebony Size 6.5,Brooks Women's Revel 3 Pearl Blue/Primer/Ebony Size 6.5,FBALYB Amazon,-8,-8,0,6,0,0
,Brooks Women's Revel 3 Pearl Blue/Primer/Ebony Size 7,Brooks Women's Revel 3 Pearl Blue/Primer/Ebony Size 7,FBALYB Amazon,5,5,0,0,0,0
,Brooks Women's Revel 3 Pearl Blue/Primer/Ebony Size 7.5,Brooks Women's Revel 3 Pearl Blue/Primer/Ebony Size 7.5,Default Ridgefield,12,12,0,0,0,0
,Brooks Women's Revel 3 Pearl Blue/Primer/Ebony Size 8,Brooks Women's Revel 3 Pearl Blue/Primer/Ebony Size 8,FBALYB Amazon,-1,-1,0,0,0,0
,Brooks Women's Revel 3 Pearl Blue/Primer/Ebony Size 8.5,Brooks Women's Revel 3 Pearl Blue/Primer/Ebony Size 8.5,FBALYB Amazon,-1,-1,0,0,0,0
,Brooks Women's Revel 3 Pearl Blue/Primer/Ebony Size 9,Brooks Women's Revel 3 Pearl Blue/Primer/Ebony Size 9,FBALYB Amazon,-6,-6,0,6,0,0
,Brooks Women's Revel 3 Pearl Blue/Primer/Ebony Size 9.5,Brooks Women's Revel 3 Pearl Blue/Primer/Ebony Size 9.5,FBALYB Amazon,-7,-7,0,6,0,0
,Brooks Women's Revel 3 White/Black Size 10,Brooks Women's Revel 3 White/Black Size 10,FBALYB Amazon,-1,-1,0,0,0,0
,Brooks Women's Revel 3 White/Black Size 6.5,Brooks Women's Revel 3 White/Black Size 6.5,FBALYB Amazon,-2,-2,0,0,0,0
,Brooks Women's Revel 3 White/Black Size 7.5,Brooks Women's Revel 3 White/Black Size 7.5,FBALYB Amazon,22,22,0,0,0,0
,Brooks Women's Revel 3 White/Black Size 8,Brooks Women's Revel 3 White/Black Size 8,FBALYB Amazon,-4,-4,0,0,0,0
,Brooks Women's Revel 3 White/Black Size 8.5,Brooks Women's Revel 3 White/Black Size 8.5,FBALYB Amazon,-1,-1,0,0,0,0
,Brooks Women's Revel 3 White/Black Size 9,Brooks Women's Revel 3 White/Black Size 9,FBALYB Amazon,-1,-1,0,0,0,0
,Brooks Women's Revel 3 White/Black Size 9.5,Brooks Women's Revel 3 White/Black Size 9.5,FBALYB Amazon,0,0,0,6,0,0
,Brooks Women's Ricochet 2 Black/Blue/Fiery Coral Size 6,Brooks Women's Ricochet 2 Black/Blue/Fiery Coral Size 6,FBALYB Amazon,-8,-8,0,0,0,0
,Brooks Women's Ricochet 2 Black/Blue/Fiery Coral Size 6.5,Brooks Women's Ricochet 2 Black/Blue/Fiery Coral Size 6.5,FBALYB Amazon,-3,-3,0,0,0,0
,Brooks Women's Ricochet 2 Black/Blue/Fiery Coral Size 7,Brooks Women's Ricochet 2 Black/Blue/Fiery Coral Size 7,Default Ridgefield,12,12,0,0,0,0
,Brooks Women's Ricochet 2 Black/Blue/Fiery Coral Size 7.5,Brooks Women's Ricochet 2 Black/Blue/Fiery Coral Size 7.5,FBALYB Amazon,-2,-2,0,0,0,0
,Brooks Women's Ricochet 2 Black/Blue/Fiery Coral Size 8,Brooks Women's Ricochet 2 Black/Blue/Fiery Coral Size 8,FBALYB Amazon,11,11,0,0,0,0
,Brooks Women's Ricochet 2 Black/Blue/Fiery Coral Size 8.5,Brooks Women's Ricochet 2 Black/Blue/Fiery Coral Size 8.5,FBALYB Amazon,-1,-1,0,0,0,0
,Brooks Women's Ricochet 2 Black/Blue/Fiery Coral Size 9,Brooks Women's Ricochet 2 Black/Blue/Fiery Coral Size 9,FBALYB Amazon,-2,-2,0,0,0,0
,Brooks Women's Ricochet 2 Grey/Cantaloupe/Grape Size 6,Brooks Women's Ricochet 2 Grey/Cantaloupe/Grape Size 6,Default Oxford,1,1,0,0,0,0
,Brooks Women's Ricochet 2 Grey/Cantaloupe/Grape Size 6,Brooks Women's Ricochet 2 Grey/Cantaloupe/Grape Size 6,FBALYB Amazon,11,11,0,0,0,0
,Brooks Women's Ricochet 2 Grey/Cantaloupe/Grape Size 6.5,Brooks Women's Ricochet 2 Grey/Cantaloupe/Grape Size 6.5,Default Oxford,1,1,0,0,0,0
,Brooks Women's Ricochet 2 Grey/Cantaloupe/Grape Size 6.5,Brooks Women's Ricochet 2 Grey/Cantaloupe/Grape Size 6.5,FBALYB Amazon,9,9,0,0,0,0
,Brooks Women's Ricochet 2 Grey/Cantaloupe/Grape Size 7,Brooks Women's Ricochet 2 Grey/Cantaloupe/Grape Size 7,Default Oxford,1,1,0,0,0,0
,Brooks Women's Ricochet 2 Grey/Cantaloupe/Grape Size 7.5,Brooks Women's Ricochet 2 Grey/Cantaloupe/Grape Size 7.5,FBALYB Amazon,-4,-4,0,0,0,0
,Brooks Women's Ricochet 2 Grey/Cantaloupe/Grape Size 8,Brooks Women's Ricochet 2 Grey/Cantaloupe/Grape Size 8,Default,1,1,0,0,0,0
,Brooks Women's Ricochet 2 Grey/Cantaloupe/Grape Size 8,Brooks Women's Ricochet 2 Grey/Cantaloupe/Grape Size 8,FBALYB Amazon,-6,-6,0,0,0,0
,Brooks Women's Ricochet 2 Grey/Cantaloupe/Grape Size 8.5,Brooks Women's Ricochet 2 Grey/Cantaloupe/Grape Size 8.5,FBALYB Amazon,-3,-3,0,0,0,0
,Brooks Women's Transcend 7 Black/Ebony/Green Size 6,Brooks Women's Transcend 7 Black/Ebony/Green Size 6,FBALYB Amazon,5,5,0,0,0,0
,Brooks Women's Transcend 7 Black/Ebony/Green Size 7,Brooks Women's Transcend 7 Black/Ebony/Green Size 7,FBALYB Amazon,-4,-4,0,0,0,0
,Brooks Women's Transcend 7 Black/Ebony/Green Size 7.5,Brooks Women's Transcend 7 Black/Ebony/Green Size 7.5,FBALYB Amazon,-2,-2,0,0,0,0
,Brooks Women's Transcend 7 Black/Ebony/Green Size 8,Brooks Women's Transcend 7 Black/Ebony/Green Size 8,FBALYB Amazon,-1,-1,0,0,0,0
,Brooks Women's Transcend 7 Black/Ebony/Green Size 8.5,Brooks Women's Transcend 7 Black/Ebony/Green Size 8.5,FBALYB Amazon,-1,-1,0,0,0,0
,Brooks Women's Transcend 7 Black/Ebony/Green Size 9,Brooks Women's Transcend 7 Black/Ebony/Green Size 9,FBALYB Amazon,-1,-1,0,0,0,0
,Brooks Women's Transcend 7 Majolica/Navy/Desert Size 6,Brooks Women's Transcend 7 Majolica/Navy/Desert Size 6,FBALYB Amazon,-1,-1,0,0,0,0
,Brooks Women's Transcend 7 Majolica/Navy/Desert Size 6.5,Brooks Women's Transcend 7 Majolica/Navy/Desert Size 6.5,FBALYB Amazon,-1,-1,0,0,0,0
,Brooks Women's Transcend 7 Majolica/Navy/Desert Size 7,Brooks Women's Transcend 7 Majolica/Navy/Desert Size 7,Default Oxford,5,5,0,0,0,0
,Brooks Women's Transcend 7 Majolica/Navy/Desert Size 7.5,Brooks Women's Transcend 7 Majolica/Navy/Desert Size 7.5,FBALYB Amazon,-3,-3,0,0,0,0
,Brooks Women's Transcend 7 Majolica/Navy/Desert Size 8,Brooks Women's Transcend 7 Majolica/Navy/Desert Size 8,FBALYB Amazon,-2,-2,0,0,0,0
,Brooks Women's Transcend 7 Majolica/Navy/Desert Size 8.5,Brooks Women's Transcend 7 Majolica/Navy/Desert Size 8.5,Default Oxford,10,10,0,0,0,0
,Brooks Women's Transcend 7 Majolica/Navy/Desert Size 9,Brooks Women's Transcend 7 Majolica/Navy/Desert Size 9,FBALYB Amazon,-1,-1,0,0,0,0
,Brooks Women's Transcend 7 Majolica/Navy/Desert Size 9.5,Brooks Women's Transcend 7 Majolica/Navy/Desert Size 9.5,FBALYB Amazon,-1,-1,0,0,0,0
,Brooks W'S LAUNCH 8 PRIMROSE/OMBRE/METALIC 1203451B653 Size 10,Brooks W'S LAUNCH 8 PRIMROSE/OMBRE/METALIC 1203451B653 Size 10,FBALYB Amazon,11,11,0,0,0,0
,Brooks W'S LAUNCH 8 PRIMROSE/OMBRE/METALIC 1203451B653 Size 6,Brooks W'S LAUNCH 8 PRIMROSE/OMBRE/METALIC 1203451B653 Size 6,FBALYB Amazon,124,122,2,0,2,0
,Brooks W'S LAUNCH 8 PRIMROSE/OMBRE/METALIC 1203451B653 Size 6.5,Brooks W'S LAUNCH 8 PRIMROSE/OMBRE/METALIC 1203451B653 Size 6.5,FBALYB Amazon,92,91,1,0,1,0
,Brooks W'S LAUNCH 8 PRIMROSE/OMBRE/METALIC 1203451B653 Size 7,Brooks W'S LAUNCH 8 PRIMROSE/OMBRE/METALIC 1203451B653 Size 7,FBALYB Amazon,-4,-5,1,1,1,0
,Brooks W'S LAUNCH 8 PRIMROSE/OMBRE/METALIC 1203451B653 Size 7.5,Brooks W'S LAUNCH 8 PRIMROSE/OMBRE/METALIC 1203451B653 Size 7.5,FBALYB Amazon,92,90,2,0,2,0
,Brooks W'S LAUNCH 8 PRIMROSE/OMBRE/METALIC 1203451B653 Size 8,Brooks W'S LAUNCH 8 PRIMROSE/OMBRE/METALIC 1203451B653 Size 8,FBALYB Amazon,12,6,6,0,6,0
,Brooks W'S LAUNCH 8 PRIMROSE/OMBRE/METALIC 1203451B653 Size 8.5,Brooks W'S LAUNCH 8 PRIMROSE/OMBRE/METALIC 1203451B653 Size 8.5,FBALYB Amazon,20,20,0,0,0,0
,Brooks W'S LAUNCH 8 PRIMROSE/OMBRE/METALIC 1203451B653 Size 9,Brooks W'S LAUNCH 8 PRIMROSE/OMBRE/METALIC 1203451B653 Size 9,FBALYB Amazon,28,23,5,0,5,0
,Brooks W'S LAUNCH 8 PRIMROSE/OMBRE/METALIC 1203451B653 Size 9.5,Brooks W'S LAUNCH 8 PRIMROSE/OMBRE/METALIC 1203451B653 Size 9.5,Default Ridgefield,10,10,0,0,0,0
,Brooks W'S LAUNCH 8 PRIMROSE/OMBRE/METALIC 1203451B653 Size 9.5,Brooks W'S LAUNCH 8 PRIMROSE/OMBRE/METALIC 1203451B653 Size 9.5,FBALYB Amazon,76,76,0,0,0,0
,Brooks W'S REVEL 4 ALMOND/METALLIC/PRIMROSE 1203371B286 Size 10,Brooks W'S REVEL 4 ALMOND/METALLIC/PRIMROSE 1203371B286 Size 10,FBALYB Amazon,1,1,0,0,0,0
,Brooks W'S REVEL 4 ALMOND/METALLIC/PRIMROSE 1203371B286 Size 6,Brooks W'S REVEL 4 ALMOND/METALLIC/PRIMROSE 1203371B286 Size 6,FBALYB Amazon,24,23,1,0,1,0
,Brooks W'S REVEL 4 ALMOND/METALLIC/PRIMROSE 1203371B286 Size 6.5,Brooks W'S REVEL 4 ALMOND/METALLIC/PRIMROSE 1203371B286 Size 6.5,FBALYB Amazon,17,16,1,0,1,0
,Brooks W'S REVEL 4 ALMOND/METALLIC/PRIMROSE 1203371B286 Size 7,Brooks W'S REVEL 4 ALMOND/METALLIC/PRIMROSE 1203371B286 Size 7,FBALYB Amazon,20,19,1,0,1,0
,Brooks W'S REVEL 4 ALMOND/METALLIC/PRIMROSE 1203371B286 Size 7.5,Brooks W'S REVEL 4 ALMOND/METALLIC/PRIMROSE 1203371B286 Size 7.5,FBALYB Amazon,28,28,0,0,0,0
,Brooks W'S REVEL 4 ALMOND/METALLIC/PRIMROSE 1203371B286 Size 8,Brooks W'S REVEL 4 ALMOND/METALLIC/PRIMROSE 1203371B286 Size 8,FBALYB Amazon,-1,-1,0,0,0,0
,Brooks W'S REVEL 4 ALMOND/METALLIC/PRIMROSE 1203371B286 Size 8.5,Brooks W'S REVEL 4 ALMOND/METALLIC/PRIMROSE 1203371B286 Size 8.5,FBALYB Amazon,3,1,2,0,2,0
,Brooks W'S REVEL 4 ALMOND/METALLIC/PRIMROSE 1203371B286 Size 9,Brooks W'S REVEL 4 ALMOND/METALLIC/PRIMROSE 1203371B286 Size 9,FBALYB Amazon,-1,-2,1,0,1,0
,Brooks W'S REVEL 4 ALMOND/METALLIC/PRIMROSE 1203371B286 Size 9.5,Brooks W'S REVEL 4 ALMOND/METALLIC/PRIMROSE 1203371B286 Size 9.5,FBALYB Amazon,-1,-1,0,0,0,0
,Brooks W'S REVEL 4 BLACK/OYSTER/SILVER 1203371B063 Size 10,Brooks W'S REVEL 4 BLACK/OYSTER/SILVER 1203371B063 Size 10,FBALYB Amazon,-2,-2,0,0,0,0
,Brooks W'S REVEL 4 BLACK/OYSTER/SILVER 1203371B063 Size 6,Brooks W'S REVEL 4 BLACK/OYSTER/SILVER 1203371B063 Size 6,Default Ridgefield,1,1,0,0,0,0
,Brooks W'S REVEL 4 BLACK/OYSTER/SILVER 1203371B063 Size 6,Brooks W'S REVEL 4 BLACK/OYSTER/SILVER 1203371B063 Size 6,FBALYB Amazon,8,8,0,0,0,0
,Brooks W'S REVEL 4 BLACK/OYSTER/SILVER 1203371B063 Size 6.5,Brooks W'S REVEL 4 BLACK/OYSTER/SILVER 1203371B063 Size 6.5,FBALYB Amazon,-2,-2,0,0,0,0
,Brooks W'S REVEL 4 BLACK/OYSTER/SILVER 1203371B063 Size 7,Brooks W'S REVEL 4 BLACK/OYSTER/SILVER 1203371B063 Size 7,Default Ridgefield,1,1,0,0,0,0
,Brooks W'S REVEL 4 BLACK/OYSTER/SILVER 1203371B063 Size 7,Brooks W'S REVEL 4 BLACK/OYSTER/SILVER 1203371B063 Size 7,FBALYB Amazon,-4,-4,0,0,0,0
,Brooks W'S REVEL 4 BLACK/OYSTER/SILVER 1203371B063 Size 7.5,Brooks W'S REVEL 4 BLACK/OYSTER/SILVER 1203371B063 Size 7.5,FBALYB Amazon,-4,-4,0,0,0,0
,Brooks W'S REVEL 4 BLACK/OYSTER/SILVER 1203371B063 Size 8,Brooks W'S REVEL 4 BLACK/OYSTER/SILVER 1203371B063 Size 8,FBALYB Amazon,-3,-3,0,0,0,0
,Brooks W'S REVEL 4 BLACK/OYSTER/SILVER 1203371B063 Size 8.5,Brooks W'S REVEL 4 BLACK/OYSTER/SILVER 1203371B063 Size 8.5,FBALYB Amazon,-5,-5,0,0,0,0
,Brooks W'S REVEL 4 BLACK/OYSTER/SILVER 1203371B063 Size 9,Brooks W'S REVEL 4 BLACK/OYSTER/SILVER 1203371B063 Size 9,FBALYB Amazon,-6,-6,0,0,0,0
,Bryte Lamp Oil with Funnel,Bryte Lamp Oil with Funnel,Default,0,0,0,0,0,200
,Bryte Lamp Oil with Funnel,Bryte Lamp Oil with Funnel,Default Ridgefield,198,198,0,0,0,0
,Bryte Lamp Oil with Funnel,Bryte Lamp Oil with Funnel,FBALYB Amazon,-1,-1,0,0,0,0
,BT-PLVJ-VUGS,"Fuji 35mm QuickSnap Single Use Camera, 400 ASA (FUJ7033661) Category: Single ...",FBALYB Amazon,-1,-1,0,0,0,0
,Buckleys Cough and Congestion 200 ml 2pk,Buckleys Cough and Congestion 200 ml 2pk,FBALYB Amazon,-7,-7,0,8,0,0
,Buckleys Cough and Congestion 200 ml (Half how it comes),Buckleys Cough and Congestion 200 ml (Half how it comes),Avrami - Ebay,520,520,0,0,0,0
,Buckleys Cough and Congestion 200 ml (Half how it comes),Buckleys Cough and Congestion 200 ml (Half how it comes),FBALYB Amazon,-36,-36,0,25,0,0
,Bucky Brakedust Car,Disney Pixar Cars Toon Car ‑ Mater The Greater Bucky Brakedust,FBALYB Amazon,1,1,0,0,0,0
,Buddy Biscuit 6oz 3pk bundle beef/bacon/chicken,Buddy Biscuit 6oz 3pk bundle beef/bacon/chicken,FBALYB Amazon,72,72,0,0,0,0
,Buddy Biscuit 6oz 4pk bundle,Buddy Biscuit 6oz 4pk bundle,FBALYB Amazon,-2,-2,0,0,0,0
,Buddy's Best 16oz Coconut Vanilla and Ripe Melon,Buddy's Best 16oz Coconut Vanilla and Ripe Melon ,FBALYB Amazon,55,55,0,0,0,0
,Buddy's Best 16oz Shampoo Conditioner OG Coconut Vanilla,Buddy's Best 16oz Shampoo Conditioner OG Coconut Vanilla,Default Oxford,4,4,0,0,0,0
,Buddy's Best 16oz Shampoo Conditioner OG Coconut Vanilla,Buddy's Best 16oz Shampoo Conditioner OG Coconut Vanilla,Default Ridgefield,1,1,0,0,0,0
,Buddy's Best 16oz Shampoo Conditioner OG Coconut Vanilla,Buddy's Best 16oz Shampoo Conditioner OG Coconut Vanilla,FBALYB Amazon,281,281,0,58,0,0
,Buddy's Best 32 oz Coconut Vanilla WITH PUMP,Buddy's Best 32 oz Coconut Vanilla WITH PUMP,FBALYB Amazon,206,206,0,9,0,0
,Buddy's Best All in One Dog Shampoo 1 Gal,Buddy's Best All in One Dog Shampoo 1 Gal,FBALYB Amazon,13,13,0,1,0,0
,Buddy's Best Coconut Vanilla 32 oz Shampoo,Buddy's Best Coconut Vanilla 32 oz Shampoo,Default,0,-613,613,0,0,0
,Buddy's Best Coconut Vanilla 32 oz Shampoo,Buddy's Best Coconut Vanilla 32 oz Shampoo,Default Ridgefield,269,269,0,0,0,0
,Buddy's Best Coconut Vanilla 32 oz Shampoo,Buddy's Best Coconut Vanilla 32 oz Shampoo,FBALYB Amazon,10,3,7,2,7,0
,Buddy's Best Ear Cleaner 8oz,Buddy's Best Ear Cleaner 8oz ,FBALYB Amazon,187,187,0,1,0,0
,Buddy's Best Hemp Oil for Dogs 2pk, Buddy's Best Hemp Oil for Dogs 2pk,FBALYB Amazon,4,4,0,0,0,0
,Buddys Best Odor Eradicator,Buddys Best Odor Eradicator,Default Ridgefield,6,6,0,0,0,0
,Buddys Best Odor Eradicator,Buddys Best Odor Eradicator,FBALYB Amazon,334,327,7,0,7,0
,BUDDY'S BEST Repellent Shampoo 16oz,BUDDY'S BEST Repellent Shampoo 16oz,Default Ridgefield,526,526,0,0,0,0
,Buddy's Best Ripe Melon 16oz,Buddy's Best Ripe Melon 16oz,FBALYB Amazon,87,87,0,62,0,0
,Buddy's Best Ripe Melon Dog Shampoo 32 oz,Buddy's Best Ripe Melon Dog Shampoo 32 oz,Default Ridgefield,216,216,0,0,0,0
,Buddy's Best Ripe Melon Dog Shampoo 32 oz,Buddy's Best Ripe Melon Dog Shampoo 32 oz,FBALYB Amazon,156,151,5,0,5,0
,Buddy's Best Salmon Oil 32 oz with Pump,Buddy's Best Salmon Oil 32 oz with Pump,Default,0,-8,8,0,0,0
,Buddy's Best Salmon Oil 32 oz with Pump,Buddy's Best Salmon Oil 32 oz with Pump,Default Ridgefield,2,2,0,0,0,0
,Buddy's Best Salmon Oil 32 oz with Pump,Buddy's Best Salmon Oil 32 oz with Pump,FBALYB Amazon,116,110,6,0,6,0
,Buddy's Best Water Additive 16oz,Buddy's Best Water Additive 16oz,Default Ridgefield,144,144,0,0,0,0
,Buddy's Best Water Additive 16oz,Buddy's Best Water Additive 16oz,FBALYB Amazon,-9,-9,0,12,0,0
,Buddy's Best Water Additive 32oz,Buddy's Best Water Additive 32oz,FBALYB Amazon,113,111,2,1,2,0
,"BUGOUT, AXIS, DROP POINT","BUGOUT, AXIS, DROP POINT 535",Default Ridgefield,3,3,0,0,0,0
,"BUGOUT, AXIS, DROP POINT","BUGOUT, AXIS, DROP POINT 535",FBALYB Amazon,-42,-50,8,2,8,0
,"BUGOUT, AXIS, DROP POINT 535GRY 1","BUGOUT, AXIS, DROP POINT 535GRY 1",Default,0,-5,5,0,0,0
,"BUGOUT, AXIS, DROP POINT 535GRY 1","BUGOUT, AXIS, DROP POINT 535GRY 1",Default Ridgefield,1,1,0,0,0,0
,"BUGOUT, AXIS, DROP POINT 535GRY 1","BUGOUT, AXIS, DROP POINT 535GRY 1",FBALYB Amazon,-16,-34,18,2,18,0
,"BUGOUT, AXIS, DROP POINT-B535S","BUGOUT, AXIS, DROP POINT-B535S",Default Ridgefield,40,40,0,0,0,0
,"BUGOUT, AXIS, DROP POINT-B535S","BUGOUT, AXIS, DROP POINT-B535S",FBALYB Amazon,23,21,2,0,2,0
,"Bully Rings Dog Treats, 4.5"" D, Pack of 3 Treats","Bully Rings Dog Treats, 4.5"" D, Pack of 3 Treats",FBALYB Amazon,-1,-1,0,1,0,0
,Bumble Bee Red Salmon 4 Pack,Bumble Bee Red Salmon 4 Pack,FBALYB Amazon,1,1,0,0,0,0
,Bumble & Bumble Bb Texture 150ml,Bumble & Bumble Bb Texture 150ml,Default Ridgefield,192,192,0,0,0,0
,Bumble & Bumble Bb Texture 150ml,Bumble & Bumble Bb Texture 150ml,FBALYB Amazon,2,1,1,0,1,0
,Bumble & Bumble Color Stick Brown 3.5g,Bumble & Bumble Color Stick Brown 3.5g,FBALYB Amazon,-1,-1,0,0,0,0
,Bumble & Bumble Curl Anti-Humidity Gel-Oil 200ml,Bumble & Bumble Curl Anti-Humidity Gel-Oil 200ml,FBALYB Amazon,0,0,0,74,0,0
,Bumble & Bumble Curl Conditioner 200ml,Bumble & Bumble Curl Conditioner 200ml,Default Ridgefield,1,1,0,0,0,0
,Bumble & Bumble Curl Conditioner 200ml,Bumble & Bumble Curl Conditioner 200ml,FBALYB Amazon,101,100,1,1,1,0
,Bumble & Bumble Curl Gel-Oil 150ml,Bumble & Bumble Curl Gel-Oil 150ml,FBALYB Amazon,-77,-77,0,0,0,0
,Bumble & Bumble Curl Primer,Bumble & Bumble Curl Primer 250ml,FBALYB Amazon,-7,-7,0,0,0,0
,Bumble & Bumble Curl Shampoo 250ml,Bumble & Bumble Curl Shampoo 250ml,FBALYB Amazon,87,87,0,0,0,0
,Bumble&Bumble curl shampoo & cond duo,Bumble&Bumble curl shampoo & cond duo,FBALYB Amazon,9,9,0,1,0,0
,Bumble & Bumble Don´t Blow It 150ml,Bumble & Bumble Don´t Blow It 150ml,FBALYB Amazon,-11,-12,1,0,1,0
,Bumble & Bumble Dry Spun Finish 150ml,Bumble & Bumble Dry Spun Finish 150ml,FBALYB Amazon,13,13,0,2,0,0
,Bumble & Bumble Gentle Shampoo 250ml,Bumble & Bumble Gentle Shampoo 250ml,Default Ridgefield,1,1,0,0,0,0
,Bumble & Bumble Gentle Shampoo 250ml,Bumble & Bumble Gentle Shampoo 250ml,FBALYB Amazon,-1,-1,0,0,0,0
,Bumble & Bumble Gentle Shampoo & Super Rich Conditioner 250ml,Bumble & Bumble Gentle Shampoo & Super Rich Conditioner 250ml,FBALYB Amazon,-58,-67,9,74,9,0
,Bumble & Bumble Grooming Creme 150ml,Bumble & Bumble Grooming Creme 150ml,Avrami - Ebay,22,22,0,0,0,0
,Bumble & Bumble Grooming Creme 150ml,Bumble & Bumble Grooming Creme 150ml,FBALYB Amazon,-33,-33,0,1,0,0
,Bumble & Bumble Grooming Creme 150ml,Bumble & Bumble Grooming Creme 150ml,FBALYB Dubai,32,32,0,0,0,0
,Bumble & Bumble Grooming Creme 150ml,Bumble & Bumble Grooming Creme 150ml,WFS,-18,-18,0,0,0,0
,Bumble & Bumble Hairdressers Invisible Oil 100ml,Bumble & Bumble Hairdressers Invisible Oil 100ml,FBALYB Amazon,-2,-4,2,0,2,0
,Bumble & Bumble Hairdressers Invisible Oil Foundation Spray 250ml,Bumble & Bumble Hairdressers Invisible Oil Foundation Spray 250ml,FBALYB Amazon,-16,-17,1,0,1,0
,Bumble & Bumble Hairdressers Invisible Oil Heat Protecting Primer 60ml,Bumble & Bumble Hairdressers Invisible Oil Heat Protecting Primer 60ml,FBALYB Amazon,112,112,0,10,0,0
,Bumble & Bumble Prep Classic 250ml,Bumble & Bumble Prep Classic 250ml,FBALYB Amazon,285,285,0,0,0,0
,Bumble & Bumble Pret a Powder Nour. Dry Shampoo 150ml,Bumble & Bumble Pret a Powder Nour. Dry Shampoo 150ml,Default Ridgefield,287,287,0,0,0,0
,Bumble & Bumble Pret a Powder Nour. Dry Shampoo 150ml,Bumble & Bumble Pret a Powder Nour. Dry Shampoo 150ml,FBALYB Amazon,4,4,0,0,0,0
,Bumble & Bumble Pret a Powder Tres Invisible 150ml,Bumble & Bumble Pret a Powder Tres Invisible 150ml,Default Ridgefield,139,139,0,0,0,0
,Bumble & Bumble Pret a Powder Tres Invisible 150ml,Bumble & Bumble Pret a Powder Tres Invisible 150ml,FBALYB Amazon,73,70,3,0,3,0
,Bumble & Bumble Quenching Conditioner & Quenching Shampoo 250ml,Bumble & Bumble Quenching Conditioner & Quenching Shampoo 250ml,FBALYB Amazon,2,2,0,0,0,0
,Bumble & Bumble Save The Daytime Protective 95ml,Bumble & Bumble Save The Daytime Protective 95ml,Default Ridgefield,219,219,0,0,0,0
,Bumble & Bumble Save The Daytime Protective 95ml,Bumble & Bumble Save The Daytime Protective 95ml,FBALYB Amazon,159,155,4,3,4,0
,Bumble & Bumble Seaweed Conditioner & Seaweed Shampoo 250ml,Bumble & Bumble Seaweed Conditioner & Seaweed Shampoo 250ml,FBALYB Amazon,7,7,0,0,0,0
,Bumble & Bumble Seaweed Shampoo 250ml,Bumble & Bumble Seaweed Shampoo 250ml,FBALYB Amazon,-1,-1,0,72,0,0
,Bumble & Bumble Spray De Mode 300ml,Bumble & Bumble Spray De Mode 300ml,Default Ridgefield,30,30,0,0,0,0
,Bumble & Bumble Spray De Mode 300ml,Bumble & Bumble Spray De Mode 300ml,FBALYB Amazon,77,66,11,25,11,0
,Bumble & Bumble Sumo Tech 50ml,Bumble & Bumble Sumo Tech 50ml,FBALYB Amazon,-6,-6,0,365,0,0
,Bumble & Bumble Sunday Shampoo 250ml,Bumble & Bumble Sunday Shampoo 250ml,FBALYB Amazon,303,298,5,0,5,0
,Bumble & Bumble Super Rich Conditioner 250ml,Bumble & Bumble Super Rich Conditioner 250ml,FBALYB Amazon,2,2,0,48,0,0
,Bumble & Bumble Surf Spray 125ml,Bumble & Bumble Surf Spray 125ml,Default Ridgefield,216,216,0,0,0,0
,Bumble & Bumble Surf Spray 125ml,Bumble & Bumble Surf Spray 125ml,FBALYB Amazon,56,48,8,1,8,0
,Bumble & Bumble Thickening Conditioner 250ml,Bumble & Bumble Thickening Conditioner 250ml,FBALYB Amazon,-8,-19,11,4,11,0
,Bumble & Bumble Thickening Crème Contour 47ml,Bumble & Bumble Thickening Crème Contour 47ml,FBALYB Amazon,-2,-2,0,96,0,0
,Bumble & Bumble Thickening Dryspun hairspray 150ml,Bumble & Bumble Thickening Dryspun hairspray 150ml,Default Ridgefield,3,3,0,0,0,0
,Bumble & Bumble Thickening Dryspun hairspray 150ml,Bumble & Bumble Thickening Dryspun hairspray 150ml,FBALYB Amazon,312,311,1,0,1,0
,Bumble & Bumble Thickening Dryspun hairspray 250 ml,Bumble & Bumble Thickening Dryspun hairspray 250 ml,FBALYB Amazon,9,9,0,0,0,0
,Bumble & Bumble Thickening Dryspun hairspray 250 ml,Bumble & Bumble Thickening Dryspun hairspray 250 ml,WFS,-2,-2,0,0,0,0
,Bumble & Bumble Thickening Hairspray  250ml,Bumble & Bumble Thickening Hairspray  250ml,Default Ridgefield,686,686,0,0,0,0
,Bumble & Bumble Thickening Hairspray  250ml,Bumble & Bumble Thickening Hairspray  250ml,FBALYB Amazon,1,1,0,0,0,0
,Bumble & Bumble Thickening Shampoo  250ml,Bumble & Bumble Thickening Shampoo  250ml,FBALYB Amazon,7,7,0,0,0,0
,Bumble & Bumble Tonic Lotion 250ml,Bumble & Bumble Tonic Lotion 250ml,FBALYB Amazon,-7,-7,0,1,0,0
,Bunch O Balloons 100 Rapid-Filling Self-Sealing Water Balloons,Bunch O Balloons 100 Rapid-Filling Self-Sealing Water Balloons,Default Ridgefield,3,3,0,0,0,0
,Bundle Pack Milk Bone 1 Large & 1 Small,Bundle Pack Milk Bone 1 Large & 1 Small,FBALYB Amazon,-1,-1,0,0,0,0
,Bundstone STYLE #: 1308 PU/TPU - Elastic Sided Dress 11,Bundstone STYLE #: 1308 PU/TPU - Elastic Sided Dress 11,Default Oxford,5,5,0,0,0,0
,Burgoyne 25 All-Occasion Cards with Organizer,Burgoyne 25 All-Occasion Cards with Organizer,FBALYB Amazon,-3,-3,0,0,0,0
,Bushnell Binoculars 10x 42mm,Bushnell Binoculars 10x 42mm,Default Ridgefield,136,136,0,0,0,0
,Bushnell Binoculars 10x 42mm,Bushnell Binoculars 10x 42mm,FBALYB Amazon,33,33,0,0,0,0
,Bustelo 10oz Brick x6,Bustelo 10oz Brick x6,FBALYB Amazon,-1,-1,0,0,0,0
,Cadbury drinking chocolate 250G,Cadbury drinking chocolate 250G,Default Ridgefield,3506,3506,0,0,0,0
,Cadbury drinking chocolate 250G,Cadbury drinking chocolate 250G,FBALYB Amazon,230,210,20,0,20,0
,Cadbury drinking chocolate 250G,Cadbury drinking chocolate 250G,FBALYB Canada,0,0,0,75,0,0
,Cadbury drinking chocolate 250G 2pk,Cadbury drinking chocolate 250G 2pk,FBALYB Amazon,145,144,1,0,1,0
,Cadbury drinking chocolate 250G  6pk,Cadbury drinking chocolate 250G  6pk,FBALYB Amazon,74,74,0,0,0,0
,Cadbury drinking chocolate 250G  6pk,Cadbury drinking chocolate 250G  6pk,FBALYB Canada,0,0,0,10,0,0
,Cadbury Drinking Chocolate 2pk,Cadbury Drinking Chocolate 2pk,FBALYB Amazon,729,673,56,0,56,0
,Cadbury Drinking Chocolate 3pk,Cadbury Drinking Chocolate 3pk,FBALYB Amazon,190,187,3,1,3,0
,Cadbury Hot Chocolate Cocoa Powder 500G,Cadbury Hot Chocolate Cocoa Powder 500G,Default,0,-902,902,0,0,0
,Cadbury Hot Chocolate Cocoa Powder 500G,Cadbury Hot Chocolate Cocoa Powder 500G,Default Ridgefield,7061,7061,0,0,0,0
,Cadbury Hot Chocolate Cocoa Powder 500G,Cadbury Hot Chocolate Cocoa Powder 500G,FBALYB Amazon,808,786,22,5,22,0
,Cafe escapes cafe caramel,Cafe Escapes Cafe Caramel K-Cups 1 Box (12 K-Cups),FBALYB Amazon,2,2,0,0,0,0
,Cafe Escapes Milk Chocolate Hot Cocoa 24ct K Cups,Cafe Escapes Milk Chocolate Hot Cocoa 24ct K Cups,Default,0,0,0,0,0,120
,Callebut Chocolate Dark,Callebut Chocolate Dark,Default,0,0,0,0,0,1
,Callebut Chocolate Dark,Callebut Chocolate Dark,FBALYB Amazon,-3,-3,0,8,0,0
,Callebut Chocolate Milk,Callebut Chocolate Milk,FBALYB Amazon,1,1,0,0,0,0
,Callebut Chocolate White,Callebut Chocolate White,FBALYB Amazon,-4,-4,0,4,0,0
,Calphalon 12-pc Cutlery Set,Calphalon 12-pc Cutlery Set,FBALYB Amazon,2,2,0,0,0,0
,Calphalon Classic Knives 016853062720,Calphalon Classic Self-Sharpening 15-pc. Cutlery Knife Block Set,Default,1,1,0,0,0,0
,Calphalon Classic Knives 016853062720,Calphalon Classic Self-Sharpening 15-pc. Cutlery Knife Block Set,FBALYB Amazon,-1,-1,0,0,0,0
,Calphalon Contemp Nostick 11-Pc,Calphalon Contemp Nostick 11-Pc,FBALYB Amazon,-1,-1,0,0,0,0
,Calphalon Contemporary 20pc,Calphalon Contemporary Sharp 20pc,FBALYB Amazon,1,1,0,0,0,0
,Calvin Klein 3430 tinted,"Calvin Klein Jeans Mens Dark Tinted, 34x30 Straight Leg",FBALYB Amazon,-3,-3,0,0,0,0
,Calvin Klein Jeans 402 Dam Blue 30*32 item 1144231 Straight Leg,Calvin Klein Jeans 402 Dam Blue 30*32 item 1144231 Straight Leg,Default Ridgefield,16,16,0,0,0,0
,Calvin Klein Jeans 402 Dam Blue 34*32 item 1144231 Straight Leg,Calvin Klein Jeans 402 Dam Blue 34*32 item 1144231 Straight Leg,Default Ridgefield,20,20,0,0,0,0
,Calvin Klein Jeans 402 Dam Blue 36*30 item 1144231 Straight Leg,Calvin Klein Jeans 402 Dam Blue 36*30 item 1144231 Straight Leg,Default Ridgefield,22,22,0,0,0,0
,Calvin Klein Jeans 402 Dam Blue 36*34 item 1144231 Straight Leg,Calvin Klein Jeans 402 Dam Blue 36*34 item 1144231 Straight Leg,Default Ridgefield,40,40,0,0,0,0
,Calvin Klein Jeans 402 Dam Blue 38*32 item 1144231 Straight Leg,Calvin Klein Jeans 402 Dam Blue 38*32 item 1144231 Straight Leg,Default Ridgefield,19,19,0,0,0,0
,Calvin Klein Jeans Straight led 32*34 Item 1144231 COlor 843 metal,Calvin Klein Jeans Straight led 32*34 Item 1144231 COlor 843 metal,Default Ridgefield,1,1,0,0,0,0
,Calvin Klein Jeans Straight led 34*34 Item 1144231 COlor 402 Dark Blue,Calvin Klein Jeans Straight led 34*34 Item 1144231 COlor 402 Dark Blue,Default Ridgefield,21,21,0,0,0,0
,Calvin Klein Jeans Straight led 36*32 Item 1144231 COlor 402 Dark Blue,Calvin Klein Jeans Straight led 36*32 Item 1144231 COlor 402 Dark Blue,Default Ridgefield,19,19,0,0,0,0
,Calvin Klein Jeans Straight led 36*34 Item 1144231 COlor 843 metal,Calvin Klein Jeans Straight led 36*34 Item 1144231 COlor 843 metal,Default Ridgefield,20,20,0,0,0,0
,Calvin Klein Jeans Straight led 38*30 Item 1144231 COlor 402 Dark Blue,Calvin Klein Jeans Straight led 38*30 Item 1144231 COlor 402 Dark Blue,Default Ridgefield,9,9,0,0,0,0
,Calvin Klein Jeans Straight led 40*32 Item 1144231 COlor 843 metal,Calvin Klein Jeans Straight led 40*32 Item 1144231 COlor 843 metal,Default Ridgefield,9,9,0,0,0,0
,Calvin Klein Jeans Straight leg 34*32 Item 1144231 COlor 843 metal,Calvin Klein Jeans Straight leg 34*32 Item 1144231 COlor 843 metal,Default Ridgefield,33,33,0,0,0,0
,Calvin Klein Jeans Straight leg 34*34 Item 1144231 COlor 843 metal,Calvin Klein Jeans Straight leg 34*34 Item 1144231 COlor 843 metal,Default Ridgefield,21,21,0,0,0,0
,Calvin Klein Jeans Straight leg 36*30 Item 1144231 COlor 843 metal,Calvin Klein Jeans Straight leg 36*30 Item 1144231 COlor 843 metal,Default Ridgefield,8,8,0,0,0,0
,Calvin Klein Jeans straight leg 36*32 Item 1144231 COlor 402 Dark Blue,Calvin Klein Jeans straight leg 36*32 Item 1144231 COlor 402 Dark Blue,Default Ridgefield,30,30,0,0,0,0
,Calvin Klein Jeans Straight leg 36*32 Item 1144231 COlor 843 metal,Calvin Klein Jeans Straight leg 36*32 Item 1144231 COlor 843 metal,Default Ridgefield,30,30,0,0,0,0
,Calvin Klein Jeans Straight leg 36*34 Item 1144231 COlor 843 metal,Calvin Klein Jeans Straight leg 36*34 Item 1144231 COlor 843 metal,Default Ridgefield,21,21,0,0,0,0
,Calvin Klein Jeans Straight leg 38*30 Item 1144231 COlor 843 metal,Calvin Klein Jeans Straight leg 38*30 Item 1144231 COlor 843 metal,Default Ridgefield,1,1,0,0,0,0
,Calvin Klein Jeans Straight leg 38*32 Item 1144231 COlor 843 metal,Calvin Klein Jeans Straight leg 38*32 Item 1144231 COlor 843 metal,Default Ridgefield,10,10,0,0,0,0
,Calvin Klein Jeans Straight leg 40*30 Item 1144231 COlor 402 Dark Blue,Calvin Klein Jeans Straight leg 40*30 Item 1144231 COlor 402 Dark Blue,Default Ridgefield,20,20,0,0,0,0
,Calvin Klein Jeans Straight leg 40*32 Item 1144231 COlor 402 Dark Blue,Calvin Klein Jeans Straight leg 40*32 Item 1144231 COlor 402 Dark Blue,Default Ridgefield,46,46,0,0,0,0
,Calvin Klein Jeans Straight leg 40*32 Item 1144231 COlor 843 metal,Calvin Klein Jeans Straight leg 40*32 Item 1144231 COlor 843 metal,Default Ridgefield,20,20,0,0,0,0
,Calvin Klein Men's Straight Leg Jeans Code: 41FO314 485 Osaka Blue Size 30 x 32,Calvin Klein Men's Straight Leg Jeans Code: 41FO314 485 Osaka Blue Size 30 x 32,Default Ridgefield,1,1,0,0,0,0
,Calvin Klein Men's Straight Leg Jeans Code: 41FO314 485 Osaka Blue Size 32 x 30,Calvin Klein Men's Straight Leg Jeans Code: 41FO314 485 Osaka Blue Size 32 x 30,Default Ridgefield,15,15,0,0,0,0
,Calvin Klein Men's Straight Leg Jeans Code: 41FO314 485 Osaka Blue Size 32 x 32,Calvin Klein Men's Straight Leg Jeans Code: 41FO314 485 Osaka Blue Size 32 x 32,Default Ridgefield,1,1,0,0,0,0
,Calvin Klein Men's Straight Leg Jeans Code: 41FO314 485 Osaka Blue Size 32 x 34,Calvin Klein Men's Straight Leg Jeans Code: 41FO314 485 Osaka Blue Size 32 x 34,Default Ridgefield,1,1,0,0,0,0
,Calvin Klein Men's Straight Leg Jeans Code: 41FO314 485 Osaka Blue Size 34 x 30,Calvin Klein Men's Straight Leg Jeans Code: 41FO314 485 Osaka Blue Size 34 x 30,Default Ridgefield,22,22,0,0,0,0
,Calvin Klein Men's Straight Leg Jeans Code: 41FO314 485 Osaka Blue Size 36 x 30,Calvin Klein Men's Straight Leg Jeans Code: 41FO314 485 Osaka Blue Size 36 x 30,Default Ridgefield,8,8,0,0,0,0
,Calvin Klein Men's Straight Leg Jeans Code: 41FO314 485 Osaka Blue Size 40 x 30,Calvin Klein Men's Straight Leg Jeans Code: 41FO314 485 Osaka Blue Size 40 x 30,Default Ridgefield,2,2,0,0,0,0
,Calvin Klein Men's Straight Leg Jeans Code: 41FO315 813 Axe Grey Size 32 x 30,Calvin Klein Men's Straight Leg Jeans Code: 41FO315 813 Axe Grey Size 32 x 30,Default Ridgefield,7,7,0,0,0,0
,Calvin Klein Men's Straight Leg Jeans Code: 41FO315 813 Axe Grey Size 32 x 32,Calvin Klein Men's Straight Leg Jeans Code: 41FO315 813 Axe Grey Size 32 x 32,Default Ridgefield,7,7,0,0,0,0
,Calvin Klein Men's Straight Leg Jeans Code: 41FO315 813 Axe Grey Size 32 x 34,Calvin Klein Men's Straight Leg Jeans Code: 41FO315 813 Axe Grey Size 32 x 34,Default Ridgefield,2,2,0,0,0,0
,Calvin Klein Men's Straight Leg Jeans Code: 41FO315 813 Axe Grey Size 34 x 30,Calvin Klein Men's Straight Leg Jeans Code: 41FO315 813 Axe Grey Size 34 x 30,Default Ridgefield,12,12,0,0,0,0
,Calvin Klein t-shirt 3 pack large,"Calvin Klein Mens Crew Neck Tee 3-Pack-Assorted, Large",FBALYB Amazon,-1,-1,0,0,0,0
,Calvin Klein V Neck T Shirt Black Small 4 Count,Calvin Klein V Neck T Shirt Black Small 4 Count,Default Ridgefield,33,33,0,0,0,0
,Calvin Klein V Neck T Shirt White Small 4 Count,Calvin Klein V Neck T Shirt White Small 4 Count,Default Ridgefield,85,85,0,0,0,0
,Calvin Klein Women's 3 Pack,Calvin Klein Women's 3 Pack Carousel Bikini Panty Medium 1039567,Default,0,-100,100,0,0,12
,Calvin Klein Women's 3 Pack,Calvin Klein Women's 3 Pack Carousel Bikini Panty Medium 1039567,Default Ridgefield,36,36,0,0,0,0
,Calvin Klein Women's Carousel Bikini Panty - SMALL,Calvin Klein Women's Carousel Bikini Panty - SMALL,Default Ridgefield,3,3,0,0,0,0
,Calvin Klein Womens grey sweater Large,Calvin Klein Jeans Ladies Long Cardigan,FBALYB Amazon,-2,-2,0,0,0,0
,Calvin Klein women's grey sweater XL,"Calvin Klein Jeans Ladies Long Cardigan (Grey, XL)",FBALYB Amazon,-1,-1,0,0,0,0
,Calvin Klein Womens grey sweater XXL,"Calvin Klein Jeans Ladies Long Cardigan (Grey, XXL)",FBALYB Amazon,-1,-1,0,0,0,0
,Camelback Clssc Lght 70oz Almnm/Blk,"Camelback Classic Light 70oz, Aluminum/Black UNISEX",Default,0,0,0,0,0,256
,Camelback Clssc Lght 70oz Almnm/Blk,"Camelback Classic Light 70oz, Aluminum/Black UNISEX",Default Ridgefield,106,106,0,0,0,0
,Camelback Clssc Lght 70oz Almnm/Blk,"Camelback Classic Light 70oz, Aluminum/Black UNISEX",FBALYB Amazon,147,146,1,0,1,0
,Camelback Clssc Lght 70oz Gnmtl/Hyd,"Camelback Classic Light 70oz, Gunmetal/Hydro UNISEX",Default,0,0,0,0,0,896
,Camelback Clssc Lght 70oz Gnmtl/Hyd,"Camelback Classic Light 70oz, Gunmetal/Hydro UNISEX",Default Ridgefield,496,496,0,0,0,0
,Camelback Clssc Lght 70oz Gnmtl/Hyd,"Camelback Classic Light 70oz, Gunmetal/Hydro UNISEX",FBALYB Amazon,394,394,0,0,0,0
,Camelback Clssc Lght 70oz GNvy/Blk,"Camelback Classic Light 70oz, Gibraltar Navy/Black UNISEX",Default,0,0,0,0,0,352
,Camelback Clssc Lght 70oz GNvy/Blk,"Camelback Classic Light 70oz, Gibraltar Navy/Black UNISEX",Default Ridgefield,202,202,0,0,0,0
,Camelback Clssc Lght 70oz GNvy/Blk,"Camelback Classic Light 70oz, Gibraltar Navy/Black UNISEX",FBALYB Amazon,149,149,0,0,0,0
,Camelback Clssc Lght 70oz SYlw/Slvr,"Camelback Classic Light 70oz, Safety Yellow/Silver UNISEX",Default,0,0,0,0,0,384
,Camelback Clssc Lght 70oz SYlw/Slvr,"Camelback Classic Light 70oz, Safety Yellow/Silver UNISEX",Default Ridgefield,235,235,0,0,0,0
,Camelback Clssc Lght 70oz SYlw/Slvr,"Camelback Classic Light 70oz, Safety Yellow/Silver UNISEX",FBALYB Amazon,138,138,0,0,0,0
,Camelback Crcit Vst 50oz AqSea/Slvr,Camelback Women's Circuit Vest 50oz Aqua Sea/ Silver,Default,0,0,0,0,0,270
,Camelback Crcit Vst 50oz AqSea/Slvr,Camelback Women's Circuit Vest 50oz Aqua Sea/ Silver,Default Ridgefield,120,120,0,0,0,0
,Camelback Crcit Vst 50oz AqSea/Slvr,Camelback Women's Circuit Vest 50oz Aqua Sea/ Silver,FBALYB Amazon,125,123,2,0,2,0
,Camelback Crcit Vst 50oz GNvy/Slvr,Camelback Women's Circuit Vest 50oz Gibraltar Navy/Silver,Default,0,0,0,0,0,90
,Camelback Crcit Vst 50oz GNvy/Slvr,Camelback Women's Circuit Vest 50oz Gibraltar Navy/Silver,Default Ridgefield,2,2,0,0,0,0
,Camelback Crcit Vst 50oz GNvy/Slvr,Camelback Women's Circuit Vest 50oz Gibraltar Navy/Silver,FBALYB Amazon,76,73,3,0,3,0
,"CamelBack Crux 2L Reservoir, Blue","CamelBack Crux 2L Reservoir, Blue",Default,0,-1,1,0,0,0
,"CamelBack Crux 2L Reservoir, Blue","CamelBack Crux 2L Reservoir, Blue",Default Oxford,115,115,0,0,0,0
,"CamelBack Crux 2L Reservoir, Blue","CamelBack Crux 2L Reservoir, Blue",FBALYB Amazon,1049,1049,0,42,0,0
,"CamelBack Crux 2L Reservoir, Blue","CamelBack Crux 2L Reservoir, Blue",FBALYB Canada,8,7,1,0,1,0
,"CamelBack Crux 3L Reservoir, Blue","CamelBack Crux 3L Reservoir, Blue",Default Oxford,61,61,0,0,0,0
,"CamelBack Crux 3L Reservoir, Blue","CamelBack Crux 3L Reservoir, Blue",FBAFBA LYB AUSTRALIA,0,0,0,50,0,0
,"CamelBack Crux 3L Reservoir, Blue","CamelBack Crux 3L Reservoir, Blue",FBALYB Amazon,1152,1140,12,0,12,0
,"CamelBack Crux 3L Reservoir, Blue","CamelBack Crux 3L Reservoir, Blue",FBALYB Canada,14,14,0,0,0,0
,Camelback Hydrbk Lght 50oz Almnm/Bk,Camelback Hydrobak Light 50oz Aluminum/Black UNISEX,Default,0,0,0,0,0,480
,Camelback Hydrbk Lght 50oz Almnm/Bk,Camelback Hydrobak Light 50oz Aluminum/Black UNISEX,Default Ridgefield,130,130,0,0,0,0
,Camelback Hydrbk Lght 50oz Almnm/Bk,Camelback Hydrobak Light 50oz Aluminum/Black UNISEX,FBALYB Amazon,340,340,0,0,0,0
,Camelback HydrbkLght 50oz ATeal/Blk,Camelback Hydrobak Light 50oz Atlantic Teal/Black UNISEX,Default,0,0,0,0,0,200
,Camelback HydrbkLght 50oz ATeal/Blk,Camelback Hydrobak Light 50oz Atlantic Teal/Black UNISEX,Default Ridgefield,50,50,0,0,0,0
,Camelback HydrbkLght 50oz ATeal/Blk,Camelback Hydrobak Light 50oz Atlantic Teal/Black UNISEX,FBALYB Amazon,129,126,3,0,3,0
,Camelback Hydrbk Lght 50oz Blk/Slvr,"Camelback Hydrobak Light 50oz, Black/Silver UNISEX",Default,0,0,0,0,0,40
,Camelback Hydrbk Lght 50oz Blk/Slvr,"Camelback Hydrobak Light 50oz, Black/Silver UNISEX",Default Ridgefield,2,2,0,0,0,0
,Camelback Hydrbk Lght 50oz Blk/Slvr,"Camelback Hydrobak Light 50oz, Black/Silver UNISEX",FBALYB Amazon,5,0,5,0,5,0
,Camelback HydrbkLght 50oz FBrk/Koi,Camelback Hydrobak Light 50oz Fired Brick/Koi UNISEX,Default,0,0,0,0,0,200
,Camelback HydrbkLght 50oz FBrk/Koi,Camelback Hydrobak Light 50oz Fired Brick/Koi UNISEX,Default Ridgefield,52,52,0,0,0,0
,Camelback HydrbkLght 50oz FBrk/Koi,Camelback Hydrobak Light 50oz Fired Brick/Koi UNISEX,FBALYB Amazon,119,117,2,0,2,0
,Camelback Hydrbk Lght 50oz GNvy/Blk,Camelback Hydrobak Light 50oz Gibraltar Navy/Black UNISEX,Default,0,0,0,0,0,720
,Camelback Hydrbk Lght 50oz GNvy/Blk,Camelback Hydrobak Light 50oz Gibraltar Navy/Black UNISEX,Default Ridgefield,320,320,0,0,0,0
,Camelback Hydrbk Lght 50oz GNvy/Blk,Camelback Hydrobak Light 50oz Gibraltar Navy/Black UNISEX,FBALYB Amazon,395,393,2,0,2,0
,Camelback Hydrbk Lgt50oz Brgndy/Svr,Camelback Women's Hydrobak Light 50oz Burgundy/Silver,Default,0,0,0,0,0,320
,Camelback Hydrbk Lgt50oz Brgndy/Svr,Camelback Women's Hydrobak Light 50oz Burgundy/Silver,Default Ridgefield,222,222,0,0,0,0
,Camelback Hydrbk Lgt50oz Brgndy/Svr,Camelback Women's Hydrobak Light 50oz Burgundy/Silver,FBALYB Amazon,97,97,0,0,0,0
,Camelback Hydrbk Lgt 50oz DGry/SCld,Camelback Women's Hydrobak Light 50oz Drizzle Grey/Silver Cloud,Default,0,0,0,0,0,200
,Camelback Hydrbk Lgt 50oz DGry/SCld,Camelback Women's Hydrobak Light 50oz Drizzle Grey/Silver Cloud,Default Ridgefield,50,50,0,0,0,0
,Camelback Hydrbk Lgt 50oz DGry/SCld,Camelback Women's Hydrobak Light 50oz Drizzle Grey/Silver Cloud,FBALYB Amazon,146,146,0,0,0,0
,"CamelBack Lobo, 100 oz., Kelp/Black","CamelBack Lobo, 100 oz., Kelp/Black",FBALYB Amazon,88,84,4,0,4,0
,"CamelBack Lobo, 100 oz., Russet Orange/Camelflage","CamelBack Lobo, 100 oz., Russet Orange/Camelflage",FBALYB Amazon,-1,-1,0,0,0,0
,"CamelBack Mini M.U.L.E., 50 oz Lapis Blue/White Stripe","CamelBack Mini M.U.L.E., 50 oz Lapis Blue/White Stripe",Default Ridgefield,48,48,0,0,0,0
,"CamelBack Mini M.U.L.E., 50 oz Lapis Blue/White Stripe","CamelBack Mini M.U.L.E., 50 oz Lapis Blue/White Stripe",FBALYB Amazon,94,83,11,0,11,0
,"CamelBack Mini M.U.L.E., 50 oz Racing Red Check","CamelBack Mini M.U.L.E., 50 oz Racing Red Check",FBALYB Amazon,27,24,3,0,3,0
,"CamelBack M.U.L.E. 100 oz., Black","CamelBack M.U.L.E. 100 oz., Black",Default Ridgefield,508,508,0,0,0,0
,"CamelBack M.U.L.E. 100 oz., Black","CamelBack M.U.L.E. 100 oz., Black",FBALYB Amazon,429,422,7,0,7,0
,"CamelBack M.U.L.E. 100 oz., Gibraltar Navy","CamelBack M.U.L.E. 100 oz., Gibraltar Navy",Default Ridgefield,4,4,0,0,0,0
,"CamelBack M.U.L.E. 100 oz., Gibraltar Navy","CamelBack M.U.L.E. 100 oz., Gibraltar Navy",FBALYB Amazon,65,60,5,0,5,0
,"CamelBack M.U.L.E. 100 oz., Racing Red/Black","CamelBack M.U.L.E. 100 oz., Racing Red/Black",Default Ridgefield,52,52,0,0,0,0
,"CamelBack M.U.L.E. 100 oz., Racing Red/Black","CamelBack M.U.L.E. 100 oz., Racing Red/Black",FBALYB Amazon,39,36,3,0,3,0
,CamelBack Octane 10 70 oz Black/Atomic Blue,CamelBack Octane 10 70 oz Black/Atomic Blue,Default,0,0,0,0,0,50
,CamelBack Octane 10 70 oz Black/Atomic Blue,CamelBack Octane 10 70 oz Black/Atomic Blue,Default Ridgefield,2,2,0,0,0,0
,CamelBack Octane 10 70 oz Black/Atomic Blue,CamelBack Octane 10 70 oz Black/Atomic Blue,FBALYB Amazon,28,28,0,0,0,0
,CamelBack Octane 10 70 oz Corsair Teal/Sulphur Spring,CamelBack Octane 10 70 oz Corsair Teal/Sulphur Spring,Default,0,0,0,0,0,25
,CamelBack Octane 10 70 oz Corsair Teal/Sulphur Spring,CamelBack Octane 10 70 oz Corsair Teal/Sulphur Spring,Default Ridgefield,2,2,0,0,0,0
,CamelBack Octane 10 70 oz Corsair Teal/Sulphur Spring,CamelBack Octane 10 70 oz Corsair Teal/Sulphur Spring,FBALYB Amazon,11,9,2,0,2,0
,Camelback Octane 50oz Bgndy/HotCral,Camelback Octane Dart 50 oz Burgundy/Hot Coral,Default,0,0,0,0,0,160
,Camelback Octane 50oz Bgndy/HotCral,Camelback Octane Dart 50 oz Burgundy/Hot Coral,Default Ridgefield,35,35,0,0,0,0
,Camelback Octane 50oz Bgndy/HotCral,Camelback Octane Dart 50 oz Burgundy/Hot Coral,FBALYB Amazon,100,100,0,0,0,0
,CamelBack Octane Dart 50 oz Corsair Teal/Sulphur Spring,CamelBack Octane Dart 50 oz Corsair Teal/Sulphur Spring,Default,0,0,0,0,0,40
,CamelBack Octane Dart 50 oz Corsair Teal/Sulphur Spring,CamelBack Octane Dart 50 oz Corsair Teal/Sulphur Spring,Default Ridgefield,2,2,0,0,0,0
,CamelBack Octane Dart 50 oz Corsair Teal/Sulphur Spring,CamelBack Octane Dart 50 oz Corsair Teal/Sulphur Spring,FBALYB Amazon,32,32,0,0,0,0
,CamelBack Octane XCT 70 oz Corsair Teal/Sulphur Spring,CamelBack Octane XCT 70 oz Corsair Teal/Sulphur Spring,Default,0,0,0,0,0,56
,CamelBack Octane XCT 70 oz Corsair Teal/Sulphur Spring,CamelBack Octane XCT 70 oz Corsair Teal/Sulphur Spring,Default Ridgefield,2,2,0,0,0,0
,CamelBack Octane XCT 70 oz Corsair Teal/Sulphur Spring,CamelBack Octane XCT 70 oz Corsair Teal/Sulphur Spring,FBALYB Amazon,50,49,1,0,1,0
,CamelBack Podium Flow Belt 21oz Camelflage/Brown Seal,CamelBack Podium Flow Belt 21oz Camelflage/Brown Seal,FBALYB Amazon,104,104,0,1,0,0
,CamelBack Ratchet 100 oz Racing Red/Silver,CamelBack Ratchet 100 oz Racing Red/Silver,FBALYB Amazon,-1,-1,0,0,0,0
,Camelback Rgue Lght 70oz Almnm/Blk,"Camelback Rogue Light 70oz, Aluminum/Black UNISEX",Default,0,0,0,0,0,160
,Camelback Rgue Lght 70oz Almnm/Blk,"Camelback Rogue Light 70oz, Aluminum/Black UNISEX",Default Ridgefield,35,35,0,0,0,0
,Camelback Rgue Lght 70oz Almnm/Blk,"Camelback Rogue Light 70oz, Aluminum/Black UNISEX",FBALYB Amazon,121,121,0,0,0,0
,Camelback Rgue Lght 70oz Blck/Slvr,Camelback Rogue Light 70oz Black/Silver UNISEX,Default,0,0,0,0,0,992
,Camelback Rgue Lght 70oz Blck/Slvr,Camelback Rogue Light 70oz Black/Silver UNISEX,Default Ridgefield,642,642,0,0,0,0
,Camelback Rgue Lght 70oz Blck/Slvr,Camelback Rogue Light 70oz Black/Silver UNISEX,FBALYB Amazon,301,296,5,0,5,0
,Camelback Rgue Lght 70oz FBrck/Koi,"Camelback Rogue Light 70oz, Fired Brick/Koi UNISEX",Default,0,0,0,0,0,160
,Camelback Rgue Lght 70oz FBrck/Koi,"Camelback Rogue Light 70oz, Fired Brick/Koi UNISEX",Default Ridgefield,35,35,0,0,0,0
,Camelback Rgue Lght 70oz FBrck/Koi,"Camelback Rogue Light 70oz, Fired Brick/Koi UNISEX",FBALYB Amazon,124,124,0,0,0,0
,Camelback Rgue Lght 70oz GNvy/Blk,"Camelback Rogue Light 70oz, Gibraltar Navy/Black UNISEX",Default,0,0,0,0,0,160
,Camelback Rgue Lght 70oz GNvy/Blk,"Camelback Rogue Light 70oz, Gibraltar Navy/Black UNISEX",Default Ridgefield,160,160,0,0,0,0
,Camelback RguLght 70oz Cstlrk/Sfoam,Camelback Women's Rogue Light 70oz Castlerock/Seafoam WOMENS,Default,0,0,0,0,0,160
,Camelback RguLght 70oz Cstlrk/Sfoam,Camelback Women's Rogue Light 70oz Castlerock/Seafoam WOMENS,Default Ridgefield,160,160,0,0,0,0
,CamelBack Women's Chase Bike Vest 50oz Charcoal/Lake Blue,CamelBack Women's Chase Bike Vest 50oz Charcoal/Lake Blue,FBALYB Amazon,-12,-12,0,0,0,0
,Candylocks 7-Inch Lacey Lemonade,Candylocks 7-Inch Lacey Lemonade,Default Ridgefield,200,200,0,0,0,0
,Candylocks 7-Inch Lacey Lemonade,Candylocks 7-Inch Lacey Lemonade,FBALYB Amazon,96,96,0,1,0,0
,Candylocks 7-Inch Straw Mary,Candylocks 7-Inch Straw Mary,Default Ridgefield,299,299,0,0,0,0
,Candylocks 7-Inch Straw Mary,Candylocks 7-Inch Straw Mary,FBALYB Amazon,-5,-5,0,0,0,0
,CandyLocks Basic Doll Assorted-6052229,CandyLocks Basic Doll Assorted-6052229,Default Oxford,6,6,0,0,0,0
,CandyLocks Basic Doll Assorted-6052229,CandyLocks Basic Doll Assorted-6052229,FBALYB Amazon,468,456,12,0,12,0
,CandyLocks Basic Doll Assorted-6052229,CandyLocks Basic Doll Assorted-6052229,FBALYB Canada,6,6,0,0,0,0
,Candylocks Deluxe Doll,,Default Oxford,2,2,0,0,0,0
,Can Mini Mover Bulldozer L&S,Can Mini Mover Bulldozer L&S,FBALYB Amazon,6,6,0,0,0,0
,"Capri Blue, Volcano candle 19 oz, 4 Pack","Capri Blue, Volcano candle 19 oz, 4 Pack",FBALYB Amazon,3,3,0,2,0,0
,Caran Dache Ballpoint pen 849 Brut Rosé in slim pack box,Caran Dache Ballpoint pen 849 Brut Rosé in slim pack box,Default Ridgefield,286,286,0,0,0,0
,Caran Dache Ballpoint pen 849 Brut Rosé in slim pack box,Caran Dache Ballpoint pen 849 Brut Rosé in slim pack box,FBALYB Amazon,-44,-47,3,198,3,0
,Caran Dache Ballpoint pen  black - black cartridge,Caran Dache Ballpoint pen  black - black cartridge,Default Ridgefield,80,80,0,0,0,0
,Caran Dache Ballpoint pen  black - black cartridge,Caran Dache Ballpoint pen  black - black cartridge,FBALYB Amazon,7,4,3,1,3,0
,Caran Dache Ballpoint pen  metal black,Caran Dache Ballpoint pen  metal black,Default Ridgefield,193,193,0,0,0,0
,Caran Dache Ballpoint pen  metal black,Caran Dache Ballpoint pen  metal black,FBALYB Amazon,92,88,4,3,4,0
,Caran Dache Ballpoint pen  metal grey,Caran Dache Ballpoint pen  metal grey  ,FBALYB Amazon,35,35,0,1,0,0
,Caran Dache Ballpoint pen  metal grey,Caran Dache Ballpoint pen  metal grey  ,FBALYB Canada,10,10,0,0,0,0
,Caran Dache Ballpoint pen orange fluo,Caran Dache Ballpoint pen orange fluo,Default Ridgefield,28,28,0,0,0,0
,"Caran Dache black, buttons assorted",Caran Dache Assorted Black Fixpencil 2mm ,Default Ridgefield,40,40,0,0,0,0
,"Caran Dache Fancolor metal box, 40 colour pencils","Caran Dache Fancolor metal box, 40 colour pencils",Default Ridgefield,422,422,0,0,0,0
,"Caran Dache Fancolor metal box, 40 colour pencils","Caran Dache Fancolor metal box, 40 colour pencils",FBALYB Amazon,43,40,3,0,3,0
,Caran Dache fluo yellow,Caran Dache fluo yellow,FBALYB Amazon,20,20,0,63,0,0
,"Caran Dache Gift box Graphite Line, assorted","Caran Dache Gift box Graphite Line, assorted",Default Ridgefield,25,25,0,0,0,0
,"Caran Dache Gouache Studio, 15 pans","Caran Dache Gouache Studio, 15 pans",FBALYB Amazon,-8,-8,0,0,0,0
,"Caran Dache Graphite Line, assort. 15 pencils Grafwood","Caran Dache Graphite Line, assort. 15 pencils Grafwood",FBALYB Amazon,-5,-5,0,1,0,0
,"Caran Dache Luminance 6901, box 40 colour pencils","Caran Dache Luminance 6901, box 40 colour pencils",FBALYB Amazon,-4,-4,0,0,0,0
,"Caran Dache Luminance 6901, box 76 + 2 full blender","Caran Dache Luminance 6901, box 76 + 2 full blender",FBALYB Amazon,-4,-4,0,0,0,0
,Caran Dache Metal box 10 Metallic pastels  ass.,Caran Dache Metal box 10 Metallic pastels  ass.,Default Ridgefield,215,215,0,0,0,0
,Caran Dache Metal box 10 Metallic pastels  ass.,Caran Dache Metal box 10 Metallic pastels  ass.,FBALYB Amazon,79,78,1,0,1,0
,Caran Dache Metal box 10 pastels assorted,Caran Dache Metal box 10 pastels assorted,Default Ridgefield,450,450,0,0,0,0
,Caran Dache Metal box 10 pastels assorted,Caran Dache Metal box 10 pastels assorted,FBALYB Amazon,-7,-7,0,0,0,0
,Caran Dache Metal box 10 pastels assorted,Caran Dache Metal box 10 pastels assorted,WFS,-4,-4,0,0,0,0
,Caran Dache Metal box 15 pastels assorted,Caran Dache Metal box 15 pastels assorted,Default Ridgefield,789,789,0,0,0,0
,Caran Dache Metal box 15 pastels assorted,Caran Dache Metal box 15 pastels assorted,FBALYB Amazon,260,242,18,1,18,0
,Caran Dache Metal box 30 pastels assorted,Caran Dache Metal box 30 pastels assorted,Default Ridgefield,385,385,0,0,0,0
,Caran Dache Metal box 30 pastels assorted,Caran Dache Metal box 30 pastels assorted,FBALYB Amazon,163,159,4,22,4,0
,Caran Dache Metal box 40 pastels assorted,Caran Dache Metal box 40 pastels assorted,Default Ridgefield,280,280,0,0,0,0
,Caran Dache Metal box 40 pastels assorted,Caran Dache Metal box 40 pastels assorted,FBALYB Amazon,86,85,1,50,1,0
,Caran Dache Metal box 84 pastels assorted,Caran Dache Metal box 84 pastels assorted,FBALYB Amazon,197,192,5,0,5,0
,Caran Dache Museum Aquarelle 12 colours,Caran Dache Museum Aquarelle 12 colours,FBALYB Amazon,-1,-1,0,0,0,0
,"Caran Dache Neopastel, box  96 pastels","Caran Dache Neopastel, box  96 pastels",FBALYB Amazon,-1,-1,0,0,0,0
,"Caran Dache Pablo, metal box  120 colour pencils","Caran Dache Pablo, metal box  120 colour pencils",FBALYB Amazon,171,171,0,1,0,0
,"Caran Dache Pablo, metal box  120 colour pencils","Caran Dache Pablo, metal box  120 colour pencils",FBALYB Canada,14,14,0,0,0,0
,"Caran Dache Pablo, metal box  18 colour pencils","Caran Dache Pablo, metal box  18 colour pencils",Default Ridgefield,220,220,0,0,0,0
,"Caran Dache Pablo, metal box  18 colour pencils","Caran Dache Pablo, metal box  18 colour pencils",FBALYB Amazon,11,11,0,0,0,0
,Caran Dache Pencil-sharpening machine metal,Caran Dache Pencil-sharpening machine metal ,Default Ridgefield,10,10,0,0,0,0
,Caran Dache Pencil-sharpening machine metal,Caran Dache Pencil-sharpening machine metal ,FBAFBA LYB AUSTRALIA,0,0,0,5,0,0
,Caran Dache Pencil-sharpening machine metal,Caran Dache Pencil-sharpening machine metal ,FBALYB Amazon,30,30,0,0,0,0
,Caran Dache Pencil-sharpening machine metal,Caran Dache Pencil-sharpening machine metal ,FBALYB Canada,3,3,0,0,0,0
,Caran Dache Plasticbag with 3 brushes with water tank,Caran Dache Plasticbag with 3 brushes with water tank,FBALYB Amazon,44,42,2,1,2,0
,CareFresh Bedding 14L,CareFresh Bedding 14L,Default,0,0,0,0,0,2
,CareFresh Bedding 30L,CareFresh Bedding 30L,Default,0,0,0,0,0,1
,CareFresh Bedding 30L,CareFresh Bedding 30L,Default Ridgefield,9,9,0,0,0,0
,CareFresh Bedding 30L,CareFresh Bedding 30L,FBALYB Amazon,26,26,0,0,0,0
,Carefresh Hamster/Gerbil Food 2lb,Carefresh Hamster/Gerbil Food 2lb,Default,0,0,0,0,0,50
,CareFresh Paper Bedding Small 23L,CareFresh Paper Bedding Small 23L,FBALYB Amazon,0,-1,1,0,1,0
,CareFresh Paper Bedding Small Pets,CareFresh Paper Bedding Small Pets,Default,0,0,0,0,0,1
,CaribSea Liferock Shapes 20 LB,CaribSea Liferock Shapes 20 LB,FBALYB Amazon,-1,-1,0,0,0,0
,Carib Sea Moonlight Sand 5lb,"Carib Sea ACS05820 Super Natural Moonlight Sand for Aquarium, 5-Pound",Default,0,-12,12,0,0,0
,Carib Sea Moonlight Sand 5lb,"Carib Sea ACS05820 Super Natural Moonlight Sand for Aquarium, 5-Pound",FBALYB Amazon,6,6,0,22,0,0
,Carib Sea Moonlight Sand 5lb 2pk,Carib Sea Moonlight Sand 5lb 2pk,FBALYB Amazon,1,1,0,0,0,0
,Caribsea Super Naturals Peace River 5lb,Caribsea Super Naturals Peace River 5lb ,FBALYB Amazon,-1,-1,0,0,0,0
,"Carib Sea Tahitian Moon Sand, 5lb","Carib Sea ACS05821 Tahitian Moon Sand, 5lb",Default Ridgefield,5,5,0,0,0,0
,"Carib Sea Tahitian Moon Sand, 5lb","Carib Sea ACS05821 Tahitian Moon Sand, 5lb",FBALYB Amazon,7,7,0,0,0,0
,Carlson Laboratories C-Gel 100 Soft Gels,Carlson Laboratories C-Gel 100 Soft Gels,Default Ridgefield,20,20,0,0,0,0
,Carlson Laboratories C-Gel 100 Soft Gels,Carlson Laboratories C-Gel 100 Soft Gels,FBALYB Amazon,-2,-4,2,0,2,0
,Carlson Laboratories C-Gel 250 Soft Gels,Carlson Laboratories C-Gel 250 Soft Gels,FBALYB Amazon,15,15,0,0,0,0
,Carlson Laboratories CLO Lemon 250ml,Carlson Laboratories CLO Lemon 250ml,Default Ridgefield,8,8,0,0,0,0
,Carlson Laboratories CLO Lemon 250ml,Carlson Laboratories CLO Lemon 250ml,FBALYB Amazon,16,16,0,2,0,0
,Carlson Laboratories CLO Lemon 500ml,Carlson Laboratories CLO Lemon 500ml,FBALYB Amazon,-215,-215,0,216,0,0
,Carlson Laboratories E-Gems Elite 400IU 120 SG,Carlson Laboratories E-Gems Elite 400IU 120 SG,FBALYB Amazon,1,1,0,0,0,0
,Carlson Laboratories E-Gems Elite 400IU 240 SG,Carlson Laboratories E-Gems Elite 400IU 240 SG,Default Ridgefield,1,1,0,0,0,0
,Carlson Laboratories E-Gems Elite 400IU 240 SG,Carlson Laboratories E-Gems Elite 400IU 240 SG,FBALYB Amazon,3,1,2,0,2,0
,Carlson Laboratories E-Gems Elite 400IU 60 SG,Carlson Laboratories E-Gems Elite 400IU 60 SG,FBALYB Amazon,29,29,0,0,0,0
,Carlson Laboratories Elite EPA Gems 120 Soft Gels,Carlson Laboratories Elite EPA Gems 120 Soft Gels,FBALYB Amazon,1,1,0,0,0,0
,Carlson Laboratories Elite Omega-3 Gems 90+30 SG,Carlson Laboratories Elite Omega-3 Gems 90+30 SG,Default Ridgefield,22,22,0,0,0,0
,Carlson Laboratories Elite Omega-3 Gems 90+30 SG,Carlson Laboratories Elite Omega-3 Gems 90+30 SG,FBALYB Amazon,-1070,-1070,0,0,0,0
,Carlson Laboratories Inflammation Balance 180 SG,Carlson Laboratories Inflammation Balance 180 SG,Default Ridgefield,90,90,0,0,0,0
,Carlson Laboratories Lecithin 100 Soft Gels,Carlson Laboratories Lecithin 100 Soft Gels,FBALYB Amazon,988,986,2,0,2,0
,Carlson Laboratories Lutein & Greens 60 Capsules,Carlson Laboratories Lutein & Greens 60 Capsules,FBALYB Amazon,8,8,0,0,0,0
,Carlson Laboratories Maximum Omega 2000 90+30 SG,Carlson Laboratories Maximum Omega 2000 90+30 SG,FBALYB Amazon,4,4,0,1066,0,0
,Carlson Laboratories Super DHA Gems 240 Soft Gels,Carlson Laboratories Super DHA Gems 240 Soft Gels,FBALYB Amazon,0,0,0,1,0,0
,Carlson Laboratories Super DHA Gems 60+20 Soft Gels,Carlson Laboratories Super DHA Gems 60+20 Soft Gels,Default Ridgefield,0,-109,109,0,0,0
,Carlson Laboratories Super Omega-3 Gems,Carlson Laboratories Super Omega-3 Gems,Default Ridgefield,1,1,0,0,0,0
,Carlson Laboratories Super Omega-3 Gems,Carlson Laboratories Super Omega-3 Gems,FBALYB Amazon,4,0,4,12,4,0
,Carlson Laboratories Super Omega-3 Gems 300 SG,Carlson Laboratories Super Omega-3 Gems 300 SG,FBALYB Amazon,86,82,4,0,4,0
,Carlson Laboratories VFFO Lemon 120+30 Soft Gels,Carlson Laboratories VFFO Lemon 120+30 Soft Gels,FBALYB Amazon,40,38,2,0,2,0
,Carlson Laboratories VFFO Lemon 120 Soft Gels,Carlson Laboratories VFFO Lemon 120 Soft Gels,FBALYB Amazon,2,1,1,0,1,0
,Carlson Laboratories VFFO Lemon 200ml,Carlson Laboratories VFFO Lemon 200ml,Default Ridgefield,10,10,0,0,0,0
,Carlson Laboratories VFFO Lemon 200ml,Carlson Laboratories VFFO Lemon 200ml,FBALYB Amazon,2,2,0,0,0,0
,Carlson Laboratories VFFO Lemon 240 Soft Gels,Carlson Laboratories VFFO Lemon 240 Soft Gels,FBALYB Amazon,1,1,0,48,0,0
,Carlson Laboratories VFFO Lemon 500ml,Carlson Laboratories VFFO Lemon 500ml,FBALYB Amazon,-222,-222,0,240,0,0
,Carlson Laboratories VFFO Orange 200ml,Carlson Laboratories VFFO Orange 200ml,Default Ridgefield,11,11,0,0,0,0
,Carlson Laboratories VFFO Orange 200ml,Carlson Laboratories VFFO Orange 200ml,FBALYB Amazon,19,19,0,0,0,0
,Carlson Laboratories VFFO Orange Flavor 500ml,Carlson Laboratories VFFO Orange Flavor 500ml,FBALYB Amazon,9,9,0,0,0,0
,Carlson Laboratories Vitamin D 2000IU 120 Soft Gels,Carlson Laboratories Vitamin D 2000IU 120 Soft Gels,Default Ridgefield,2,2,0,0,0,0
,Carlson Laboratories Vitamin D 2000IU 120 Soft Gels,Carlson Laboratories Vitamin D 2000IU 120 Soft Gels,FBALYB Amazon,23,15,8,1,8,0
,Carole Hochman Plush Robe Large,Carole Hochman Plush Robe Large,FBALYB Amazon,-6,-6,0,0,0,0
,Carole Hochman Plush Robe Small,Carole Hochman Plush Robe Small ,FBALYB Amazon,-12,-12,0,0,0,0
,Carole Hochman Plush Robe X-Large,Carole Hochman Plush Robe X-Large,FBALYB Amazon,-5,-5,0,6,0,0
,Cars kids refill 4pc,Cars kids refill 4pc,Default,0,0,0,0,0,6
,Cars kids refill 4pc,Cars kids refill 4pc,FBALYB Amazon,-49,-58,9,17,9,0
,Carter's Boys 12-24 m Blue Stripes,Carter's Boys 12-24 m Blue Stripes,Default,0,0,0,0,0,6
,"Carter's Boys 12-24 m Blue, White, Grey","Carter's Boys 12-24 m Blue, White, Grey",Default,0,0,0,0,0,4
,Carter's Boys 12-24 m Top Striped Blue,Carter's Boys 12-24 m Top Striped Blue,Default,0,0,0,0,0,5
,Carter's Boys 3-12 m Animals and Stripes,Carter's Boys 3-12 m Animals and Stripes,Default,0,0,0,0,0,3
,Carter's Boys 3-12 m Blue Stripes,Carter's Boys 3-12 m Blue Stripes,Default,0,0,0,0,0,3
,"Carter's Boys 3-12 m Blue, White, Grey","Carter's Boys 3-12 m Blue, White, Grey",Default,0,0,0,0,0,3
,Carter's Boys 3-12 m Mighty and Stripes,Carter's Boys 3-12 m Mighty and Stripes,Default,0,0,0,0,0,2
,Carter's Boys 3-12 m Top Striped Blue,Carter's Boys 3-12 m Top Striped Blue,Default,0,0,0,0,0,3
,Carter's Boys 3-12 m Top Striped White,Carter's Boys 3-12 m Top Striped White,Default,0,0,0,0,0,4
,"Carter's Girls 12-24 m Pink, Blue, White w/ Bows","Carter's Girls 12-24 m Pink, Blue, White w/ Bows",Default,0,0,0,0,0,4
,"Carter's Girls 12-24 m Pink, White, Grey","Carter's Girls 12-24 m Pink, White, Grey",Default,0,0,0,0,0,5
,Carter's Girls 12-24 m Stripes and Polka Dots,Carter's Girls 12-24 m Stripes and Polka Dots,Default,0,0,0,0,0,5
,"Carter's Girls 3-12 m Pink, Blue, White w/ Bows","Carter's Girls 3-12 m Pink, Blue, White w/ Bows",Default,0,0,0,0,0,3
,"Carter's Girls 3-12 m Pink, Grey, Blue w/ Sparkles","Carter's Girls 3-12 m Pink, Grey, Blue w/ Sparkles",Default,0,0,0,0,0,1
,"Carter's Girls 3-12 m Pink, White, Grey","Carter's Girls 3-12 m Pink, White, Grey",Default,0,0,0,0,0,4
,Carter's Girls 3-12 m Stripes,Carter's Girls 3-12 m Stripes,Default,0,0,0,0,0,3
,Carter's Girls 3-12 m Stripes and Polka Dots,Carter's Girls 3-12 m Stripes and Polka Dots,Default,0,0,0,0,0,3
,Carter's Girls 3-12 m Stripes + Owl,Carter's Girls 3-12 m Stripes + Owl,Default,0,0,0,0,0,3
,Carters Girls Swim Bright Orange 7,Carters Girls Swim Bright Orange 7,FBALYB Amazon,-1,-1,0,0,0,0
,Carters Girls Swim Pink Dino 7,Carters Girls Swim Pink Dino 7,FBALYB Amazon,1,1,0,0,0,0
,Carters Girls Swim Pink Hearts 7,Carters Girls Swim Pink Hearts 7,FBALYB Amazon,3,3,0,0,0,0
,Cascade 102ct,Cascade 102ct,FBALYB Amazon,-11,-11,0,49,0,0
,Cascade Advanced Dishwasher Gel,Cascade Advanced Power Dishwasher Gel,Default,0,-728,728,0,0,0
,Cascade Advanced Dishwasher Gel,Cascade Advanced Power Dishwasher Gel,Default Ridgefield,4,4,0,0,0,0
,Cascade Advanced Dishwasher Gel,Cascade Advanced Power Dishwasher Gel,FBALYB Amazon,92,91,1,21,1,0
,Cascade Advanced Dishwasher Gel 2pk,Cascade Advanced Dishwasher Gel 2pk,FBALYB Amazon,32,29,3,6,3,0
,Cascade Platinum (92 count),Cascade Platinum (92 count),Default,0,0,0,0,0,2
,Cascade Platinum 92 ct,Cascade Platinum 92 ct,Default Oxford,1,1,0,0,0,0
,Cascade Platinum 92 ct,Cascade Platinum 92 ct,Default Ridgefield,39,39,0,0,0,0
,Cascade Platinum 92 ct,Cascade Platinum 92 ct,FBALYB Amazon,85,67,18,42,18,0
,Cascade Power Clean 115ct,Cascade Power Clean 115ct,Default,0,0,0,0,0,12
,Cascade Power Clean 115ct,Cascade Power Clean 115ct,FBALYB Amazon,-6,-7,1,7,1,0
,CAT 2-pack LED Worklight with Magnetic Base,CAT 2-pack LED Worklight with Magnetic Base,Default,0,0,0,0,0,2
,CAT 2-pack LED Worklight with Magnetic Base,CAT 2-pack LED Worklight with Magnetic Base,FBALYB Amazon,1,1,0,0,0,0
,Cat Mini Mover Dump Truck L&S,Cat Mini Mover Dump Truck L&S,FBALYB Amazon,4,4,0,0,0,0
,Cat Small Trucks ‑ Excavator,Cat Small Tough Trucks ‑ Excavator,FBALYB Amazon,-1,-1,0,1,0,0
,Cat Small Trucks - Wheel Loader,Cat Small Trucks ‑ Wheel Loader,FBALYB Amazon,15,15,0,0,0,0
,Catwalk Curls Rock Amplifier 2pk,Catwalk Curls Rock Amplifier 2pk,Default,30,-30,60,0,0,0
,Catwalk Curls Rock Amplifier 2pk,Catwalk Curls Rock Amplifier 2pk,FBALYB Amazon,1191,1158,33,720,33,0
,Catwalk Curls Rock Amplifier 2pk,Catwalk Curls Rock Amplifier 2pk,FBALYB Dubai,-24,-24,0,0,0,0
,Catwalk Curls Rock Amplifier 5.07oz 6pk,Catwalk Curls Rock Amplifier 5.07oz 6pk,FBALYB Amazon,770,769,1,19,1,0
,"Caudalie - Instant Detox Mask	2.5 oz","Caudalie - Instant Detox Mask	2.5 oz",FBALYB Amazon,-10,-10,0,10,0,0
,"Caudalie - Make-Up Removing Cleansing Oil	5 oz","Caudalie - Make-Up Removing Cleansing Oil	5 oz",FBALYB Amazon,128,128,0,0,0,0
,"Caudalie - Make-Up Removing Cleansing Oil	5 oz","Caudalie - Make-Up Removing Cleansing Oil	5 oz",WFS,-39,-39,0,0,0,0
,"Caudalie - Micellar Cleansing Water	6.7 oz","Caudalie - Micellar Cleansing Water	6.7 oz",FBALYB Amazon,-4,-4,0,0,0,0
,"Caudalie - Moisturizing Toner	6.7 oz","Caudalie - Moisturizing Toner	6.7 oz",FBALYB Amazon,-1,-1,0,0,0,0
,Caudalie - Vinopure Natural Salicylic Acid Pore Minimizing Serum 1 oz,Caudalie - Vinopure Natural Salicylic Acid Pore Minimizing Serum 1 oz,FBALYB Amazon,259,259,0,0,0,0
,Caudalie - Vinopure Natural Salicylic Acid Pore Minimizing Serum 1 oz,Caudalie - Vinopure Natural Salicylic Acid Pore Minimizing Serum 1 oz,WFS,-42,-42,0,0,0,0
,Caudalie - Vinosource Moisturizing Sorbet 1.3 oz,Caudalie - Vinosource Moisturizing Sorbet 1.3 oz,FBALYB Amazon,-1,-1,0,0,0,0
,Caveman Nutrition Bars 20 count,"Caveman Nutrition Bars, 20 Count - 10 Dark Chocolate Cashew Almond Bars and 10 Chocolate Almond Coconut Bars",FBALYB Amazon,2,2,0,0,0,0
,Celeste poncho black,Celeste Women's Wool/Cashmere Blend Poncho (Black),FBALYB Amazon,-1,-1,0,0,0,0
,Celeste Poncho Quiksilver,Celeste Women's Wool/Cashmere Blend Poncho (Quicksilver/Blue Heron),FBALYB Amazon,-1,-1,0,0,0,0
,Celeste Poncho Wheat,Celeste Women's Wool/Cashmere Blend Poncho (Wheat/Mink),FBALYB Amazon,-1,-1,0,0,0,0
,Celestial Peppermint Tea 20ct 3pk,Celestial Peppermint Tea 20ct 3pk,FBALYB Amazon,6,6,0,0,0,0
,Celestial Peppermint Tea 20ct 6pk,Celestial Peppermint Tea 20ct 6pk,FBALYB Amazon,50,50,0,2,0,0
,"Celestial Seasonings Sleepytime Variety Pack, 4 pk.","Celestial Seasonings Sleepytime Variety Pack, 4 pk.",Default,0,0,0,0,0,1
,Celestial Tea - Peppermint Herb,Celestial Tea - Peppermint Herb,Default,0,0,0,0,0,476
,Centrum Silver Adults 325ct,Centrum Silver Adults 325ct,Default,0,0,0,0,0,60
,Cerave 19oz pump cream 2 pack,Cerave 19oz pump cream 2 pack,FBALYB Amazon,-2,-2,0,0,0,0
,Cerave 539G + 57g,Cerave 539G + 57g,Default,0,0,0,0,0,140
,Cerave 539G + 57g,Cerave 539G + 57g,Default Oxford,100,100,0,0,0,0
,Cerave 539G + 57g,Cerave 539G + 57g,Default Ridgefield,580,580,0,0,0,0
,Cerave AM/PM Moisturizer Set 2 X 3 oz,Cerave AM/PM Moisturizer Set 2 X 3 oz,Default,13,13,0,0,0,0
,Cerave AM/PM Moisturizer Set 2 X 3 oz,Cerave AM/PM Moisturizer Set 2 X 3 oz,FBALYB Amazon,-12,-12,0,13,0,0
,Cerave Cream 19 Oz Jar with Pump,Cerave Cream 19 Oz Jar with Pump,FBALYB Amazon,-1,-1,0,3,0,0
,Certified International Chelsea 6 Ceramic Bowls,Certified International Chelsea 6 Ceramic Bowls,FBALYB Amazon,-2,-2,0,2,0,0
,Cetaphil Cleanser 20oz 2pk + 4oz,"Cetaphil Gentle Skin Cleanser 20 fl oz., 2-pack, + 4 fl oz. Bonus",Default,-86,-86,0,0,0,130
,Cetaphil Cleanser 20oz 2pk + 4oz,"Cetaphil Gentle Skin Cleanser 20 fl oz., 2-pack, + 4 fl oz. Bonus",FBALYB Amazon,0,0,0,2,0,0
,Cetaphil Cream 20oz 3pk,Cetaphil Cream 20oz 3pk,FBALYB Amazon,-5,-5,0,4,0,0
,Cetaphil Gentle Skin Cleanser Face and Body,Cetaphil Gentle Skin Cleanser Face and Body,Default Ridgefield,102,102,0,0,0,0
,Cetaphil Gentle Skin Cleanser Face and Body,Cetaphil Gentle Skin Cleanser Face and Body,FBALYB Amazon,82,82,0,0,0,0
,Cetaphil Lotion 1 Liter,Cetaphil Lotion 1 Liter,Default,0,-1,1,0,0,0
,Cetaphil Lotion 1 Liter,Cetaphil Lotion 1 Liter,Default Ridgefield,497,497,0,0,0,0
,Cetaphil Lotion 1 Liter,Cetaphil Lotion 1 Liter,FBALYB Amazon,140,140,0,2,0,0
,Cetaphil Lotion 20oz 2pk + 4oz,"Cetaphil Moisture Lotion 20 fl oz, 2-pack + 4 fl oz Bonus",FBALYB Amazon,-1,-1,0,0,0,0
,Cetaphil Moisturizing Cream 28.8oz,"Cetaphil Moisturizing Cream, Dry Sensitive Skin ‑ 28.8 oz total",FBALYB Amazon,1,1,0,0,0,0
,CF 100% Pure Avocado Oil,Chosen Foods 100% Pure Avocado Oil - 1 L bottle,FBALYB Amazon,0,0,0,24,0,0
,Cfh-v10,"Kodak CFH-V10 - HD WiFi Video Monitoring Surveillance Security Camera, Two-Wa...",FBALYB Amazon,-1,-1,0,0,0,0
,Chaco BANDED Z CLOUD BANDED Z CLOUD US size 10 JCH107702,Chaco BANDED Z CLOUD BANDED Z CLOUD US size 10 JCH107702,Default Ridgefield,4,4,0,0,0,0
,Chaco BANDED Z CLOUD BANDED Z CLOUD US size 10 JCH107702,Chaco BANDED Z CLOUD BANDED Z CLOUD US size 10 JCH107702,FBALYB Amazon,30,30,0,0,0,0
,Chaco BANDED Z CLOUD BANDED Z CLOUD US size 11 JCH107702,Chaco BANDED Z CLOUD BANDED Z CLOUD US size 11 JCH107702,FBALYB Amazon,12,12,0,0,0,0
,Chaco BANDED Z CLOUD BANDED Z CLOUD US size 6 JCH107702,Chaco BANDED Z CLOUD BANDED Z CLOUD US size 6 JCH107702,FBALYB Amazon,22,22,0,0,0,0
,Chaco BANDED Z CLOUD BANDED Z CLOUD US size 7 JCH107702,Chaco BANDED Z CLOUD BANDED Z CLOUD US size 7 JCH107702,Default Ridgefield,50,50,0,0,0,0
,Chaco BANDED Z CLOUD BANDED Z CLOUD US size 7 JCH107702,Chaco BANDED Z CLOUD BANDED Z CLOUD US size 7 JCH107702,FBALYB Amazon,0,0,0,20,0,0
,Chaco BANDED Z CLOUD BANDED Z CLOUD US size 8 JCH107702,Chaco BANDED Z CLOUD BANDED Z CLOUD US size 8 JCH107702,Default Ridgefield,82,82,0,0,0,0
,Chaco BANDED Z CLOUD BANDED Z CLOUD US size 8 JCH107702,Chaco BANDED Z CLOUD BANDED Z CLOUD US size 8 JCH107702,FBALYB Amazon,0,0,0,20,0,0
,Chaco BANDED Z CLOUD BANDED Z CLOUD US size 9 JCH107702,Chaco BANDED Z CLOUD BANDED Z CLOUD US size 9 JCH107702,FBALYB Amazon,59,59,0,0,0,0
,Chaco BANDED Z CLOUD/COGNAC BLACK US size: M10 Width:M JCH106811,Chaco BANDED Z CLOUD/COGNAC BLACK US size: M10 Width:M JCH106811,FBALYB Amazon,-2,-2,0,0,0,0
,Chaco BANDED Z CLOUD/COGNAC BLACK US size: M11 Width:M JCH106811,Chaco BANDED Z CLOUD/COGNAC BLACK US size: M11 Width:M JCH106811,FBALYB Amazon,-4,-4,0,0,0,0
,Chaco BANDED Z CLOUD/COGNAC BLACK US size: M12 Width:M JCH106811,Chaco BANDED Z CLOUD/COGNAC BLACK US size: M12 Width:M JCH106811,FBALYB Amazon,-2,-2,0,0,0,0
,Chaco BANDED Z CLOUD/COGNAC BLACK US size: M13 Width:M JCH106811,Chaco BANDED Z CLOUD/COGNAC BLACK US size: M13 Width:M JCH106811,FBALYB Amazon,21,21,0,0,0,0
,Chaco BANDED Z CLOUD/COGNAC BLACK US size: M8 Width:M JCH106811,Chaco BANDED Z CLOUD/COGNAC BLACK US size: M8 Width:M JCH106811,FBALYB Amazon,-4,-4,0,0,0,0
,Chaco BANDED Z CLOUD/COGNAC BLACK US size: M9 Width:M JCH106811,Chaco BANDED Z CLOUD/COGNAC BLACK US size: M9 Width:M JCH106811,FBALYB Amazon,-2,-2,0,0,0,0
,Chaco BANDED Z CLOUD/NAVY RED US size: M10 Width:M JCH106815,Chaco BANDED Z CLOUD/NAVY RED US size: M10 Width:M JCH106815,FBALYB Amazon,-2,-2,0,0,0,0
,Chaco BANDED Z CLOUD/NAVY RED US size: M12 Width:M JCH106815,Chaco BANDED Z CLOUD/NAVY RED US size: M12 Width:M JCH106815,FBALYB Amazon,-1,-1,0,0,0,0
,Chaco BANDED Z CLOUD/NAVY RED US size: M13 Width:M JCH106815,Chaco BANDED Z CLOUD/NAVY RED US size: M13 Width:M JCH106815,FBALYB Amazon,-5,-5,0,0,0,0
,Chaco BANDED Z CLOUD/NAVY RED US size: M8 Width:M JCH106815,Chaco BANDED Z CLOUD/NAVY RED US size: M8 Width:M JCH106815,FBALYB Amazon,-2,-2,0,0,0,0
,Chaco BANDED Z CLOUD/NAVY RED US size: M9 Width:M JCH106815,Chaco BANDED Z CLOUD/NAVY RED US size: M9 Width:M JCH106815,FBALYB Amazon,-2,-2,0,0,0,0
,Chaco BANDED Z CLOUD/SOLID BLACK US size: M10 Width:M JCH106829,Chaco BANDED Z CLOUD/SOLID BLACK US size: M10 Width:M JCH106829,Default Ridgefield,0,0,0,0,0,69
,Chaco BANDED Z CLOUD/SOLID BLACK US size: M10 Width:M JCH106829,Chaco BANDED Z CLOUD/SOLID BLACK US size: M10 Width:M JCH106829,FBALYB Amazon,-3,-3,0,0,0,0
,Chaco BANDED Z CLOUD/SOLID BLACK US size: M8 Width:M JCH106829,Chaco BANDED Z CLOUD/SOLID BLACK US size: M8 Width:M JCH106829,Default Ridgefield,0,0,0,0,0,30
,Chaco BANDED Z CLOUD/SOLID BLACK US size: M8 Width:M JCH106829,Chaco BANDED Z CLOUD/SOLID BLACK US size: M8 Width:M JCH106829,FBALYB Amazon,-7,-7,0,0,0,0
,Chaco BANDED Z CLOUD/SOLID BLACK US size: M9 Width:M JCH106829,Chaco BANDED Z CLOUD/SOLID BLACK US size: M9 Width:M JCH106829,Default Ridgefield,0,0,0,0,0,52
,Chaco BANDED Z CLOUD/SOLID BLACK US size: M9 Width:M JCH106829,Chaco BANDED Z CLOUD/SOLID BLACK US size: M9 Width:M JCH106829,FBALYB Amazon,-4,-4,0,0,0,0
,Chaco BANDED Z CLOUD/SOLID BLACK US size: W10 Width:M JCH107556,Chaco BANDED Z CLOUD/SOLID BLACK US size: W10 Width:M JCH107556,FBALYB Amazon,25,25,0,0,0,0
,Chaco BANDED Z CLOUD/SOLID BLACK US size: W11 Width:M JCH107556,Chaco BANDED Z CLOUD/SOLID BLACK US size: W11 Width:M JCH107556,Default Ridgefield,12,12,0,0,0,0
,Chaco BANDED Z CLOUD/SOLID BLACK US size: W11 Width:M JCH107556,Chaco BANDED Z CLOUD/SOLID BLACK US size: W11 Width:M JCH107556,FBALYB Amazon,-1,-1,0,0,0,0
,Chaco BANDED Z CLOUD/SOLID BLACK US size: W6 Width:M JCH107556,Chaco BANDED Z CLOUD/SOLID BLACK US size: W6 Width:M JCH107556,FBALYB Amazon,17,17,0,0,0,0
,Chaco BANDED Z CLOUD/SOLID BLACK US size: W7 Width:M JCH107556,Chaco BANDED Z CLOUD/SOLID BLACK US size: W7 Width:M JCH107556,Default Ridgefield,67,67,0,0,0,0
,Chaco BANDED Z CLOUD/SOLID BLACK US size: W7 Width:M JCH107556,Chaco BANDED Z CLOUD/SOLID BLACK US size: W7 Width:M JCH107556,FBALYB Amazon,-6,-6,0,0,0,0
,Chaco BANDED Z CLOUD/SOLID BLACK US size: W8 Width:M JCH107556,Chaco BANDED Z CLOUD/SOLID BLACK US size: W8 Width:M JCH107556,Default Ridgefield,1,1,0,0,0,0
,Chaco BANDED Z CLOUD/SOLID BLACK US size: W8 Width:M JCH107556,Chaco BANDED Z CLOUD/SOLID BLACK US size: W8 Width:M JCH107556,FBALYB Amazon,76,76,0,0,0,0
,Chaco BANDED Z CLOUD/SOLID BLACK US size: W9 Width:M JCH107556,Chaco BANDED Z CLOUD/SOLID BLACK US size: W9 Width:M JCH107556,Default Ridgefield,2,2,0,0,0,0
,Chaco BANDED Z CLOUD/SOLID BLACK US size: W9 Width:M JCH107556,Chaco BANDED Z CLOUD/SOLID BLACK US size: W9 Width:M JCH107556,FBALYB Amazon,30,30,0,0,0,0
,Chaco CHILLOS SLIDE/WHITE US size: W7 Width:M JCH108260,Chaco CHILLOS SLIDE/WHITE US size: W7 Width:M JCH108260,FBALYB Amazon,-3,-3,0,0,0,0
,Chaco LOWDOWN SANDAL/BLACK US size: M10 Width:M JCH107109,Chaco LOWDOWN SANDAL/BLACK US size: M10 Width:M JCH107109,FBALYB Amazon,59,59,0,0,0,0
,Chaco LOWDOWN SANDAL/BLACK US size: M11 Width:M JCH107109,Chaco LOWDOWN SANDAL/BLACK US size: M11 Width:M JCH107109,Default Ridgefield,30,30,0,0,0,0
,Chaco LOWDOWN SANDAL/BLACK US size: M11 Width:M JCH107109,Chaco LOWDOWN SANDAL/BLACK US size: M11 Width:M JCH107109,FBALYB Amazon,0,0,0,20,0,0
,Chaco LOWDOWN SANDAL/BLACK US size: M12 Width:M JCH107109,Chaco LOWDOWN SANDAL/BLACK US size: M12 Width:M JCH107109,FBALYB Amazon,41,41,0,0,0,0
,Chaco LOWDOWN SANDAL/BLACK US size: M13 Width:M JCH107109,Chaco LOWDOWN SANDAL/BLACK US size: M13 Width:M JCH107109,FBALYB Amazon,46,46,0,0,0,0
,Chaco LOWDOWN SANDAL/BLACK US size: M14 Width:M JCH107109,Chaco LOWDOWN SANDAL/BLACK US size: M14 Width:M JCH107109,Default Ridgefield,12,12,0,0,0,0
,Chaco LOWDOWN SANDAL/BLACK US size: M8 Width:M JCH107109,Chaco LOWDOWN SANDAL/BLACK US size: M8 Width:M JCH107109,Default Ridgefield,18,18,0,0,0,0
,Chaco LOWDOWN SANDAL/BLACK US size: M8 Width:M JCH107109,Chaco LOWDOWN SANDAL/BLACK US size: M8 Width:M JCH107109,FBALYB Amazon,-1,-1,0,10,0,0
,Chaco LOWDOWN SANDAL/BLACK US size: M9 Width:M JCH107109,Chaco LOWDOWN SANDAL/BLACK US size: M9 Width:M JCH107109,Default Ridgefield,2,2,0,0,0,0
,Chaco LOWDOWN SANDAL/BLACK US size: M9 Width:M JCH107109,Chaco LOWDOWN SANDAL/BLACK US size: M9 Width:M JCH107109,FBALYB Amazon,41,40,1,0,1,0
,Chaco LOWDOWN SANDAL/GREY US size: M10 Width:M JCH107275,Chaco LOWDOWN SANDAL/GREY US size: M10 Width:M JCH107275,FBALYB Amazon,-2,-2,0,0,0,0
,Chaco LOWDOWN SANDAL/GREY US size: M11 Width:M JCH107275,Chaco LOWDOWN SANDAL/GREY US size: M11 Width:M JCH107275,FBALYB Amazon,-1,-2,1,0,1,0
,Chaco LOWDOWN SANDAL/GREY US size: M12 Width:M JCH107275,Chaco LOWDOWN SANDAL/GREY US size: M12 Width:M JCH107275,FBALYB Amazon,-1,-1,0,0,0,0
,Chaco LOWDOWN SANDAL/GREY US size: M13 Width:M JCH107275,Chaco LOWDOWN SANDAL/GREY US size: M13 Width:M JCH107275,FBALYB Amazon,-1,-1,0,0,0,0
,Chaco LOWDOWN SANDAL/GREY US size: M8 Width:M JCH107275,Chaco LOWDOWN SANDAL/GREY US size: M8 Width:M JCH107275,FBALYB Amazon,-2,-3,1,0,1,0
,Chaco LOWDOWN SANDAL/GREY US size: M9 Width:M JCH107275,Chaco LOWDOWN SANDAL/GREY US size: M9 Width:M JCH107275,FBALYB Amazon,-2,-2,0,0,0,0
,Chaco LOWDOWN SANDAL/NAVY US size: M10 Width:M JCH107273,Chaco LOWDOWN SANDAL/NAVY US size: M10 Width:M JCH107273,FBALYB Amazon,63,63,0,0,0,0
,Chaco LOWDOWN SANDAL/NAVY US size: M11 Width:M JCH107273,Chaco LOWDOWN SANDAL/NAVY US size: M11 Width:M JCH107273,Default Ridgefield,1,1,0,0,0,0
,Chaco LOWDOWN SANDAL/NAVY US size: M11 Width:M JCH107273,Chaco LOWDOWN SANDAL/NAVY US size: M11 Width:M JCH107273,FBALYB Amazon,41,40,1,0,1,0
,Chaco LOWDOWN SANDAL/NAVY US size: M12 Width:M JCH107273,Chaco LOWDOWN SANDAL/NAVY US size: M12 Width:M JCH107273,FBALYB Amazon,41,41,0,0,0,0
,Chaco LOWDOWN SANDAL/NAVY US size: M13 Width:M JCH107273,Chaco LOWDOWN SANDAL/NAVY US size: M13 Width:M JCH107273,FBALYB Amazon,47,47,0,0,0,0
,Chaco LOWDOWN SANDAL/NAVY US size: M14 Width:M JCH107273,Chaco LOWDOWN SANDAL/NAVY US size: M14 Width:M JCH107273,FBALYB Amazon,0,0,0,12,0,0
,Chaco LOWDOWN SANDAL/NAVY US size: M8 Width:M JCH107273,Chaco LOWDOWN SANDAL/NAVY US size: M8 Width:M JCH107273,Default Ridgefield,29,29,0,0,0,0
,Chaco LOWDOWN SANDAL/NAVY US size: M8 Width:M JCH107273,Chaco LOWDOWN SANDAL/NAVY US size: M8 Width:M JCH107273,FBALYB Amazon,-2,-2,0,0,0,0
,Chaco LOWDOWN SANDAL/NAVY US size: M9 Width:M JCH107273,Chaco LOWDOWN SANDAL/NAVY US size: M9 Width:M JCH107273,FBALYB Amazon,26,24,2,0,2,0
,Chaco LOWDOWN SANDAL/RAMBLING MOSS US size: M10 Width:M JCH107271,Chaco LOWDOWN SANDAL/RAMBLING MOSS US size: M10 Width:M JCH107271,FBALYB Amazon,-6,-6,0,0,0,0
,Chaco LOWDOWN SANDAL/RAMBLING MOSS US size: M11 Width:M JCH107271,Chaco LOWDOWN SANDAL/RAMBLING MOSS US size: M11 Width:M JCH107271,FBALYB Amazon,-3,-3,0,0,0,0
,Chaco LOWDOWN SANDAL/RAMBLING MOSS US size: M12 Width:M JCH107271,Chaco LOWDOWN SANDAL/RAMBLING MOSS US size: M12 Width:M JCH107271,FBALYB Amazon,-1,-1,0,0,0,0
,Chaco LOWDOWN SANDAL/RAMBLING MOSS US size: M13 Width:M JCH107271,Chaco LOWDOWN SANDAL/RAMBLING MOSS US size: M13 Width:M JCH107271,FBALYB Amazon,4,4,0,0,0,0
,Chaco LOWDOWN SANDAL/RAMBLING MOSS US size: M7 Width:M JCH107271,Chaco LOWDOWN SANDAL/RAMBLING MOSS US size: M7 Width:M JCH107271,FBALYB Amazon,-4,-4,0,0,0,0
,Chaco LOWDOWN SANDAL/RAMBLING MOSS US size: M8 Width:M JCH107271,Chaco LOWDOWN SANDAL/RAMBLING MOSS US size: M8 Width:M JCH107271,FBALYB Amazon,1,1,0,0,0,0
,Chaco LOWDOWN SANDAL/RAMBLING MOSS US size: M9 Width:M JCH107271,Chaco LOWDOWN SANDAL/RAMBLING MOSS US size: M9 Width:M JCH107271,FBALYB Amazon,-3,-3,0,0,0,0
,Chaco MEGA Z CLOUD/SOLID BLACK US size: W10 Width:M JCH107756,Chaco MEGA Z CLOUD/SOLID BLACK US size: W10 Width:M JCH107756,FBALYB Amazon,40,40,0,0,0,0
,Chaco MEGA Z CLOUD/SOLID BLACK US size: W11 Width:M JCH107756,Chaco MEGA Z CLOUD/SOLID BLACK US size: W11 Width:M JCH107756,Default Ridgefield,18,18,0,0,0,0
,Chaco MEGA Z CLOUD/SOLID BLACK US size: W11 Width:M JCH107756,Chaco MEGA Z CLOUD/SOLID BLACK US size: W11 Width:M JCH107756,FBALYB Amazon,-2,-2,0,0,0,0
,Chaco MEGA Z CLOUD/SOLID BLACK US size: W6 Width:M JCH107756,Chaco MEGA Z CLOUD/SOLID BLACK US size: W6 Width:M JCH107756,Default Ridgefield,22,22,0,0,0,0
,Chaco MEGA Z CLOUD/SOLID BLACK US size: W7 Width:M JCH107756,Chaco MEGA Z CLOUD/SOLID BLACK US size: W7 Width:M JCH107756,Default Ridgefield,63,63,0,0,0,0
,Chaco MEGA Z CLOUD/SOLID BLACK US size: W7 Width:M JCH107756,Chaco MEGA Z CLOUD/SOLID BLACK US size: W7 Width:M JCH107756,FBALYB Amazon,-4,-4,0,0,0,0
,Chaco MEGA Z CLOUD/SOLID BLACK US size: W8 Width:M JCH107756,Chaco MEGA Z CLOUD/SOLID BLACK US size: W8 Width:M JCH107756,Default Ridgefield,73,73,0,0,0,0
,Chaco MEGA Z CLOUD/SOLID BLACK US size: W8 Width:M JCH107756,Chaco MEGA Z CLOUD/SOLID BLACK US size: W8 Width:M JCH107756,FBALYB Amazon,-9,-9,0,20,0,0
,Chaco MEGA Z CLOUD/SOLID BLACK US size: W9 Width:M JCH107756,Chaco MEGA Z CLOUD/SOLID BLACK US size: W9 Width:M JCH107756,FBALYB Amazon,57,55,2,0,2,0
,Chaco MEGA Z CLOUD/SPRINK PINE US size: W10 Width:M JCH107760,Chaco MEGA Z CLOUD/SPRINK PINE US size: W10 Width:M JCH107760,FBALYB Amazon,-1,-1,0,0,0,0
,Chaco MEGA Z CLOUD/SPRINK PINE US size: W6 Width:M JCH107760,Chaco MEGA Z CLOUD/SPRINK PINE US size: W6 Width:M JCH107760,FBALYB Amazon,-2,-2,0,0,0,0
,Chaco MEGA Z CLOUD/SPRINK PINE US size: W8 Width:M JCH107760,Chaco MEGA Z CLOUD/SPRINK PINE US size: W8 Width:M JCH107760,FBALYB Amazon,-1,-1,0,0,0,0
,Chaco Men CHILLOS SLIDE CHILLOS SLIDE Size 10 JCH107089,Chaco Men CHILLOS SLIDE CHILLOS SLIDE Size 10 JCH107089,FBALYB Amazon,-11,-13,2,1,2,0
,Chaco Men CHILLOS SLIDE CHILLOS SLIDE Size 10 JCH107099,Chaco Men CHILLOS SLIDE CHILLOS SLIDE Size 10 JCH107099,FBALYB Amazon,-3,-3,0,0,0,0
,Chaco Men CHILLOS SLIDE CHILLOS SLIDE Size 10 JCH107321,Chaco Men CHILLOS SLIDE CHILLOS SLIDE Size 10 JCH107321,FBALYB Amazon,-12,-12,0,0,0,0
,Chaco Men CHILLOS SLIDE CHILLOS SLIDE Size 11 JCH107089,Chaco Men CHILLOS SLIDE CHILLOS SLIDE Size 11 JCH107089,FBALYB Amazon,-10,-10,0,0,0,0
,Chaco Men CHILLOS SLIDE CHILLOS SLIDE Size 11 JCH107099,Chaco Men CHILLOS SLIDE CHILLOS SLIDE Size 11 JCH107099,FBALYB Amazon,7,5,2,0,2,0
,Chaco Men CHILLOS SLIDE CHILLOS SLIDE Size 11 JCH107321,Chaco Men CHILLOS SLIDE CHILLOS SLIDE Size 11 JCH107321,FBALYB Amazon,-5,-5,0,0,0,0
,Chaco Men CHILLOS SLIDE CHILLOS SLIDE Size 12 JCH107089,Chaco Men CHILLOS SLIDE CHILLOS SLIDE Size 12 JCH107089,FBALYB Amazon,-9,-9,0,0,0,0
,Chaco Men CHILLOS SLIDE CHILLOS SLIDE Size 12 JCH107099,Chaco Men CHILLOS SLIDE CHILLOS SLIDE Size 12 JCH107099,FBALYB Amazon,35,34,1,0,1,0
,Chaco Men CHILLOS SLIDE CHILLOS SLIDE Size 12 JCH107321,Chaco Men CHILLOS SLIDE CHILLOS SLIDE Size 12 JCH107321,FBALYB Amazon,-9,-11,2,0,2,0
,Chaco Men CHILLOS SLIDE CHILLOS SLIDE Size 13 JCH107089,Chaco Men CHILLOS SLIDE CHILLOS SLIDE Size 13 JCH107089,FBALYB Amazon,-4,-4,0,1,0,0
,Chaco Men CHILLOS SLIDE CHILLOS SLIDE Size 13 JCH107099,Chaco Men CHILLOS SLIDE CHILLOS SLIDE Size 13 JCH107099,FBALYB Amazon,35,35,0,0,0,0
,Chaco Men CHILLOS SLIDE CHILLOS SLIDE Size 13 JCH107321,Chaco Men CHILLOS SLIDE CHILLOS SLIDE Size 13 JCH107321,Default Ridgefield,1,1,0,0,0,0
,Chaco Men CHILLOS SLIDE CHILLOS SLIDE Size 13 JCH107321,Chaco Men CHILLOS SLIDE CHILLOS SLIDE Size 13 JCH107321,FBALYB Amazon,-2,-2,0,0,0,0
,Chaco Men CHILLOS SLIDE CHILLOS SLIDE Size 14 JCH107089,Chaco Men CHILLOS SLIDE CHILLOS SLIDE Size 14 JCH107089,FBALYB Amazon,2,2,0,0,0,0
,Chaco Men CHILLOS SLIDE CHILLOS SLIDE Size 14 JCH107099,Chaco Men CHILLOS SLIDE CHILLOS SLIDE Size 14 JCH107099,FBALYB Amazon,12,12,0,0,0,0
,Chaco Men CHILLOS SLIDE CHILLOS SLIDE Size 14 JCH107321,Chaco Men CHILLOS SLIDE CHILLOS SLIDE Size 14 JCH107321,FBALYB Amazon,7,7,0,0,0,0
,Chaco Men CHILLOS SLIDE CHILLOS SLIDE Size 8 JCH107099,Chaco Men CHILLOS SLIDE CHILLOS SLIDE Size 8 JCH107099,FBALYB Amazon,29,29,0,0,0,0
,Chaco Men CHILLOS SLIDE CHILLOS SLIDE Size 8 JCH107321,Chaco Men CHILLOS SLIDE CHILLOS SLIDE Size 8 JCH107321,FBALYB Amazon,2,2,0,0,0,0
,Chaco Men CHILLOS SLIDE CHILLOS SLIDE Size 9 JCH107089,Chaco Men CHILLOS SLIDE CHILLOS SLIDE Size 9 JCH107089,FBALYB Amazon,-9,-10,1,0,1,0
,Chaco Men CHILLOS SLIDE CHILLOS SLIDE Size 9 JCH107099,Chaco Men CHILLOS SLIDE CHILLOS SLIDE Size 9 JCH107099,FBALYB Amazon,1,1,0,0,0,0
,Chaco Men CHILLOS SLIDE CHILLOS SLIDE Size 9 JCH107321,Chaco Men CHILLOS SLIDE CHILLOS SLIDE Size 9 JCH107321,FBALYB Amazon,-6,-6,0,0,0,0
,Chaco Men LOWDOWN FLIP LOWDOWN FLIP US size 10 JCH107325,Chaco Men LOWDOWN FLIP LOWDOWN FLIP US size 10 JCH107325,FBALYB Amazon,23,23,0,0,0,0
,Chaco Men LOWDOWN FLIP LOWDOWN FLIP US size 10 JCH107331,Chaco Men LOWDOWN FLIP LOWDOWN FLIP US size 10 JCH107331,FBALYB Amazon,49,49,0,0,0,0
,Chaco Men LOWDOWN FLIP LOWDOWN FLIP US size 10 JCH107333,Chaco Men LOWDOWN FLIP LOWDOWN FLIP US size 10 JCH107333,FBALYB Amazon,-6,-6,0,0,0,0
,Chaco Men LOWDOWN FLIP LOWDOWN FLIP US size 11 JCH107325,Chaco Men LOWDOWN FLIP LOWDOWN FLIP US size 11 JCH107325,FBALYB Amazon,-1,-1,0,0,0,0
,Chaco Men LOWDOWN FLIP LOWDOWN FLIP US size 11 JCH107331,Chaco Men LOWDOWN FLIP LOWDOWN FLIP US size 11 JCH107331,FBALYB Amazon,32,30,2,0,2,0
,Chaco Men LOWDOWN FLIP LOWDOWN FLIP US size 11 JCH107333,Chaco Men LOWDOWN FLIP LOWDOWN FLIP US size 11 JCH107333,FBALYB Amazon,-4,-4,0,0,0,0
,Chaco Men LOWDOWN FLIP LOWDOWN FLIP US size 12 JCH107325,Chaco Men LOWDOWN FLIP LOWDOWN FLIP US size 12 JCH107325,FBALYB Amazon,20,20,0,0,0,0
,Chaco Men LOWDOWN FLIP LOWDOWN FLIP US size 12 JCH107331,Chaco Men LOWDOWN FLIP LOWDOWN FLIP US size 12 JCH107331,FBALYB Amazon,46,46,0,0,0,0
,Chaco Men LOWDOWN FLIP LOWDOWN FLIP US size 12 JCH107333,Chaco Men LOWDOWN FLIP LOWDOWN FLIP US size 12 JCH107333,FBALYB Amazon,-3,-3,0,0,0,0
,Chaco Men LOWDOWN FLIP LOWDOWN FLIP US size 13 JCH107325,Chaco Men LOWDOWN FLIP LOWDOWN FLIP US size 13 JCH107325,Default Ridgefield,1,1,0,0,0,0
,Chaco Men LOWDOWN FLIP LOWDOWN FLIP US size 13 JCH107325,Chaco Men LOWDOWN FLIP LOWDOWN FLIP US size 13 JCH107325,FBALYB Amazon,25,24,1,0,1,0
,Chaco Men LOWDOWN FLIP LOWDOWN FLIP US size 13 JCH107331,Chaco Men LOWDOWN FLIP LOWDOWN FLIP US size 13 JCH107331,Default Ridgefield,55,55,0,0,0,0
,Chaco Men LOWDOWN FLIP LOWDOWN FLIP US size 13 JCH107333,Chaco Men LOWDOWN FLIP LOWDOWN FLIP US size 13 JCH107333,Default Ridgefield,1,1,0,0,0,0
,Chaco Men LOWDOWN FLIP LOWDOWN FLIP US size 13 JCH107333,Chaco Men LOWDOWN FLIP LOWDOWN FLIP US size 13 JCH107333,FBALYB Amazon,21,20,1,0,1,0
,Chaco Men LOWDOWN FLIP LOWDOWN FLIP US size 14 JCH107325,Chaco Men LOWDOWN FLIP LOWDOWN FLIP US size 14 JCH107325,Default Ridgefield,12,12,0,0,0,0
,Chaco Men LOWDOWN FLIP LOWDOWN FLIP US size 14 JCH107331,Chaco Men LOWDOWN FLIP LOWDOWN FLIP US size 14 JCH107331,FBALYB Amazon,6,6,0,0,0,0
,Chaco Men LOWDOWN FLIP LOWDOWN FLIP US size 14 JCH107333,Chaco Men LOWDOWN FLIP LOWDOWN FLIP US size 14 JCH107333,FBALYB Amazon,7,7,0,0,0,0
,Chaco Men LOWDOWN FLIP LOWDOWN FLIP US size 8 JCH107325,Chaco Men LOWDOWN FLIP LOWDOWN FLIP US size 8 JCH107325,Default Ridgefield,18,18,0,0,0,0
,Chaco Men LOWDOWN FLIP LOWDOWN FLIP US size 8 JCH107325,Chaco Men LOWDOWN FLIP LOWDOWN FLIP US size 8 JCH107325,FBALYB Amazon,0,0,0,10,0,0
,Chaco Men LOWDOWN FLIP LOWDOWN FLIP US size 8 JCH107331,Chaco Men LOWDOWN FLIP LOWDOWN FLIP US size 8 JCH107331,FBALYB Amazon,31,31,0,0,0,0
,Chaco Men LOWDOWN FLIP LOWDOWN FLIP US size 8 JCH107333,Chaco Men LOWDOWN FLIP LOWDOWN FLIP US size 8 JCH107333,FBALYB Amazon,20,20,0,0,0,0
,Chaco Men LOWDOWN FLIP LOWDOWN FLIP US size 9 JCH107325,Chaco Men LOWDOWN FLIP LOWDOWN FLIP US size 9 JCH107325,Default Ridgefield,67,67,0,0,0,0
,Chaco Men LOWDOWN FLIP LOWDOWN FLIP US size 9 JCH107331,Chaco Men LOWDOWN FLIP LOWDOWN FLIP US size 9 JCH107331,Default Ridgefield,1,1,0,0,0,0
,Chaco Men LOWDOWN FLIP LOWDOWN FLIP US size 9 JCH107331,Chaco Men LOWDOWN FLIP LOWDOWN FLIP US size 9 JCH107331,FBALYB Amazon,55,55,0,0,0,0
,Chaco Men LOWDOWN FLIP LOWDOWN FLIP US size 9 JCH107333,Chaco Men LOWDOWN FLIP LOWDOWN FLIP US size 9 JCH107333,FBALYB Amazon,30,30,0,0,0,0
,Chaco Men LOWDOWN SLIDE LOWDOWN SLIDE US size 10 JCH107123,Chaco Men LOWDOWN SLIDE LOWDOWN SLIDE US size 10 JCH107123,Default Ridgefield,1,1,0,0,0,0
,Chaco Men LOWDOWN SLIDE LOWDOWN SLIDE US size 10 JCH107123,Chaco Men LOWDOWN SLIDE LOWDOWN SLIDE US size 10 JCH107123,FBALYB Amazon,66,66,0,0,0,0
,Chaco Men LOWDOWN SLIDE LOWDOWN SLIDE US size 11 JCH107123,Chaco Men LOWDOWN SLIDE LOWDOWN SLIDE US size 11 JCH107123,FBALYB Amazon,43,43,0,0,0,0
,Chaco Men LOWDOWN SLIDE LOWDOWN SLIDE US size 12 JCH107123,Chaco Men LOWDOWN SLIDE LOWDOWN SLIDE US size 12 JCH107123,Default Ridgefield,1,1,0,0,0,0
,Chaco Men LOWDOWN SLIDE LOWDOWN SLIDE US size 12 JCH107123,Chaco Men LOWDOWN SLIDE LOWDOWN SLIDE US size 12 JCH107123,FBALYB Amazon,50,50,0,0,0,0
,Chaco Men LOWDOWN SLIDE LOWDOWN SLIDE US size 13 JCH107123,Chaco Men LOWDOWN SLIDE LOWDOWN SLIDE US size 13 JCH107123,FBALYB Amazon,46,46,0,0,0,0
,Chaco Men LOWDOWN SLIDE LOWDOWN SLIDE US size 14 JCH107123,Chaco Men LOWDOWN SLIDE LOWDOWN SLIDE US size 14 JCH107123,FBALYB Amazon,12,11,1,0,1,0
,Chaco Men LOWDOWN SLIDE LOWDOWN SLIDE US size 8 JCH107123,Chaco Men LOWDOWN SLIDE LOWDOWN SLIDE US size 8 JCH107123,Default Ridgefield,18,18,0,0,0,0
,Chaco Men LOWDOWN SLIDE LOWDOWN SLIDE US size 8 JCH107123,Chaco Men LOWDOWN SLIDE LOWDOWN SLIDE US size 8 JCH107123,FBALYB Amazon,0,0,0,10,0,0
,Chaco Men LOWDOWN SLIDE LOWDOWN SLIDE US size 9 JCH107123,Chaco Men LOWDOWN SLIDE LOWDOWN SLIDE US size 9 JCH107123,FBALYB Amazon,54,54,0,0,0,0
,Chaco ODYSSEY/BLACK US size: W10 Width:M J107030,Chaco ODYSSEY/BLACK US size: W10 Width:M J107030,FBALYB Amazon,-2,-2,0,0,0,0
,Chaco ODYSSEY/BLACK US size: W11 Width:M J107030,Chaco ODYSSEY/BLACK US size: W11 Width:M J107030,FBALYB Amazon,-3,-3,0,0,0,0
,Chaco ODYSSEY/BLACK US size: W7 Width:M J107030,Chaco ODYSSEY/BLACK US size: W7 Width:M J107030,FBALYB Amazon,-1,-1,0,0,0,0
,Chaco ODYSSEY/BLACK US size: W8 Width:M J107030,Chaco ODYSSEY/BLACK US size: W8 Width:M J107030,FBALYB Amazon,-3,-3,0,0,0,0
,Chaco TULIP/BLACK US size: W6 Width:M JCH107914,Chaco TULIP/BLACK US size: W6 Width:M JCH107914,FBALYB Amazon,-2,-2,0,0,0,0
,Chaco TULIP/BLACK US size: W7 Width:M JCH107914,Chaco TULIP/BLACK US size: W7 Width:M JCH107914,FBALYB Amazon,-6,-6,0,0,0,0
,Chaco TULIP/BLACK US size: W9 Width:M JCH107914,Chaco TULIP/BLACK US size: W9 Width:M JCH107914,FBALYB Amazon,-3,-3,0,0,0,0
,Chaco Women CHILLOS SLIDE CHILLOS SLIDE Size 10 JCH107818,Chaco Women CHILLOS SLIDE CHILLOS SLIDE Size 10 JCH107818,FBALYB Amazon,-4,-5,1,0,1,0
,Chaco Women CHILLOS SLIDE CHILLOS SLIDE Size 10 JCH107820,Chaco Women CHILLOS SLIDE CHILLOS SLIDE Size 10 JCH107820,FBALYB Amazon,32,32,0,0,0,0
,Chaco Women CHILLOS SLIDE CHILLOS SLIDE Size 10 JCH107824,Chaco Women CHILLOS SLIDE CHILLOS SLIDE Size 10 JCH107824,FBALYB Amazon,3,3,0,0,0,0
,Chaco Women CHILLOS SLIDE CHILLOS SLIDE Size 10 JCH108144,Chaco Women CHILLOS SLIDE CHILLOS SLIDE Size 10 JCH108144,FBALYB Amazon,1,1,0,0,0,0
,Chaco Women CHILLOS SLIDE CHILLOS SLIDE Size 11 JCH107818,Chaco Women CHILLOS SLIDE CHILLOS SLIDE Size 11 JCH107818,FBALYB Amazon,-1,-1,0,0,0,0
,Chaco Women CHILLOS SLIDE CHILLOS SLIDE Size 11 JCH108144,Chaco Women CHILLOS SLIDE CHILLOS SLIDE Size 11 JCH108144,FBALYB Amazon,21,20,1,0,1,0
,Chaco Women CHILLOS SLIDE CHILLOS SLIDE Size 6 JCH107818,Chaco Women CHILLOS SLIDE CHILLOS SLIDE Size 6 JCH107818,FBALYB Amazon,-3,-3,0,0,0,0
,Chaco Women CHILLOS SLIDE CHILLOS SLIDE Size 6 JCH107820,Chaco Women CHILLOS SLIDE CHILLOS SLIDE Size 6 JCH107820,FBALYB Amazon,16,16,0,0,0,0
,Chaco Women CHILLOS SLIDE CHILLOS SLIDE Size 6 JCH107824,Chaco Women CHILLOS SLIDE CHILLOS SLIDE Size 6 JCH107824,FBALYB Amazon,3,2,1,0,1,0
,Chaco Women CHILLOS SLIDE CHILLOS SLIDE Size 6 JCH108144,Chaco Women CHILLOS SLIDE CHILLOS SLIDE Size 6 JCH108144,FBALYB Amazon,23,23,0,0,0,0
,Chaco Women CHILLOS SLIDE CHILLOS SLIDE Size 7 JCH107818,Chaco Women CHILLOS SLIDE CHILLOS SLIDE Size 7 JCH107818,FBALYB Amazon,-10,-11,1,0,1,0
,Chaco Women CHILLOS SLIDE CHILLOS SLIDE Size 7 JCH107820,Chaco Women CHILLOS SLIDE CHILLOS SLIDE Size 7 JCH107820,FBALYB Amazon,-8,-10,2,0,2,0
,Chaco Women CHILLOS SLIDE CHILLOS SLIDE Size 7 JCH107824,Chaco Women CHILLOS SLIDE CHILLOS SLIDE Size 7 JCH107824,FBALYB Amazon,8,8,0,0,0,0
,Chaco Women CHILLOS SLIDE CHILLOS SLIDE Size 7 JCH108144,Chaco Women CHILLOS SLIDE CHILLOS SLIDE Size 7 JCH108144,FBALYB Amazon,45,45,0,0,0,0
,Chaco Women CHILLOS SLIDE CHILLOS SLIDE Size 8 JCH107818,Chaco Women CHILLOS SLIDE CHILLOS SLIDE Size 8 JCH107818,FBALYB Amazon,18,18,0,0,0,0
,Chaco Women CHILLOS SLIDE CHILLOS SLIDE Size 8 JCH107820,Chaco Women CHILLOS SLIDE CHILLOS SLIDE Size 8 JCH107820,FBALYB Amazon,-2,-3,1,0,1,0
,Chaco Women CHILLOS SLIDE CHILLOS SLIDE Size 8 JCH107824,Chaco Women CHILLOS SLIDE CHILLOS SLIDE Size 8 JCH107824,Default Ridgefield,1,1,0,0,0,0
,Chaco Women CHILLOS SLIDE CHILLOS SLIDE Size 8 JCH107824,Chaco Women CHILLOS SLIDE CHILLOS SLIDE Size 8 JCH107824,FBALYB Amazon,-7,-7,0,0,0,0
,Chaco Women CHILLOS SLIDE CHILLOS SLIDE Size 8 JCH108144,Chaco Women CHILLOS SLIDE CHILLOS SLIDE Size 8 JCH108144,FBALYB Amazon,42,41,1,0,1,0
,Chaco Women CHILLOS SLIDE CHILLOS SLIDE Size 9 JCH107818,Chaco Women CHILLOS SLIDE CHILLOS SLIDE Size 9 JCH107818,FBALYB Amazon,-8,-8,0,0,0,0
,Chaco Women CHILLOS SLIDE CHILLOS SLIDE Size 9 JCH107820,Chaco Women CHILLOS SLIDE CHILLOS SLIDE Size 9 JCH107820,FBALYB Amazon,-2,-3,1,0,1,0
,Chaco Women CHILLOS SLIDE CHILLOS SLIDE Size 9 JCH107824,Chaco Women CHILLOS SLIDE CHILLOS SLIDE Size 9 JCH107824,FBALYB Amazon,-8,-9,1,0,1,0
,Chaco Women CHILLOS SLIDE CHILLOS SLIDE Size 9 JCH108144,Chaco Women CHILLOS SLIDE CHILLOS SLIDE Size 9 JCH108144,FBALYB Amazon,15,14,1,0,1,0
,Chaco Women LOWDOWN FLIP LOWDOWN FLIP US size 10 JCH108132,Chaco Women LOWDOWN FLIP LOWDOWN FLIP US size 10 JCH108132,Default Ridgefield,16,16,0,0,0,0
,Chaco Women LOWDOWN FLIP LOWDOWN FLIP US size 10 JCH108132,Chaco Women LOWDOWN FLIP LOWDOWN FLIP US size 10 JCH108132,FBALYB Amazon,22,21,1,0,1,0
,Chaco Women LOWDOWN FLIP LOWDOWN FLIP US size 10 JCH108222,Chaco Women LOWDOWN FLIP LOWDOWN FLIP US size 10 JCH108222,FBALYB Amazon,38,38,0,0,0,0
,Chaco Women LOWDOWN FLIP LOWDOWN FLIP US size 11 JCH108222,Chaco Women LOWDOWN FLIP LOWDOWN FLIP US size 11 JCH108222,FBALYB Amazon,11,11,0,0,0,0
,Chaco Women LOWDOWN FLIP LOWDOWN FLIP US size 6 JCH108132,Chaco Women LOWDOWN FLIP LOWDOWN FLIP US size 6 JCH108132,Default Ridgefield,18,18,0,0,0,0
,Chaco Women LOWDOWN FLIP LOWDOWN FLIP US size 6 JCH108132,Chaco Women LOWDOWN FLIP LOWDOWN FLIP US size 6 JCH108132,FBALYB Amazon,0,0,0,10,0,0
,Chaco Women LOWDOWN FLIP LOWDOWN FLIP US size 6 JCH108222,Chaco Women LOWDOWN FLIP LOWDOWN FLIP US size 6 JCH108222,Default Ridgefield,5,5,0,0,0,0
,Chaco Women LOWDOWN FLIP LOWDOWN FLIP US size 6 JCH108222,Chaco Women LOWDOWN FLIP LOWDOWN FLIP US size 6 JCH108222,FBALYB Amazon,22,22,0,0,0,0
,Chaco Women LOWDOWN FLIP LOWDOWN FLIP US size 7 JCH108132,Chaco Women LOWDOWN FLIP LOWDOWN FLIP US size 7 JCH108132,Default Ridgefield,63,63,0,0,0,0
,Chaco Women LOWDOWN FLIP LOWDOWN FLIP US size 7 JCH108132,Chaco Women LOWDOWN FLIP LOWDOWN FLIP US size 7 JCH108132,FBALYB Amazon,0,0,0,20,0,0
,Chaco Women LOWDOWN FLIP LOWDOWN FLIP US size 7 JCH108222,Chaco Women LOWDOWN FLIP LOWDOWN FLIP US size 7 JCH108222,FBALYB Amazon,76,75,1,0,1,0
,Chaco Women LOWDOWN FLIP LOWDOWN FLIP US size 8 JCH108132,Chaco Women LOWDOWN FLIP LOWDOWN FLIP US size 8 JCH108132,Default Ridgefield,109,109,0,0,0,0
,Chaco Women LOWDOWN FLIP LOWDOWN FLIP US size 8 JCH108132,Chaco Women LOWDOWN FLIP LOWDOWN FLIP US size 8 JCH108132,FBALYB Amazon,0,0,0,19,0,0
,Chaco Women LOWDOWN FLIP LOWDOWN FLIP US size 8 JCH108222,Chaco Women LOWDOWN FLIP LOWDOWN FLIP US size 8 JCH108222,FBALYB Amazon,117,117,0,0,0,0
,Chaco Women LOWDOWN FLIP LOWDOWN FLIP US size 9 JCH108132,Chaco Women LOWDOWN FLIP LOWDOWN FLIP US size 9 JCH108132,FBALYB Amazon,51,48,3,0,3,0
,Chaco Women LOWDOWN FLIP LOWDOWN FLIP US size 9 JCH108222,Chaco Women LOWDOWN FLIP LOWDOWN FLIP US size 9 JCH108222,FBALYB Amazon,66,66,0,0,0,0
,Chaco Women LOWDOWN SANDAL LOWDOWN SANDAL US size 10 JCH108086,Chaco Women LOWDOWN SANDAL LOWDOWN SANDAL US size 10 JCH108086,FBALYB Amazon,41,41,0,0,0,0
,Chaco Women LOWDOWN SANDAL LOWDOWN SANDAL US size 10 JCH108090,Chaco Women LOWDOWN SANDAL LOWDOWN SANDAL US size 10 JCH108090,FBALYB Amazon,36,36,0,0,0,0
,Chaco Women LOWDOWN SANDAL LOWDOWN SANDAL US size 11 JCH108086,Chaco Women LOWDOWN SANDAL LOWDOWN SANDAL US size 11 JCH108086,FBALYB Amazon,0,0,0,12,0,0
,Chaco Women LOWDOWN SANDAL LOWDOWN SANDAL US size 11 JCH108090,Chaco Women LOWDOWN SANDAL LOWDOWN SANDAL US size 11 JCH108090,FBALYB Amazon,18,18,0,0,0,0
,Chaco Women LOWDOWN SANDAL LOWDOWN SANDAL US size 6 JCH108086,Chaco Women LOWDOWN SANDAL LOWDOWN SANDAL US size 6 JCH108086,FBALYB Amazon,21,21,0,0,0,0
,Chaco Women LOWDOWN SANDAL LOWDOWN SANDAL US size 6 JCH108090,Chaco Women LOWDOWN SANDAL LOWDOWN SANDAL US size 6 JCH108090,FBALYB Amazon,19,19,0,0,0,0
,Chaco Women LOWDOWN SANDAL LOWDOWN SANDAL US size 7 JCH108086,Chaco Women LOWDOWN SANDAL LOWDOWN SANDAL US size 7 JCH108086,FBALYB Amazon,69,69,0,0,0,0
,Chaco Women LOWDOWN SANDAL LOWDOWN SANDAL US size 7 JCH108090,Chaco Women LOWDOWN SANDAL LOWDOWN SANDAL US size 7 JCH108090,FBALYB Amazon,55,55,0,0,0,0
,Chaco Women LOWDOWN SANDAL LOWDOWN SANDAL US size 8 JCH108086,Chaco Women LOWDOWN SANDAL LOWDOWN SANDAL US size 8 JCH108086,FBALYB Amazon,104,103,1,0,1,0
,Chaco Women LOWDOWN SANDAL LOWDOWN SANDAL US size 8 JCH108090,Chaco Women LOWDOWN SANDAL LOWDOWN SANDAL US size 8 JCH108090,FBALYB Amazon,71,70,1,0,1,0
,Chaco Women LOWDOWN SANDAL LOWDOWN SANDAL US size 9 JCH108086,Chaco Women LOWDOWN SANDAL LOWDOWN SANDAL US size 9 JCH108086,FBALYB Amazon,51,50,1,0,1,0
,Chaco Women LOWDOWN SANDAL LOWDOWN SANDAL US size 9 JCH108090,Chaco Women LOWDOWN SANDAL LOWDOWN SANDAL US size 9 JCH108090,FBALYB Amazon,48,48,0,0,0,0
,Chaco Women LOWDOWN SLIDE LOWDOWN SLIDE US size 10 JCH107854,Chaco Women LOWDOWN SLIDE LOWDOWN SLIDE US size 10 JCH107854,FBALYB Amazon,40,40,0,0,0,0
,Chaco Women LOWDOWN SLIDE LOWDOWN SLIDE US size 10 JCH107856,Chaco Women LOWDOWN SLIDE LOWDOWN SLIDE US size 10 JCH107856,FBALYB Amazon,35,34,1,0,1,0
,Chaco Women LOWDOWN SLIDE LOWDOWN SLIDE US size 10 JCH107858,Chaco Women LOWDOWN SLIDE LOWDOWN SLIDE US size 10 JCH107858,FBALYB Amazon,41,41,0,0,0,0
,Chaco Women LOWDOWN SLIDE LOWDOWN SLIDE US size 11 JCH107854,Chaco Women LOWDOWN SLIDE LOWDOWN SLIDE US size 11 JCH107854,FBALYB Amazon,29,29,0,0,0,0
,Chaco Women LOWDOWN SLIDE LOWDOWN SLIDE US size 11 JCH107856,Chaco Women LOWDOWN SLIDE LOWDOWN SLIDE US size 11 JCH107856,Default Ridgefield,2,2,0,0,0,0
,Chaco Women LOWDOWN SLIDE LOWDOWN SLIDE US size 11 JCH107856,Chaco Women LOWDOWN SLIDE LOWDOWN SLIDE US size 11 JCH107856,FBALYB Amazon,28,28,0,0,0,0
,Chaco Women LOWDOWN SLIDE LOWDOWN SLIDE US size 11 JCH107858,Chaco Women LOWDOWN SLIDE LOWDOWN SLIDE US size 11 JCH107858,FBALYB Amazon,16,16,0,0,0,0
,Chaco Women LOWDOWN SLIDE LOWDOWN SLIDE US size 6 JCH107854,Chaco Women LOWDOWN SLIDE LOWDOWN SLIDE US size 6 JCH107854,Default Ridgefield,5,5,0,0,0,0
,Chaco Women LOWDOWN SLIDE LOWDOWN SLIDE US size 6 JCH107854,Chaco Women LOWDOWN SLIDE LOWDOWN SLIDE US size 6 JCH107854,FBALYB Amazon,24,24,0,0,0,0
,Chaco Women LOWDOWN SLIDE LOWDOWN SLIDE US size 6 JCH107856,Chaco Women LOWDOWN SLIDE LOWDOWN SLIDE US size 6 JCH107856,FBALYB Amazon,27,27,0,0,0,0
,Chaco Women LOWDOWN SLIDE LOWDOWN SLIDE US size 6 JCH107858,Chaco Women LOWDOWN SLIDE LOWDOWN SLIDE US size 6 JCH107858,FBALYB Amazon,21,21,0,0,0,0
,Chaco Women LOWDOWN SLIDE LOWDOWN SLIDE US size 7 JCH107854,Chaco Women LOWDOWN SLIDE LOWDOWN SLIDE US size 7 JCH107854,FBALYB Amazon,55,55,0,0,0,0
,Chaco Women LOWDOWN SLIDE LOWDOWN SLIDE US size 7 JCH107856,Chaco Women LOWDOWN SLIDE LOWDOWN SLIDE US size 7 JCH107856,Default Ridgefield,37,37,0,0,0,0
,Chaco Women LOWDOWN SLIDE LOWDOWN SLIDE US size 7 JCH107856,Chaco Women LOWDOWN SLIDE LOWDOWN SLIDE US size 7 JCH107856,FBALYB Amazon,0,0,0,20,0,0
,Chaco Women LOWDOWN SLIDE LOWDOWN SLIDE US size 7 JCH107858,Chaco Women LOWDOWN SLIDE LOWDOWN SLIDE US size 7 JCH107858,FBALYB Amazon,76,76,0,0,0,0
,Chaco Women LOWDOWN SLIDE LOWDOWN SLIDE US size 8 JCH107854,Chaco Women LOWDOWN SLIDE LOWDOWN SLIDE US size 8 JCH107854,FBALYB Amazon,78,78,0,0,0,0
,Chaco Women LOWDOWN SLIDE LOWDOWN SLIDE US size 8 JCH107856,Chaco Women LOWDOWN SLIDE LOWDOWN SLIDE US size 8 JCH107856,Default Ridgefield,1,1,0,0,0,0
,Chaco Women LOWDOWN SLIDE LOWDOWN SLIDE US size 8 JCH107856,Chaco Women LOWDOWN SLIDE LOWDOWN SLIDE US size 8 JCH107856,FBALYB Amazon,68,68,0,0,0,0
,Chaco Women LOWDOWN SLIDE LOWDOWN SLIDE US size 8 JCH107858,Chaco Women LOWDOWN SLIDE LOWDOWN SLIDE US size 8 JCH107858,Default Ridgefield,3,3,0,0,0,0
,Chaco Women LOWDOWN SLIDE LOWDOWN SLIDE US size 8 JCH107858,Chaco Women LOWDOWN SLIDE LOWDOWN SLIDE US size 8 JCH107858,FBALYB Amazon,104,104,0,0,0,0
,Chaco Women LOWDOWN SLIDE LOWDOWN SLIDE US size 9 JCH107854,Chaco Women LOWDOWN SLIDE LOWDOWN SLIDE US size 9 JCH107854,FBALYB Amazon,57,57,0,0,0,0
,Chaco Women LOWDOWN SLIDE LOWDOWN SLIDE US size 9 JCH107856,Chaco Women LOWDOWN SLIDE LOWDOWN SLIDE US size 9 JCH107856,Default Ridgefield,37,37,0,0,0,0
,Chaco Women LOWDOWN SLIDE LOWDOWN SLIDE US size 9 JCH107856,Chaco Women LOWDOWN SLIDE LOWDOWN SLIDE US size 9 JCH107856,FBALYB Amazon,0,0,0,20,0,0
,Chaco Women LOWDOWN SLIDE LOWDOWN SLIDE US size 9 JCH107858,Chaco Women LOWDOWN SLIDE LOWDOWN SLIDE US size 9 JCH107858,Default Ridgefield,1,1,0,0,0,0
,Chaco Women LOWDOWN SLIDE LOWDOWN SLIDE US size 9 JCH107858,Chaco Women LOWDOWN SLIDE LOWDOWN SLIDE US size 9 JCH107858,FBALYB Amazon,75,75,0,0,0,0
,Chaco Women MEGA Z CLOUD MEGA Z CLOUD US size 10 J107076,Chaco Women MEGA Z CLOUD MEGA Z CLOUD US size 10 J107076,FBALYB Amazon,30,30,0,0,0,0
,Chaco Women MEGA Z CLOUD MEGA Z CLOUD US size 10 J107078,Chaco Women MEGA Z CLOUD MEGA Z CLOUD US size 10 J107078,Default Ridgefield,40,40,0,0,0,0
,Chaco Women MEGA Z CLOUD MEGA Z CLOUD US size 11 J107076,Chaco Women MEGA Z CLOUD MEGA Z CLOUD US size 11 J107076,Default Ridgefield,23,23,0,0,0,0
,Chaco Women MEGA Z CLOUD MEGA Z CLOUD US size 11 J107078,Chaco Women MEGA Z CLOUD MEGA Z CLOUD US size 11 J107078,Default Ridgefield,12,12,0,0,0,0
,Chaco Women MEGA Z CLOUD MEGA Z CLOUD US size 6 J107076,Chaco Women MEGA Z CLOUD MEGA Z CLOUD US size 6 J107076,FBALYB Amazon,0,0,0,29,0,0
,Chaco Women MEGA Z CLOUD MEGA Z CLOUD US size 6 J107078,Chaco Women MEGA Z CLOUD MEGA Z CLOUD US size 6 J107078,Default Ridgefield,18,18,0,0,0,0
,Chaco Women MEGA Z CLOUD MEGA Z CLOUD US size 7 J107076,Chaco Women MEGA Z CLOUD MEGA Z CLOUD US size 7 J107076,Default Ridgefield,33,33,0,0,0,0
,Chaco Women MEGA Z CLOUD MEGA Z CLOUD US size 7 J107076,Chaco Women MEGA Z CLOUD MEGA Z CLOUD US size 7 J107076,FBALYB Amazon,0,0,0,20,0,0
,Chaco Women MEGA Z CLOUD MEGA Z CLOUD US size 7 J107078,Chaco Women MEGA Z CLOUD MEGA Z CLOUD US size 7 J107078,Default Ridgefield,69,69,0,0,0,0
,Chaco Women MEGA Z CLOUD MEGA Z CLOUD US size 8 J107076,Chaco Women MEGA Z CLOUD MEGA Z CLOUD US size 8 J107076,Default Ridgefield,41,41,0,0,0,0
,Chaco Women MEGA Z CLOUD MEGA Z CLOUD US size 8 J107076,Chaco Women MEGA Z CLOUD MEGA Z CLOUD US size 8 J107076,FBALYB Amazon,0,0,0,20,0,0
,Chaco Women MEGA Z CLOUD MEGA Z CLOUD US size 8 J107078,Chaco Women MEGA Z CLOUD MEGA Z CLOUD US size 8 J107078,Default Ridgefield,85,85,0,0,0,0
,Chaco Women MEGA Z CLOUD MEGA Z CLOUD US size 8 J107078,Chaco Women MEGA Z CLOUD MEGA Z CLOUD US size 8 J107078,FBALYB Amazon,0,0,0,20,0,0
,Chaco Women MEGA Z CLOUD MEGA Z CLOUD US size 9 J107076,Chaco Women MEGA Z CLOUD MEGA Z CLOUD US size 9 J107076,Default Ridgefield,34,34,0,0,0,0
,Chaco Women MEGA Z CLOUD MEGA Z CLOUD US size 9 J107076,Chaco Women MEGA Z CLOUD MEGA Z CLOUD US size 9 J107076,FBALYB Amazon,0,0,0,20,0,0
,Chaco Women MEGA Z CLOUD MEGA Z CLOUD US size 9 J107078,Chaco Women MEGA Z CLOUD MEGA Z CLOUD US size 9 J107078,Default Ridgefield,49,49,0,0,0,0
,Chaco Women MEGA Z CLOUD MEGA Z CLOUD US size 9 J107078,Chaco Women MEGA Z CLOUD MEGA Z CLOUD US size 9 J107078,FBALYB Amazon,0,0,0,20,0,0
,Chaco Women Z1 CLASSIC Z1 CLASSIC US size 10 JCH107628,Chaco Women Z1 CLASSIC Z1 CLASSIC US size 10 JCH107628,FBALYB Amazon,0,0,0,33,0,0
,Chaco Women Z1 CLASSIC Z1 CLASSIC US size 11 JCH107628,Chaco Women Z1 CLASSIC Z1 CLASSIC US size 11 JCH107628,FBALYB Amazon,0,0,0,12,0,0
,Chaco Women Z1 CLASSIC Z1 CLASSIC US size 6 JCH107628,Chaco Women Z1 CLASSIC Z1 CLASSIC US size 6 JCH107628,FBALYB Amazon,0,0,0,18,0,0
,Chaco Women Z1 CLASSIC Z1 CLASSIC US size 7 JCH107628,Chaco Women Z1 CLASSIC Z1 CLASSIC US size 7 JCH107628,FBALYB Amazon,0,0,0,64,0,0
,Chaco Women Z1 CLASSIC Z1 CLASSIC US size 8 JCH107628,Chaco Women Z1 CLASSIC Z1 CLASSIC US size 8 JCH107628,FBALYB Amazon,78,77,1,0,1,0
,Chaco Women Z1 CLASSIC Z1 CLASSIC US size 9 JCH107628,Chaco Women Z1 CLASSIC Z1 CLASSIC US size 9 JCH107628,FBALYB Amazon,0,0,0,63,0,0
,Chaco Z1 CLASSIC/BLACK US Size: M11 Widht: M J105375,Chaco Z1 CLASSIC/BLACK US Size: M11 Widht: M J105375,Default Ridgefield,0,0,0,0,0,72
,Chaco Z1 CLASSIC/BLACK US Size: M11 Widht: M J105375,Chaco Z1 CLASSIC/BLACK US Size: M11 Widht: M J105375,FBALYB Amazon,-9,-9,0,0,0,0
,Chaco Z1 CLASSIC/BLACK US Size: M11 Widht: W J105375W,Chaco Z1 CLASSIC/BLACK US Size: M11 Widht: W J105375W,Default Ridgefield,0,0,0,0,0,59
,Chaco Z1 CLASSIC/BLACK US Size: M11 Widht: W J105375W,Chaco Z1 CLASSIC/BLACK US Size: M11 Widht: W J105375W,FBALYB Amazon,-2,-2,0,0,0,0
,Chaco Z1 CLASSIC/BLACK US Size: M9 Widht: W J105375W,Chaco Z1 CLASSIC/BLACK US Size: M9 Widht: W J105375W,Default Ridgefield,0,0,0,0,0,102
,Chaco Z1 CLASSIC/BLACK US Size: M9 Widht: W J105375W,Chaco Z1 CLASSIC/BLACK US Size: M9 Widht: W J105375W,FBALYB Amazon,-12,-13,1,0,1,0
,Chaco Z1 CLASSIC/BLACK US Size: W10 Widht: M J105414,Chaco Z1 CLASSIC/BLACK US Size: W10 Widht: M J105414,Default Ridgefield,0,0,0,0,0,78
,Chaco Z1 CLASSIC/BLACK US Size: W10 Widht: M J105414,Chaco Z1 CLASSIC/BLACK US Size: W10 Widht: M J105414,FBALYB Amazon,-31,-31,0,0,0,0
,Chaco Z1 CLASSIC/BLACK US size: W11 Width:M J105414,Chaco Z1 CLASSIC/BLACK US size: W11 Width:M J105414,Default Ridgefield,0,0,0,0,0,24
,Chaco Z1 CLASSIC/BLACK US size: W11 Width:M J105414,Chaco Z1 CLASSIC/BLACK US size: W11 Width:M J105414,FBALYB Amazon,-9,-9,0,0,0,0
,Chaco Z1 CLASSIC/BLACK US size: W12 Width:M J105414,Chaco Z1 CLASSIC/BLACK US size: W12 Width:M J105414,FBALYB Amazon,-4,-4,0,0,0,0
,Chaco Z1 CLASSIC/BLACK US size: W5 Width:M J105414,Chaco Z1 CLASSIC/BLACK US size: W5 Width:M J105414,FBALYB Amazon,-9,-9,0,0,0,0
,Chaco Z1 CLASSIC/BLACK US Size: W6 Widht: M J105414,Chaco Z1 CLASSIC/BLACK US Size: W6 Widht: M J105414,Default Ridgefield,0,0,0,0,0,36
,Chaco Z1 CLASSIC/BLACK US Size: W6 Widht: M J105414,Chaco Z1 CLASSIC/BLACK US Size: W6 Widht: M J105414,FBALYB Amazon,-20,-20,0,0,0,0
,Chaco Z1 CLASSIC/BLACK US Size: W7 Widht: M J105414,Chaco Z1 CLASSIC/BLACK US Size: W7 Widht: M J105414,Default,2,2,0,0,0,0
,Chaco Z1 CLASSIC/BLACK US Size: W7 Widht: M J105414,Chaco Z1 CLASSIC/BLACK US Size: W7 Widht: M J105414,Default Ridgefield,0,0,0,0,0,132
,Chaco Z1 CLASSIC/BLACK US Size: W7 Widht: M J105414,Chaco Z1 CLASSIC/BLACK US Size: W7 Widht: M J105414,FBALYB Amazon,-46,-46,0,0,0,0
,Chaco Z1 CLASSIC/BLACK US Size: W7 Widht: W J105414W,Chaco Z1 CLASSIC/BLACK US Size: W7 Widht: W J105414W,Default Ridgefield,1,1,0,0,0,63
,Chaco Z1 CLASSIC/BLACK US Size: W7 Widht: W J105414W,Chaco Z1 CLASSIC/BLACK US Size: W7 Widht: W J105414W,FBALYB Amazon,-26,-26,0,0,0,0
,Chaco Z1 CLASSIC/BLACK US Size: W8 Widht: M J105414,Chaco Z1 CLASSIC/BLACK US Size: W8 Widht: M J105414,Default,3,3,0,0,0,0
,Chaco Z1 CLASSIC/BLACK US Size: W8 Widht: M J105414,Chaco Z1 CLASSIC/BLACK US Size: W8 Widht: M J105414,Default Ridgefield,0,0,0,0,0,198
,Chaco Z1 CLASSIC/BLACK US Size: W8 Widht: M J105414,Chaco Z1 CLASSIC/BLACK US Size: W8 Widht: M J105414,FBALYB Amazon,-30,-30,0,0,0,0
,Chaco Z1 CLASSIC/BLACK US Size: W8 Widht: W J105414W,Chaco Z1 CLASSIC/BLACK US Size: W8 Widht: W J105414W,Default Ridgefield,0,0,0,0,0,90
,Chaco Z1 CLASSIC/BLACK US Size: W8 Widht: W J105414W,Chaco Z1 CLASSIC/BLACK US Size: W8 Widht: W J105414W,FBALYB Amazon,-21,-21,0,0,0,0
,Chaco Z1 CLASSIC/BLACK US Size: W9 Widht: M J105414,Chaco Z1 CLASSIC/BLACK US Size: W9 Widht: M J105414,Default Ridgefield,0,0,0,0,0,132
,Chaco Z1 CLASSIC/BLACK US Size: W9 Widht: M J105414,Chaco Z1 CLASSIC/BLACK US Size: W9 Widht: M J105414,FBALYB Amazon,-37,-37,0,0,0,0
,Chaco Z1 CLASSIC/SPLIT GRAY US Size: M10 Widht: M J105961,Chaco Z1 CLASSIC/SPLIT GRAY US Size: M10 Widht: M J105961,Default Ridgefield,0,0,0,0,0,96
,Chaco Z1 CLASSIC/SPLIT GRAY US Size: M10 Widht: W J105961W,Chaco Z1 CLASSIC/SPLIT GRAY US Size: M10 Widht: W J105961W,Default Ridgefield,0,0,0,0,0,96
,Chaco Z1 CLASSIC/SPLIT GRAY US Size: M10 Widht: W J105961W,Chaco Z1 CLASSIC/SPLIT GRAY US Size: M10 Widht: W J105961W,FBALYB Amazon,-8,-8,0,0,0,0
,Chaco Z1 CLASSIC/SPLIT GRAY US Size: M12 Widht: M J105961,Chaco Z1 CLASSIC/SPLIT GRAY US Size: M12 Widht: M J105961,Default Ridgefield,0,0,0,0,0,72
,Chaco Z1 CLASSIC/SPLIT GRAY US Size: M12 Widht: M J105961,Chaco Z1 CLASSIC/SPLIT GRAY US Size: M12 Widht: M J105961,FBALYB Amazon,-3,-3,0,0,0,0
,Chaco Z1 CLASSIC/SPLIT GRAY US Size: M8 Widht: M J105961,Chaco Z1 CLASSIC/SPLIT GRAY US Size: M8 Widht: M J105961,Default Ridgefield,0,0,0,0,0,36
,Chaco Z1 CLASSIC/SPLIT GRAY US Size: M8 Widht: M J105961,Chaco Z1 CLASSIC/SPLIT GRAY US Size: M8 Widht: M J105961,FBALYB Amazon,-2,-2,0,0,0,0
,Chaco Z1 CLASSIC/SPLIT GRAY US Size: M9 Widht: M J105961,Chaco Z1 CLASSIC/SPLIT GRAY US Size: M9 Widht: M J105961,Default Ridgefield,0,0,0,0,0,84
,Chaco Z1 CLASSIC/SPLIT GRAY US Size: M9 Widht: M J105961,Chaco Z1 CLASSIC/SPLIT GRAY US Size: M9 Widht: M J105961,FBALYB Amazon,-12,-12,0,0,0,0
,Chaco Z1 CLASSIC/SPLIT GRAY US Size: M9 Widht: W J105961W,Chaco Z1 CLASSIC/SPLIT GRAY US Size: M9 Widht: W J105961W,Default Ridgefield,0,0,0,0,0,84
,Chaco Z1 CLASSIC/SPLIT GRAY US Size: M9 Widht: W J105961W,Chaco Z1 CLASSIC/SPLIT GRAY US Size: M9 Widht: W J105961W,FBALYB Amazon,-4,-4,0,0,0,0
,Chaco Z2 CLASSIC/BLACK US Size: M10 Widht: M J105427,Chaco Z2 CLASSIC/BLACK US Size: M10 Widht: M J105427,Default Ridgefield,0,0,0,0,0,72
,Chaco Z2 CLASSIC/BLACK US Size: M10 Widht: M J105427,Chaco Z2 CLASSIC/BLACK US Size: M10 Widht: M J105427,FBALYB Amazon,-22,-22,0,0,0,0
,Chaco Z2 CLASSIC/BLACK US Size: M11 Widht: M J105427,Chaco Z2 CLASSIC/BLACK US Size: M11 Widht: M J105427,Default Ridgefield,0,0,0,0,0,54
,Chaco Z2 CLASSIC/BLACK US Size: M11 Widht: M J105427,Chaco Z2 CLASSIC/BLACK US Size: M11 Widht: M J105427,FBALYB Amazon,-11,-11,0,0,0,0
,Chaco Z2 CLASSIC/BLACK US Size: M12 Widht: M J105427,Chaco Z2 CLASSIC/BLACK US Size: M12 Widht: M J105427,Default Ridgefield,0,0,0,0,0,54
,Chaco Z2 CLASSIC/BLACK US Size: M12 Widht: M J105427,Chaco Z2 CLASSIC/BLACK US Size: M12 Widht: M J105427,FBALYB Amazon,-8,-8,0,0,0,0
,Chaco Z2 CLASSIC/BLACK US Size: M13 Widht: M J105427,Chaco Z2 CLASSIC/BLACK US Size: M13 Widht: M J105427,Default Ridgefield,0,0,0,0,0,48
,Chaco Z2 CLASSIC/BLACK US Size: M13 Widht: M J105427,Chaco Z2 CLASSIC/BLACK US Size: M13 Widht: M J105427,FBALYB Amazon,-10,-10,0,0,0,0
,Chaco Z2 CLASSIC/BLACK US Size: M8 Widht: M J105427,Chaco Z2 CLASSIC/BLACK US Size: M8 Widht: M J105427,Default Ridgefield,0,0,0,0,0,30
,Chaco Z2 CLASSIC/BLACK US Size: M8 Widht: M J105427,Chaco Z2 CLASSIC/BLACK US Size: M8 Widht: M J105427,FBALYB Amazon,-2,-2,0,0,0,0
,Chaco Z2 CLASSIC/BLACK US Size: M8 Widht: W J105427W,Chaco Z2 CLASSIC/BLACK US Size: M8 Widht: W J105427W,FBALYB Amazon,-3,-3,0,0,0,0
,Chaco Z2 CLASSIC/BLACK US Size: M9 Widht: M J105427,Chaco Z2 CLASSIC/BLACK US Size: M9 Widht: M J105427,Default Ridgefield,0,0,0,0,0,66
,Chaco Z2 CLASSIC/BLACK US Size: M9 Widht: M J105427,Chaco Z2 CLASSIC/BLACK US Size: M9 Widht: M J105427,FBALYB Amazon,-6,-6,0,0,0,0
,Chaco Z2 CLASSIC/BLACK US Size: M9 Widht: W J105427W,Chaco Z2 CLASSIC/BLACK US Size: M9 Widht: W J105427W,FBALYB Amazon,-5,-5,0,0,0,0
,Chaco Z2 CLASSIC/BLACK US size: W12 Width:M J105430,Chaco Z2 CLASSIC/BLACK US size: W12 Width:M J105430,FBALYB Amazon,-2,-3,1,0,1,0
,Chaco Z2 CLASSIC/BLACK US Size: W6 Widht: M J105430,Chaco Z2 CLASSIC/BLACK US Size: W6 Widht: M J105430,Default Ridgefield,0,0,0,0,0,24
,Chaco Z2 CLASSIC/BLACK US Size: W6 Widht: M J105430,Chaco Z2 CLASSIC/BLACK US Size: W6 Widht: M J105430,FBALYB Amazon,-2,-2,0,0,0,0
,Chaco Z2 CLASSIC/BLACK US Size: W7 Widht: W J105430W,Chaco Z2 CLASSIC/BLACK US Size: W7 Widht: W J105430W,Default Ridgefield,0,0,0,0,0,65
,Chaco Z2 CLASSIC/BLACK US Size: W7 Widht: W J105430W,Chaco Z2 CLASSIC/BLACK US Size: W7 Widht: W J105430W,FBALYB Amazon,-8,-8,0,0,0,0
,Chaco Z2 CLASSIC/STEPPED NAVY US Size: M13 Widht: M J106171,Chaco Z2 CLASSIC/STEPPED NAVY US Size: M13 Widht: M J106171,Default Ridgefield,0,0,0,0,0,60
,Chaco Z2 CLASSIC/STEPPED NAVY US Size: M13 Widht: M J106171,Chaco Z2 CLASSIC/STEPPED NAVY US Size: M13 Widht: M J106171,FBALYB Amazon,-9,-9,0,0,0,0
,Chaco Z2 CLASSIC/STEPPED NAVY US Size: M8 Widht: M J106171,Chaco Z2 CLASSIC/STEPPED NAVY US Size: M8 Widht: M J106171,Default Ridgefield,0,0,0,0,0,36
,Chaco Z2 CLASSIC/STEPPED NAVY US Size: M8 Widht: M J106171,Chaco Z2 CLASSIC/STEPPED NAVY US Size: M8 Widht: M J106171,FBALYB Amazon,-8,-8,0,0,0,0
,Chaco Z2 CLASSIC/STEPPED NAVY US Size: M8 Widht: W J106171W,Chaco Z2 CLASSIC/STEPPED NAVY US Size: M8 Widht: W J106171W,Default Ridgefield,0,0,0,0,0,39
,Chaco Z2 CLASSIC/STEPPED NAVY US Size: M8 Widht: W J106171W,Chaco Z2 CLASSIC/STEPPED NAVY US Size: M8 Widht: W J106171W,FBALYB Amazon,-2,-2,0,0,0,0
,Chaco Z2 CLASSIC/STEPPED NAVY US Size: M9 Widht: W J106171W,Chaco Z2 CLASSIC/STEPPED NAVY US Size: M9 Widht: W J106171W,Default Ridgefield,0,0,0,0,0,82
,Chaco Z2 CLASSIC/STEPPED NAVY US Size: M9 Widht: W J106171W,Chaco Z2 CLASSIC/STEPPED NAVY US Size: M9 Widht: W J106171W,FBALYB Amazon,-1,-1,0,0,0,0
,Chaco ZCLOUD 2/PUNTA PINE US size: W6 Width:M JCH108060,Chaco ZCLOUD 2/PUNTA PINE US size: W6 Width:M JCH108060,FBALYB Amazon,-5,-5,0,0,0,0
,Chaco ZCLOUD 2/SOLID BLACK US Size: W10 Widht: W J107364W,Chaco ZCLOUD 2/SOLID BLACK US Size: W10 Widht: W J107364W,FBALYB Amazon,-6,-6,0,0,0,0
,Chaco ZCLOUD 2/SOLID BLACK US Size: W6 Widht: M J107364,Chaco ZCLOUD 2/SOLID BLACK US Size: W6 Widht: M J107364,FBALYB Amazon,-4,-4,0,0,0,0
,Chaco ZCLOUD 2/SOLID BLACK US Size: W6 Widht: W J107364W,Chaco ZCLOUD 2/SOLID BLACK US Size: W6 Widht: W J107364W,FBALYB Amazon,-7,-7,0,0,0,0
,Chaco ZCLOUD 2/SOLID BLACK US Size: W7 Widht: M J107364,Chaco ZCLOUD 2/SOLID BLACK US Size: W7 Widht: M J107364,FBALYB Amazon,-1,-1,0,0,0,0
,Chaco ZCLOUD 2/SOLID BLACK US Size: W7 Widht: W J107364W,Chaco ZCLOUD 2/SOLID BLACK US Size: W7 Widht: W J107364W,FBALYB Amazon,18,18,0,0,0,0
,Chaco ZCLOUD 2/SOLID BLACK US Size: W8 Widht: W J107364W,Chaco ZCLOUD 2/SOLID BLACK US Size: W8 Widht: W J107364W,Default Ridgefield,1,1,0,0,0,0
,Chaco ZCLOUD 2/SOLID BLACK US Size: W8 Widht: W J107364W,Chaco ZCLOUD 2/SOLID BLACK US Size: W8 Widht: W J107364W,FBALYB Amazon,-13,-13,0,0,0,0
,Chaco ZCLOUD 2/SOLID BLACK US Size: W9 Widht: W J107364W,Chaco ZCLOUD 2/SOLID BLACK US Size: W9 Widht: W J107364W,FBALYB Amazon,-13,-13,0,0,0,0
,Chaco ZCLOUD X2/LIMB BLACK US size: W10 Width:W JCH108002W,Chaco ZCLOUD X2/LIMB BLACK US size: W10 Width:W JCH108002W,Default Ridgefield,41,41,0,0,0,0
,Chaco ZCLOUD X2/LIMB BLACK US size: W11 Width:W JCH108002W,Chaco ZCLOUD X2/LIMB BLACK US size: W11 Width:W JCH108002W,FBALYB Amazon,11,11,0,0,0,0
,Chaco ZCLOUD X2/LIMB BLACK US size: W6 Width:W JCH108002W,Chaco ZCLOUD X2/LIMB BLACK US size: W6 Width:W JCH108002W,FBALYB Amazon,19,19,0,0,0,0
,Chaco ZCLOUD X2/LIMB BLACK US size: W7 Width:W JCH108002W,Chaco ZCLOUD X2/LIMB BLACK US size: W7 Width:W JCH108002W,Default Ridgefield,1,1,0,0,0,0
,Chaco ZCLOUD X2/LIMB BLACK US size: W7 Width:W JCH108002W,Chaco ZCLOUD X2/LIMB BLACK US size: W7 Width:W JCH108002W,FBALYB Amazon,60,60,0,0,0,0
,Chaco ZCLOUD X2/LIMB BLACK US size: W8 Width:W JCH108002W,Chaco ZCLOUD X2/LIMB BLACK US size: W8 Width:W JCH108002W,Default Ridgefield,1,1,0,0,0,0
,Chaco ZCLOUD X2/LIMB BLACK US size: W8 Width:W JCH108002W,Chaco ZCLOUD X2/LIMB BLACK US size: W8 Width:W JCH108002W,FBALYB Amazon,98,98,0,0,0,0
,Chaco ZCLOUD X2/LIMB BLACK US size: W9 Width:W JCH108002W,Chaco ZCLOUD X2/LIMB BLACK US size: W9 Width:W JCH108002W,Default Ridgefield,1,1,0,0,0,0
,Chaco ZCLOUD X2/LIMB BLACK US size: W9 Width:W JCH108002W,Chaco ZCLOUD X2/LIMB BLACK US size: W9 Width:W JCH108002W,FBALYB Amazon,60,60,0,0,0,0
,Chaco ZCLOUD X2/SOLID BLACK US Size: W10 Widht: W J107320W,Chaco ZCLOUD X2/SOLID BLACK US Size: W10 Widht: W J107320W,FBALYB Amazon,-2,-2,0,0,0,0
,Chaco ZCLOUD X2/SOLID BLACK US Size: W6 Widht: W J107320W,Chaco ZCLOUD X2/SOLID BLACK US Size: W6 Widht: W J107320W,FBALYB Amazon,-3,-3,0,0,0,0
,Chaco ZCLOUD X2/SOLID BLACK US Size: W7 Widht: W J107320W,Chaco ZCLOUD X2/SOLID BLACK US Size: W7 Widht: W J107320W,FBALYB Amazon,-2,-2,0,0,0,0
,Chaco ZCLOUD X2/SOLID BLACK US Size: W8 Widht: W J107320W,Chaco ZCLOUD X2/SOLID BLACK US Size: W8 Widht: W J107320W,FBALYB Amazon,-2,-2,0,0,0,0
,Chaco ZCLOUD X2/SOLID BLACK US Size: W9 Widht: W J107320W,Chaco ZCLOUD X2/SOLID BLACK US Size: W9 Widht: W J107320W,FBALYB Amazon,-1,-1,0,0,0,0
,Chaco ZX2 CLASSIC/BLACK US Size: W10 Widht: M J105492,Chaco ZX2 CLASSIC/BLACK US Size: W10 Widht: M J105492,Default Ridgefield,0,0,0,0,0,48
,Chaco ZX2 CLASSIC/BLACK US Size: W10 Widht: M J105492,Chaco ZX2 CLASSIC/BLACK US Size: W10 Widht: M J105492,FBALYB Amazon,-1,-1,0,0,0,0
,Chaco ZX2 CLASSIC/BLACK US Size: W10 Widht: W J105492W,Chaco ZX2 CLASSIC/BLACK US Size: W10 Widht: W J105492W,Default Ridgefield,0,0,0,0,0,41
,Chaco ZX2 CLASSIC/BLACK US size: W11 Width:M J105492,Chaco ZX2 CLASSIC/BLACK US size: W11 Width:M J105492,Default Ridgefield,0,0,0,0,0,12
,Chaco ZX2 CLASSIC/BLACK US Size: W7 Widht: W J105492W,Chaco ZX2 CLASSIC/BLACK US Size: W7 Widht: W J105492W,Default Ridgefield,0,0,0,0,0,63
,Chaco ZX2 CLASSIC/BLACK US Size: W7 Widht: W J105492W,Chaco ZX2 CLASSIC/BLACK US Size: W7 Widht: W J105492W,FBALYB Amazon,-2,-2,0,0,0,0
,Chaco ZX2 CLASSIC/BLACK US Size: W8 Widht: W J105492W,Chaco ZX2 CLASSIC/BLACK US Size: W8 Widht: W J105492W,Default Ridgefield,0,0,0,0,0,90
,Chaco ZX2 CLASSIC/BLACK US Size: W8 Widht: W J105492W,Chaco ZX2 CLASSIC/BLACK US Size: W8 Widht: W J105492W,FBALYB Amazon,-9,-9,0,0,0,0
,Chaco ZX2 CLASSIC/BLACK US Size: W9 Widht: M J105492,Chaco ZX2 CLASSIC/BLACK US Size: W9 Widht: M J105492,Default Ridgefield,0,0,0,0,0,78
,Chaco ZX2 CLASSIC/BLACK US Size: W9 Widht: M J105492,Chaco ZX2 CLASSIC/BLACK US Size: W9 Widht: M J105492,FBALYB Amazon,-16,-16,0,0,0,0
,Chaco ZX2 CLASSIC/BOOST BLACK US size: W11 Width:M J106266,Chaco ZX2 CLASSIC/BOOST BLACK US size: W11 Width:M J106266,FBALYB Amazon,-2,-2,0,0,0,0
,Chaco ZX2 CLASSIC/BOOST BLACK US size: W12 Width:M J106266,Chaco ZX2 CLASSIC/BOOST BLACK US size: W12 Width:M J106266,FBALYB Amazon,-6,-6,0,0,0,0
,Chaco ZX2 CLASSIC/BOOST BLACK US size: W5 Width:M J106266,Chaco ZX2 CLASSIC/BOOST BLACK US size: W5 Width:M J106266,FBALYB Amazon,-8,-8,0,0,0,0
,Chaco ZX2 CLASSIC/BOOST BLACK US Size: W6 Widht: W J106266W,Chaco ZX2 CLASSIC/BOOST BLACK US Size: W6 Widht: W J106266W,FBALYB Amazon,7,7,0,0,0,0
,Chaco ZX2 CLASSIC/BOOST BLACK US Size: W7 Widht: W J106266W,Chaco ZX2 CLASSIC/BOOST BLACK US Size: W7 Widht: W J106266W,FBALYB Amazon,-3,-3,0,0,0,0
,Champion Men  POWERBLEND GRAPHIC CREW FLEECE Black GF88HY06794-BKC US Size Extra Large,Champion Men  POWERBLEND GRAPHIC CREW FLEECE Black GF88HY06794-BKC US Size Extra Large,Default Ridgefield,81,81,0,0,0,599
,Champion Men  POWERBLEND GRAPHIC CREW FLEECE Black GF88HY06794-BKC US Size Extra Small,Champion Men  POWERBLEND GRAPHIC CREW FLEECE Black GF88HY06794-BKC US Size Extra Small,Default Ridgefield,8,8,0,0,0,0
,Champion Men  POWERBLEND GRAPHIC CREW FLEECE Black GF88HY06794-BKC US Size Large,Champion Men  POWERBLEND GRAPHIC CREW FLEECE Black GF88HY06794-BKC US Size Large,Default Ridgefield,1248,1248,0,0,0,76
,Champion Men  POWERBLEND GRAPHIC CREW FLEECE Black GF88HY06794-BKC US Size Large,Champion Men  POWERBLEND GRAPHIC CREW FLEECE Black GF88HY06794-BKC US Size Large,FBALYB Amazon,182,179,3,0,3,0
,Champion Men  POWERBLEND GRAPHIC CREW FLEECE Black GF88HY06794-BKC US Size Medium,Champion Men  POWERBLEND GRAPHIC CREW FLEECE Black GF88HY06794-BKC US Size Medium,Default Ridgefield,297,297,0,0,0,435
,Champion Men  POWERBLEND GRAPHIC CREW FLEECE Black GF88HY06794-BKC US Size Medium,Champion Men  POWERBLEND GRAPHIC CREW FLEECE Black GF88HY06794-BKC US Size Medium,FBALYB Amazon,76,71,5,0,5,0
,Champion Men  POWERBLEND GRAPHIC CREW FLEECE Black GF88HY06794-BKC US Size Small,Champion Men  POWERBLEND GRAPHIC CREW FLEECE Black GF88HY06794-BKC US Size Small,Default Ridgefield,300,300,0,0,0,450
,Champion Men  POWERBLEND GRAPHIC CREW FLEECE Black GF88HY06794-BKC US Size Small,Champion Men  POWERBLEND GRAPHIC CREW FLEECE Black GF88HY06794-BKC US Size Small,FBALYB Amazon,104,102,2,0,2,0
,Champion Men  POWERBLEND GRAPHIC CREW FLEECE Oxford Gray GF88HY06794-1IC US Size Extra Large,Champion Men  POWERBLEND GRAPHIC CREW FLEECE Oxford Gray GF88HY06794-1IC US Size Extra Large,Default Ridgefield,49,49,0,0,0,15
,Champion Men  POWERBLEND GRAPHIC CREW FLEECE Oxford Gray GF88HY06794-1IC US Size Extra Small,Champion Men  POWERBLEND GRAPHIC CREW FLEECE Oxford Gray GF88HY06794-1IC US Size Extra Small,Default Ridgefield,49,49,0,0,0,0
,Champion Men  POWERBLEND GRAPHIC CREW FLEECE Oxford Gray GF88HY06794-1IC US Size Medium,Champion Men  POWERBLEND GRAPHIC CREW FLEECE Oxford Gray GF88HY06794-1IC US Size Medium,Default Ridgefield,2,2,0,0,0,50
,Champion Men  POWERBLEND GRAPHIC CREW FLEECE Oxford Gray GF88HY06794-1IC US Size Medium,Champion Men  POWERBLEND GRAPHIC CREW FLEECE Oxford Gray GF88HY06794-1IC US Size Medium,FBALYB Amazon,44,37,7,0,7,0
,Champion Men  POWERBLEND GRAPHIC CREW FLEECE Oxford Gray GF88HY06794-1IC US Size XXL,Champion Men  POWERBLEND GRAPHIC CREW FLEECE Oxford Gray GF88HY06794-1IC US Size XXL,Default Ridgefield,0,0,0,0,0,10
,Champion Men  POWERBLEND GRAPHIC CREW FLEECE Oxford Gray GF88HY06794-1IC US Size XXL,Champion Men  POWERBLEND GRAPHIC CREW FLEECE Oxford Gray GF88HY06794-1IC US Size XXL,FBALYB Amazon,31,26,5,0,5,0
,Champion Men Reverse Weave Crewneck Sweater Black GF70Y06145-BKC US Size 2XL,Champion Men Reverse Weave Crewneck Sweater Black GF70Y06145-BKC US Size 2XL,Default Ridgefield,125,125,0,0,0,0
,Champion Men Reverse Weave Crewneck Sweater Black GF70Y06145-BKC  US Size Extra Large,Champion Men Reverse Weave Crewneck Sweater Black GF70Y06145-BKC  US Size Extra Large,Default Ridgefield,300,300,0,0,0,300
,Champion Men Reverse Weave Crewneck Sweater Black GF70Y06145-BKC US Size Large,Champion Men Reverse Weave Crewneck Sweater Black GF70Y06145-BKC US Size Large,Default Ridgefield,250,250,0,0,0,400
,Champion Men Reverse Weave Crewneck Sweater Black GF70Y06145-BKC US Size Large,Champion Men Reverse Weave Crewneck Sweater Black GF70Y06145-BKC US Size Large,FBALYB Amazon,148,148,0,0,0,0
,Champion Men Reverse Weave Crewneck Sweater Black GF70Y06145-BKC US Size Medium,Champion Men Reverse Weave Crewneck Sweater Black GF70Y06145-BKC US Size Medium,Default Ridgefield,242,242,0,0,0,300
,Champion Men Reverse Weave Crewneck Sweater Black GF70Y06145-BKC US Size Medium,Champion Men Reverse Weave Crewneck Sweater Black GF70Y06145-BKC US Size Medium,FBALYB Amazon,49,49,0,0,0,0
,Champion Men Reverse Weave Crewneck Sweater Black GF70Y06145-BKC  US Size Small,Champion Men Reverse Weave Crewneck Sweater Black GF70Y06145-BKC  US Size Small,Default Ridgefield,75,75,0,0,0,75
,Champion Men Reverse Weave Crewneck Sweater Oxford Gray GF70Y06145-1IC US Size 2XL,Champion Men Reverse Weave Crewneck Sweater Oxford Gray GF70Y06145-1IC US Size 2XL,Default Ridgefield,25,25,0,0,0,75
,Champion Men Reverse Weave Crewneck Sweater Oxford Gray GF70Y06145-1IC US Size 2XL,Champion Men Reverse Weave Crewneck Sweater Oxford Gray GF70Y06145-1IC US Size 2XL,FBALYB Amazon,50,50,0,0,0,0
,Champion Men Reverse Weave Crewneck Sweater Oxford Gray GF70Y06145-1IC US Size Extra Large,Champion Men Reverse Weave Crewneck Sweater Oxford Gray GF70Y06145-1IC US Size Extra Large,Default Ridgefield,100,100,0,0,0,150
,Champion Men Reverse Weave Crewneck Sweater Oxford Gray GF70Y06145-1IC US Size Extra Large,Champion Men Reverse Weave Crewneck Sweater Oxford Gray GF70Y06145-1IC US Size Extra Large,FBALYB Amazon,50,50,0,0,0,0
,Champion Men Reverse Weave Crewneck Sweater Oxford Gray GF70Y06145-1IC US Size Large,Champion Men Reverse Weave Crewneck Sweater Oxford Gray GF70Y06145-1IC US Size Large,Default Ridgefield,99,99,0,0,0,250
,Champion Men Reverse Weave Crewneck Sweater Oxford Gray GF70Y06145-1IC US Size Large,Champion Men Reverse Weave Crewneck Sweater Oxford Gray GF70Y06145-1IC US Size Large,FBALYB Amazon,131,131,0,0,0,0
,Champion Men Reverse Weave Crewneck Sweater Oxford Gray GF70Y06145-1IC US Size Medium,Champion Men Reverse Weave Crewneck Sweater Oxford Gray GF70Y06145-1IC US Size Medium,Default Ridgefield,75,75,0,0,0,0
,Champion Men Reverse Weave Crewneck Sweater Oxford Gray GF70Y06145-1IC US Size Medium,Champion Men Reverse Weave Crewneck Sweater Oxford Gray GF70Y06145-1IC US Size Medium,FBALYB Amazon,50,50,0,0,0,0
,Champion Men Reverse Weave Crewneck Sweater TEAM RED SCARLET GF70Y06145-2WC US Size Extra Large,Champion Men Reverse Weave Crewneck Sweater TEAM RED SCARLET GF70Y06145-2WC US Size Extra Large,Default Ridgefield,48,48,0,0,0,41
,Champion Men Reverse Weave Trim Jogger Oxford Gray Black GF01Y06146-1IC US Size 2XL,Champion Men Reverse Weave Trim Jogger Oxford Gray Black GF01Y06146-1IC US Size 2XL,FBALYB Amazon,50,50,0,0,0,0
,Champion Men Reverse Weave Trim Jogger Pants Black GF01Y06146-BKC US Size 2XL,Champion Men Reverse Weave Trim Jogger Pants Black GF01Y06146-BKC US Size 2XL,Default Ridgefield,150,150,0,0,0,150
,Champion Men Reverse Weave Trim Jogger Pants Black GF01Y06146-BKC US Size Small,Champion Men Reverse Weave Trim Jogger Pants Black GF01Y06146-BKC US Size Small,Default Ridgefield,125,125,0,0,0,0
,Champion Men's Classic Athletic Fit Jersey Tee Cotton Blend TEAM GOLD T0223-MLV US Size Small,Champion Men's Classic Athletic Fit Jersey Tee Cotton Blend TEAM GOLD T0223-MLV US Size Small,Default Ridgefield,184,184,0,0,0,0
,Champion Mens  Classic Jersey Graphic Tee DARK GREEN GT23HY07718-014 US Size Small,Champion Mens  Classic Jersey Graphic Tee DARK GREEN GT23HY07718-014 US Size Small,Default Ridgefield,99,99,0,0,0,0
,Champion Mens  Classic Jersey Graphic Tee GRANITE HEATHER GT23HY07718-G61 US Size Small,Champion Mens  Classic Jersey Graphic Tee GRANITE HEATHER GT23HY07718-G61 US Size Small,Default Ridgefield,181,181,0,0,0,0
,Champion Mens  Classic Jersey Graphic Tee SPICY ORANGE GT23HY07718-5TQ US Size Large,Champion Mens  Classic Jersey Graphic Tee SPICY ORANGE GT23HY07718-5TQ US Size Large,Default Ridgefield,65,65,0,0,0,0
,Champion Mens  Classic Jersey Graphic Tee SPICY ORANGE GT23HY07718-5TQ US Size Medium,Champion Mens  Classic Jersey Graphic Tee SPICY ORANGE GT23HY07718-5TQ US Size Medium,Default Ridgefield,140,140,0,0,0,0
,Champion Mens  Classic Jersey Graphic Tee SWISS BLUE GT23HY07718-K7P US Size Medium,Champion Mens  Classic Jersey Graphic Tee SWISS BLUE GT23HY07718-K7P US Size Medium,Default Ridgefield,100,100,0,0,0,0
,Champion Men's Classic Jersey Jogger Pant GRANITE HEATHER GP08H586296-G61 US Size Small,Champion Men's Classic Jersey Jogger Pant GRANITE HEATHER GP08H586296-G61 US Size Small,Default Ridgefield,66,66,0,0,0,0
,Champion Men's Classic Jersey Jogger Pant Navy GP08H586296-031 US Size Large,Champion Men's Classic Jersey Jogger Pant Navy GP08H586296-031 US Size Large,Default Ridgefield,92,92,0,0,0,12
,Champion Men's Classic Jersey Jogger Pant Oxford Gray GP08H586296-806 US Size Medium,Champion Men's Classic Jersey Jogger Pant Oxford Gray GP08H586296-806 US Size Medium,Default Ridgefield,72,72,0,0,0,220
,Champion Men's Classic Jersey Jogger Pant Oxford Gray GP08H586296-806 US Size Medium,Champion Men's Classic Jersey Jogger Pant Oxford Gray GP08H586296-806 US Size Medium,FBALYB Amazon,36,30,6,0,6,0
,Champion Men's Classic Jersey Muscle Tee SURF THE WEB T0222-GUX US Size Small,Champion Men's Classic Jersey Muscle Tee SURF THE WEB T0222-GUX US Size Small,Default Ridgefield,99,99,0,0,0,0
,Champion Mens Powerblend Fleece Pullover Crew Black S0888407D55-003 US Size Medium,Champion Mens Powerblend Fleece Pullover Crew Black S0888407D55-003 US Size Medium,Default Ridgefield,132,132,0,0,0,3186
,Champion Mens Powerblend Fleece Pullover Crew Black S0888407D55-003 US Size Medium,Champion Mens Powerblend Fleece Pullover Crew Black S0888407D55-003 US Size Medium,FBALYB Amazon,40,37,3,0,3,0
,Champion Mens Powerblend Fleece Pullover Crew Black S0888407D55-003 US Size Small,Champion Mens Powerblend Fleece Pullover Crew Black S0888407D55-003 US Size Small,Default Ridgefield,100,100,0,0,0,100
,Champion Mens Powerblend Fleece Pullover Crew Black S0888407D55-003 US Size XXL,Champion Mens Powerblend Fleece Pullover Crew Black S0888407D55-003 US Size XXL,Default Ridgefield,3,3,0,0,0,25
,Champion Mens Powerblend Fleece Pullover Crew CARGO OLIVE S0888407D55-9AX US Size Extra Large,Champion Mens Powerblend Fleece Pullover Crew CARGO OLIVE S0888407D55-9AX US Size Extra Large,Default Ridgefield,48,48,0,0,0,0
,Champion Mens Powerblend Fleece Pullover Crew GRANITE HEATHER S0888407D55-G61 US Size Extra Large,Champion Mens Powerblend Fleece Pullover Crew GRANITE HEATHER S0888407D55-G61 US Size Extra Large,Default Ridgefield,105,105,0,0,0,0
,Champion Mens Powerblend Fleece Pullover Crew GRANITE HEATHER S0888407D55-G61 US Size Extra Large,Champion Mens Powerblend Fleece Pullover Crew GRANITE HEATHER S0888407D55-G61 US Size Extra Large,FBALYB Amazon,39,39,0,0,0,0
,Champion Mens Powerblend Fleece Pullover Crew GRANITE HEATHER S0888407D55-G61 US Size Small,Champion Mens Powerblend Fleece Pullover Crew GRANITE HEATHER S0888407D55-G61 US Size Small,Default Ridgefield,0,0,0,0,0,50
,Champion Mens Powerblend Fleece Pullover Crew GRANITE HEATHER S0888407D55-G61 US Size Small,Champion Mens Powerblend Fleece Pullover Crew GRANITE HEATHER S0888407D55-G61 US Size Small,FBALYB Amazon,36,35,1,0,1,0
,Champion Mens Powerblend Fleece Pullover Crew Navy S0888407D55-031 US Size 2XL,Champion Mens Powerblend Fleece Pullover Crew Navy S0888407D55-031 US Size 2XL,Default Ridgefield,91,91,0,0,0,82
,Champion Mens Powerblend Fleece Pullover Crew Navy S0888407D55-031 US Size 2XL,Champion Mens Powerblend Fleece Pullover Crew Navy S0888407D55-031 US Size 2XL,FBALYB Amazon,44,44,0,0,0,0
,Champion Mens Powerblend Fleece Pullover Crew Navy S0888407D55-031 US Size Extra Large,Champion Mens Powerblend Fleece Pullover Crew Navy S0888407D55-031 US Size Extra Large,Default Ridgefield,150,150,0,0,0,0
,Champion Mens Powerblend Fleece Pullover Crew Navy S0888407D55-031 US Size Extra Large,Champion Mens Powerblend Fleece Pullover Crew Navy S0888407D55-031 US Size Extra Large,FBALYB Amazon,37,33,4,0,4,0
,Champion Mens Powerblend Fleece Pullover Crew Navy S0888407D55-031 US Size Large,Champion Mens Powerblend Fleece Pullover Crew Navy S0888407D55-031 US Size Large,Default Ridgefield,4,4,0,0,0,669
,Champion Mens Powerblend Fleece Pullover Crew Navy S0888407D55-031 US Size Small,Champion Mens Powerblend Fleece Pullover Crew Navy S0888407D55-031 US Size Small,Default Ridgefield,68,68,0,0,0,118
,Champion Mens Powerblend Fleece Pullover Crew Navy S0888407D55-031 US Size Small,Champion Mens Powerblend Fleece Pullover Crew Navy S0888407D55-031 US Size Small,FBALYB Amazon,49,48,1,0,1,0
,Champion Mens Powerblend Fleece Pullover Crew Oxford Gray S0888407D55-806 US Size Medium,Champion Mens Powerblend Fleece Pullover Crew Oxford Gray S0888407D55-806 US Size Medium,Default Ridgefield,0,0,0,0,0,100
,Champion Mens Powerblend Fleece Pullover Crew Oxford Gray S0888407D55-806 US Size Medium,Champion Mens Powerblend Fleece Pullover Crew Oxford Gray S0888407D55-806 US Size Medium,FBALYB Amazon,39,33,6,0,6,0
,Champion Mens Powerblend Fleece Pullover Crew Purple S0888407D55-037 US Size Extra Large,Champion Mens Powerblend Fleece Pullover Crew Purple S0888407D55-037 US Size Extra Large,Default Ridgefield,1,1,0,0,0,0
,Champion Mens Powerblend Fleece Pullover Crew Purple S0888407D55-037 US Size Extra Large,Champion Mens Powerblend Fleece Pullover Crew Purple S0888407D55-037 US Size Extra Large,FBALYB Amazon,45,45,0,0,0,0
,Champion Mens Powerblend Fleece Pullover Crew Purple S0888407D55-037 US Size Large,Champion Mens Powerblend Fleece Pullover Crew Purple S0888407D55-037 US Size Large,Default Ridgefield,0,0,0,0,0,42
,Champion Mens Powerblend Fleece Pullover Crew Purple S0888407D55-037 US Size Large,Champion Mens Powerblend Fleece Pullover Crew Purple S0888407D55-037 US Size Large,FBALYB Amazon,45,43,2,0,2,0
,Champion Mens Powerblend Fleece Pullover Crew Purple S0888407D55-037 US Size Medium,Champion Mens Powerblend Fleece Pullover Crew Purple S0888407D55-037 US Size Medium,Default Ridgefield,49,49,0,0,0,50
,Champion Mens Powerblend Fleece Pullover Crew Purple S0888407D55-037 US Size Small,Champion Mens Powerblend Fleece Pullover Crew Purple S0888407D55-037 US Size Small,Default Ridgefield,47,47,0,0,0,36
,Champion Mens Powerblend Fleece Pullover Crew Spicy Orange S0888407D55-5TQ US Size Small,Champion Mens Powerblend Fleece Pullover Crew Spicy Orange S0888407D55-5TQ US Size Small,Default Ridgefield,18,18,0,0,0,0
,Champion Mens Powerblend Fleece Pullover Crew Spicy Orange S0888407D55-5TQ US Size Small,Champion Mens Powerblend Fleece Pullover Crew Spicy Orange S0888407D55-5TQ US Size Small,FBALYB Amazon,50,49,1,0,1,0
,Champion Mens Powerblend Fleece Pullover Crew SURF THE WEB S0888407D55-GUX US Size 2XL,Champion Mens Powerblend Fleece Pullover Crew SURF THE WEB S0888407D55-GUX US Size 2XL,FBALYB Amazon,48,48,0,0,0,0
,Champion Mens Powerblend Fleece Pullover Crew SURF THE WEB S0888407D55-GUX US Size Extra Large,Champion Mens Powerblend Fleece Pullover Crew SURF THE WEB S0888407D55-GUX US Size Extra Large,Default Ridgefield,30,30,0,0,0,0
,Champion Mens Powerblend Fleece Pullover Crew SURF THE WEB S0888407D55-GUX US Size Extra Large,Champion Mens Powerblend Fleece Pullover Crew SURF THE WEB S0888407D55-GUX US Size Extra Large,FBALYB Amazon,50,50,0,0,0,0
,Champion Mens Powerblend Fleece Pullover Crew Swiss Blue S0888407D55-K7P US Size Medium,Champion Mens Powerblend Fleece Pullover Crew Swiss Blue S0888407D55-K7P US Size Medium,FBALYB Amazon,46,46,0,0,0,0
,Champion Mens Powerblend Fleece Pullover Crew Team Gold S0888407D55-MLV US Size Extra Large,Champion Mens Powerblend Fleece Pullover Crew Team Gold S0888407D55-MLV US Size Extra Large,Default Ridgefield,2,2,0,0,0,0
,Champion Mens Powerblend Fleece Pullover Crew Team Gold S0888407D55-MLV US Size Extra Large,Champion Mens Powerblend Fleece Pullover Crew Team Gold S0888407D55-MLV US Size Extra Large,FBALYB Amazon,24,24,0,0,0,0
,Champion Mens Powerblend Fleece Pullover Crew Team Red Scarlet S0888407D55-W3J US Size Extra Large,Champion Mens Powerblend Fleece Pullover Crew Team Red Scarlet S0888407D55-W3J US Size Extra Large,Default Ridgefield,49,49,0,0,0,0
,Champion Mens Powerblend Fleece Pullover Crew Team Red Scarlet S0888407D55-W3J US Size Large,Champion Mens Powerblend Fleece Pullover Crew Team Red Scarlet S0888407D55-W3J US Size Large,Default Ridgefield,1,1,0,0,0,50
,Champion Mens Powerblend Fleece Pullover Crew Team Red Scarlet S0888407D55-W3J US Size Large,Champion Mens Powerblend Fleece Pullover Crew Team Red Scarlet S0888407D55-W3J US Size Large,FBALYB Amazon,43,42,1,0,1,0
,Champion Mens Powerblend Fleece Pullover Crew Team Red Scarlet S0888407D55-W3J US Size Medium,Champion Mens Powerblend Fleece Pullover Crew Team Red Scarlet S0888407D55-W3J US Size Medium,Default Ridgefield,1,1,0,0,0,50
,Champion Mens Powerblend Fleece Pullover Crew Team Red Scarlet S0888407D55-W3J US Size Medium,Champion Mens Powerblend Fleece Pullover Crew Team Red Scarlet S0888407D55-W3J US Size Medium,FBALYB Amazon,27,27,0,0,0,0
,Champion Mens Powerblend Fleece Pullover Crew Team Red Scarlet S0888407D55-W3J US Size Small,Champion Mens Powerblend Fleece Pullover Crew Team Red Scarlet S0888407D55-W3J US Size Small,Default Ridgefield,47,47,0,0,0,50
,Champion Mens Powerblend Fleece Pullover Crew White S0888407D55-045 US Size Large,Champion Mens Powerblend Fleece Pullover Crew White S0888407D55-045 US Size Large,Default Ridgefield,76,76,0,0,0,127
,Champion Mens Powerblend Fleece Pullover Crew White S0888407D55-045 US Size Large,Champion Mens Powerblend Fleece Pullover Crew White S0888407D55-045 US Size Large,FBALYB Amazon,46,44,2,0,2,0
,Champion Men's Powerblend Fleece Pullover Hoodie Black GF89HY06794-BKC US Size Large,Champion Men's Powerblend Fleece Pullover Hoodie Black GF89HY06794-BKC US Size Large,Default Ridgefield,24,24,0,0,0,0
,Champion Men's Powerblend Fleece Pullover Hoodie Black GF89HY06794-BKC US Size Large,Champion Men's Powerblend Fleece Pullover Hoodie Black GF89HY06794-BKC US Size Large,FBALYB Amazon,44,41,3,0,3,0
,Champion Men's Powerblend Fleece Pullover Hoodie Black GF89HY06794-BKC US Size XXL,Champion Men's Powerblend Fleece Pullover Hoodie Black GF89HY06794-BKC US Size XXL,Default Ridgefield,49,49,0,0,0,0
,Champion Men's Powerblend Fleece Pullover Hoodie White GF89HY06794-WHC US Size Extra Large,Champion Men's Powerblend Fleece Pullover Hoodie White GF89HY06794-WHC US Size Extra Large,Default Ridgefield,37,37,0,0,0,0
,Champion Men's Powerblend Fleece Pullover Hoodie White GF89HY06794-WHC US Size Medium,Champion Men's Powerblend Fleece Pullover Hoodie White GF89HY06794-WHC US Size Medium,Default Ridgefield,34,34,0,0,0,41
,Champion Men's Powerblend Sweats Pullover Hoodie Black S0889407D55-003 US Size Medium,Champion Men's Powerblend Sweats Pullover Hoodie Black S0889407D55-003 US Size Medium,Default Ridgefield,35,35,0,0,0,212
,Champion Men's Powerblend Sweats Pullover Hoodie Black S0889407D55-003 US Size Small,Champion Men's Powerblend Sweats Pullover Hoodie Black S0889407D55-003 US Size Small,Default Ridgefield,298,298,0,0,0,311
,Champion Men's Powerblend Sweats Pullover Hoodie CARGO OLIVE S0889407D55-9AX US Size Medium,Champion Men's Powerblend Sweats Pullover Hoodie CARGO OLIVE S0889407D55-9AX US Size Medium,Default Ridgefield,3,3,0,0,0,0
,Champion Men's Powerblend Sweats Pullover Hoodie CARGO OLIVE S0889407D55-9AX US Size Medium,Champion Men's Powerblend Sweats Pullover Hoodie CARGO OLIVE S0889407D55-9AX US Size Medium,FBALYB Amazon,29,24,5,0,5,0
,Champion Men's Powerblend Sweats Pullover Hoodie CARGO OLIVE S0889407D55-9AX US Size Small,Champion Men's Powerblend Sweats Pullover Hoodie CARGO OLIVE S0889407D55-9AX US Size Small,Default Ridgefield,51,51,0,0,0,0
,Champion Men's Powerblend Sweats Pullover Hoodie Dark Green S0889407D55-014 US Size 3XL,Champion Men's Powerblend Sweats Pullover Hoodie Dark Green S0889407D55-014 US Size 3XL,Default Ridgefield,50,50,0,0,0,50
,Champion Men's Powerblend Sweats Pullover Hoodie Dark Green S0889407D55-014 US Size 4XL,Champion Men's Powerblend Sweats Pullover Hoodie Dark Green S0889407D55-014 US Size 4XL,Default Ridgefield,50,50,0,0,0,50
,Champion Men's Powerblend Sweats Pullover Hoodie Dark Green S0889407D55-014 US Size Small,Champion Men's Powerblend Sweats Pullover Hoodie Dark Green S0889407D55-014 US Size Small,Default Ridgefield,53,53,0,0,0,0
,Champion Men's Powerblend Sweats Pullover Hoodie Dark Green S0889407D55-014 US Size Small,Champion Men's Powerblend Sweats Pullover Hoodie Dark Green S0889407D55-014 US Size Small,FBALYB Amazon,10,10,0,0,0,0
,Champion Men's Powerblend Sweats Pullover Hoodie GRANITE HEATHER S0889407D55-G61 US Size Extra Large,Champion Men's Powerblend Sweats Pullover Hoodie GRANITE HEATHER S0889407D55-G61 US Size Extra Large,Default Ridgefield,70,70,0,0,0,120
,Champion Men's Powerblend Sweats Pullover Hoodie GRANITE HEATHER S0889407D55-G61 US Size Extra Large,Champion Men's Powerblend Sweats Pullover Hoodie GRANITE HEATHER S0889407D55-G61 US Size Extra Large,FBALYB Amazon,46,45,1,0,1,0
,Champion Men's Powerblend Sweats Pullover Hoodie GRANITE HEATHER S0889407D55-G61 US Size Extra Small,Champion Men's Powerblend Sweats Pullover Hoodie GRANITE HEATHER S0889407D55-G61 US Size Extra Small,Default Ridgefield,83,83,0,0,0,0
,Champion Men's Powerblend Sweats Pullover Hoodie MAROON S0889407D55-029 US Size 3XL,Champion Men's Powerblend Sweats Pullover Hoodie MAROON S0889407D55-029 US Size 3XL,Default Ridgefield,50,50,0,0,0,50
,Champion Men's Powerblend Sweats Pullover Hoodie MAROON S0889407D55-029 US Size 4XL,Champion Men's Powerblend Sweats Pullover Hoodie MAROON S0889407D55-029 US Size 4XL,Default Ridgefield,50,50,0,0,0,50
,Champion Men's Powerblend Sweats Pullover Hoodie MAROON S0889407D55-029 US Size Extra Large,Champion Men's Powerblend Sweats Pullover Hoodie MAROON S0889407D55-029 US Size Extra Large,Default Ridgefield,103,103,0,0,0,149
,Champion Men's Powerblend Sweats Pullover Hoodie NAVY S0889407D55-031 US Size 4XL,Champion Men's Powerblend Sweats Pullover Hoodie NAVY S0889407D55-031 US Size 4XL,Default Ridgefield,100,100,0,0,0,0
,Champion Men's Powerblend Sweats Pullover Hoodie NAVYS0889407D55-031  US Size Medium,Champion Men's Powerblend Sweats Pullover Hoodie NAVYS0889407D55-031  US Size Medium,Default Ridgefield,175,175,0,0,0,178
,Champion Men's Powerblend Sweats Pullover Hoodie NAVY S0889407D55-031 US Size Small,Champion Men's Powerblend Sweats Pullover Hoodie NAVY S0889407D55-031 US Size Small,Default Ridgefield,130,130,0,0,0,153
,Champion Men's Powerblend Sweats Pullover Hoodie OXFORD GRAY S0889407D55-806 US Size Extra Large,Champion Men's Powerblend Sweats Pullover Hoodie OXFORD GRAY S0889407D55-806 US Size Extra Large,Default Ridgefield,236,236,0,0,0,24
,Champion Men's Powerblend Sweats Pullover Hoodie OXFORD GRAY S0889407D55-806 US Size Extra Small,Champion Men's Powerblend Sweats Pullover Hoodie OXFORD GRAY S0889407D55-806 US Size Extra Small,Default Ridgefield,203,203,0,0,0,0
,Champion Men's Powerblend Sweats Pullover Hoodie OXFORD GRAY S0889407D55-806 US Size Large,Champion Men's Powerblend Sweats Pullover Hoodie OXFORD GRAY S0889407D55-806 US Size Large,Default Ridgefield,77,77,0,0,0,206
,Champion Men's Powerblend Sweats Pullover Hoodie OXFORD GRAY S0889407D55-806 US Size Large,Champion Men's Powerblend Sweats Pullover Hoodie OXFORD GRAY S0889407D55-806 US Size Large,FBALYB Amazon,215,214,1,0,1,0
,Champion Men's Powerblend Sweats Pullover Hoodie OXFORD GRAY S0889407D55-806 US Size Medium,Champion Men's Powerblend Sweats Pullover Hoodie OXFORD GRAY S0889407D55-806 US Size Medium,Default Ridgefield,48,48,0,0,0,0
,Champion Men's Powerblend Sweats Pullover Hoodie OXFORD GRAY S0889407D55-806 US Size Small,Champion Men's Powerblend Sweats Pullover Hoodie OXFORD GRAY S0889407D55-806 US Size Small,Default Ridgefield,73,73,0,0,0,200
,Champion Men's Powerblend Sweats Pullover Hoodie OXFORD GRAY S0889407D55-806 US Size Small,Champion Men's Powerblend Sweats Pullover Hoodie OXFORD GRAY S0889407D55-806 US Size Small,FBALYB Amazon,42,37,5,0,5,0
,Champion Men's Powerblend Sweats Pullover Hoodie PURPLE S0889407D55-037 US Size 3XL,Champion Men's Powerblend Sweats Pullover Hoodie PURPLE S0889407D55-037 US Size 3XL,Default Ridgefield,50,50,0,0,0,0
,Champion Men's Powerblend Sweats Pullover Hoodie PURPLE S0889407D55-037 US Size 4XL,Champion Men's Powerblend Sweats Pullover Hoodie PURPLE S0889407D55-037 US Size 4XL,Default Ridgefield,50,50,0,0,0,0
,Champion Men's Powerblend Sweats Pullover Hoodie PURPLE S0889407D55-037 US Size Medium,Champion Men's Powerblend Sweats Pullover Hoodie PURPLE S0889407D55-037 US Size Medium,Default Ridgefield,3,3,0,0,0,0
,Champion Men's Powerblend Sweats Pullover Hoodie PURPLE S0889407D55-037 US Size Medium,Champion Men's Powerblend Sweats Pullover Hoodie PURPLE S0889407D55-037 US Size Medium,FBALYB Amazon,31,29,2,0,2,0
,Champion Men's Powerblend Sweats Pullover Hoodie PURPLE S0889407D55-037 US Size Small,Champion Men's Powerblend Sweats Pullover Hoodie PURPLE S0889407D55-037 US Size Small,Default Ridgefield,97,97,0,0,0,0
,Champion Men's Powerblend Sweats Pullover Hoodie SURF THE WEB S0889407D55-GUX US Size Extra Large,Champion Men's Powerblend Sweats Pullover Hoodie SURF THE WEB S0889407D55-GUX US Size Extra Large,Default Ridgefield,90,90,0,0,0,0
,Champion Men's Powerblend Sweats Pullover Hoodie SURF THE WEB S0889407D55-GUX US Size Small,Champion Men's Powerblend Sweats Pullover Hoodie SURF THE WEB S0889407D55-GUX US Size Small,Default Ridgefield,53,53,0,0,0,0
,Champion Men's Powerblend Sweats Pullover Hoodie SWISS BLUE S0889407D55-K7P US Size 3XL,Champion Men's Powerblend Sweats Pullover Hoodie SWISS BLUE S0889407D55-K7P US Size 3XL,Default Ridgefield,35,35,0,0,0,50
,Champion Men's Powerblend Sweats Pullover Hoodie SWISS BLUE S0889407D55-K7P US Size 4XL,Champion Men's Powerblend Sweats Pullover Hoodie SWISS BLUE S0889407D55-K7P US Size 4XL,Default Ridgefield,50,50,0,0,0,50
,Champion Men's Powerblend Sweats Pullover Hoodie SWISS BLUE S0889407D55-K7P US Size Large,Champion Men's Powerblend Sweats Pullover Hoodie SWISS BLUE S0889407D55-K7P US Size Large,Default Ridgefield,54,54,0,0,0,0
,Champion Men's Powerblend Sweats Pullover Hoodie TEAM GOLD S0889407D55-MLV US Size 3XL,Champion Men's Powerblend Sweats Pullover Hoodie TEAM GOLD S0889407D55-MLV US Size 3XL,Default Ridgefield,50,50,0,0,0,50
,Champion Men's Powerblend Sweats Pullover Hoodie TEAM GOLD S0889407D55-MLV US Size 4XL,Champion Men's Powerblend Sweats Pullover Hoodie TEAM GOLD S0889407D55-MLV US Size 4XL,Default Ridgefield,48,48,0,0,0,52
,Champion Men's Powerblend Sweats Pullover Hoodie TEAM GOLD S0889407D55-MLV US Size Medium,Champion Men's Powerblend Sweats Pullover Hoodie TEAM GOLD S0889407D55-MLV US Size Medium,Default Ridgefield,1,1,0,0,0,0
,Champion Men's Powerblend Sweats Pullover Hoodie TEAM GOLD S0889407D55-MLV US Size Medium,Champion Men's Powerblend Sweats Pullover Hoodie TEAM GOLD S0889407D55-MLV US Size Medium,FBALYB Amazon,40,38,2,0,2,0
,Champion Men's Powerblend Sweats Pullover Hoodie TEAM GOLD S0889407D55-MLV US Size Small,Champion Men's Powerblend Sweats Pullover Hoodie TEAM GOLD S0889407D55-MLV US Size Small,Default Ridgefield,2,2,0,0,0,50
,Champion Men's Powerblend Sweats Pullover Hoodie TEAM GOLD S0889407D55-MLV US Size Small,Champion Men's Powerblend Sweats Pullover Hoodie TEAM GOLD S0889407D55-MLV US Size Small,FBALYB Amazon,34,34,0,0,0,0
,Champion Men's Powerblend Sweats Pullover Hoodie TEAM RED SCARLET S0889407D55-W3J US Size XXL,Champion Men's Powerblend Sweats Pullover Hoodie TEAM RED SCARLET S0889407D55-W3J US Size XXL,Default Ridgefield,50,50,0,0,0,0
,Champion Men's Powerblend Sweats Pullover Hoodie White S0889407D55-045 US Size 4XL,Champion Men's Powerblend Sweats Pullover Hoodie White S0889407D55-045 US Size 4XL,Default Ridgefield,49,49,0,0,0,50
,Champion Men's Powerblend Sweats Pullover Hoodie White S0889407D55-045 US Size Large,Champion Men's Powerblend Sweats Pullover Hoodie White S0889407D55-045 US Size Large,Default Ridgefield,23,23,0,0,0,93
,Champion Men's Powerblend Sweats Pullover Hoodie White S0889407D55-045 US Size Medium,Champion Men's Powerblend Sweats Pullover Hoodie White S0889407D55-045 US Size Medium,Default Ridgefield,10,10,0,0,0,255
,Champion Men's Powerblend Sweats Pullover Hoodie White S0889407D55-045 US Size Small,Champion Men's Powerblend Sweats Pullover Hoodie White S0889407D55-045 US Size Small,Default Ridgefield,105,105,0,0,0,105
,Champion Mens PowerFlex Athletic Compression Shorts Black 84956407Z98-003 Size Small,Champion Mens PowerFlex Athletic Compression Shorts Black 84956407Z98-003 Size Small,Default Ridgefield,100,100,0,0,0,0
,Champion Mens Short Sleeve T-shirt Black GT23HY06794-003 US Size Medium,Champion Mens Short Sleeve T-shirt Black GT23HY06794-003 US Size Medium,Default Ridgefield,232,232,0,0,0,0
,Champion Mens Short Sleeve T-shirt Navy GT23HY06794-031 US Size Medium,Champion Mens Short Sleeve T-shirt Navy GT23HY06794-031 US Size Medium,Default Ridgefield,219,219,0,0,0,0
,Champion Mens Short Sleeve T-shirt Navy GT23HY06794-031 US Size Medium,Champion Mens Short Sleeve T-shirt Navy GT23HY06794-031 US Size Medium,FBALYB Amazon,3,1,2,0,2,0
,Champion Mens Short Sleeve T-shirt Navy GT23HY06794-031 US Size Small,Champion Mens Short Sleeve T-shirt Navy GT23HY06794-031 US Size Small,Default Ridgefield,120,120,0,0,0,0
,Champion Mens Short Sleeve T-shirt Oxford Gray GT23HY06794-806 US Size Extra Small,Champion Mens Short Sleeve T-shirt Oxford Gray GT23HY06794-806 US Size Extra Small,Default Ridgefield,36,36,0,0,0,0
,Champion Mens Short Sleeve T-shirt Oxford Gray GT23HY06794-806 US Size Small,Champion Mens Short Sleeve T-shirt Oxford Gray GT23HY06794-806 US Size Small,Default Ridgefield,150,150,0,0,0,0
,Champion Mens Short Sleeve T-shirt Oxford Gray GT23HY06794-806 US Size Small,Champion Mens Short Sleeve T-shirt Oxford Gray GT23HY06794-806 US Size Small,FBALYB Amazon,87,87,0,0,0,0
,Champion Mens Short Sleeve T-shirt Scarlet GT23HY06794-040 US Size Large,Champion Mens Short Sleeve T-shirt Scarlet GT23HY06794-040 US Size Large,Default Ridgefield,399,399,0,0,0,0
,Champion Mens Short Sleeve T-shirt White GT23HY06794-045 US Size Extra Small,Champion Mens Short Sleeve T-shirt White GT23HY06794-045 US Size Extra Small,Default Ridgefield,100,100,0,0,0,0
,Champion Mens Sport 6 Compression Shorts Black 87294407Z32-003 US Size Medium,Champion Mens Sport 6 Compression Shorts Black 87294407Z32-003 US Size Medium,Default Ridgefield,298,298,0,0,0,0
,Champion Reverse Weave Pullover Hoodie Mens Black GF68Y06145-BKC US Size Medium,Champion Reverse Weave Pullover Hoodie Mens Black GF68Y06145-BKC US Size Medium,Default Ridgefield,4,4,0,0,0,0
,Champion Reverse Weave Pullover Hoodie Mens Black GF68Y06145-BKC US Size Medium,Champion Reverse Weave Pullover Hoodie Mens Black GF68Y06145-BKC US Size Medium,FBALYB Amazon,194,193,1,0,1,0
,Champion Reverse Weave Pullover Hoodie Mens Oxford Gray GF68Y06145-1IC US Size Extra Large,Champion Reverse Weave Pullover Hoodie Mens Oxford Gray GF68Y06145-1IC US Size Extra Large,Default Ridgefield,101,101,0,0,0,3
,Champion Reverse Weave Pullover Hoodie Mens Oxford Gray GF68Y06145-1IC US Size Extra Large,Champion Reverse Weave Pullover Hoodie Mens Oxford Gray GF68Y06145-1IC US Size Extra Large,FBALYB Amazon,45,43,2,0,2,0
,Champion Reverse Weave Pullover Hoodie Mens Oxford Gray GF68Y06145-1IC US Size Large,Champion Reverse Weave Pullover Hoodie Mens Oxford Gray GF68Y06145-1IC US Size Large,Default Ridgefield,251,251,0,0,0,0
,Champion Reverse Weave Pullover Hoodie Mens Oxford Gray GF68Y06145-1IC US Size Large,Champion Reverse Weave Pullover Hoodie Mens Oxford Gray GF68Y06145-1IC US Size Large,FBALYB Amazon,46,45,1,0,1,0
,Champion Reverse Weave Pullover Hoodie Mens Oxford Gray GF68Y06145-1IC US Size Medium,Champion Reverse Weave Pullover Hoodie Mens Oxford Gray GF68Y06145-1IC US Size Medium,Default Ridgefield,248,248,0,0,0,300
,Champion Reverse Weave Pullover Hoodie Mens Oxford Gray GF68Y06145-1IC US Size Medium,Champion Reverse Weave Pullover Hoodie Mens Oxford Gray GF68Y06145-1IC US Size Medium,FBALYB Amazon,36,32,4,0,4,0
,Champion Reverse Weave Pullover Hoodie Mens Oxford Gray GF68Y06145-1IC US Size Small,Champion Reverse Weave Pullover Hoodie Mens Oxford Gray GF68Y06145-1IC US Size Small,Default Ridgefield,100,100,0,0,0,150
,Champion Reverse Weave Pullover Hoodie Mens Oxford Gray GF68Y06145-1IC US Size Small,Champion Reverse Weave Pullover Hoodie Mens Oxford Gray GF68Y06145-1IC US Size Small,FBALYB Amazon,43,41,2,0,2,0
,Champion Reverse Weave Pullover Hoodie Mens White GF68Y06145-WHC US Size 2XL,Champion Reverse Weave Pullover Hoodie Mens White GF68Y06145-WHC US Size 2XL,Default Ridgefield,177,177,0,0,0,179
,Champion Reverse Weave Pullover Hoodie Mens White GF68Y06145-WHC US Size 3XL,Champion Reverse Weave Pullover Hoodie Mens White GF68Y06145-WHC US Size 3XL,Default Ridgefield,97,97,0,0,0,100
,Champion Reverse Weave Pullover Hoodie Mens White GF68Y06145-WHC US Size Extra Large,Champion Reverse Weave Pullover Hoodie Mens White GF68Y06145-WHC US Size Extra Large,Default Ridgefield,177,177,0,0,0,180
,Champion Reverse Weave Pullover Hoodie Mens White GF68Y06145-WHC US Size Medium,Champion Reverse Weave Pullover Hoodie Mens White GF68Y06145-WHC US Size Medium,Default Ridgefield,247,247,0,0,0,400
,Champion Reverse Weave Pullover Hoodie Mens White GF68Y06145-WHC US Size Medium,Champion Reverse Weave Pullover Hoodie Mens White GF68Y06145-WHC US Size Medium,FBALYB Amazon,147,147,0,0,0,0
,Champion Reverse Weave Pullover Hoodie Mens White GF68Y06145-WHC US Size Small,Champion Reverse Weave Pullover Hoodie Mens White GF68Y06145-WHC US Size Small,Default Ridgefield,127,127,0,0,0,180
,Champion Reverse Weave Pullover Hoodie Mens White GF68Y06145-WHC US Size Small,Champion Reverse Weave Pullover Hoodie Mens White GF68Y06145-WHC US Size Small,FBALYB Amazon,43,43,0,0,0,0
,Champion Women Seamless Criss Cross Bras Extra Large White/Blue Set of 2,Champion Women Seamless Criss Cross Bras Extra Large White/Blue Set of 2,Default Ridgefield,13,13,0,0,0,0
,Champion Women Seamless Criss Cross Bras Large Black/Pink Set of 2,Champion Women Seamless Criss Cross Bras Large Black/Pink Set of 2,Default Ridgefield,58,58,0,0,0,0
,Champion Women Seamless Criss Cross Bras Large White/Blue Set of 2,Champion Women Seamless Criss Cross Bras Large White/Blue Set of 2,Default Ridgefield,20,20,0,0,0,0
,Champion Women Seamless Criss Cross Bras Medium Black/Pink Set of 2,Champion Women Seamless Criss Cross Bras Medium Black/Pink Set of 2,Default Ridgefield,66,66,0,0,0,0
,Champion Women Seamless Criss Cross Bras Medium White/Blue Set of 2,Champion Women Seamless Criss Cross Bras Medium White/Blue Set of 2,Default Ridgefield,18,18,0,0,0,0
,Champion Women Seamless Criss Cross Bras Small Black/Pink Set of 2,Champion Women Seamless Criss Cross Bras Small Black/Pink Set of 2,Default Ridgefield,64,64,0,0,0,0
,Champion Women Seamless Criss Cross Bras Small White/Blue Set of 2,Champion Women Seamless Criss Cross Bras Small White/Blue Set of 2,Default Ridgefield,10,10,0,0,0,0
,Charcoal Bags 8 ct,Charcoal Bags 8 ct,FBALYB Amazon,41,41,0,0,0,0
,Charlee Bear 8oz Variety 3pk,Charlee Bear 8oz Variety 3pk,FBALYB Amazon,3,3,0,0,0,0
,Charlee Bear Bacon/Cranberry 8oz 2pk,Charlee Bear Bacon/Cranberry 8oz 2pk,FBALYB Amazon,1,1,0,0,0,0
,Charms Blow Pops 100 Count,Charms Blow Pops 100 Count,Default Ridgefield,181,181,0,0,0,0
,Charms Blow Pops 100 Count,Charms Blow Pops 100 Count,FBALYB Amazon,311,310,1,13,1,0
,Charms Blow Pops 100 Count,Charms Blow Pops 100 Count,FBALYB Canada,0,0,0,25,0,0
,Checkups Dental Dog Treats,"Checkups- Dental Dog Treats, 24ct 48 oz.",FBALYB Amazon,1,1,0,0,0,0
,Cheddar Goldfish Crackers 3ct,Cheddar Goldfish Crackers 3ct,FBALYB Amazon,4,4,0,0,0,0
,CHERIBUNDI TART CHERRY JUICE 32oz,CHERIBUNDI TART CHERRY JUICE 32oz,FBALYB Amazon,4,4,0,0,0,0
,Chewmaster Beef Liver Dog Treat 500g,Chewmaster Beef Liver Dog Treat 500g,FBALYB Amazon,-6,-6,0,9,0,0
,Chewmasters Beef Liver Bites 17.6oz,Chewmasters Beef Liver Bites 17.6oz,FBALYB Amazon,-1,-1,0,3,0,0
,Chex Mix Traditional 40 OZ,"Chex Mix Traditional Snack Mix, Original, 40 Ounce",Default,0,0,0,0,0,38
,Chex Mix Traditional 40 OZ,"Chex Mix Traditional Snack Mix, Original, 40 Ounce",FBALYB Amazon,9,9,0,0,0,0
,Chicago Cutlery 18-Piece Knife Set,Chicago Cutlery 18-Piece Insignia Steel Knife Set with Block and In-Block Sharpener,Default,0,0,0,0,0,1
,Chicago Cutlery 18-Piece Knife Set,Chicago Cutlery 18-Piece Insignia Steel Knife Set with Block and In-Block Sharpener,FBALYB Amazon,9,9,0,0,0,0
,Chicken Soup Adult Dog Small Bites 5lb,Chicken Soup for the Soul Adult Dog Small Bites 5lb,FBALYB Amazon,1,1,0,0,0,0
,Chicken Soup for the Soul Puppy 30lb,Chicken Soup for the Soul Puppy 30lb,FBALYB Amazon,3,3,0,0,0,0
,Chicken Soup for the Soul Puppy 5lb,Chicken Soup for the Soul Puppy 5lb,FBALYB Amazon,4,4,0,0,0,0
,"Chicken Soup for the Soul Turkey, Pea 4 lb","Chicken Soup for the Dog Lover's Soul Grain Free Chicken, Turkey, Pea and Sweet Potato Dry Formula - 4 lb bag",FBALYB Amazon,8,8,0,0,0,0
,CHI Infra Shampoo 32 oz.,CHI Infra Shampoo 32 oz.,Default Ridgefield,4,4,0,0,0,0
,CHI Infra Treatment 32 oz.,CHI Infra Treatment 32 oz.,Default Ridgefield,958,958,0,0,0,0
,CHI Infra Treatment 32 oz.,CHI Infra Treatment 32 oz.,FBALYB Saudi,23,23,0,0,0,0
,CHI Infra Treatment 32 oz. + CHI Infra Shampoo 32 oz  DUO SET,CHI Infra Treatment 32 oz. + CHI Infra Shampoo 32 oz  DUO SET,FBALYB Amazon,15,4,11,0,11,0
,CHI KERATIN RECONSTRUCTING CONDITIONER 32 OZ,CHI KERATIN RECONSTRUCTING CONDITIONER 32 OZ,Default Ridgefield,1447,1447,0,0,0,0
,CHI KERATIN RECONSTRUCTING SHAMPOO 32 OZ,CHI KERATIN RECONSTRUCTING SHAMPOO 32 OZ,Default Ridgefield,1450,1450,0,0,0,0
,CHI KERATIN RECONSTRUCTING SHAMPOO 32 OZ + CONDITIONER 32 OZ SET,CHI KERATIN RECONSTRUCTING SHAMPOO 32 OZ + CONDITIONER 32 OZ SET,FBALYB Amazon,-1,-1,0,250,0,0
,Children's Aller-Tec 2 x 18oz,Children's Aller-Tec 2 x 18oz,FBALYB Amazon,1,1,0,0,0,0
,"Children's Motrin Suspension Berry Flavor, 2x4","Children's Motrin Suspension Berry Flavor, 2x4",Default,0,0,0,0,0,100
,Children's Tylenol 4 OZ,Children's Tylenol 4 OZ 2 PK,FBALYB Amazon,-58,-58,0,73,0,0
,Chile lime seasoning blend,Trader Joe's chile lime seasoning blend,Default,0,0,0,0,0,3
,Chinet Cut Crystal 7 Inch Plastic Plates 32 Ct Pack,Chinet Cut Crystal 7 Inch Plastic Plates 32 Ct Pack,FBALYB Amazon,-18,-18,0,0,0,0
,Chinet Cut Plastic Plates,Chinet Cut Crystal 10 Inch Plastic Plates 20 Ct Pack,Default Ridgefield,4,4,0,0,0,0
,Chinet Cut Plastic Plates,Chinet Cut Crystal 10 Inch Plastic Plates 20 Ct Pack,FBALYB Amazon,-67,-67,0,69,0,0
,"Chinet Cut Plastic Plates 10"" 20ct 2pk","Chinet Cut Plastic Plates 10"" 20ct 2pk",FBALYB Amazon,-5,-5,0,0,0,0
,Chinet Premium White Cups,Chinet Premium Plastic 10 Oz. White Cups 420 Ct Bag,FBALYB Amazon,-4,-4,0,0,0,0
,Chock Full of Nuts 48oz 2pk,Chock Full of Nuts 48oz 2pk,Default,0,-34,34,0,0,0
,Chock Full of Nuts 48oz 2pk,Chock Full of Nuts 48oz 2pk,FBALYB Amazon,-156,-156,0,158,0,0
,Chock Full O Nuts Original 48oz Pack of 3,Chock Full O Nuts Original 48oz Pack of 3,FBALYB Amazon,-114,-116,2,112,2,0
,Choco Keto Organic snack,Choco Keto Organic snack,FBALYB Amazon,2,1,1,0,1,0
,Choc snapper Snack,Choc snapper Snack,Default Oxford,80,80,0,0,0,0
,Choc snapper Snack,Choc snapper Snack,Default Ridgefield,11,11,0,0,0,0
,Choc snapper Snack,Choc snapper Snack,FBALYB Amazon,13,13,0,0,0,0
,Cholestoff 210ct,Cholestoff 210ct,Default,0,0,0,0,0,8
,Cholestoff 210ct,Cholestoff 210ct,FBALYB Amazon,175,175,0,0,0,0
,Chosen Avocado Oil 2 Pack,Chosen Avocado Oil 2 Pack,FBALYB Amazon,-2,-2,0,151,0,0
,CHRISTOPHE ROBIN CLEANSING PURIFYING SCRUB WITH SEA SALT 8.33 FL OZ./250ML,CHRISTOPHE ROBIN CLEANSING PURIFYING SCRUB WITH SEA SALT 8.33 FL OZ./250ML,FBALYB Amazon,2,2,0,0,0,0
,CHRISTOPHE ROBIN HYDRATING LEAVE IN MIST WITH ALOE VERA 5.0 FL OZ./150ML,CHRISTOPHE ROBIN HYDRATING LEAVE IN MIST WITH ALOE VERA 5.0 FL OZ./150ML,FBALYB Amazon,4,4,0,0,0,0
,CHRISTOPHE ROBIN HYDRATING MASK WITH ALOE VERA 200 ML,CHRISTOPHE ROBIN HYDRATING MASK WITH ALOE VERA 200 ML,FBALYB Amazon,-1,-1,0,0,0,0
,"CHRISTOPHE ROBIN HYDRATING SHAMPOO WITH ALOE VERA 8,33 FL OZ./250ML","CHRISTOPHE ROBIN HYDRATING SHAMPOO WITH ALOE VERA 8,33 FL OZ./250ML",FBALYB Amazon,4,4,0,0,0,0
,CHRISTOPHE ROBIN REGENERATING MASK WITH PRICKLY PEAR OIL 8.33 FL OZ./250ML,CHRISTOPHE ROBIN REGENERATING MASK WITH PRICKLY PEAR OIL 8.33 FL OZ./250ML,FBALYB Amazon,32,31,1,0,1,0
,CHRISTOPHE ROBIN SHADE VARIATION CARE -BABY BLOND 250 ML,CHRISTOPHE ROBIN SHADE VARIATION CARE -BABY BLOND 250 ML,Default Ridgefield,4,4,0,0,0,0
,CHRISTOPHE ROBIN SHADE VARIATION CARE -BABY BLOND 250 ML,CHRISTOPHE ROBIN SHADE VARIATION CARE -BABY BLOND 250 ML,FBALYB Amazon,-5,-5,0,0,0,0
,Chuckit! Amphibious Shark Fin Large,Chuckit! Amphibious Shark Fin Large,Default,0,-1,1,0,0,0
,Chuckit Max Glow Ball Medium,Chuckit Max Glow Ball Medium,Default,0,0,0,0,0,12
,Chuckit Max Glow Ball Medium 4pk,Chuckit Max Glow Ball Medium 4pk,FBALYB Amazon,-3,-3,0,1,0,0
,Chuckit Pro 26L Large Ball Launcher,Chuckit Pro 26L Large Ball Launcher,FBALYB Amazon,-2,-2,0,0,0,0
,"Chuckit Tennis balls, Medium 4ct","Chuckit Tennis balls, Medium 4ct",FBALYB Amazon,100,100,0,0,0,0
,"Chuckit Tennis balls, Medium 4ct 2pk","Chuckit Tennis balls, Medium 4ct 2pk",FBALYB Amazon,55,55,0,0,0,0
,chwarzkopf BlondMe Bond Enforcing Premium Lightener 450ml,chwarzkopf BlondMe Bond Enforcing Premium Lightener 450ml,FBALYB Amazon,90,90,0,135,0,0
,Cif 500ml lemon cream,Cif 500ml lemon cream,Default CT,762,762,0,0,0,0
,Cif 500ml lemon cream,Cif 500ml lemon cream,FBALYB Amazon,1,1,0,0,0,0
,Cif 500ml lemon cream 3PK,Cif 500ml lemon cream 3PK,FBALYB Amazon,3,3,0,13,0,0
,Cif cream 500ml original,Cif cream 500ml original,Default,0,-336,336,0,0,0
,Cif cream 500ml original,Cif cream 500ml original,Default CT,1,1,0,0,0,0
,Cif cream 500ml original,Cif cream 500ml original,FBALYB Amazon,9,8,1,0,1,0
,Cif cream 500ml original 3pk,Cif cream 500ml original 3pk,FBALYB Amazon,7,4,3,5,3,0
,Circuit Vest 50oz Graphite/Sulphur Spring,Circuit Vest 50oz Graphite/Sulphur Spring,Default,0,0,0,0,0,135
,Circuit Vest 50oz Graphite/Sulphur Spring,Circuit Vest 50oz Graphite/Sulphur Spring,Default Ridgefield,2,2,0,0,0,0
,Circuit Vest 50oz Graphite/Sulphur Spring,Circuit Vest 50oz Graphite/Sulphur Spring,FBALYB Amazon,76,76,0,0,0,0
,Circuit Vest 50oz Nautical Blue/Black,Circuit Vest 50oz Nautical Blue/Black,Default,0,0,0,0,0,90
,Circuit Vest 50oz Nautical Blue/Black,Circuit Vest 50oz Nautical Blue/Black,Default Ridgefield,2,2,0,0,0,0
,Circuit Vest 50oz Nautical Blue/Black,Circuit Vest 50oz Nautical Blue/Black,FBALYB Amazon,26,25,1,1,1,0
,Citracal Calcium Citrate + D,Citracal Calcium Citrate + D,FBALYB Amazon,-1,-1,0,2,0,0
,Citracal Calcium Citrate + D 2pk,Citracal Calcium Citrate + D 2pk,FBALYB Amazon,10,10,0,0,0,0
,"Citrucel, 240 Caplets","Citrucel, 240 Caplets",Default,0,0,0,0,0,30
,CK Boxer Black L,Calvin Klein Boxer Black Large,FBALYB Amazon,35,35,0,0,0,0
,CK Boxer Black M,Calvin Klein Boxer Black Medium,Default,0,0,0,0,0,4
,CK Boxer Black M,Calvin Klein Boxer Black Medium,FBALYB Amazon,-10,-10,0,0,0,0
,CK Boxer White L,Calvin Klein Boxer White Large,Default,0,0,0,0,0,1
,CK Boxer White L,Calvin Klein Boxer White Large,FBALYB Amazon,-1,-1,0,0,0,0
,CK Boys L Black/Navy/Grey,CK Boys L Black/Navy/Grey,Default,0,0,0,0,0,23
,CK Boys L Black/Navy/Grey,CK Boys L Black/Navy/Grey,Default Ridgefield,28,28,0,0,0,0
,CK Boys L Black/Navy/Grey,CK Boys L Black/Navy/Grey,FBALYB Amazon,-1,-1,0,0,0,0
,CK Boys L Blue/Red/Skyblue/Green,CK Boys L Blue/Red/Skyblue/Green,Default,0,0,0,0,0,21
,CK Boys L Blue/Red/Skyblue/Green,CK Boys L Blue/Red/Skyblue/Green,Default Ridgefield,5,5,0,0,0,0
,CK Boys L Blue/Yellow/Red,CK Boys L Blue/Yellow/Red,Default,0,0,0,0,0,3
,CK Boys L Navy/Black/Grey,CK Boys L Navy/Black/Grey,Default,0,0,0,0,0,3
,CK Boys M Black/Nay/Grey,CK Boys M Black/Nay/Grey,Default Ridgefield,84,84,0,0,0,0
,CK Boys M Blue/Red/Skyblue/Green,CK Boys M Blue/Red/Skyblue/Green,Default Ridgefield,7,7,0,0,0,0
,CK Boys M Blue/Red/Skyblue/Green,CK Boys M Blue/Red/Skyblue/Green,FBALYB Amazon,21,21,0,0,0,0
,CK Boys M Blue/Yellow/Red,CK Boys M Blue/Yellow/Red,Default,0,0,0,0,0,2
,CK Boys M Blue/Yellow/Red,CK Boys M Blue/Yellow/Red,Default Ridgefield,10,10,0,0,0,0
,CK Boys M Navy/Black/Grey,CK Boys M Navy/Black/Grey,Default,0,0,0,0,0,16
,CK Boys M Navy/Black/Grey,CK Boys M Navy/Black/Grey,Default Ridgefield,12,12,0,0,0,0
,CK Boys S Black/Navy/Grey,CK Boys S Black/Navy/Grey,Default,0,0,0,0,0,34
,CK Boys S Black/Navy/Grey,CK Boys S Black/Navy/Grey,Default Ridgefield,23,23,0,0,0,0
,CK Boys S Blue/Red/Skyblue/Green,CK Boys S Blue/Red/Skyblue/Green,Default,0,0,0,0,0,18
,CK Boys S Blue/Red/Skyblue/Green,CK Boys S Blue/Red/Skyblue/Green,Default Ridgefield,15,15,0,0,0,0
,CK Boys S Navy/Black/Grey,CK Boys S Navy/Black/Grey,Default,0,0,0,0,0,1
,CK Boys S Navy/Black/Grey,CK Boys S Navy/Black/Grey,Default Ridgefield,1,1,0,0,0,0
,CK Boys XL Black/Navy/Grey,CK Boys XL Black/Navy/Grey,Default,0,0,0,0,0,19
,CK Boys XL Black/Navy/Grey,CK Boys XL Black/Navy/Grey,Default Ridgefield,45,45,0,0,0,0
,CK Boys XL Blue/Red/Skyblue/Green,CK Boys XL Blue/Red/Skyblue/Green,Default,0,0,0,0,0,10
,CK Boys XL Blue/Red/Skyblue/Green,CK Boys XL Blue/Red/Skyblue/Green,Default Ridgefield,15,15,0,0,0,0
,CK Boys XL Blue/Red/Skyblue/Green,CK Boys XL Blue/Red/Skyblue/Green,FBALYB Amazon,-1,-1,0,0,0,0
,CK Girls L Pink/Orange,CK Girls Large Pink/Orange,Default Ridgefield,96,96,0,0,0,0
,CK Girls L Print/Solid Pink,CK Girls Large Print/Solid Pink,Default Ridgefield,180,180,0,0,0,0
,CK Girls L Print/Solid Pink,CK Girls Large Print/Solid Pink,FBALYB Amazon,-3,-3,0,0,0,0
,CK Girls L Solid Pink/Purple,CK Girls Large Solid Pink/Purple,Default Ridgefield,642,642,0,0,0,0
,CK Girls L Solid Pink/Purple,CK Girls Large Solid Pink/Purple,FBALYB Amazon,167,167,0,189,0,0
,CK Girls L Torquoise,CK Girls Large Torquoise,Default Ridgefield,2,2,0,0,0,0
,CK Girls L Torquoise,CK Girls Large Torquoise,FBALYB Amazon,-15,-15,0,15,0,0
,CK Girls M Pink/Orange,CK Girls Medium Pink/Orange,Default Ridgefield,145,145,0,0,0,0
,CK Girls M Print/Solid Pink,CK Girls Medium Print/Solid Pink,Default Ridgefield,742,742,0,0,0,0
,CK Girls M Print/Solid Pink,CK Girls Medium Print/Solid Pink,FBALYB Amazon,788,788,0,1,0,0
,CK Girls M Solid Pink/Purple,CK Girls Medium Solid Pink/Purple,Default Ridgefield,509,509,0,0,0,0
,CK Girls M Solid Pink/Purple,CK Girls Medium Solid Pink/Purple,FBALYB Amazon,146,146,0,0,0,0
,CK Girls M Torquoise,CK Girls Medium Torquoise,Default Ridgefield,43,43,0,0,0,0
,CK Girls S Pink/Orange,CK Girls Small Pink/Orange,Default Ridgefield,10,10,0,0,0,0
,CK Girls S Print/Solid Pink,CK Girls Small Print/Solid Pink,Default Ridgefield,455,455,0,0,0,0
,CK Girls S Print/Solid Pink,CK Girls Small Print/Solid Pink,FBALYB Amazon,167,167,0,0,0,0
,CK Girls S Solid Pink/Purple,CK Girls Small Solid Pink/Purple,Default Ridgefield,216,216,0,0,0,0
,CK Girls S Solid Pink/Purple,CK Girls Small Solid Pink/Purple,FBALYB Amazon,151,151,0,0,0,0
,CK Girls S Torquoise,CK Girls Small Torquoise,Default,0,0,0,0,0,4
,CK Girls S Torquoise,CK Girls Small Torquoise,Default Ridgefield,5,5,0,0,0,0
,CK Girls XL Pink/Orange,CK Girls XLarge Pink/Orange,Default Ridgefield,1,1,0,0,0,0
,CK Girls XL Pink/Orange,CK Girls XLarge Pink/Orange,FBALYB Amazon,-17,-17,0,17,0,0
,CK Girls XL Print/Solid Pink,CK Girls XL Print/Solid Pink,Default Ridgefield,213,213,0,0,0,0
,CK Girls XL Print/Solid Pink,CK Girls XL Print/Solid Pink,FBALYB Amazon,134,129,5,64,5,0
,CK Girls XL Solid Pink/Purple,CK Girls XL Solid Pink/Purple,Default Ridgefield,455,455,0,0,0,0
,CK Girls XL Solid Pink/Purple,CK Girls XL Solid Pink/Purple,FBALYB Amazon,132,132,0,5,0,0
,CK Mens Large Black 3 pack,CK Mens Large Black 3 pack,Default Ridgefield,17,17,0,0,0,0
,CK Mens Large Black 3 pack,CK Mens Large Black 3 pack,FBALYB Amazon,77,77,0,0,0,0
,CK Mens Large Navy/Grey/White,CK Mens Large Navy/Grey/White,Default Ridgefield,65,65,0,0,0,0
,CK Mens Medium Black 3 pack,CK Mens Medium Black 3 pack,Default Ridgefield,34,34,0,0,0,0
,CK Mens Medium Black 3 pack,CK Mens Medium Black 3 pack,FBALYB Amazon,71,70,1,0,1,0
,CK Mens Medium Navy/Grey/White,CK Mens Medium Navy/Grey/White,Default Ridgefield,103,103,0,0,0,0
,CK Mens Medium Navy/Grey/White,CK Mens Medium Navy/Grey/White,FBALYB Amazon,-38,-38,0,43,0,0
,CK Mens X-Large Black 3 pack,CK Mens X-Large Black 3 pack,Default Ridgefield,58,58,0,0,0,0
,CK Mens X-Large Black 3 pack,CK Mens X-Large Black 3 pack,FBALYB Amazon,24,23,1,0,1,0
,CK Mens X-Large Navy/Grey/White,CK Mens X-Large Navy/Grey/White,Default Ridgefield,26,26,0,0,0,0
,CK Pants Black,Calvin Klein Twill Pants Color 010 Black,Default,0,0,0,0,0,3
,CK Pants Castle Rock,Calvin Klein Twill Pants Color 031 Castle Rock,Default,0,0,0,0,0,3
,CK Pants Dress Blues,Calvin Klein Twill Pants Color 475 Dress Blues,Default,0,0,0,0,0,4
,CK Women Jeans 10 x 30 Star Blue,CK Women Jeans 10 x 30 Star Blue,Default Ridgefield,3,3,0,0,0,0
,CK Women Jeans 12 x 30 Star Blue,CK Women Jeans 12 x 30 Star Blue,Default Ridgefield,1,1,0,0,0,0
,CK Women Jeans 2 x 30 Rinse,CK Women Jeans 2 x 30 Rinse,Default Ridgefield,1,1,0,0,0,0
,CK Women Jeans 2 x 32,CK Women Jeans 2 x 32,Default Ridgefield,4,4,0,0,0,0
,CK Women Jeans 2 x 32 Black,CK Women Jeans 2 x 32 Black,Default Ridgefield,3,3,0,0,0,0
,CK Women Jeans 4 x 32 Rinse,CK Women Jeans 4 x 32 Rinse,Default Ridgefield,5,5,0,0,0,0
,CK Women Jeans 6 x 30 Rinse,CK Women Jeans 6 x 30 Rinse 42e0313,Default Ridgefield,8,8,0,0,0,0
,CK Women Jeans 6 x 32 Indigo Blue,CK Women Jeans 6 x 32 Indigo Blue,FBALYB Amazon,-2,-2,0,0,0,0
,CK Women Jeans 6 x 32 Rinse,CK Women Jeans 6 x 32 Rinse 42f0302,Default Ridgefield,2,2,0,0,0,0
,CK Women Jeans 8 x 30 Rinse,CK Women Jeans 8 x 30 Rinse,Default Ridgefield,1,1,0,0,0,0
,CK Women Jeans 8 x 32,CK Women Jeans 8 x 32,Default Ridgefield,5,5,0,0,0,0
,CK Women L Black/Grey/Peach,CK Women Large Black/Grey/Peach,Default,0,-184,184,0,0,0
,CK Women L Black/Grey/Peach,CK Women Large Black/Grey/Peach,Default Ridgefield,2,2,0,0,0,0
,CK Women L Black/White/Grey,CK Women Large Black/White/Grey,Default Ridgefield,52,52,0,0,0,0
,CK Women L Black/White/Grey,CK Women Large Black/White/Grey,FBALYB Amazon,-1,-1,0,0,0,0
,CK Women M Black/Grey/Peach,CK Women Medium Black/Grey/Peach,Default,0,-111,111,0,0,0
,CK Women M Black/Grey/Peach,CK Women Medium Black/Grey/Peach,Default Ridgefield,8,-167,175,0,0,0
,CK Women M Black/Grey/Peach,CK Women Medium Black/Grey/Peach,FBAAP Amazon,0,-1,1,0,0,0
,CK Women M Black/Grey/Peach,CK Women Medium Black/Grey/Peach,FBALYB Amazon,-8,-8,0,4,0,0
,CK Women M Black/White/Grey,CK Women Medium Black/White/Grey,Default Ridgefield,163,163,0,0,0,0
,CK Women M Black/White/Grey,CK Women Medium Black/White/Grey,FBALYB Amazon,130,130,0,22,0,0
,CK Women's Bikini 3pk Black/Silver/White,CK Women's Bikini 3pk Black/Silver/White,FBALYB Amazon,-63,-63,0,53,0,0
,CK Women's Bikini 3pk Pink/Blue/Purple,CK Women's Bikini 3pk Pink/Blue/Purple,Default Ridgefield,141,141,0,0,0,0
,CK Women's Bikini 3pk Pink/Blue/Purple,CK Women's Bikini 3pk Pink/Blue/Purple,FBALYB Amazon,0,-1,1,0,1,0
,CK Women S Black/Grey/Peach,CK Women Small Black/Grey/Peach,Default Ridgefield,70,70,0,0,0,0
,CK Women S Black/Grey/Peach,CK Women Small Black/Grey/Peach,FBALYB Amazon,-20,-20,0,0,0,0
,CK Women S Black/White/Grey,CK Women Small Black/White/Grey,Default Ridgefield,158,158,0,0,0,0
,CK Women S Black/White/Grey,CK Women Small Black/White/Grey,FBALYB Amazon,193,192,1,0,1,0
,CK Women's Hipster Medium White/Silver/Black,CK Women's Hipster Medium White/Silver/Black,Default,0,0,0,0,0,1
,CK Women's Hipster Small White/Silver/Black,CK Women's Hipster Small White/Silver/Black,Default,0,0,0,0,0,1
,CK Women's Hipster Small White/Silver/Black,CK Women's Hipster Small White/Silver/Black,Default Ridgefield,1,1,0,0,0,0
,CK Women's Medium 3pk Black/Silver/White,CK Women's Medium 3pk Black/Silver/White,Default Ridgefield,11,11,0,0,0,0
,CK Women's Medium 3pk Black/Silver/White,CK Women's Medium 3pk Black/Silver/White,FBALYB Amazon,-1,-1,0,0,0,0
,Clarins ACTIVE FACE WASH 125ML,Clarins ACTIVE FACE WASH 125ML,Default Ridgefield,12,12,0,0,0,0
,Clarins ACTIVE FACE WASH 125ML,Clarins ACTIVE FACE WASH 125ML,FBALYB Amazon,-2,-2,0,1,0,0
,Clarins Beauty Flash Balm 15 ml,Clarins Beauty Flash Balm 15 ml,FBALYB Amazon,2,2,0,2,0,0
,Clarins Be Long Mascara - 01 Black,Clarins Be Long Mascara - 01 Black,FBALYB Amazon,1,1,0,0,0,0
,Clarins BODY SHAPING CREAM/MASVELT,Clarins BODY SHAPING CREAM/MASVELT,Default Ridgefield,30,30,0,0,0,0
,Clarins BUST BEAUTY EXTRA LIFT GEL,Clarins BUST BEAUTY EXTRA LIFT GEL,FBALYB Amazon,1,0,1,0,1,0
,Clarins Clarinsmen Exfoliatng Cleanser,Clarins Clarinsmen Exfoliatng Cleanser,FBALYB Amazon,-2,-2,0,0,0,0
,Clarins Contouring Body Oil 100ml,Clarins Contouring Body Oil 100ml,FBALYB Amazon,1,1,0,0,0,0
,Clarins DOUBLE SERUM  30 ML,Clarins DOUBLE SERUM  30 ML,Default Ridgefield,100,100,0,0,0,0
,Clarins DOUBLE SERUM  30 ML,Clarins DOUBLE SERUM  30 ML,FBALYB Amazon,-12,-12,0,0,0,0
,Clarins DOUBLE SERUM JUMBO  50 ML,Clarins DOUBLE SERUM JUMBO  50 ML,Default Ridgefield,45,45,0,0,0,0
,Clarins DOUBLE SERUM JUMBO  50 ML,Clarins DOUBLE SERUM JUMBO  50 ML,FBALYB Amazon,-1,-4,3,3,3,0
,Clarins EAU DYNAMISANTE REFILLABLE,Clarins EAU DYNAMISANTE REFILLABLE,Default Ridgefield,71,71,0,0,0,0
,Clarins EAU DYNAMISANTE REFILLABLE,Clarins EAU DYNAMISANTE REFILLABLE,FBALYB Amazon,2,0,2,0,2,0
,Clarins EXTRA FIRMING BODY CREAM,Clarins EXTRA FIRMING BODY CREAM,Default Ridgefield,48,48,0,0,0,0
,Clarins EXTRA FIRMING BODY LOTION,Clarins EXTRA FIRMING BODY LOTION,Default Ridgefield,42,42,0,0,0,0
,Clarins EXTRA FIRMING BODY LOTION,Clarins EXTRA FIRMING BODY LOTION,FBALYB Amazon,-1,-1,0,0,0,0
,Clarins EXTRA FIRMING DAY CREAM (ALL SKIN TYPES) 50 ML,Clarins EXTRA FIRMING DAY CREAM (ALL SKIN TYPES) 50 ML,FBALYB Amazon,-5,-5,0,1,0,0
,Clarins Extra Firming Day Lotion SPF 15 50ml,Clarins Extra Firming Day Lotion SPF 15 50ml,FBALYB Amazon,-1,-1,0,0,0,0
,Clarins EXTRA FIRMING LIP & CONTOUR BALM,Clarins EXTRA FIRMING LIP & CONTOUR BALM,Default Ridgefield,48,48,0,0,0,0
,Clarins EXTRA FIRMING MASK  75ML,Clarins EXTRA FIRMING MASK  75ML,Default Ridgefield,14,14,0,0,0,0
,Clarins EXTRA FIRMING NECK CREAM AST 50ML,Clarins EXTRA FIRMING NECK CREAM AST 50ML,FBALYB Amazon,-1,-1,0,0,0,0
,Clarins EXTRA FIRMING NIGHT CREAM (AST),Clarins EXTRA FIRMING NIGHT CREAM (AST),Default Ridgefield,40,40,0,0,0,0
,Clarins EXTRA FIRMING NIGHT CREAM (AST),Clarins EXTRA FIRMING NIGHT CREAM (AST),FBALYB Amazon,-1,-2,1,0,1,0
,Clarins EXTRA FIRMING NIGHT CREAM (SPECIAL FOR DRY SKIN)  50 ML,Clarins EXTRA FIRMING NIGHT CREAM (SPECIAL FOR DRY SKIN)  50 ML,Default Ridgefield,28,28,0,0,0,0
,Clarins Eye Contour Gel 20ml,Clarins Eye Contour Gel 20ml,Avrami - Ebay,2,2,0,0,0,0
,Clarins Eye Contour Gel 20ml,Clarins Eye Contour Gel 20ml,Default Ridgefield,104,104,0,0,0,0
,Clarins Eye Contour Gel 20ml,Clarins Eye Contour Gel 20ml,FBALYB Amazon,109,109,0,2,0,0
,Clarins Eye Contour Gel 20ml,Clarins Eye Contour Gel 20ml,WFS,-8,-8,0,0,0,0
,Clarins Firming Body Oil 100ml / Huile Tonique,Clarins Firming Body Oil 100ml / Huile Tonique,FBALYB Amazon,-4,-4,0,2,0,0
,Clarins GENTLE FOAMING CLEANSER NORMAL/COMBINATION SKIN  125 ML,Clarins GENTLE FOAMING CLEANSER NORMAL/COMBINATION SKIN  125 ML,Avrami - Ebay,5,5,0,0,0,0
,Clarins GENTLE FOAMING CLEANSER NORMAL/COMBINATION SKIN  125 ML,Clarins GENTLE FOAMING CLEANSER NORMAL/COMBINATION SKIN  125 ML,FBALYB Amazon,3,3,0,0,0,0
,Clarins Gentle Foaming Cleanser with Cottonseed for Normal or Combination Skin 30ml,Clarins Gentle Foaming Cleanser with Cottonseed for Normal or Combination Skin 30ml,FBALYB Amazon,1,1,0,0,0,0
,Clarins Hand & Nail Treatment Cream 100ml,Clarins Hand & Nail Treatment Cream 100ml,Default Ridgefield,64,64,0,0,0,0
,Clarins Hand & Nail Treatment Cream 100ml,Clarins Hand & Nail Treatment Cream 100ml,FBALYB Amazon,8,8,0,0,0,0
,Clarins Holding Body Oil 100ml,Clarins Holding Body Oil 100ml,Avrami - Ebay,2,2,0,0,0,0
,Clarins Holding Body Oil 100ml,Clarins Holding Body Oil 100ml,FBALYB Amazon,2,2,0,0,0,0
,Clarins HYDRA-ESSENTIEL BI-SERUM 30 ML,Clarins HYDRA-ESSENTIEL BI-SERUM 30 ML,Default Ridgefield,79,79,0,0,0,0
,Clarins HYDRA-ESSENTIEL BI-SERUM 30 ML,Clarins HYDRA-ESSENTIEL BI-SERUM 30 ML,FBALYB Amazon,28,28,0,0,0,0
,Clarins HYDRA-ESSENTIEL CREAM PNS 50 ML,Clarins HYDRA-ESSENTIEL CREAM PNS 50 ML,FBALYB Amazon,-6,-6,0,1,0,0
,Clarins HYDRA-ESSENTIEL CREAM RICH 50 ML,Clarins HYDRA-ESSENTIEL CREAM RICH 50 ML,FBALYB Amazon,-3,-9,6,1,6,0
,CLARINS HYDRA-ESSENTIEL GEL CREAM,CLARINS HYDRA-ESSENTIEL GEL CREAM,Default Ridgefield,35,35,0,0,0,0
,Clarins Instant Eye Make Up Remover 125ml,Clarins Instant Eye Make Up Remover 125ml,Default Ridgefield,23,23,0,0,0,0
,Clarins INSTANT EYE MAKE UP REMOVER  125 ML,Clarins INSTANT EYE MAKE UP REMOVER  125 ML,Avrami - Ebay,11,11,0,0,0,0
,Clarins INSTANT EYE MAKE UP REMOVER  125 ML,Clarins INSTANT EYE MAKE UP REMOVER  125 ML,FBALYB Amazon,128,128,0,0,0,0
,Clarins INSTANT EYE MAKE UP REMOVER  125 ML,Clarins INSTANT EYE MAKE UP REMOVER  125 ML,WFS,-7,-7,0,0,0,0
,Clarins Instant Light Lip Comfort Oil - Red Berry,Clarins Instant Light Lip Comfort Oil - Red Berry ,FBALYB Amazon,-1,-1,0,0,0,0
,Clarins LINE CONTROL EYE BALM 20ML,Clarins LINE CONTROL EYE BALM 20ML,Avrami - Ebay,2,2,0,0,0,0
,Clarins LINE CONTROL EYE BALM 20ML,Clarins LINE CONTROL EYE BALM 20ML,FBALYB Amazon,1,0,1,0,1,0
,Clarins Men After Shave Soother 75ml,Clarins Men After Shave Soother 75ml,Default Ridgefield,7,7,0,0,0,0
,Clarins Men After Shave Soother 75ml,Clarins Men After Shave Soother 75ml,WFS,-7,-7,0,0,0,0
,Clarins Men Anti Fatigue Eye,Clarins Men Anti Fatigue Eye ,FBALYB Amazon,-2,-2,0,4,0,0
,Clarins Men Fluide A-Rasage 75ml,Clarins Men Fluide A-Rasage 75ml,FBALYB Amazon,6,4,2,0,2,0
,Clarins Men Line Control Balm 50ml,Clarins Men Line Control Balm 50ml,Default Ridgefield,37,37,0,0,0,0
,Clarins Men Line Control Balm 50ml,Clarins Men Line Control Balm 50ml,FBALYB Amazon,97,97,0,1,0,0
,Clarins Men Line Control Balm 50ml,Clarins Men Line Control Balm 50ml,WFS,-21,-21,0,0,0,0
,Clarins MOISTURE RICH BODY LOTION  200 ML,Clarins MOISTURE RICH BODY LOTION  200 ML,FBALYB Amazon,-2,-2,0,0,0,0
,Clarins MULTI-ACTIVE CORRECTION CREAM (ALL SKIN TYPES)  50 ML,Clarins MULTI-ACTIVE CORRECTION CREAM (Dry Skin)  50 ML,Avrami - Ebay,2,2,0,0,0,0
,Clarins MULTI-ACTIVE CORRECTION CREAM (ALL SKIN TYPES)  50 ML,Clarins MULTI-ACTIVE CORRECTION CREAM (Dry Skin)  50 ML,FBALYB Amazon,34,34,0,0,0,0
,Clarins MULTI-ACTIVE CORRECTION CREAM (AST),Clarins MULTI-ACTIVE CORRECTION CREAM (AST),Default Ridgefield,22,22,0,0,0,0
,Clarins Multi-Active Dry Wrinkle Correction Cream 50ml,Clarins Multi-Active Dry Wrinkle Correction Cream 50ml,FBALYB Amazon,-39,-39,0,0,0,0
,Clarins MULTI-ACTIVE NIGHT CREAM (NORMAL/COMB),Clarins MULTI-ACTIVE NIGHT CREAM (NORMAL/COMB),FBALYB Amazon,47,47,0,0,0,0
,Clarins MULTI-ACTIVE NIGHT YOUTH RECOVERY COMFORT CREAM (NORMAL TO DRY)   50 ML,Clarins MULTI-ACTIVE NIGHT YOUTH RECOVERY COMFORT CREAM (NORMAL TO DRY)   50 ML,Default Ridgefield,12,12,0,0,0,0
,Clarins MULTI-ACTIVE NIGHT YOUTH RECOVERY COMFORT CREAM (NORMAL TO DRY)   50 ML,Clarins MULTI-ACTIVE NIGHT YOUTH RECOVERY COMFORT CREAM (NORMAL TO DRY)   50 ML,FBALYB Amazon,-2,-2,0,0,0,0
,Clarins ONE STEP GENTLE EXFOLIATING CLEANSER  125 ML,Clarins ONE STEP GENTLE EXFOLIATING CLEANSER  125 ML,Avrami - Ebay,2,2,0,0,0,0
,Clarins ONE STEP GENTLE EXFOLIATING CLEANSER  125 ML,Clarins ONE STEP GENTLE EXFOLIATING CLEANSER  125 ML,FBALYB Amazon,10,10,0,1,0,0
,Clarins Self Tanning Gel 125ml,Clarins Self Tanning Gel 125ml,FBALYB Amazon,-1,-1,0,0,0,0
,Clarins SELF TANNING MILKY LOTION  125 ML,Clarins SELF TANNING MILKY LOTION  125 ML,FBALYB Amazon,147,147,0,0,0,0
,Clarins Set Double Serum 30ml,Clarins Set Double Serum 30ml,Default Ridgefield,16,16,0,0,0,0
,Clarins Shea Butter Dry skin 4.4 oz Exfoliating cleanser,Clarins Shea Butter Dry skin 4.4 oz Exfoliating cleanser,FBALYB Amazon,-2,-2,0,10,0,0
,Clarins SOS Primer 05 RP 30ml,Clarins SOS Primer 05 RP 30ml,FBALYB Amazon,6,6,0,0,0,0
,Clarins Super Moisture Gel,Clarins Super Moisture Gel,Default,0,-56,56,0,0,0
,Clarins Super Moisture Gel,Clarins Super Moisture Gel,FBALYB Amazon,-2,-2,0,0,0,0
,Clarins Super Moisture Gel,Clarins Super Moisture Gel,WFS,-18,-18,0,0,0,0
,Clarins SUPER RESTORATIVE DAY CREAM AST 50 ML,Clarins SUPER RESTORATIVE DAY CREAM AST 50 ML,Avrami - Ebay,2,2,0,0,0,0
,Clarins SUPER RESTORATIVE DAY CREAM AST 50 ML,Clarins SUPER RESTORATIVE DAY CREAM AST 50 ML,FBALYB Amazon,137,137,0,0,0,0
,Clarins SUPER RESTORATIVE DAY CREAM DS,Clarins SUPER RESTORATIVE DAY CREAM DRY SKIN,Default Ridgefield,72,72,0,0,0,0
,Clarins SUPER RESTORATIVE NIGHT CREAM AST 50 ML,Clarins SUPER RESTORATIVE NIGHT CREAM AST 50 ML,FBALYB Amazon,-1,-2,1,0,1,0
,Clarins SUPER RESTORATIVE NIGHT CREAM DS 50 ML,Clarins SUPER RESTORATIVE NIGHT CREAM DS 50 ML,Default Ridgefield,18,18,0,0,0,0
,Clarins SUPER RESTORATIVE NIGHT CREAM DS 50 ML,Clarins SUPER RESTORATIVE NIGHT CREAM DS 50 ML,FBALYB Amazon,-1,-1,0,0,0,0
,Clarins SUPER RESTORATIVE SERUM,Clarins SUPER RESTORATIVE SERUM,Default Ridgefield,2,2,0,0,0,0
,Clarins SUPER RESTORATIVE SERUM,Clarins SUPER RESTORATIVE SERUM,FBALYB Amazon,23,21,2,0,2,0
,Clarins SUPER RESTORATIVE TOTAL EYE CARE (45+) 15 ML,Clarins SUPER RESTORATIVE TOTAL EYE CARE (45+) 15 ML,Default,0,-1,1,0,0,0
,Clarins SUPER RESTORATIVE TOTAL EYE CARE (45+) 15 ML,Clarins SUPER RESTORATIVE TOTAL EYE CARE (45+) 15 ML,FBALYB Amazon,0,0,0,1,0,0
,Clarins TONIC BODY TREATMENT OIL   100 ML,Clarins TONIC BODY TREATMENT OIL   100 ML,Default Ridgefield,49,49,0,0,0,0
,Clarins TONIC BODY TREATMENT OIL   100 ML,Clarins TONIC BODY TREATMENT OIL   100 ML,FBALYB Amazon,-2,-2,0,3,0,0
,Clarins TONING LOTION DRY/NORMAL SKIN  200 ML,Clarins TONING LOTION DRY/NORMAL SKIN  200 ML,FBALYB Amazon,3,3,0,0,0,0
,"Clarins UV + SPF 50, 50 ML","Clarins UV + SPF 50, 50 ML",FBALYB Amazon,4,4,0,0,0,0
,"Claritin Clarispray Dose, 60ct","Claritin Clarispray Dose, 60ct",FBALYB Amazon,-2,-2,0,0,0,0
,Classic 85 oz Graphite/Black,Classic 85 oz Graphite/Black,FBALYB Amazon,-15,-15,0,1,0,0
,Classic 85 oz Lapis Blue/Atomic Blue,Classic 85 oz Lapis Blue/Atomic Blue,Default,0,-5,5,0,0,0
,Classic 85 oz Lapis Blue/Atomic Blue,Classic 85 oz Lapis Blue/Atomic Blue,FBALYB Amazon,-17,-17,0,0,0,0
,Claw Game,Electronic Claw Arcade Game,Default,0,0,0,0,0,30
,Claw Game,Electronic Claw Arcade Game,FBALYB Amazon,2,2,0,0,0,0
,Clean Ones Premium Gloves Large,"Clean Ones Premium Multi Purpose Rubber Gloves, Large (Pack of 9 pairs) ",FBALYB Amazon,-4,-4,0,0,0,0
,Clear Hockey Tape 12 Pack,Clear Hockey Tape 12 Pack,Default Ridgefield,180,180,0,0,0,0
,Clear Hockey Tape 12 Pack,Clear Hockey Tape 12 Pack,FBALYB Amazon,-200,-210,10,256,10,0
,Clear Hockey Tape 12 Pack,Clear Hockey Tape 12 Pack,FBALYB Canada,0,0,0,50,0,0
,Clear Hockey Tape 5 Pack (25m Length),Clear Hockey Tape 5 Pack (25m Length),FBALYB Amazon,-10,-10,0,1,0,0
,Clearly Natural Liquid Soap Unscented 32oz,Clearly Natural Liquid Soap Unscented 32oz,Default,0,0,0,0,0,25
,Clear Skin Probiotic Moisturizer 2oz,Eminence Clear Skin Probiotic Moisturizer 2oz,Default Ridgefield,2,2,0,0,0,0
,Clear Skin Probiotic Moisturizer 2oz,Eminence Clear Skin Probiotic Moisturizer 2oz,FBALYB Amazon,721,709,12,3,12,0
,Clever Crates 62 L,Clever Crates 62 L,Default,0,0,0,0,0,6
,Clever Crates 62 L,Clever Crates 62 L,FBALYB Amazon,-2,-2,0,1,0,0
,CleverMade Milk Crate 25L Red,CleverMade Collapsible Milk Crate 25L Red,Default,0,0,0,0,0,68
,CleverMade Milk Crate 25L Red,CleverMade Collapsible Milk Crate 25L Red,FBALYB Amazon,-1,-1,0,1,0,0
,CLIF Energy Bar Variety Pack 18ct,CLIF Energy Bar Variety Pack 18ct,FBALYB Amazon,-8,-8,0,10,0,0
,Cliff 18ct Variety Snack Bar,Cliff 18ct Variety Snack Bar ,FBALYB Amazon,2,2,0,0,0,0
,Clinique Beyond Perfecting Super Concealer 10 Moderately Fair 8ml,Clinique Beyond Perfecting Super Concealer 10 Moderately Fair 8ml,FBALYB Amazon,-1,-1,0,0,0,0
,Clinique - Blended Face Powder Transparency 3 35gr,Clinique - Blended Face Powder Transparency 3 35gr,FBALYB Amazon,-3,-3,0,0,0,0
,CLINIQUE - Clarifying Lotion 3 200ml,CLINIQUE - Clarifying Lotion 3 200ml,FBALYB Amazon,-4,-4,0,0,0,0
,Clinique Staymatte Powder Stay Beige 7.6gr,Clinique Staymatte Powder Stay Beige 7.6gr,FBALYB Amazon,-8,-8,0,0,0,0
,Clinique Staymatte Powder Stay Nuetral 7.6gr,Clinique Staymatte Powder Stay Nuetral 7.6gr,FBALYB Amazon,65,59,6,2,6,0
,CLINIQUE - Superpowder - Matte Ivory 10gr,CLINIQUE - Superpowder - Matte Ivory 10gr,FBALYB Amazon,0,0,0,8,0,0
,CLINIQUE - Superpowder - Matte Neutral 10gr,CLINIQUE - Superpowder - Matte Neutral 10gr,FBALYB Amazon,-2,-2,0,0,0,0
,Clinique - Take The Day Off Makeup Remover 125ml,Clinique - Take The Day Off Makeup Remover 125ml,Default Ridgefield,13,13,0,0,0,0
,Clinique - Take The Day Off Makeup Remover 125ml,Clinique - Take The Day Off Makeup Remover 125ml,FBALYB Amazon,291,291,0,1,0,0
,Clorox 2 Ontario,Clorox 2 Ontario,FBALYB Amazon,31,31,0,0,0,0
,Clorox 30oz Bathroom Spray Blue 2pk,Clorox 30oz Bathroom Spray Blue 2pk,FBALYB Amazon,290,290,0,15,0,0
,Clorox 32oz Green,Clorox 32oz Green,Default,0,-3120,3120,0,0,0
,Clorox 32oz Green 2pk,Clorox 32oz Green 2pk,FBALYB Amazon,997,896,101,1247,101,0
,Clorox 32oz Green 3pk,Clorox 32oz Green 3pk,FBALYB Amazon,162,146,16,342,16,0
,Clorox 32oz Green 4pk,Clorox 32oz Green 4pk,FBALYB Amazon,69,63,6,0,6,0
,Clorox Bleach Foamer Bathroom Cleaner 2pk,Clorox Bleach Foamer Bathroom Cleaner 2pk,FBALYB Amazon,84,84,0,6,0,0
,Clorox Kitchen Cleaner,Clorox Kitchen Cleaner,FBALYB Amazon,3,3,0,1,0,0
,Clorox Kitchen Cleaner 2pk,Clorox Kitchen Cleaner 2pk,FBALYB Amazon,12,12,0,0,0,0
,Clorox Original Bleach 1.89 ML 2pk,Clorox Original Bleach 1.89 ML 2pk,FBALYB Amazon,2,2,0,0,0,0
,Clorox Original Bleach 887 ML,Clorox Original Bleach 887 ML,Default,0,-2576,2576,0,0,0
,Clorox Original Bleach 887 ML 2pk,Clorox Original Bleach 887 ML 2pk,Default,0,-100,100,0,0,0
,Clorox Original Bleach 887 ML 2pk,Clorox Original Bleach 887 ML 2pk,FBALYB Amazon,-612,-612,0,1646,0,0
,Cloud Star Buddy Biscuits Bacon/Cheese 6oz,Cloud Star Buddy Biscuits Bacon/Cheese 6oz,Default,0,-24,24,0,0,49
,Cloud Star Buddy Biscuits Beef 6oz,Cloud Star Buddy Biscuits Beef 6oz,Default,0,0,0,0,0,23
,Cloud Star Buddy Biscuits Chicken 6oz,Cloud Star Buddy Biscuits Chicken 6oz,Default,0,0,0,0,0,22
,Cloud Star Buddy Biscuits PButter 5oz 4pk,Cloud Star Buddy Biscuits PButter 5oz 4pk,FBALYB Amazon,-6,-6,0,6,0,0
,Cloudstar Dog Tricky Trainers Liver 5oz,Cloudstar Dog Tricky Trainers Liver 5oz,Default,0,0,0,0,0,12
,Cloud Star Itty Bitty Buddy Biscuits Chicken 7oz 2pk,Cloud Star Itty Bitty Buddy Biscuits Chicken 7oz 2pk,FBALYB Amazon,1,1,0,0,0,0
,Cloud Star Itty Bitty Buddy Biscuits PButter 7oz,Cloud Star Itty Bitty Buddy Biscuits PButter 7oz,Default,0,0,0,0,0,14
,Cloud Star Tricky 14oz Liver 2pk,Cloud Star Tricky 14oz Liver 2pk,FBALYB Amazon,-1,-1,0,0,0,0
,Cloud Star Tricky Trainers Cheddar 5oz,Cloud Star Tricky Trainers Cheddar 5oz,Default,0,0,0,0,0,12
,Cloud Star Tricky Trainers Cheddar 8oz,Cloud Star Tricky Trainers Cheddar 8oz,Default,0,0,0,0,0,1
,Cloud Star Tricky Trainers Cheddar 8oz 3pk,Cloud Star Tricky Trainers Cheddar 8oz 3pk,FBALYB Amazon,1,1,0,0,0,0
,Cloud Star Tricky Trainers Cheddar 8oz 4pk,Cloud Star Tricky Trainers Cheddar 8oz 4pk,FBALYB Amazon,0,-1,1,0,1,0
,"Cloud Star Tricky Trainers Chewy Cheddar, 14 oz","Cloud Star Tricky Trainers Chewy Cheddar, 14 oz",Default,0,0,0,0,0,25
,"Cloud Star Tricky Trainers Chewy Cheddar, 14 oz","Cloud Star Tricky Trainers Chewy Cheddar, 14 oz",FBALYB Amazon,28,28,0,4,0,0
,Cloud Star Tricky Trainers Liver 14oz,Cloud Star Tricky Trainers Liver 14oz,Default,0,0,0,0,0,23
,Cloud Star Tricky Trainers Liver 14oz 3pk,Cloud Star Tricky Trainers Liver 14oz 3pk,FBALYB Amazon,0,0,0,1,0,0
,Cloud Star Tricky Trainers Liver 8oz,Cloud Star Tricky Trainers Liver 8oz,Default,0,0,0,0,0,2
,Cloud Star Tricky Trainers PButter 12oz,Cloud Star Tricky Trainers PButter 12oz,Default,0,0,0,0,0,1
,Cloud Star Tricky Trainers PButter 12oz,Cloud Star Tricky Trainers PButter 12oz,FBALYB Amazon,-6,-6,0,6,0,0
,Cloud Star Tricky Trainers Salmon 14oz,Cloud Star Tricky Trainers Salmon 14oz,Default,0,0,0,0,0,25
,Cloud Star Tricky Trainers Salmon 8oz,Cloud Star Tricky Trainers Salmon 8oz,Default,41,41,0,0,0,1
,Cloud Star Tricky Trainers Salmon 8oz 4pk,Cloud Star Tricky Trainers Salmon 8oz 4pk,FBALYB Amazon,-1,-3,2,0,2,0
,Cloud Star Wag More Bacon/Cheese 6oz,Cloud Star Wag More Bacon/Cheese 6oz,Default,0,0,0,0,0,14
,Cloud Star Wag More Bacon/Cheese/Apple 16oz,Cloud Star Wag More Bacon/Cheese/Apple 16oz,Default,0,0,0,0,0,14
,Cloud Star Wag More Chicken/Carrot 16oz,Cloud Star Wag More Chicken/Carrot 16oz,Default,0,0,0,0,0,14
,Cloud Star Wag More Chicken/Carrots 6oz,Cloud Star Wag More Chicken/Carrots 6oz,Default,0,0,0,0,0,128
,Cloud Star Wag More Itty Bitty Cheddar 7oz,Cloud Star Wag More Itty Bitty Cheddar 7oz,Default,0,0,0,0,0,14
,Cloud Star Wag More PButter 16oz,Cloud Star Wag More PButter 16oz,Default,0,0,0,0,0,14
,Cloud Star Wag More PButter 3lb,Cloud Star Wag More PButter 3lb,FBALYB Amazon,22,22,0,0,0,0
,Cloud Star Wag More PButter 6oz,Cloud Star Wag More PButter 6oz,Default,0,0,0,0,0,100
,CM-L3NW-8MQS,Gymboree Bubble Ooodles with Wand and Tray - 4oz,FBALYB Amazon,-1,-1,0,0,0,0
,CO-6PN1-69C7,"NuWave 20631 Oven Pro Plus, Black",FBAAP Amazon,-1,-1,0,0,0,0
,Coastal Pet 769082 30 Heavy Tieout Cable,Coastal Pet Products 769082 30 Heavy Tieout Cable,FBALYB Amazon,95,95,0,0,0,0
,Coastal Pet Head Halter Black Small,Coastal Pet Walk'n Train Head Halter Black Small,FBALYB Amazon,2,2,0,0,0,0
,Coconut Clusters 16 oz,Innofoods Coconut Clusters with Organic Super Seeds ‑ 16 oz,FBALYB Amazon,-275,-275,0,402,0,0
,Coconut Clusters 16 oz 2pk,Coconut Clusters 16 oz 2pk,FBALYB Amazon,-4,-5,1,0,1,0
,COCONUT Cookie Thins 16 Oz 2pk,COCONUT Cookie Thins 16 Oz 2pk,FBALYB Amazon,2,2,0,0,0,0
,Coffeemate French Vanilla 180ct,"Coffeemate Single‑Serve Creamer, French Vanilla ‑ 180ct",FBALYB Amazon,4,4,0,0,0,0
,Coffee People Black Tiger 24ct,Coffee People Black Tiger 24ct,Default,0,0,0,0,0,1140
,Coffee People Turbo Caffeine 24ct,Coffee People Turbo Caffeine 24ct,Default,0,0,0,0,0,600
,Cole Haan GrandPro Tennis - Optic White/WHT - US Size: 6,Cole Haan GrandPro Tennis - Optic White/WHT - US Size: 6,Default,0,-13,13,0,0,0
,Cole Haan GrandPro Tennis - Optic White/WHT - US Size: 6,Cole Haan GrandPro Tennis - Optic White/WHT - US Size: 6,FBALYB Amazon,-4,-4,0,0,0,0
,Cole Haan GrandPro Tennis - Optic White/WHT - US Size: 6.5,Cole Haan GrandPro Tennis - Optic White/WHT - US Size: 6.5,FBALYB Amazon,-4,-4,0,0,0,0
,Cole Haan GrandPro Tennis - Optic White/WHT - US Size: 7,Cole Haan GrandPro Tennis - Optic White/WHT - US Size: 7,FBALYB Amazon,-1,-1,0,0,0,0
,Cole Haan GrandPro Tennis - Optic White/WHT - US Size: 7.5,Cole Haan GrandPro Tennis - Optic White/WHT - US Size: 7.5,FBALYB Amazon,-2,-2,0,0,0,0
,Cole Haan GrandPro Tennis - Optic White/WHT - US Size: 8,Cole Haan GrandPro Tennis - Optic White/WHT - US Size: 8,FBALYB Amazon,-3,-3,0,0,0,0
,Cole Haan GrandPro Tennis - Optic White/WHT - US Size: 8.5,Cole Haan GrandPro Tennis - Optic White/WHT - US Size: 8.5,FBALYB Amazon,-7,-7,0,0,0,0
,Cole Haan GrandPro Tennis - Optic White/WHT - US Size: 9,Cole Haan GrandPro Tennis - Optic White/WHT - US Size: 9,FBALYB Amazon,-4,-4,0,0,0,0
,Cole Haan GrandPro Tennis Sneaker - Blazer Blue Handstain - US Size: 10,Cole Haan GrandPro Tennis Sneaker - Blazer Blue Handstain - US Size: 10,FBALYB Amazon,-3,-3,0,0,0,0
,Cole Haan GrandPro Tennis Sneaker - Blazer Blue Handstain - US Size: 10.5,Cole Haan GrandPro Tennis Sneaker - Blazer Blue Handstain - US Size: 10.5,FBALYB Amazon,-5,-5,0,0,0,0
,Cole Haan GrandPro Tennis Sneaker - Blazer Blue Handstain - US Size: 11,Cole Haan GrandPro Tennis Sneaker - Blazer Blue Handstain - US Size: 11,FBALYB Amazon,-3,-3,0,0,0,0
,Cole Haan GrandPro Tennis Sneaker - Blazer Blue Handstain - US Size: 11.5,Cole Haan GrandPro Tennis Sneaker - Blazer Blue Handstain - US Size: 11.5,FBALYB Amazon,-4,-4,0,0,0,0
,Cole Haan GrandPro Tennis Sneaker - Blazer Blue Handstain - US Size: 8.5,Cole Haan GrandPro Tennis Sneaker - Blazer Blue Handstain - US Size: 8.5,FBALYB Amazon,-2,-2,0,0,0,0
,Cole Haan GrandPro Tennis Sneaker - Blazer Blue Handstain - US Size: 9,Cole Haan GrandPro Tennis Sneaker - Blazer Blue Handstain - US Size: 9,FBALYB Amazon,-2,-2,0,0,0,0
,Cole Haan GrandPro Tennis Sneaker - Blazer Blue Handstain - US Size: 9.5,Cole Haan GrandPro Tennis Sneaker - Blazer Blue Handstain - US Size: 9.5,FBALYB Amazon,-3,-3,0,0,0,0
,Cole Haan GrandPro Tennis - White - US Size: 10,Cole Haan GrandPro Tennis - White - US Size: 10,FBALYB Amazon,-3,-3,0,0,0,0
,Cole Haan GrandPro Tennis - White - US Size: 11,Cole Haan GrandPro Tennis - White - US Size: 11,FBALYB Amazon,-6,-6,0,0,0,0
,Cole Haan GrandPro Tennis - White - US Size: 12,Cole Haan GrandPro Tennis - White - US Size: 12,FBALYB Amazon,-4,-4,0,0,0,0
,Cole Haan GrandPro Tennis - White - US Size: 9,Cole Haan GrandPro Tennis - White - US Size: 9,FBALYB Amazon,-2,-2,0,0,0,0
,Cole Haan OriginalGrand Stitchlite Wingtip Oxford - Marine Blue - US Size: 6,Cole Haan OriginalGrand Stitchlite Wingtip Oxford - Marine Blue - US Size: 6,FBALYB Amazon,-1,-1,0,0,0,0
,Cole Haan OriginalGrand Stitchlite Wingtip Oxford - Navy/Ivory - US Size: 10,Cole Haan OriginalGrand Stitchlite Wingtip Oxford - Navy/Ivory - US Size: 10,FBALYB Amazon,-19,-20,1,0,1,0
,Cole Haan OriginalGrand Stitchlite Wingtip Oxford - Navy/Ivory - US Size: 10.5,Cole Haan OriginalGrand Stitchlite Wingtip Oxford - Navy/Ivory - US Size: 10.5,FBALYB Amazon,-15,-15,0,1,0,0
,Cole Haan OriginalGrand Stitchlite Wingtip Oxford - Navy/Ivory - US Size: 11.5,Cole Haan OriginalGrand Stitchlite Wingtip Oxford - Navy/Ivory - US Size: 11.5,FBALYB Amazon,-1,-1,0,0,0,0
,Cole Haan OriginalGrand Stitchlite Wingtip Oxford - Navy/Ivory - US Size: 12,Cole Haan OriginalGrand Stitchlite Wingtip Oxford - Navy/Ivory - US Size: 12,FBALYB Amazon,-5,-5,0,0,0,0
,Cole Haan OriginalGrand Stitchlite Wingtip Oxford - Navy/Ivory - US Size: 13,Cole Haan OriginalGrand Stitchlite Wingtip Oxford - Navy/Ivory - US Size: 13,FBALYB Amazon,-5,-5,0,0,0,0
,Cole Haan OriginalGrand Stitchlite Wingtip Oxford - Navy/Ivory - US Size: 7.5,Cole Haan OriginalGrand Stitchlite Wingtip Oxford - Navy/Ivory - US Size: 7.5,FBALYB Amazon,-1,-1,0,0,0,0
,Cole Haan OriginalGrand Stitchlite Wingtip Oxford - Navy/Ivory - US Size: 8,Cole Haan OriginalGrand Stitchlite Wingtip Oxford - Navy/Ivory - US Size: 8,FBALYB Amazon,-3,-3,0,0,0,0
,Cole Haan OriginalGrand Stitchlite Wingtip Oxford - Navy/Ivory - US Size: 9,Cole Haan OriginalGrand Stitchlite Wingtip Oxford - Navy/Ivory - US Size: 9,FBALYB Amazon,-11,-11,0,0,0,0
,Cole Haan OriginalGrand Stitchlite Wingtip Oxford - Navy/Ivory - US Size: 9.5,Cole Haan OriginalGrand Stitchlite Wingtip Oxford - Navy/Ivory - US Size: 9.5,FBALYB Amazon,-13,-13,0,0,0,0
,Cole Haan OriginalGrand Wingtip Oxford - Black Leather/White - US Size: 10,Cole Haan OriginalGrand Wingtip Oxford - Black Leather/White - US Size: 10,FBALYB Amazon,-1,-1,0,0,0,0
,Cole Haan OriginalGrand Wingtip Oxford - Black Leather/White - US Size: 11,Cole Haan OriginalGrand Wingtip Oxford - Black Leather/White - US Size: 11,FBALYB Amazon,-2,-2,0,0,0,0
,Cole Haan OriginalGrand Wingtip Oxford - Black Leather/White - US Size: 13,Cole Haan OriginalGrand Wingtip Oxford - Black Leather/White - US Size: 13,FBALYB Amazon,-1,-1,0,0,0,0
,Cole Haan OriginalGrand Wingtip Oxford - Black Leather/White - US Size: 8,Cole Haan OriginalGrand Wingtip Oxford - Black Leather/White - US Size: 8,FBALYB Amazon,16,16,0,0,0,0
,Cole Haan OriginalGrand Wingtip Oxford - Black Leather/White - US Size: 8.5,Cole Haan OriginalGrand Wingtip Oxford - Black Leather/White - US Size: 8.5,FBALYB Amazon,-1,-1,0,0,0,0
,Cole Haan OriginalGrand Wingtip Oxford - Black Leather/White - US Size: 9,Cole Haan OriginalGrand Wingtip Oxford - Black Leather/White - US Size: 9,FBALYB Amazon,0,-2,2,0,2,0
,Cole Haan OriginalGrand Wingtip Oxford - Black Leather/White - US Size: 9.5,Cole Haan OriginalGrand Wingtip Oxford - Black Leather/White - US Size: 9.5,FBALYB Amazon,-3,-3,0,0,0,0
,Cole Haan OriginalGrand Wingtip Oxford - Woodbury/Ivory -   US Size: 10,Cole Haan OriginalGrand Wingtip Oxford - Woodbury/Ivory -   US Size: 10,FBALYB Amazon,-10,-10,0,0,0,0
,Cole Haan OriginalGrand Wingtip Oxford - Woodbury/Ivory -   US Size: 10.5,Cole Haan OriginalGrand Wingtip Oxford - Woodbury/Ivory -   US Size: 10.5,FBALYB Amazon,-6,-6,0,0,0,0
,Cole Haan OriginalGrand Wingtip Oxford - Woodbury/Ivory -   US Size: 11,Cole Haan OriginalGrand Wingtip Oxford - Woodbury/Ivory -   US Size: 11,FBALYB Amazon,18,18,0,0,0,0
,Cole Haan OriginalGrand Wingtip Oxford - Woodbury/Ivory -   US Size: 11.5,Cole Haan OriginalGrand Wingtip Oxford - Woodbury/Ivory -   US Size: 11.5,FBALYB Amazon,-1,-1,0,0,0,0
,Cole Haan OriginalGrand Wingtip Oxford - Woodbury/Ivory -   US Size: 9,Cole Haan OriginalGrand Wingtip Oxford - Woodbury/Ivory -   US Size: 9,FBALYB Amazon,-3,-3,0,0,0,0
,Cole Haan OriginalGrand Wingtip Oxford - Woodbury/Ivory -   US Size: 9.5,Cole Haan OriginalGrand Wingtip Oxford - Woodbury/Ivory -   US Size: 9.5,FBALYB Amazon,-13,-13,0,0,0,0
,Cole Haan Zerogrand Stitchlite Oxford - Marine Blue Knit/Ivory - US Size: 10,Cole Haan Zerogrand Stitchlite Oxford - Marine Blue Knit/Ivory - US Size: 10,FBALYB Amazon,-18,-20,2,0,2,0
,Cole Haan Zerogrand Stitchlite Oxford - Marine Blue Knit/Ivory - US Size: 10.5,Cole Haan Zerogrand Stitchlite Oxford - Marine Blue Knit/Ivory - US Size: 10.5,FBALYB Amazon,-9,-9,0,0,0,0
,Cole Haan Zerogrand Stitchlite Oxford - Marine Blue Knit/Ivory - US Size: 11,Cole Haan Zerogrand Stitchlite Oxford - Marine Blue Knit/Ivory - US Size: 11,FBALYB Amazon,-3,-3,0,0,0,0
,Cole Haan Zerogrand Stitchlite Oxford - Marine Blue Knit/Ivory - US Size: 12,Cole Haan Zerogrand Stitchlite Oxford - Marine Blue Knit/Ivory - US Size: 12,FBALYB Amazon,-5,-5,0,0,0,0
,Cole Haan Zerogrand Stitchlite Oxford - Marine Blue Knit/Ivory - US Size: 13,Cole Haan Zerogrand Stitchlite Oxford - Marine Blue Knit/Ivory - US Size: 13,FBALYB Amazon,-2,-2,0,0,0,0
,Cole Haan Zerogrand Stitchlite Oxford - Marine Blue Knit/Ivory - US Size: 8,Cole Haan Zerogrand Stitchlite Oxford - Marine Blue Knit/Ivory - US Size: 8,FBALYB Amazon,-1,-1,0,0,0,0
,Cole Haan Zerogrand Stitchlite Oxford - Marine Blue Knit/Ivory - US Size: 9,Cole Haan Zerogrand Stitchlite Oxford - Marine Blue Knit/Ivory - US Size: 9,FBALYB Amazon,-10,-10,0,0,0,0
,Cole Haan Zerogrand Stitchlite Oxford - Marine Blue Knit/Ivory - US Size: 9.5,Cole Haan Zerogrand Stitchlite Oxford - Marine Blue Knit/Ivory - US Size: 9.5,FBALYB Amazon,14,14,0,0,0,0
,Cole Haan Zerogrand Stitchlite Oxford - Marine Blue Knit/Ivory - US Size: 9.5,Cole Haan Zerogrand Stitchlite Oxford - Marine Blue Knit/Ivory - US Size: 9.5,WFS,-11,-11,0,0,0,0
,Cole Haan Zerogrand Wing Ox - Black/Black - US Size: 10,Cole Haan Zerogrand Wing Ox - Black/Black - US Size: 10,FBALYB Amazon,-3,-3,0,0,0,0
,Cole Haan Zerogrand Wing Ox - Black/Black - US Size: 10.5,Cole Haan Zerogrand Wing Ox - Black/Black - US Size: 10.5,FBALYB Amazon,-8,-8,0,0,0,0
,Cole Haan Zerogrand Wing Ox - Black/Black - US Size: 11,Cole Haan Zerogrand Wing Ox - Black/Black - US Size: 11,FBALYB Amazon,-3,-3,0,0,0,0
,Cole Haan Zerogrand Wing Ox - Black/Black - US Size: 13,Cole Haan Zerogrand Wing Ox - Black/Black - US Size: 13,FBALYB Amazon,-1,-1,0,0,0,0
,Cole Haan Zerogrand Wing Ox - Black/Black - US Size: 7,Cole Haan Zerogrand Wing Ox - Black/Black - US Size: 7,FBALYB Amazon,-3,-3,0,0,0,0
,Cole Haan Zerogrand Wing Ox - Black/Black - US Size: 7.5,Cole Haan Zerogrand Wing Ox - Black/Black - US Size: 7.5,FBALYB Amazon,-9,-9,0,0,0,0
,Cole Haan Zerogrand Wing Ox - Black/Black - US Size: 8,Cole Haan Zerogrand Wing Ox - Black/Black - US Size: 8,FBALYB Amazon,-3,-3,0,0,0,0
,Cole Haan Zerogrand Wing Ox - Black/Black - US Size: 8.5,Cole Haan Zerogrand Wing Ox - Black/Black - US Size: 8.5,FBALYB Amazon,-1,-1,0,0,0,0
,Cole Haan Zerogrand Wing Ox - Black/Black - US Size: 9,Cole Haan Zerogrand Wing Ox - Black/Black - US Size: 9,Default,0,-48,48,0,0,0
,Cole Haan Zerogrand Wing Ox - Black/Black - US Size: 9,Cole Haan Zerogrand Wing Ox - Black/Black - US Size: 9,FBALYB Amazon,-3,-3,0,0,0,0
,Cole Haan Zerogrand Wing Ox - Black/Black - US Size: 9.5,Cole Haan Zerogrand Wing Ox - Black/Black - US Size: 9.5,FBALYB Amazon,-2,-2,0,0,0,0
,Cole Haan Zerogrand Wing Ox - British Tan - US Size: 10,Cole Haan Zerogrand Wing Ox - British Tan - US Size: 10,FBALYB Amazon,-8,-8,0,1,0,0
,Cole Haan Zerogrand Wing Ox - British Tan - US Size: 10.5,Cole Haan Zerogrand Wing Ox - British Tan - US Size: 10.5,FBALYB Amazon,-10,-10,0,0,0,0
,Cole Haan Zerogrand Wing Ox - British Tan - US Size: 11,Cole Haan Zerogrand Wing Ox - British Tan - US Size: 11,FBALYB Amazon,-9,-9,0,0,0,0
,Cole Haan Zerogrand Wing Ox - British Tan - US Size: 11.5,Cole Haan Zerogrand Wing Ox - British Tan - US Size: 11.5,FBALYB Amazon,-1,-1,0,0,0,0
,Cole Haan Zerogrand Wing Ox - British Tan - US Size: 12,Cole Haan Zerogrand Wing Ox - British Tan - US Size: 12,FBALYB Amazon,-33,-38,5,0,5,0
,Cole Haan Zerogrand Wing Ox - British Tan - US Size: 13,Cole Haan Zerogrand Wing Ox - British Tan - US Size: 13,FBALYB Amazon,-1,-1,0,0,0,0
,Cole Haan Zerogrand Wing Ox - British Tan - US Size: 8.5,Cole Haan Zerogrand Wing Ox - British Tan - US Size: 8.5,FBALYB Amazon,-2,-2,0,0,0,0
,Cole Haan Zerogrand Wing Ox - British Tan - US Size: 9,Cole Haan Zerogrand Wing Ox - British Tan - US Size: 9,FBALYB Amazon,-2,-3,1,0,1,0
,Cole Haan Zerogrand Wing Ox - British Tan - US Size: 9.5,Cole Haan Zerogrand Wing Ox - British Tan - US Size: 9.5,FBALYB Amazon,-6,-6,0,0,0,0
,Colgate Optic White Platinum High Impact Toothpaste 2pk,Colgate Optic White Platinum High Impact Toothpaste 2pk,FBALYB Amazon,-1,-1,0,0,0,0
,Colgate Toothpaste,Colgate Toothpaste 5pk 8OZ,FBALYB Amazon,-62,-62,0,32,0,0
,Colgate Toothpaste 2pk,Colgate Toothpaste 2pk,FBALYB Amazon,0,0,0,8,0,0
,Colgate Total Advanced Whitening 8oz 4ct,Colgate Total Advanced Whitening 8oz 4ct,Default,0,0,0,0,0,14
,Colgate Total Travel Size,Colgate Total Travel Size,FBALYB Amazon,72,72,0,0,0,0
,Colgate Total Whitening Toothpaste - 4.4 oz 6ct,Colgate Total Whitening Toothpaste - 4.4 oz 6ct,Default,0,0,0,0,0,1
,Color Balance Purple Shampoo & Conditioner 10.1 oz,Color Balance Purple Shampoo & Conditioner 10.1 oz,FBALYB Amazon,-876,-878,2,844,2,0
,Colour pencil PITT PASTEL tin of 60,Colour pencil PITT PASTEL tin of 60,Default,0,0,0,0,0,10
,Colour Pencil Polychromos tin of 12,Colour Pencil Polychromos tin of 12,Default Ridgefield,95,95,0,0,0,0
,Colour Pencil Polychromos tin of 12,Colour Pencil Polychromos tin of 12,FBALYB Amazon,197,196,1,0,1,0
,Colour Pencil Polychromos tin of 120 Colour Pencil,Colour Pencil Polychromos tin of 120 Colour Pencil,FBALYB Amazon,175,175,0,4,0,0
,Colour Pencil Polychromos tin of 24,Colour Pencil Polychromos tin of 24,FBALYB Amazon,-1,-1,0,0,0,0
,Colour Pencil Polychromos tin of 36,Colour Pencil Polychromos tin of 36,FBALYB Amazon,-6,-6,0,10,0,0
,Comfort Zone CAT Calming Refill 2PK,Comfort Zone CAT Calming Refill 2PK,Default Ridgefield,350,350,0,0,0,0
,Comfort Zone CAT Calming Refill 2PK,Comfort Zone CAT Calming Refill 2PK,FBALYB Amazon,147,147,0,0,0,0
,Comfort Zone CAT Calming Refill 2PK 2pk,Comfort Zone CAT Calming Refill 2PK 2pk,FBALYB Amazon,-1,-1,0,0,0,0
,Comfort Zone CAT Calming SPRAY 2OZ,Comfort Zone CAT Calming SPRAY 2OZ,Default Ridgefield,7,7,0,0,0,0
,Comfort Zone CAT Calming SPRAY 2OZ,Comfort Zone CAT Calming SPRAY 2OZ,FBALYB Amazon,-3,-3,0,0,0,0
,Comfort Zone CAT Calming SPRAY 2OZ 2PK,Comfort Zone CAT Calming SPRAY 2OZ 2PK,FBALYB Amazon,1,1,0,1,0,0
,Comfort Zone CAT Multicat Refill 2ct 2pk,Comfort Zone CAT Multicat Refill 2ct 2pk,FBALYB Amazon,48,48,0,0,0,0
,Comfort Zone CAT Multicat Refill 2PK,Comfort Zone CAT Multicat Refill 2PK,Default Ridgefield,250,250,0,0,0,0
,Command Hanging Strips 2pk,Command Hanging Strips 2pk,FBALYB Amazon,-14,-14,0,11,0,0
,"Command S Clear Strips 20Hooks, 24Strips","Command S Clear Strips 20Hooks, 24Strips",FBALYB Amazon,7,7,0,0,0,0
,Commnd Picture Strip 24ct,Commnd Picture Strip 24ct,FBALYB Amazon,1,1,0,0,0,0
,CONAIRPRO DOG DELUXE PET WASHER,CONAIRPRO DOG DELUXE PET WASHER,FBALYB Amazon,-1,-1,0,0,0,0
,ConairPRO Dog Slicker Small Soft,ConairPRO Dog Slicker Small Soft,Default,1,1,0,0,0,0
,ConairPRO Dog Slicker Small Soft,ConairPRO Dog Slicker Small Soft,FBALYB Amazon,-2,-2,0,0,0,0
,Contigo 3pk Monaco/Mint/Grape,Contigo 3pk Monaco/Mint/Grape,Default,4,4,0,0,0,0
,Contigo 3pk Monaco/Mint/Grape,Contigo 3pk Monaco/Mint/Grape,FBALYB Amazon,-7,-7,0,0,0,0
,Contigo 3pk Smoke/Aqua/Grape,Contigo 3pk Smoke/Aqua/Grape,FBALYB Amazon,-2,-2,0,0,0,0
,Contigo 3pk Smoke/Jade/Sangria,Contigo 3pk Smoke/Jade/Sangria,Default Ridgefield,3,3,0,0,0,0
,Contigo 3pk Smoke/Jade/Sangria,Contigo 3pk Smoke/Jade/Sangria,FBALYB Amazon,-6,-6,0,0,0,0
,Contigo 3pk Stormy/Scuba/Berry,Contigo 3pk Stormy/Scuba/Berry,FBALYB Amazon,-1,-1,0,0,0,0
,"Contigo Auto Seal Red, Green, Yellow 3ct","Contigo Auto Seal Red, Green, Yellow 3ct ",Default Ridgefield,12,12,0,0,0,0
,Contigo Blue pink green,Contigo Blue pink green,FBALYB Amazon,-2,-2,0,0,0,0
,Contigo Blue/ Red/ Purple,Contigo Blue/ Red/ Purple,FBALYB Amazon,-2,-2,0,0,0,0
,Contigo Blue / Silver,Contigo Blue / Silver,Default,0,0,0,0,0,1
,Contigo Blue / Silver,Contigo Blue / Silver,FBALYB Amazon,-5,-5,0,4,0,0
,Contigo BLUE / TURQUOISE / PURPLE,Contigo BLUE / TURQUOISE / PURPLE ,FBALYB Amazon,-13,-13,0,14,0,0
,Contigo Couture BLK / Purple,Contigo Couture BLK / Purple,FBALYB Amazon,-3,-4,1,2,1,0
,Contigo Couture Gray / Purple,Contigo Couture Gray / Purple,Default,0,0,0,0,0,75
,Contigo Couture Gray / Purple,Contigo Couture Gray / Purple,Default Ridgefield,3,3,0,0,0,0
,Contigo Couture Gray / Purple,Contigo Couture Gray / Purple,FBALYB Amazon,124,124,0,3,0,0
,Contigo Couture Gray/White,Contigo Couture Gray/White,Default,0,0,0,0,0,1
,Contigo Couture Gray/White,Contigo Couture Gray/White,Default Ridgefield,-1,-1,0,0,0,0
,Contigo Couture Gray/White,Contigo Couture Gray/White,FBALYB Amazon,-7,-8,1,6,1,0
,Contigo Gray / Green / Purple,Contigo Gray / Green / Purple,FBALYB Amazon,-30,-30,0,0,0,0
,Contigo Green / Blue /Turquoise,Contigo Green / Blue /Turquoise ,Default,0,-199,199,0,0,0
,Contigo Green / Blue /Turquoise,Contigo Green / Blue /Turquoise ,Default Ridgefield,0,-22,22,0,0,0
,Contigo Green / Blue /Turquoise,Contigo Green / Blue /Turquoise ,FBALYB Amazon,-11,-11,0,0,0,0
,Contigo Hot/Cold 20oz 2pk Black,Contigo Hot/Cold 20oz 2pk Black,FBALYB Amazon,-1,-2,1,0,1,0
,Contigo Hot/Cold 20oz 2pk Blue,Contigo Hot/Cold 20oz 2pk Blue,FBALYB Amazon,-1,-1,0,0,0,0
,Contigo Kids Boys 3 color set,Contigo Kids Boys 3 color set,FBALYB Amazon,-5,-5,0,4,0,0
,Contigo Kids Girls 3 Color set,Contigo Kids Girls 3 Color set,Default Ridgefield,0,-12,12,0,0,0
,Contigo Kids Girls 3 Color set,Contigo Kids Girls 3 Color set,FBALYB Amazon,-1,-1,0,0,0,0
,Contigo Master Kit 3/27,Contigo Master Kit 3/27,Default Ridgefield,0,-12,12,0,0,0
,Contigo Master Kit 3/27,Contigo Master Kit 3/27,FBALYB Amazon,-1,-1,0,0,0,0
,"Contigo Monaco, Scuba & Stormy Weather","Contigo Monaco, Scuba & Stormy Weather",FBALYB Amazon,-8,-8,0,8,0,0
,Contigo Monaco/Scuba/Very Berry,Contigo Monaco/Scuba/Very Berry,Default,0,-120,120,0,0,0
,Contigo Monaco/Scuba/Very Berry,Contigo Monaco/Scuba/Very Berry,Default Oxford,0,-1,1,0,0,0
,Contigo Monaco/Scuba/Very Berry,Contigo Monaco/Scuba/Very Berry,Default Ridgefield,0,-2,2,0,0,0
,Contigo Monaco/Scuba/Very Berry,Contigo Monaco/Scuba/Very Berry,FBALYB Amazon,-4,-4,0,0,0,0
,Contigo Pink/Purple/Green,Contigo Pink/Purple/Green ,FBALYB Amazon,-1,-1,0,1,0,0
,Contigo Purple Blue green,Contigo Purple Blue green,FBALYB Amazon,-9,-9,0,3,0,0
,Contigo Silver / Purple,Contigo Silver / Purple,Default,0,0,0,0,0,2
,Contigo Silver / Purple,Contigo Silver / Purple,FBALYB Amazon,-3,-3,0,15,0,0
,Contigo Turquoise / Blue / Yellow,Contigo Turquoise / Blue / Yellow,FBALYB Amazon,-27,-27,0,47,0,0
,Contigo Turquoise / Silver,Contigo Turquoise / Silver,FBALYB Amazon,-14,-14,0,0,0,0
,Contour Next EZ Monitoring System,Contour Next EZ Monitoring System ,FBALYB Amazon,1,-6,7,0,7,0
,Contour Next ONE Monitoring System,Contour Next ONE Monitoring System ,FBALYB Amazon,0,-2,2,0,2,0
,Converse 3J231-001 KIDS Chuck Taylor ALL Star HI Black SIZE 1,Converse 3J231-001 KIDS Chuck Taylor ALL Star HI Black SIZE 1,Default,0,0,0,0,0,48
,Converse 3J231-001 KIDS Chuck Taylor ALL Star HI Black SIZE 1,Converse 3J231-001 KIDS Chuck Taylor ALL Star HI Black SIZE 1,FBALYB Amazon,-4,-4,0,0,0,0
,Converse 3J231-001 KIDS Chuck Taylor ALL Star HI Black SIZE 10.5,Converse 3J231-001 KIDS Chuck Taylor ALL Star HI Black SIZE 10.5,Default,0,0,0,0,0,4
,Converse 3J231-001 KIDS Chuck Taylor ALL Star HI Black SIZE 10.5,Converse 3J231-001 KIDS Chuck Taylor ALL Star HI Black SIZE 10.5,FBALYB Amazon,-1,-1,0,0,0,0
,Converse 3J231-001 KIDS Chuck Taylor ALL Star HI Black SIZE 12,Converse 3J231-001 KIDS Chuck Taylor ALL Star HI Black SIZE 12,Default,0,0,0,0,0,48
,Converse 3J231-001 KIDS Chuck Taylor ALL Star HI Black SIZE 12,Converse 3J231-001 KIDS Chuck Taylor ALL Star HI Black SIZE 12,FBALYB Amazon,-3,-3,0,0,0,0
,Converse 3J231-001 KIDS Chuck Taylor ALL Star HI Black SIZE 1.5,Converse 3J231-001 KIDS Chuck Taylor ALL Star HI Black SIZE 1.5,Default,0,0,0,0,0,38
,Converse 3J231-001 KIDS Chuck Taylor ALL Star HI Black SIZE 1.5,Converse 3J231-001 KIDS Chuck Taylor ALL Star HI Black SIZE 1.5,FBALYB Amazon,-2,-2,0,0,0,0
,Converse 3J231-001 KIDS Chuck Taylor ALL Star HI Black SIZE 2,Converse 3J231-001 KIDS Chuck Taylor ALL Star HI Black SIZE 2,Default,0,0,0,0,0,12
,Converse 3J231-001 KIDS Chuck Taylor ALL Star HI Black SIZE 2,Converse 3J231-001 KIDS Chuck Taylor ALL Star HI Black SIZE 2,FBALYB Amazon,2,2,0,0,0,0
,Converse 3J231-001 KIDS Chuck Taylor ALL Star HI Black SIZE 3,Converse 3J231-001 KIDS Chuck Taylor ALL Star HI Black SIZE 3,Default,0,0,0,0,0,48
,Converse 3J231-001 KIDS Chuck Taylor ALL Star HI Black SIZE 3,Converse 3J231-001 KIDS Chuck Taylor ALL Star HI Black SIZE 3,FBALYB Amazon,-1,-1,0,0,0,0
,Converse 3J235-001 KIDS Chuck Taylor ALL Star OX Black SIZE 2,Converse 3J235-001 KIDS Chuck Taylor ALL Star OX Black SIZE 2,Default,0,0,0,0,0,38
,Converse 3J235-001 KIDS Chuck Taylor ALL Star OX Black SIZE 2,Converse 3J235-001 KIDS Chuck Taylor ALL Star OX Black SIZE 2,Default Ridgefield,24,24,0,0,0,0
,Converse 3J235-001 KIDS Chuck Taylor ALL Star OX Black SIZE 2.5,Converse 3J235-001 KIDS Chuck Taylor ALL Star OX Black SIZE 2.5,Default,0,0,0,0,0,17
,Converse 3J235-001 KIDS Chuck Taylor ALL Star OX Black SIZE 2.5,Converse 3J235-001 KIDS Chuck Taylor ALL Star OX Black SIZE 2.5,FBALYB Amazon,-3,-3,0,0,0,0
,Converse 3J235-001 KIDS Chuck Taylor ALL Star OX Black SIZE 3,Converse 3J235-001 KIDS Chuck Taylor ALL Star OX Black SIZE 3,Default,0,0,0,0,0,37
,Converse 3J235-001 KIDS Chuck Taylor ALL Star OX Black SIZE 3,Converse 3J235-001 KIDS Chuck Taylor ALL Star OX Black SIZE 3,Default Ridgefield,24,24,0,0,0,0
,Converse 3J236-600 KIDS Chuck Taylor ALL Star OX Red SIZE 1,Converse 3J236-600 KIDS Chuck Taylor ALL Star OX Red SIZE 1,Default,0,0,0,0,0,6
,Converse 3J236-600 KIDS Chuck Taylor ALL Star OX Red SIZE 1,Converse 3J236-600 KIDS Chuck Taylor ALL Star OX Red SIZE 1,FBALYB Amazon,-1,-1,0,0,0,0
,Converse 3J236-600 KIDS Chuck Taylor ALL Star OX Red SIZE 12,Converse 3J236-600 KIDS Chuck Taylor ALL Star OX Red SIZE 12,FBALYB Amazon,-1,-1,0,0,0,0
,Converse 3J236-600 KIDS Chuck Taylor ALL Star OX Red SIZE 1.5,Converse 3J236-600 KIDS Chuck Taylor ALL Star OX Red SIZE 1.5,Default,0,0,0,0,0,10
,Converse 3J236-600 KIDS Chuck Taylor ALL Star OX Red SIZE 2,Converse 3J236-600 KIDS Chuck Taylor ALL Star OX Red SIZE 2,Default,0,0,0,0,0,6
,Converse 3J236-600 KIDS Chuck Taylor ALL Star OX Red SIZE 2,Converse 3J236-600 KIDS Chuck Taylor ALL Star OX Red SIZE 2,FBALYB Amazon,-9,-9,0,7,0,0
,Converse 3J236-600 KIDS Chuck Taylor ALL Star OX Red SIZE 2.5,Converse 3J236-600 KIDS Chuck Taylor ALL Star OX Red SIZE 2.5,Default,0,0,0,0,0,8
,Converse 3J236-600 KIDS Chuck Taylor ALL Star OX Red SIZE 2.5,Converse 3J236-600 KIDS Chuck Taylor ALL Star OX Red SIZE 2.5,FBALYB Amazon,-2,-2,0,0,0,0
,Converse 3J236-600 KIDS Chuck Taylor ALL Star OX Red SIZE 3,Converse 3J236-600 KIDS Chuck Taylor ALL Star OX Red SIZE 3,Default,0,0,0,0,0,14
,Converse 3J236-600 KIDS Chuck Taylor ALL Star OX Red SIZE 3,Converse 3J236-600 KIDS Chuck Taylor ALL Star OX Red SIZE 3,FBALYB Amazon,-4,-4,0,0,0,0
,Converse 3J256-102 KIDS CHUCK TAYLOR ALL STAR Optical White SIZE 1,Converse 3J256-102 KIDS CHUCK TAYLOR ALL STAR Optical White SIZE 1,Default,0,0,0,0,0,24
,Converse 3J256-102 KIDS CHUCK TAYLOR ALL STAR Optical White SIZE 10.5,Converse 3J256-102 KIDS CHUCK TAYLOR ALL STAR Optical White SIZE 10.5,Default,0,0,0,0,0,8
,Converse 3J256-102 KIDS CHUCK TAYLOR ALL STAR Optical White SIZE 11.5,Converse 3J256-102 KIDS CHUCK TAYLOR ALL STAR Optical White SIZE 11.5,Default,0,0,0,0,0,12
,Converse 3J256-102 KIDS CHUCK TAYLOR ALL STAR Optical White SIZE 12,Converse 3J256-102 KIDS CHUCK TAYLOR ALL STAR Optical White SIZE 12,Default,0,0,0,0,0,5
,Converse 3J256-102 KIDS CHUCK TAYLOR ALL STAR Optical White SIZE 12.5,Converse 3J256-102 KIDS CHUCK TAYLOR ALL STAR Optical White SIZE 12.5,Default,0,0,0,0,0,8
,Converse 3J256-102 KIDS CHUCK TAYLOR ALL STAR Optical White SIZE 13,Converse 3J256-102 KIDS CHUCK TAYLOR ALL STAR Optical White SIZE 13,Default,0,0,0,0,0,24
,Converse 3J256-102 KIDS CHUCK TAYLOR ALL STAR Optical White SIZE 1.5,Converse 3J256-102 KIDS CHUCK TAYLOR ALL STAR Optical White SIZE 1.5,Default,0,0,0,0,0,16
,Converse 3J256-102 KIDS CHUCK TAYLOR ALL STAR Optical White SIZE 2,Converse 3J256-102 KIDS CHUCK TAYLOR ALL STAR Optical White SIZE 2,Default,0,0,0,0,0,19
,Converse 3J256-102 KIDS CHUCK TAYLOR ALL STAR Optical White SIZE 2.5,Converse 3J256-102 KIDS CHUCK TAYLOR ALL STAR Optical White SIZE 2.5,Default,0,0,0,0,0,20
,Converse 3J256-102 KIDS CHUCK TAYLOR ALL STAR Optical White SIZE 3,Converse 3J256-102 KIDS CHUCK TAYLOR ALL STAR Optical White SIZE 3,Default,0,0,0,0,0,13
,Converse 7J235-001 Toddler Chuck Taylor ALL Star OX Black SIZE 10,Converse 7J235-001 Toddler Chuck Taylor ALL Star OX Black SIZE 10,Default,0,0,0,0,0,31
,Converse 7J235-001 Toddler Chuck Taylor ALL Star OX Black SIZE 10,Converse 7J235-001 Toddler Chuck Taylor ALL Star OX Black SIZE 10,FBALYB Amazon,-1,-1,0,0,0,0
,Converse 7J235-001 Toddler Chuck Taylor ALL Star OX Black SIZE 4,Converse 7J235-001 Toddler Chuck Taylor ALL Star OX Black SIZE 4,Default,0,0,0,0,0,29
,Converse 7J235-001 Toddler Chuck Taylor ALL Star OX Black SIZE 4,Converse 7J235-001 Toddler Chuck Taylor ALL Star OX Black SIZE 4,FBALYB Amazon,-4,-4,0,0,0,0
,Converse 7J235-001 Toddler Chuck Taylor ALL Star OX Black SIZE 6,Converse 7J235-001 Toddler Chuck Taylor ALL Star OX Black SIZE 6,Default,0,0,0,0,0,13
,Converse 7J235-001 Toddler Chuck Taylor ALL Star OX Black SIZE 6,Converse 7J235-001 Toddler Chuck Taylor ALL Star OX Black SIZE 6,FBALYB Amazon,-1,-1,0,0,0,0
,Converse 7J235-001 Toddler Chuck Taylor ALL Star OX Black SIZE 7,Converse 7J235-001 Toddler Chuck Taylor ALL Star OX Black SIZE 7,Default,0,0,0,0,0,40
,Converse 7J235-001 Toddler Chuck Taylor ALL Star OX Black SIZE 7,Converse 7J235-001 Toddler Chuck Taylor ALL Star OX Black SIZE 7,FBALYB Amazon,-1,-1,0,0,0,0
,Converse 7J235-001 Toddler Chuck Taylor ALL Star OX Black SIZE 8,Converse 7J235-001 Toddler Chuck Taylor ALL Star OX Black SIZE 8,Default,0,0,0,0,0,8
,Converse 7J235-001 Toddler Chuck Taylor ALL Star OX Black SIZE 8,Converse 7J235-001 Toddler Chuck Taylor ALL Star OX Black SIZE 8,FBALYB Amazon,-1,-1,0,0,0,0
,Converse 7J235-001 Toddler Chuck Taylor ALL Star OX Black SIZE 9,Converse 7J235-001 Toddler Chuck Taylor ALL Star OX Black SIZE 9,Default,0,0,0,0,0,14
,Converse 7J235-001 Toddler Chuck Taylor ALL Star OX Black SIZE 9,Converse 7J235-001 Toddler Chuck Taylor ALL Star OX Black SIZE 9,FBALYB Amazon,-2,-2,0,0,0,0
,Converse 7J236-600 Toddler Chuck Taylor ALL Star OX Red SIZE 10,Converse 7J236-600 Toddler Chuck Taylor ALL Star OX Red SIZE 10,Default,0,0,0,0,0,20
,Converse 7J236-600 Toddler Chuck Taylor ALL Star OX Red SIZE 4,Converse 7J236-600 Toddler Chuck Taylor ALL Star OX Red SIZE 4,Default,0,0,0,0,0,19
,Converse 7J236-600 Toddler Chuck Taylor ALL Star OX Red SIZE 4,Converse 7J236-600 Toddler Chuck Taylor ALL Star OX Red SIZE 4,FBALYB Amazon,-1,-1,0,0,0,0
,Converse 7J236-600 Toddler Chuck Taylor ALL Star OX Red SIZE 6,Converse 7J236-600 Toddler Chuck Taylor ALL Star OX Red SIZE 6,Default,0,0,0,0,0,39
,Converse 7J236-600 Toddler Chuck Taylor ALL Star OX Red SIZE 6,Converse 7J236-600 Toddler Chuck Taylor ALL Star OX Red SIZE 6,FBALYB Amazon,-1,-1,0,0,0,0
,Converse 7J236-600 Toddler Chuck Taylor ALL Star OX Red SIZE 7,Converse 7J236-600 Toddler Chuck Taylor ALL Star OX Red SIZE 7,Default,0,0,0,0,0,8
,Converse 7J236-600 Toddler Chuck Taylor ALL Star OX Red SIZE 8,Converse 7J236-600 Toddler Chuck Taylor ALL Star OX Red SIZE 8,Default,0,0,0,0,0,15
,Converse 7J236-600 Toddler Chuck Taylor ALL Star OX Red SIZE 9,Converse 7J236-600 Toddler Chuck Taylor ALL Star OX Red SIZE 9,Default,0,0,0,0,0,18
,Converse 7J238-650 Toddler Chuck Taylor ALL Star OX Pink SIZE 4,Converse 7J238-650 Toddler Chuck Taylor ALL Star OX Pink SIZE 4,Default,0,0,0,0,0,20
,Converse 7J238-650 Toddler Chuck Taylor ALL Star OX Pink SIZE 4,Converse 7J238-650 Toddler Chuck Taylor ALL Star OX Pink SIZE 4,FBALYB Amazon,-2,-2,0,0,0,0
,Converse 7J238-650 Toddler Chuck Taylor ALL Star OX Pink SIZE 6,Converse 7J238-650 Toddler Chuck Taylor ALL Star OX Pink SIZE 6,Default,0,0,0,0,0,40
,Converse 7J238-650 Toddler Chuck Taylor ALL Star OX Pink SIZE 7,Converse 7J238-650 Toddler Chuck Taylor ALL Star OX Pink SIZE 7,Default,0,0,0,0,0,12
,Converse 7J238-650 Toddler Chuck Taylor ALL Star OX Pink SIZE 8,Converse 7J238-650 Toddler Chuck Taylor ALL Star OX Pink SIZE 8,Default,0,0,0,0,0,12
,Converse 7J238-650 Toddler Chuck Taylor ALL Star OX Pink SIZE 9,Converse 7J238-650 Toddler Chuck Taylor ALL Star OX Pink SIZE 9,Default,0,0,0,0,0,8
,CONVERSE 7J256-102 Toddler CHUCK TAYLOR ALL STAR CORE OX Optical White Size 4,CONVERSE 7J256-102 Toddler CHUCK TAYLOR ALL STAR CORE OX Optical White Size 4,Default,0,0,0,0,0,1
,CONVERSE 7J256-102 Toddler CHUCK TAYLOR ALL STAR CORE OX Optical White Size 5,CONVERSE 7J256-102 Toddler CHUCK TAYLOR ALL STAR CORE OX Optical White Size 5,Default,0,0,0,0,0,1
,CONVERSE 7J256-102 Toddler CHUCK TAYLOR ALL STAR CORE OX Optical White Size 6,CONVERSE 7J256-102 Toddler CHUCK TAYLOR ALL STAR CORE OX Optical White Size 6,Default,0,0,0,0,0,1
,CONVERSE 7J256-102 Toddler CHUCK TAYLOR ALL STAR CORE OX Optical White Size 7,CONVERSE 7J256-102 Toddler CHUCK TAYLOR ALL STAR CORE OX Optical White Size 7,Default,0,0,0,0,0,1
,CONVERSE 7J256-102 Toddler CHUCK TAYLOR ALL STAR CORE OX Optical White Size 8,CONVERSE 7J256-102 Toddler CHUCK TAYLOR ALL STAR CORE OX Optical White Size 8,Default,0,0,0,0,0,1
,CONVERSE 7J256-102 Toddler CHUCK TAYLOR ALL STAR CORE OX Optical White Size 9,CONVERSE 7J256-102 Toddler CHUCK TAYLOR ALL STAR CORE OX Optical White Size 9,Default,0,0,0,0,0,1
,CONVERSE Kids 314786F-006 CHUCK TAYLOR ALL STAR Black Monochrome SIZE 1,CONVERSE Kids 314786F-006 CHUCK TAYLOR ALL STAR Black Monochrome SIZE 1,Default,0,0,0,0,0,12
,CONVERSE Kids 314786F-006 CHUCK TAYLOR ALL STAR Black Monochrome SIZE 10.5,CONVERSE Kids 314786F-006 CHUCK TAYLOR ALL STAR Black Monochrome SIZE 10.5,Default,0,0,0,0,0,6
,CONVERSE Kids 314786F-006 CHUCK TAYLOR ALL STAR Black Monochrome SIZE 11.5,CONVERSE Kids 314786F-006 CHUCK TAYLOR ALL STAR Black Monochrome SIZE 11.5,Default,0,0,0,0,0,6
,CONVERSE Kids 314786F-006 CHUCK TAYLOR ALL STAR Black Monochrome SIZE 12,CONVERSE Kids 314786F-006 CHUCK TAYLOR ALL STAR Black Monochrome SIZE 12,Default,0,0,0,0,0,6
,CONVERSE Kids 314786F-006 CHUCK TAYLOR ALL STAR Black Monochrome SIZE 12.5,CONVERSE Kids 314786F-006 CHUCK TAYLOR ALL STAR Black Monochrome SIZE 12.5,Default,0,0,0,0,0,6
,CONVERSE Kids 314786F-006 CHUCK TAYLOR ALL STAR Black Monochrome SIZE 13,CONVERSE Kids 314786F-006 CHUCK TAYLOR ALL STAR Black Monochrome SIZE 13,Default,0,0,0,0,0,6
,CONVERSE Kids 314786F-006 CHUCK TAYLOR ALL STAR Black Monochrome SIZE 13.5,CONVERSE Kids 314786F-006 CHUCK TAYLOR ALL STAR Black Monochrome SIZE 13.5,Default,0,0,0,0,0,6
,CONVERSE Kids 314786F-006 CHUCK TAYLOR ALL STAR Black Monochrome SIZE 1.5,CONVERSE Kids 314786F-006 CHUCK TAYLOR ALL STAR Black Monochrome SIZE 1.5,Default,0,0,0,0,0,12
,CONVERSE Kids 314786F-006 CHUCK TAYLOR ALL STAR Black Monochrome SIZE 2,CONVERSE Kids 314786F-006 CHUCK TAYLOR ALL STAR Black Monochrome SIZE 2,Default,0,0,0,0,0,12
,CONVERSE Kids 314786F-006 CHUCK TAYLOR ALL STAR Black Monochrome SIZE 2.5,CONVERSE Kids 314786F-006 CHUCK TAYLOR ALL STAR Black Monochrome SIZE 2.5,Default,0,0,0,0,0,12
,CONVERSE Kids 314786F-006 CHUCK TAYLOR ALL STAR Black Monochrome SIZE 3,CONVERSE Kids 314786F-006 CHUCK TAYLOR ALL STAR Black Monochrome SIZE 3,Default,0,0,0,0,0,12
,Converse M7652-102 Optic White 3/5,Converse Men M7652-102 Chuck Taylor ALL Star Optical White SIZE M 3/ W 5,Default Ridgefield,759,759,0,0,0,0
,Converse M7652-102 Optic White 3/5,Converse Men M7652-102 Chuck Taylor ALL Star Optical White SIZE M 3/ W 5,FBALYB Amazon,148,148,0,0,0,0
,Converse M9622 Chuck Taylor All Star High Top Navy Size M 10/ W 12,Converse M9622 Chuck Taylor All Star High Top Navy Size M 10/ W 12,Default Ridgefield,42,42,0,0,0,0
,Converse M9622 Chuck Taylor High Top Navy Size M 11/ W 13,Converse M9622 Chuck Taylor High Top Navy Size M 11/ W 13,Default Ridgefield,5,5,0,0,0,0
,Converse M9622 Chuck Taylor High Top Navy Size M 12/ W 14,Converse M9622 Chuck Taylor High Top Navy Size M 12/ W 14,Default Ridgefield,26,26,0,0,0,0
,Converse M9622 Chuck Taylor High Top Navy Size M 3.5/ W 5.5,Converse M9622 Chuck Taylor High Top Navy Size M 3.5/ W 5.5,Default Ridgefield,50,50,0,0,0,0
,Converse M9622 Chuck Taylor High Top Navy Size M 4.5/ W 6.5,Converse M9622 Chuck Taylor High Top Navy Size M 4.5/ W 6.5,Default Ridgefield,2,2,0,0,0,0
,Converse M9622 Chuck Taylor High Top Navy Size M 4/ W 6,Converse M9622 Chuck Taylor High Top Navy Size M 4/ W 6,Default Ridgefield,2,2,0,0,0,0
,Converse M9622 Chuck Taylor High Top Navy Size M 4/ W 6,Converse M9622 Chuck Taylor High Top Navy Size M 4/ W 6,FBALYB Amazon,-1,-1,0,0,0,0
,Converse M9622 Chuck Taylor High Top Navy Size M 5.5/ W 7.5,Converse M9622 Chuck Taylor High Top Navy Size M 5.5/ W 7.5,Default Ridgefield,19,19,0,0,0,0
,Converse M9622 Chuck Taylor High Top Navy Size M 5/ W 7,Converse M9622 Chuck Taylor High Top Navy Size M 5/ W 7,Default Ridgefield,1,1,0,0,0,0
,Converse M9622 Chuck Taylor High Top Navy Size M 5/ W 7,Converse M9622 Chuck Taylor High Top Navy Size M 5/ W 7,FBALYB Amazon,10,10,0,0,0,0
,Converse M9622 Chuck Taylor High Top Navy Size M 6.5/ W 8.5,Converse M9622 Chuck Taylor High Top Navy Size M 6.5/ W 8.5,Default Ridgefield,11,11,0,0,0,0
,Converse M9622 Chuck Taylor High Top Navy Size M 6/ W 8,Converse M9622 Chuck Taylor High Top Navy Size M 6/ W 8,Default Ridgefield,1,1,0,0,0,0
,Converse M9622 Chuck Taylor High Top Navy Size M 6/ W 8,Converse M9622 Chuck Taylor High Top Navy Size M 6/ W 8,FBALYB Amazon,4,4,0,0,0,0
,Converse M9622 Chuck Taylor High Top Navy Size M 7.5/ W 9.5,Converse M9622 Chuck Taylor High Top Navy Size M 7.5/ W 9.5,Default Ridgefield,24,24,0,0,0,0
,Converse M9622 Chuck Taylor High Top Navy Size M 7/ W 9,Converse M9622 Chuck Taylor High Top Navy Size M 7/ W 9,Default Ridgefield,12,12,0,0,0,0
,Converse M9622 Chuck Taylor High Top Navy Size M 8.5/ W 10.5,Converse M9622 Chuck Taylor High Top Navy Size M 8.5/ W 10.5,Default Ridgefield,18,18,0,0,0,0
,Converse M9622 Chuck Taylor High Top Navy Size M 8/ W 10,Converse M9622 Chuck Taylor High Top Navy Size M 8/ W 10,Default Ridgefield,10,10,0,0,0,0
,Converse M9622 Chuck Taylor High Top Navy Size M 9.5/ W 11.5,Converse M9622 Chuck Taylor High Top Navy Size M 9.5/ W 11.5,FBALYB Amazon,9,9,0,0,0,0
,Converse M9622 Chuck Taylor High Top Navy Size M 9/ W 11,Converse M9622 Chuck Taylor High Top Navy Size M 9/ W 11,Default Ridgefield,24,24,0,0,0,0
,Converse M9696-600 Chuck Taylor ALL Star Core OX Red SIZE M 3.5/ W 5.5,Converse M9696-600 Chuck Taylor ALL Star Core OX Red SIZE M 3.5/ W 5.5,Default Ridgefield,130,130,0,0,0,0
,Converse M9696-600 Chuck Taylor ALL Star Core OX Red SIZE M 3/ W 5,Converse M9696-600 Chuck Taylor ALL Star Core OX Red SIZE M 3/ W 5,Default Ridgefield,240,240,0,0,0,0
,Converse  M9697 Chuck Taylor Low Top Navy Size M 10/ W 12,Converse  M9697 Chuck Taylor Low Top Navy Size M 10/ W 12,Default Ridgefield,71,71,0,0,0,0
,Converse  M9697 Chuck Taylor Low Top Navy Size M 11/ W 13,Converse  M9697 Chuck Taylor Low Top Navy Size M 11/ W 13,Default Ridgefield,24,24,0,0,0,0
,Converse  M9697 Chuck Taylor Low Top Navy Size M 3.5/ W 5.5,Converse  M9697 Chuck Taylor Low Top Navy Size M 3.5/ W 5.5,Default Ridgefield,121,121,0,0,0,0
,Converse  M9697 Chuck Taylor Low Top Navy Size M 3/ W 5,Converse  M9697 Chuck Taylor Low Top Navy Size M 3/ W 5,Default Ridgefield,248,248,0,0,0,0
,Converse  M9697 Chuck Taylor Low Top Navy Size M 3/ W 5,Converse  M9697 Chuck Taylor Low Top Navy Size M 3/ W 5,FBALYB Amazon,49,49,0,0,0,0
,Converse  M9697 Chuck Taylor Low Top Navy Size M 4.5/ W 6.5,Converse  M9697 Chuck Taylor Low Top Navy Size M 4.5/ W 6.5,Default Ridgefield,168,168,0,0,0,0
,Converse  M9697 Chuck Taylor Low Top Navy Size M 4/ W 6,Converse  M9697 Chuck Taylor Low Top Navy Size M 4/ W 6,Default Ridgefield,118,118,0,0,0,0
,Converse  M9697 Chuck Taylor Low Top Navy Size M 5.5/ W 7.5,Converse  M9697 Chuck Taylor Low Top Navy Size M 5.5/ W 7.5,Default Ridgefield,24,24,0,0,0,0
,Converse  M9697 Chuck Taylor Low Top Navy Size M 5/ W 7,Converse  M9697 Chuck Taylor Low Top Navy Size M 5/ W 7,Default Ridgefield,24,24,0,0,0,0
,Converse  M9697 Chuck Taylor Low Top Navy Size M 6.5/ W 8.5,Converse  M9697 Chuck Taylor Low Top Navy Size M 6.5/ W 8.5,Default Ridgefield,13,13,0,0,0,0
,Converse  M9697 Chuck Taylor Low Top Navy Size M 6/ W 8,Converse  M9697 Chuck Taylor Low Top Navy Size M 6/ W 8,Default Ridgefield,23,23,0,0,0,0
,Converse  M9697 Chuck Taylor Low Top Navy Size M 7.5/ W 9.5,Converse  M9697 Chuck Taylor Low Top Navy Size M 7.5/ W 9.5,Default Ridgefield,19,19,0,0,0,0
,Converse  M9697 Chuck Taylor Low Top Navy Size M 7/ W 9,Converse  M9697 Chuck Taylor Low Top Navy Size M 7/ W 9,Default Ridgefield,18,18,0,0,0,0
,Converse  M9697 Chuck Taylor Low Top Navy Size M 8.5/ W 10.5,Converse  M9697 Chuck Taylor Low Top Navy Size M 8.5/ W 10.5,Default Ridgefield,10,10,0,0,0,0
,Converse  M9697 Chuck Taylor Low Top Navy Size M 8/ W 10,Converse  M9697 Chuck Taylor Low Top Navy Size M 8/ W 10,Default Ridgefield,21,21,0,0,0,0
,Converse  M9697 Chuck Taylor Low Top Navy Size M 9.5/ W 11.5,Converse  M9697 Chuck Taylor Low Top Navy Size M 9.5/ W 11.5,Default Ridgefield,11,11,0,0,0,0
,Converse  M9697 Chuck Taylor Low Top Navy Size M 9/ W 11,Converse  M9697 Chuck Taylor Low Top Navy Size M 9/ W 11,Default Ridgefield,10,10,0,0,0,0
,Converse Men 162050C-001 Chuck 70 HI Black Black Egret SIZE 10,Converse Men 162050C-001 Chuck 70 HI Black Black Egret SIZE 10,Default,0,0,0,0,0,20
,Converse Men 162050C-001 Chuck 70 HI Black Black Egret SIZE 10,Converse Men 162050C-001 Chuck 70 HI Black Black Egret SIZE 10,FBALYB Amazon,-3,-3,0,0,0,0
,Converse Men 162050C-001 Chuck 70 HI Black Black Egret SIZE 10.5,Converse Men 162050C-001 Chuck 70 HI Black Black Egret SIZE 10.5,Default,0,0,0,0,0,40
,Converse Men 162050C-001 Chuck 70 HI Black Black Egret SIZE 10.5,Converse Men 162050C-001 Chuck 70 HI Black Black Egret SIZE 10.5,FBALYB Amazon,-2,-2,0,0,0,0
,Converse Men 162050C-001 Chuck 70 HI Black Black Egret SIZE 11,Converse Men 162050C-001 Chuck 70 HI Black Black Egret SIZE 11,Default,0,0,0,0,0,40
,Converse Men 162050C-001 Chuck 70 HI Black Black Egret SIZE 11.5,Converse Men 162050C-001 Chuck 70 HI Black Black Egret SIZE 11.5,Default,0,0,0,0,0,10
,Converse Men 162050C-001 Chuck 70 HI Black Black Egret SIZE 11.5,Converse Men 162050C-001 Chuck 70 HI Black Black Egret SIZE 11.5,FBALYB Amazon,-1,-1,0,0,0,0
,Converse Men 162050C-001 Chuck 70 HI Black Black Egret SIZE 12,Converse Men 162050C-001 Chuck 70 HI Black Black Egret SIZE 12,Default,0,0,0,0,0,10
,Converse Men 162050C-001 Chuck 70 HI Black Black Egret SIZE 7,Converse Men 162050C-001 Chuck 70 HI Black Black Egret SIZE 7,Default,0,0,0,0,0,20
,Converse Men 162050C-001 Chuck 70 HI Black Black Egret SIZE 7,Converse Men 162050C-001 Chuck 70 HI Black Black Egret SIZE 7,FBALYB Amazon,-3,-3,0,1,0,0
,Converse Men 162050C-001 Chuck 70 HI Black Black Egret SIZE 7.5,Converse Men 162050C-001 Chuck 70 HI Black Black Egret SIZE 7.5,Default,0,0,0,0,0,40
,Converse Men 162050C-001 Chuck 70 HI Black Black Egret SIZE 7.5,Converse Men 162050C-001 Chuck 70 HI Black Black Egret SIZE 7.5,FBALYB Amazon,-5,-5,0,0,0,0
,Converse Men 162050C-001 Chuck 70 HI Black Black Egret SIZE 8,Converse Men 162050C-001 Chuck 70 HI Black Black Egret SIZE 8,Default,0,0,0,0,0,40
,Converse Men 162050C-001 Chuck 70 HI Black Black Egret SIZE 8,Converse Men 162050C-001 Chuck 70 HI Black Black Egret SIZE 8,FBALYB Amazon,-1,-1,0,0,0,0
,Converse Men 162050C-001 Chuck 70 HI Black Black Egret SIZE 8.5,Converse Men 162050C-001 Chuck 70 HI Black Black Egret SIZE 8.5,Default,0,0,0,0,0,20
,Converse Men 162050C-001 Chuck 70 HI Black Black Egret SIZE 8.5,Converse Men 162050C-001 Chuck 70 HI Black Black Egret SIZE 8.5,FBALYB Amazon,-4,-4,0,0,0,0
,Converse Men 162050C-001 Chuck 70 HI Black Black Egret SIZE 9,Converse Men 162050C-001 Chuck 70 HI Black Black Egret SIZE 9,Default,0,0,0,0,0,40
,Converse Men 162050C-001 Chuck 70 HI Black Black Egret SIZE 9,Converse Men 162050C-001 Chuck 70 HI Black Black Egret SIZE 9,FBALYB Amazon,-5,-5,0,0,0,0
,Converse Men 162050C-001 Chuck 70 HI Black Black Egret SIZE 9.5,Converse Men 162050C-001 Chuck 70 HI Black Black Egret SIZE 9.5,Default,0,0,0,0,0,20
,Converse Men 164300F-001 Chuck Taylor ALL Star Slip Black White Black SIZE 10,Converse Men 164300F-001 Chuck Taylor ALL Star Slip Black White Black SIZE 10,Default,0,0,0,0,0,40
,Converse Men 164300F-001 Chuck Taylor ALL Star Slip Black White Black SIZE 10,Converse Men 164300F-001 Chuck Taylor ALL Star Slip Black White Black SIZE 10,FBALYB Amazon,-6,-6,0,0,0,0
,Converse Men 164300F-001 Chuck Taylor ALL Star Slip Black White Black SIZE 10.5,Converse Men 164300F-001 Chuck Taylor ALL Star Slip Black White Black SIZE 10.5,Default,0,0,0,0,0,40
,Converse Men 164300F-001 Chuck Taylor ALL Star Slip Black White Black SIZE 10.5,Converse Men 164300F-001 Chuck Taylor ALL Star Slip Black White Black SIZE 10.5,FBALYB Amazon,-3,-3,0,0,0,0
,Converse Men 164300F-001 Chuck Taylor ALL Star Slip Black White Black SIZE 11,Converse Men 164300F-001 Chuck Taylor ALL Star Slip Black White Black SIZE 11,Default,0,0,0,0,0,10
,Converse Men 164300F-001 Chuck Taylor ALL Star Slip Black White Black SIZE 11,Converse Men 164300F-001 Chuck Taylor ALL Star Slip Black White Black SIZE 11,FBALYB Amazon,-2,-2,0,0,0,0
,Converse Men 164300F-001 Chuck Taylor ALL Star Slip Black White Black SIZE 11.5,Converse Men 164300F-001 Chuck Taylor ALL Star Slip Black White Black SIZE 11.5,Default,0,0,0,0,0,10
,Converse Men 164300F-001 Chuck Taylor ALL Star Slip Black White Black SIZE 11.5,Converse Men 164300F-001 Chuck Taylor ALL Star Slip Black White Black SIZE 11.5,FBALYB Amazon,-2,-2,0,0,0,0
,Converse Men 164300F-001 Chuck Taylor ALL Star Slip Black White Black SIZE 12,Converse Men 164300F-001 Chuck Taylor ALL Star Slip Black White Black SIZE 12,Default,0,0,0,0,0,10
,Converse Men 164300F-001 Chuck Taylor ALL Star Slip Black White Black SIZE 12,Converse Men 164300F-001 Chuck Taylor ALL Star Slip Black White Black SIZE 12,FBALYB Amazon,-3,-3,0,0,0,0
,Converse Men 164300F-001 Chuck Taylor ALL Star Slip Black White Black SIZE 6.5,Converse Men 164300F-001 Chuck Taylor ALL Star Slip Black White Black SIZE 6.5,Default,0,0,0,0,0,10
,Converse Men 164300F-001 Chuck Taylor ALL Star Slip Black White Black SIZE 6.5,Converse Men 164300F-001 Chuck Taylor ALL Star Slip Black White Black SIZE 6.5,FBALYB Amazon,-1,-1,0,0,0,0
,Converse Men 164300F-001 Chuck Taylor ALL Star Slip Black White Black SIZE 7,Converse Men 164300F-001 Chuck Taylor ALL Star Slip Black White Black SIZE 7,Default,0,0,0,0,0,10
,Converse Men 164300F-001 Chuck Taylor ALL Star Slip Black White Black SIZE 7,Converse Men 164300F-001 Chuck Taylor ALL Star Slip Black White Black SIZE 7,FBALYB Amazon,-1,-1,0,0,0,0
,Converse Men 164300F-001 Chuck Taylor ALL Star Slip Black White Black SIZE 7.5,Converse Men 164300F-001 Chuck Taylor ALL Star Slip Black White Black SIZE 7.5,Default,0,0,0,0,0,10
,Converse Men 164300F-001 Chuck Taylor ALL Star Slip Black White Black SIZE 7.5,Converse Men 164300F-001 Chuck Taylor ALL Star Slip Black White Black SIZE 7.5,FBALYB Amazon,-1,-1,0,0,0,0
,Converse Men 164300F-001 Chuck Taylor ALL Star Slip Black White Black SIZE 8,Converse Men 164300F-001 Chuck Taylor ALL Star Slip Black White Black SIZE 8,Default,0,0,0,0,0,40
,Converse Men 164300F-001 Chuck Taylor ALL Star Slip Black White Black SIZE 8,Converse Men 164300F-001 Chuck Taylor ALL Star Slip Black White Black SIZE 8,Default Ridgefield,24,24,0,0,0,0
,Converse Men 164300F-001 Chuck Taylor ALL Star Slip Black White Black SIZE 8,Converse Men 164300F-001 Chuck Taylor ALL Star Slip Black White Black SIZE 8,FBALYB Amazon,-28,-28,0,0,0,0
,Converse Men 164300F-001 Chuck Taylor ALL Star Slip Black White Black SIZE 8.5,Converse Men 164300F-001 Chuck Taylor ALL Star Slip Black White Black SIZE 8.5,Default,0,0,0,0,0,40
,Converse Men 164300F-001 Chuck Taylor ALL Star Slip Black White Black SIZE 8.5,Converse Men 164300F-001 Chuck Taylor ALL Star Slip Black White Black SIZE 8.5,FBALYB Amazon,-4,-4,0,0,0,0
,Converse Men 164300F-001 Chuck Taylor ALL Star Slip Black White Black SIZE 9,Converse Men 164300F-001 Chuck Taylor ALL Star Slip Black White Black SIZE 9,Default,0,0,0,0,0,40
,Converse Men 164300F-001 Chuck Taylor ALL Star Slip Black White Black SIZE 9,Converse Men 164300F-001 Chuck Taylor ALL Star Slip Black White Black SIZE 9,FBALYB Amazon,-7,-7,0,0,0,0
,Converse Men 164300F-001 Chuck Taylor ALL Star Slip Black White Black SIZE 9.5,Converse Men 164300F-001 Chuck Taylor ALL Star Slip Black White Black SIZE 9.5,Default,0,0,0,0,0,10
,Converse Men 164300F-001 Chuck Taylor ALL Star Slip Black White Black SIZE 9.5,Converse Men 164300F-001 Chuck Taylor ALL Star Slip Black White Black SIZE 9.5,FBALYB Amazon,-2,-2,0,0,0,0
,Converse Men 164301F-102 Chuck Taylor ALL Star Slip Optical White SIZE 10,Converse Men 164301F-102 Chuck Taylor ALL Star Slip Optical White SIZE 10,Default,0,0,0,0,0,40
,Converse Men 164301F-102 Chuck Taylor ALL Star Slip Optical White SIZE 10,Converse Men 164301F-102 Chuck Taylor ALL Star Slip Optical White SIZE 10,FBALYB Amazon,-4,-4,0,0,0,0
,Converse Men 164301F-102 Chuck Taylor ALL Star Slip Optical White SIZE 10.5,Converse Men 164301F-102 Chuck Taylor ALL Star Slip Optical White SIZE 10.5,Default,0,0,0,0,0,40
,Converse Men 164301F-102 Chuck Taylor ALL Star Slip Optical White SIZE 10.5,Converse Men 164301F-102 Chuck Taylor ALL Star Slip Optical White SIZE 10.5,FBALYB Amazon,-2,-2,0,0,0,0
,Converse Men 164301F-102 Chuck Taylor ALL Star Slip Optical White SIZE 11,Converse Men 164301F-102 Chuck Taylor ALL Star Slip Optical White SIZE 11,Default,0,0,0,0,0,10
,Converse Men 164301F-102 Chuck Taylor ALL Star Slip Optical White SIZE 11.5,Converse Men 164301F-102 Chuck Taylor ALL Star Slip Optical White SIZE 11.5,Default,0,0,0,0,0,10
,Converse Men 164301F-102 Chuck Taylor ALL Star Slip Optical White SIZE 12,Converse Men 164301F-102 Chuck Taylor ALL Star Slip Optical White SIZE 12,Default,0,0,0,0,0,10
,Converse Men 164301F-102 Chuck Taylor ALL Star Slip Optical White SIZE 6.5,Converse Men 164301F-102 Chuck Taylor ALL Star Slip Optical White SIZE 6.5,Default,0,0,0,0,0,10
,Converse Men 164301F-102 Chuck Taylor ALL Star Slip Optical White SIZE 6.5,Converse Men 164301F-102 Chuck Taylor ALL Star Slip Optical White SIZE 6.5,FBALYB Amazon,-5,-5,0,0,0,0
,Converse Men 164301F-102 Chuck Taylor ALL Star Slip Optical White SIZE 7,Converse Men 164301F-102 Chuck Taylor ALL Star Slip Optical White SIZE 7,Default,0,0,0,0,0,10
,Converse Men 164301F-102 Chuck Taylor ALL Star Slip Optical White SIZE 7,Converse Men 164301F-102 Chuck Taylor ALL Star Slip Optical White SIZE 7,FBALYB Amazon,-1,-1,0,0,0,0
,Converse Men 164301F-102 Chuck Taylor ALL Star Slip Optical White SIZE 7.5,Converse Men 164301F-102 Chuck Taylor ALL Star Slip Optical White SIZE 7.5,Default,0,0,0,0,0,20
,Converse Men 164301F-102 Chuck Taylor ALL Star Slip Optical White SIZE 7.5,Converse Men 164301F-102 Chuck Taylor ALL Star Slip Optical White SIZE 7.5,FBALYB Amazon,-3,-3,0,0,0,0
,Converse Men 164301F-102 Chuck Taylor ALL Star Slip Optical White SIZE 8,Converse Men 164301F-102 Chuck Taylor ALL Star Slip Optical White SIZE 8,Default,0,0,0,0,0,40
,Converse Men 164301F-102 Chuck Taylor ALL Star Slip Optical White SIZE 8,Converse Men 164301F-102 Chuck Taylor ALL Star Slip Optical White SIZE 8,FBALYB Amazon,-7,-7,0,0,0,0
,Converse Men 164301F-102 Chuck Taylor ALL Star Slip Optical White SIZE 8.5,Converse Men 164301F-102 Chuck Taylor ALL Star Slip Optical White SIZE 8.5,Default,0,0,0,0,0,40
,Converse Men 164301F-102 Chuck Taylor ALL Star Slip Optical White SIZE 8.5,Converse Men 164301F-102 Chuck Taylor ALL Star Slip Optical White SIZE 8.5,FBALYB Amazon,-7,-7,0,0,0,0
,Converse Men 164301F-102 Chuck Taylor ALL Star Slip Optical White SIZE 9,Converse Men 164301F-102 Chuck Taylor ALL Star Slip Optical White SIZE 9,Default,0,0,0,0,0,40
,Converse Men 164301F-102 Chuck Taylor ALL Star Slip Optical White SIZE 9,Converse Men 164301F-102 Chuck Taylor ALL Star Slip Optical White SIZE 9,FBALYB Amazon,-3,-3,0,0,0,0
,Converse Men 164301F-102 Chuck Taylor ALL Star Slip Optical White SIZE 9.5,Converse Men 164301F-102 Chuck Taylor ALL Star Slip Optical White SIZE 9.5,Default,0,0,0,0,0,10
,Converse Men 164301F-102 Chuck Taylor ALL Star Slip Optical White SIZE 9.5,Converse Men 164301F-102 Chuck Taylor ALL Star Slip Optical White SIZE 9.5,FBALYB Amazon,-1,-1,0,0,0,0
,CONVERSE Men 537084F-1008 CHUCK TAYLOR SHORELINE White SIZE 10,CONVERSE Men 537084F-1008 CHUCK TAYLOR SHORELINE White SIZE 10,Default,0,0,0,0,0,24
,CONVERSE Men 537084F-1008 CHUCK TAYLOR SHORELINE White SIZE 10.5,CONVERSE Men 537084F-1008 CHUCK TAYLOR SHORELINE White SIZE 10.5,Default,0,0,0,0,0,24
,CONVERSE Men 537084F-1008 CHUCK TAYLOR SHORELINE White SIZE 11,CONVERSE Men 537084F-1008 CHUCK TAYLOR SHORELINE White SIZE 11,Default,0,0,0,0,0,24
,CONVERSE Men 537084F-1008 CHUCK TAYLOR SHORELINE White SIZE 7,CONVERSE Men 537084F-1008 CHUCK TAYLOR SHORELINE White SIZE 7,Default,0,0,0,0,0,24
,CONVERSE Men 537084F-1008 CHUCK TAYLOR SHORELINE White SIZE 7.5,CONVERSE Men 537084F-1008 CHUCK TAYLOR SHORELINE White SIZE 7.5,Default,0,0,0,0,0,24
,CONVERSE Men 537084F-1008 CHUCK TAYLOR SHORELINE White SIZE 8,CONVERSE Men 537084F-1008 CHUCK TAYLOR SHORELINE White SIZE 8,Default,0,0,0,0,0,24
,CONVERSE Men 537084F-1008 CHUCK TAYLOR SHORELINE White SIZE 8.5,CONVERSE Men 537084F-1008 CHUCK TAYLOR SHORELINE White SIZE 8.5,Default,0,0,0,0,0,24
,CONVERSE Men 537084F-1008 CHUCK TAYLOR SHORELINE White SIZE 9,CONVERSE Men 537084F-1008 CHUCK TAYLOR SHORELINE White SIZE 9,Default,0,0,0,0,0,24
,CONVERSE Men 537084F-1008 CHUCK TAYLOR SHORELINE White SIZE 9.5,CONVERSE Men 537084F-1008 CHUCK TAYLOR SHORELINE White SIZE 9.5,Default,0,0,0,0,0,24
,Converse Men M3310-006 Chuck Taylor ALL Star HI Black SIZE 10,Converse Men M3310-006 Chuck Taylor ALL Star HI Black SIZE 10,Default,0,0,0,0,0,27
,Converse Men M3310-006 Chuck Taylor ALL Star HI Black SIZE 10,Converse Men M3310-006 Chuck Taylor ALL Star HI Black SIZE 10,Default Ridgefield,10,10,0,0,0,0
,Converse Men M3310-006 Chuck Taylor ALL Star HI Black SIZE 10,Converse Men M3310-006 Chuck Taylor ALL Star HI Black SIZE 10,FBALYB Amazon,1,1,0,0,0,0
,Converse Men M3310-006 Chuck Taylor ALL Star HI Black SIZE 10.5,Converse Men M3310-006 Chuck Taylor ALL Star HI Black SIZE 10.5,Default,0,0,0,0,0,2
,Converse Men M3310-006 Chuck Taylor ALL Star HI Black SIZE 10.5,Converse Men M3310-006 Chuck Taylor ALL Star HI Black SIZE 10.5,FBALYB Amazon,-2,-2,0,0,0,0
,Converse Men M3310-006 Chuck Taylor ALL Star HI Black SIZE 11,Converse Men M3310-006 Chuck Taylor ALL Star HI Black SIZE 11,Default,0,0,0,0,0,14
,Converse Men M3310-006 Chuck Taylor ALL Star HI Black SIZE 11,Converse Men M3310-006 Chuck Taylor ALL Star HI Black SIZE 11,FBALYB Amazon,9,6,3,0,3,0
,Converse Men M3310-006 Chuck Taylor ALL Star HI Black SIZE 12,Converse Men M3310-006 Chuck Taylor ALL Star HI Black SIZE 12,Default,0,0,0,0,0,6
,Converse Men M3310-006 Chuck Taylor ALL Star HI Black SIZE 5,Converse Men M3310-006 Chuck Taylor ALL Star HI Black SIZE 5,Default,0,0,0,0,0,14
,Converse Men M3310-006 Chuck Taylor ALL Star HI Black SIZE 5,Converse Men M3310-006 Chuck Taylor ALL Star HI Black SIZE 5,Default Ridgefield,17,17,0,0,0,0
,Converse Men M3310-006 Chuck Taylor ALL Star HI Black SIZE 5,Converse Men M3310-006 Chuck Taylor ALL Star HI Black SIZE 5,FBALYB Amazon,-1,-1,0,0,0,0
,Converse Men M3310-006 Chuck Taylor ALL Star HI Black SIZE 5.5,Converse Men M3310-006 Chuck Taylor ALL Star HI Black SIZE 5.5,Default,0,0,0,0,0,13
,Converse Men M3310-006 Chuck Taylor ALL Star HI Black SIZE 5.5,Converse Men M3310-006 Chuck Taylor ALL Star HI Black SIZE 5.5,Default Ridgefield,21,21,0,0,0,0
,Converse Men M3310-006 Chuck Taylor ALL Star HI Black SIZE 6,Converse Men M3310-006 Chuck Taylor ALL Star HI Black SIZE 6,Default,0,0,0,0,0,28
,Converse Men M3310-006 Chuck Taylor ALL Star HI Black SIZE 6,Converse Men M3310-006 Chuck Taylor ALL Star HI Black SIZE 6,FBALYB Amazon,-1,-1,0,0,0,0
,Converse Men M3310-006 Chuck Taylor ALL Star HI Black SIZE 6.5,Converse Men M3310-006 Chuck Taylor ALL Star HI Black SIZE 6.5,Default,0,0,0,0,0,28
,Converse Men M3310-006 Chuck Taylor ALL Star HI Black SIZE 6.5,Converse Men M3310-006 Chuck Taylor ALL Star HI Black SIZE 6.5,Default Ridgefield,24,24,0,0,0,0
,Converse Men M3310-006 Chuck Taylor ALL Star HI Black SIZE 7,Converse Men M3310-006 Chuck Taylor ALL Star HI Black SIZE 7,Default,0,0,0,0,0,27
,Converse Men M3310-006 Chuck Taylor ALL Star HI Black SIZE 7,Converse Men M3310-006 Chuck Taylor ALL Star HI Black SIZE 7,Default Ridgefield,24,24,0,0,0,0
,Converse Men M3310-006 Chuck Taylor ALL Star HI Black SIZE 7,Converse Men M3310-006 Chuck Taylor ALL Star HI Black SIZE 7,FBALYB Amazon,-1,-1,0,0,0,0
,Converse Men M3310-006 Chuck Taylor ALL Star HI Black SIZE 7.5,Converse Men M3310-006 Chuck Taylor ALL Star HI Black SIZE 7.5,Default,0,0,0,0,0,28
,Converse Men M3310-006 Chuck Taylor ALL Star HI Black SIZE 7.5,Converse Men M3310-006 Chuck Taylor ALL Star HI Black SIZE 7.5,Default Ridgefield,18,18,0,0,0,0
,Converse Men M3310-006 Chuck Taylor ALL Star HI Black SIZE 7.5,Converse Men M3310-006 Chuck Taylor ALL Star HI Black SIZE 7.5,FBALYB Amazon,5,5,0,0,0,0
,Converse Men M3310-006 Chuck Taylor ALL Star HI Black SIZE 8,Converse Men M3310-006 Chuck Taylor ALL Star HI Black SIZE 8,Default,0,0,0,0,0,28
,Converse Men M3310-006 Chuck Taylor ALL Star HI Black SIZE 8,Converse Men M3310-006 Chuck Taylor ALL Star HI Black SIZE 8,Default Ridgefield,24,24,0,0,0,0
,Converse Men M3310-006 Chuck Taylor ALL Star HI Black SIZE 8,Converse Men M3310-006 Chuck Taylor ALL Star HI Black SIZE 8,FBALYB Amazon,7,7,0,0,0,0
,Converse Men M3310-006 Chuck Taylor ALL Star HI Black SIZE 8.5,Converse Men M3310-006 Chuck Taylor ALL Star HI Black SIZE 8.5,Default,0,0,0,0,0,28
,Converse Men M3310-006 Chuck Taylor ALL Star HI Black SIZE 8.5,Converse Men M3310-006 Chuck Taylor ALL Star HI Black SIZE 8.5,Default Ridgefield,23,23,0,0,0,0
,Converse Men M3310-006 Chuck Taylor ALL Star HI Black SIZE 8.5,Converse Men M3310-006 Chuck Taylor ALL Star HI Black SIZE 8.5,FBALYB Amazon,5,5,0,0,0,0
,Converse Men M3310-006 Chuck Taylor ALL Star HI Black SIZE M 3.5/ W 5.5,Converse Men M3310-006 Chuck Taylor ALL Star HI Black SIZE M 3.5/ W 5.5,Default Ridgefield,22,22,0,0,0,0
,Converse Men M3310-006 Chuck Taylor ALL Star HI Black SIZE M 3.5/ W5.5,Converse Men M3310-006 Chuck Taylor ALL Star HI Black SIZE M 3.5/ W5.5,Default Ridgefield,156,156,0,0,0,0
,Converse Men M3310-006 Chuck Taylor ALL Star HI Black SIZE M 3/ W 5,Converse Men M3310-006 Chuck Taylor ALL Star HI Black SIZE M 3/ W 5,Default Ridgefield,17,17,0,0,0,0
,Converse Men M3310-006 Chuck Taylor ALL Star HI Black SIZE M 4.5/ W 6.5,Converse Men M3310-006 Chuck Taylor ALL Star HI Black SIZE M 4.5/ W 6.5,Default Ridgefield,22,22,0,0,0,0
,Converse Men M3310-006 Chuck Taylor ALL Star HI Black SIZE M 4/ W 6,Converse Men M3310-006 Chuck Taylor ALL Star HI Black SIZE M 4/ W 6,FBALYB Amazon,0,0,0,1,0,0
,Converse Men M3310-006 Chuck Taylor ALL Star HI Black SIZE M 9.5/ W 11.5,Converse Men M3310-006 Chuck Taylor ALL Star HI Black SIZE M 9.5/ W 11.5,Default Ridgefield,24,24,0,0,0,0
,Converse Men M3310-006 Chuck Taylor ALL Star HI Black SIZE M 9/ W 11,Converse Men M3310-006 Chuck Taylor ALL Star HI Black SIZE M 9/ W 11,Default Ridgefield,22,22,0,0,0,0
,Converse Men M5039-006 Chuck Taylor ALL Star OX Black SIZE 10,Converse Men M5039-006 Chuck Taylor ALL Star OX Black SIZE 10,Default,0,0,0,0,0,24
,Converse Men M5039-006 Chuck Taylor ALL Star OX Black SIZE 10,Converse Men M5039-006 Chuck Taylor ALL Star OX Black SIZE 10,Default Ridgefield,1,1,0,0,0,0
,Converse Men M5039-006 Chuck Taylor ALL Star OX Black SIZE 10,Converse Men M5039-006 Chuck Taylor ALL Star OX Black SIZE 10,FBALYB Amazon,-1,-1,0,0,0,0
,Converse Men M5039-006 Chuck Taylor ALL Star OX Black SIZE 10.5,Converse Men M5039-006 Chuck Taylor ALL Star OX Black SIZE 10.5,Default,0,0,0,0,0,12
,Converse Men M5039-006 Chuck Taylor ALL Star OX Black SIZE 11,Converse Men M5039-006 Chuck Taylor ALL Star OX Black SIZE 11,Default,0,0,0,0,0,6
,Converse Men M5039-006 Chuck Taylor ALL Star OX Black SIZE 11,Converse Men M5039-006 Chuck Taylor ALL Star OX Black SIZE 11,Default Ridgefield,2,2,0,0,0,0
,Converse Men M5039-006 Chuck Taylor ALL Star OX Black SIZE 11,Converse Men M5039-006 Chuck Taylor ALL Star OX Black SIZE 11,FBALYB Amazon,-1,-1,0,0,0,0
,Converse Men M5039-006 Chuck Taylor ALL Star OX Black SIZE 11.5,Converse Men M5039-006 Chuck Taylor ALL Star OX Black SIZE 11.5,Default,0,0,0,0,0,6
,Converse Men M5039-006 Chuck Taylor ALL Star OX Black SIZE 12,Converse Men M5039-006 Chuck Taylor ALL Star OX Black SIZE 12,Default,0,0,0,0,0,26
,Converse Men M5039-006 Chuck Taylor ALL Star OX Black SIZE 12,Converse Men M5039-006 Chuck Taylor ALL Star OX Black SIZE 12,Default Ridgefield,3,3,0,0,0,0
,Converse Men M5039-006 Chuck Taylor ALL Star OX Black SIZE 12,Converse Men M5039-006 Chuck Taylor ALL Star OX Black SIZE 12,FBALYB Amazon,-2,-2,0,9,0,0
,Converse Men M5039-006 Chuck Taylor ALL Star OX Black SIZE 3.5,Converse Men M5039-006 Chuck Taylor ALL Star OX Black SIZE 3.5,Default,0,0,0,0,0,22
,Converse Men M5039-006 Chuck Taylor ALL Star OX Black SIZE 3.5,Converse Men M5039-006 Chuck Taylor ALL Star OX Black SIZE 3.5,Default Ridgefield,87,87,0,0,0,0
,Converse Men M5039-006 Chuck Taylor ALL Star OX Black SIZE 3.5,Converse Men M5039-006 Chuck Taylor ALL Star OX Black SIZE 3.5,FBALYB Amazon,17,17,0,0,0,0
,Converse Men M5039-006 Chuck Taylor ALL Star OX Black SIZE 4,Converse Men M5039-006 Chuck Taylor ALL Star OX Black SIZE 4,Default,0,0,0,0,0,20
,Converse Men M5039-006 Chuck Taylor ALL Star OX Black SIZE 4,Converse Men M5039-006 Chuck Taylor ALL Star OX Black SIZE 4,Default Ridgefield,43,43,0,0,0,0
,Converse Men M5039-006 Chuck Taylor ALL Star OX Black SIZE 4.5,Converse Men M5039-006 Chuck Taylor ALL Star OX Black SIZE 4.5,Default,0,0,0,0,0,20
,Converse Men M5039-006 Chuck Taylor ALL Star OX Black SIZE 4.5,Converse Men M5039-006 Chuck Taylor ALL Star OX Black SIZE 4.5,Default Ridgefield,87,87,0,0,0,0
,Converse Men M5039-006 Chuck Taylor ALL Star OX Black SIZE 4.5,Converse Men M5039-006 Chuck Taylor ALL Star OX Black SIZE 4.5,FBALYB Amazon,18,18,0,0,0,0
,Converse Men M5039-006 Chuck Taylor ALL Star OX Black SIZE 5,Converse Men M5039-006 Chuck Taylor ALL Star OX Black SIZE 5,Default,0,0,0,0,0,27
,Converse Men M5039-006 Chuck Taylor ALL Star OX Black SIZE 5,Converse Men M5039-006 Chuck Taylor ALL Star OX Black SIZE 5,Default Ridgefield,48,48,0,0,0,0
,Converse Men M5039-006 Chuck Taylor ALL Star OX Black SIZE 5.5,Converse Men M5039-006 Chuck Taylor ALL Star OX Black SIZE 5.5,Default,0,0,0,0,0,26
,Converse Men M5039-006 Chuck Taylor ALL Star OX Black SIZE 5.5,Converse Men M5039-006 Chuck Taylor ALL Star OX Black SIZE 5.5,Default Ridgefield,18,18,0,0,0,0
,Converse Men M5039-006 Chuck Taylor ALL Star OX Black SIZE 6,Converse Men M5039-006 Chuck Taylor ALL Star OX Black SIZE 6,Default,0,0,0,0,0,26
,Converse Men M5039-006 Chuck Taylor ALL Star OX Black SIZE 6,Converse Men M5039-006 Chuck Taylor ALL Star OX Black SIZE 6,Default Ridgefield,36,36,0,0,0,0
,Converse Men M5039-006 Chuck Taylor ALL Star OX Black SIZE 6.5,Converse Men M5039-006 Chuck Taylor ALL Star OX Black SIZE 6.5,Default,0,0,0,0,0,26
,Converse Men M5039-006 Chuck Taylor ALL Star OX Black SIZE 6.5,Converse Men M5039-006 Chuck Taylor ALL Star OX Black SIZE 6.5,Default Ridgefield,40,40,0,0,0,0
,Converse Men M5039-006 Chuck Taylor ALL Star OX Black SIZE 7,Converse Men M5039-006 Chuck Taylor ALL Star OX Black SIZE 7,Default,0,0,0,0,0,24
,Converse Men M5039-006 Chuck Taylor ALL Star OX Black SIZE 7,Converse Men M5039-006 Chuck Taylor ALL Star OX Black SIZE 7,Default Ridgefield,15,15,0,0,0,0
,Converse Men M5039-006 Chuck Taylor ALL Star OX Black SIZE 7,Converse Men M5039-006 Chuck Taylor ALL Star OX Black SIZE 7,FBALYB Amazon,12,12,0,0,0,0
,Converse Men M5039-006 Chuck Taylor ALL Star OX Black SIZE 7.5,Converse Men M5039-006 Chuck Taylor ALL Star OX Black SIZE 7.5,Default,0,0,0,0,0,24
,Converse Men M5039-006 Chuck Taylor ALL Star OX Black SIZE 7.5,Converse Men M5039-006 Chuck Taylor ALL Star OX Black SIZE 7.5,Default Ridgefield,25,25,0,0,0,0
,Converse Men M5039-006 Chuck Taylor ALL Star OX Black SIZE 7.5,Converse Men M5039-006 Chuck Taylor ALL Star OX Black SIZE 7.5,FBALYB Amazon,9,9,0,0,0,0
,Converse Men M5039-006 Chuck Taylor ALL Star OX Black SIZE 8,Converse Men M5039-006 Chuck Taylor ALL Star OX Black SIZE 8,Default,0,0,0,0,0,24
,Converse Men M5039-006 Chuck Taylor ALL Star OX Black SIZE 8,Converse Men M5039-006 Chuck Taylor ALL Star OX Black SIZE 8,Default Ridgefield,23,23,0,0,0,0
,Converse Men M5039-006 Chuck Taylor ALL Star OX Black SIZE 8,Converse Men M5039-006 Chuck Taylor ALL Star OX Black SIZE 8,FBALYB Amazon,23,23,0,0,0,0
,Converse Men M5039-006 Chuck Taylor ALL Star OX Black SIZE 8.5,Converse Men M5039-006 Chuck Taylor ALL Star OX Black SIZE 8.5,Default,0,0,0,0,0,24
,Converse Men M5039-006 Chuck Taylor ALL Star OX Black SIZE 8.5,Converse Men M5039-006 Chuck Taylor ALL Star OX Black SIZE 8.5,Default Ridgefield,12,12,0,0,0,0
,Converse Men M5039-006 Chuck Taylor ALL Star OX Black SIZE 8.5,Converse Men M5039-006 Chuck Taylor ALL Star OX Black SIZE 8.5,FBALYB Amazon,-4,-4,0,0,0,0
,Converse Men M5039-006 Chuck Taylor ALL Star OX Black SIZE 9,Converse Men M5039-006 Chuck Taylor ALL Star OX Black SIZE 9,Default,0,0,0,0,0,24
,Converse Men M5039-006 Chuck Taylor ALL Star OX Black SIZE 9,Converse Men M5039-006 Chuck Taylor ALL Star OX Black SIZE 9,Default Ridgefield,47,47,0,0,0,0
,Converse Men M5039-006 Chuck Taylor ALL Star OX Black SIZE 9.5,Converse Men M5039-006 Chuck Taylor ALL Star OX Black SIZE 9.5,Default,0,0,0,0,0,24
,Converse Men M5039-006 Chuck Taylor ALL Star OX Black SIZE 9.5,Converse Men M5039-006 Chuck Taylor ALL Star OX Black SIZE 9.5,Default Ridgefield,23,23,0,0,0,0
,Converse Men M5039-006 Chuck Taylor ALL Star OX Black SIZE M 3/ W 5,Converse Men M5039-006 Chuck Taylor ALL Star OX Black SIZE M 3/ W 5,Default Ridgefield,124,124,0,0,0,0
,Converse Men M7650-102 Chuck Taylor ALL Star HI Optical White SIZE 10,Converse Men M7650-102 Chuck Taylor ALL Star HI Optical White SIZE 10,Default,0,0,0,0,0,32
,Converse Men M7650-102 Chuck Taylor ALL Star HI Optical White SIZE 10,Converse Men M7650-102 Chuck Taylor ALL Star HI Optical White SIZE 10,Default Ridgefield,243,243,0,0,0,0
,Converse Men M7650-102 Chuck Taylor ALL Star HI Optical White SIZE 10,Converse Men M7650-102 Chuck Taylor ALL Star HI Optical White SIZE 10,FBALYB Amazon,-2,-2,0,0,0,0
,Converse Men M7650-102 Chuck Taylor ALL Star HI Optical White SIZE 10.5,Converse Men M7650-102 Chuck Taylor ALL Star HI Optical White SIZE 10.5,Default,0,0,0,0,0,31
,Converse Men M7650-102 Chuck Taylor ALL Star HI Optical White SIZE 11,Converse Men M7650-102 Chuck Taylor ALL Star HI Optical White SIZE 11,Default,0,0,0,0,0,32
,Converse Men M7650-102 Chuck Taylor ALL Star HI Optical White SIZE 11,Converse Men M7650-102 Chuck Taylor ALL Star HI Optical White SIZE 11,Default Ridgefield,24,24,0,0,0,0
,Converse Men M7650-102 Chuck Taylor ALL Star HI Optical White SIZE 11,Converse Men M7650-102 Chuck Taylor ALL Star HI Optical White SIZE 11,FBALYB Amazon,22,22,0,0,0,0
,Converse Men M7650-102 Chuck Taylor ALL Star HI Optical White SIZE 12,Converse Men M7650-102 Chuck Taylor ALL Star HI Optical White SIZE 12,Default,0,0,0,0,0,12
,Converse Men M7650-102 Chuck Taylor ALL Star HI Optical White SIZE 12,Converse Men M7650-102 Chuck Taylor ALL Star HI Optical White SIZE 12,Default Ridgefield,50,50,0,0,0,0
,Converse Men M7650-102 Chuck Taylor ALL Star HI Optical White SIZE 12,Converse Men M7650-102 Chuck Taylor ALL Star HI Optical White SIZE 12,FBALYB Amazon,2,2,0,0,0,0
,Converse Men M7650-102 Chuck Taylor ALL Star HI Optical White SIZE 5,Converse Men M7650-102 Chuck Taylor ALL Star HI Optical White SIZE 5,FBALYB Amazon,-5,-5,0,0,0,0
,Converse Men M7650-102 Chuck Taylor ALL Star HI Optical White SIZE 5.5,Converse Men M7650-102 Chuck Taylor ALL Star HI Optical White SIZE 5.5,FBALYB Amazon,-1,-1,0,0,0,0
,Converse Men M7650-102 Chuck Taylor ALL Star HI Optical White SIZE 6,Converse Men M7650-102 Chuck Taylor ALL Star HI Optical White SIZE 6,Default,0,0,0,0,0,30
,Converse Men M7650-102 Chuck Taylor ALL Star HI Optical White SIZE 6,Converse Men M7650-102 Chuck Taylor ALL Star HI Optical White SIZE 6,Default Ridgefield,19,19,0,0,0,0
,Converse Men M7650-102 Chuck Taylor ALL Star HI Optical White SIZE 6,Converse Men M7650-102 Chuck Taylor ALL Star HI Optical White SIZE 6,FBALYB Amazon,-4,-4,0,0,0,0
,Converse Men M7650-102 Chuck Taylor ALL Star HI Optical White SIZE 6.5,Converse Men M7650-102 Chuck Taylor ALL Star HI Optical White SIZE 6.5,Default,0,0,0,0,0,12
,Converse Men M7650-102 Chuck Taylor ALL Star HI Optical White SIZE 6.5,Converse Men M7650-102 Chuck Taylor ALL Star HI Optical White SIZE 6.5,FBALYB Amazon,-1,-1,0,0,0,0
,Converse Men M7650-102 Chuck Taylor ALL Star HI Optical White SIZE 7,Converse Men M7650-102 Chuck Taylor ALL Star HI Optical White SIZE 7,Default,0,0,0,0,0,13
,Converse Men M7650-102 Chuck Taylor ALL Star HI Optical White SIZE 7.5,Converse Men M7650-102 Chuck Taylor ALL Star HI Optical White SIZE 7.5,Default,0,0,0,0,0,6
,Converse Men M7650-102 Chuck Taylor ALL Star HI Optical White SIZE 8,Converse Men M7650-102 Chuck Taylor ALL Star HI Optical White SIZE 8,Default,0,0,0,0,0,32
,Converse Men M7650-102 Chuck Taylor ALL Star HI Optical White SIZE 8.5,Converse Men M7650-102 Chuck Taylor ALL Star HI Optical White SIZE 8.5,Default,0,0,0,0,0,12
,Converse Men M7650-102 Chuck Taylor ALL Star HI Optical White SIZE 8.5,Converse Men M7650-102 Chuck Taylor ALL Star HI Optical White SIZE 8.5,FBALYB Amazon,-1,-1,0,0,0,0
,Converse Men M7650-102 Chuck Taylor ALL Star HI Optical White SIZE 9,Converse Men M7650-102 Chuck Taylor ALL Star HI Optical White SIZE 9,Default,0,0,0,0,0,32
,Converse Men M7650-102 Chuck Taylor ALL Star HI Optical White SIZE 9,Converse Men M7650-102 Chuck Taylor ALL Star HI Optical White SIZE 9,FBALYB Amazon,-3,-3,0,0,0,0
,Converse Men M7650-102 Chuck Taylor ALL Star HI Optical White SIZE 9.5,Converse Men M7650-102 Chuck Taylor ALL Star HI Optical White SIZE 9.5,Default,0,0,0,0,0,31
,Converse Men M7650-102 Chuck Taylor ALL Star HI Optical White SIZE 9.5,Converse Men M7650-102 Chuck Taylor ALL Star HI Optical White SIZE 9.5,FBALYB Amazon,-13,-13,0,0,0,0
,Converse Men M7650-102 Chuck Taylor ALL Star HI Optical White SIZE M 3/ W 5,Converse Men M7650-102 Chuck Taylor ALL Star HI Optical White SIZE M 3/ W 5,Default Ridgefield,61,61,0,0,0,0
,Converse Men M7652-102 Chuck Taylor ALL Star Optical White SIZE 10,Converse Men M7652-102 Chuck Taylor ALL Star Optical White SIZE 10,Default Ridgefield,2,2,0,0,0,0
,Converse Men M7652-102 Chuck Taylor ALL Star Optical White SIZE 10,Converse Men M7652-102 Chuck Taylor ALL Star Optical White SIZE 10,FBALYB Amazon,40,40,0,0,0,0
,Converse Men M7652-102 Chuck Taylor ALL Star Optical White SIZE 10.5,Converse Men M7652-102 Chuck Taylor ALL Star Optical White SIZE 10.5,Default,0,0,0,0,0,6
,Converse Men M7652-102 Chuck Taylor ALL Star Optical White SIZE 11,Converse Men M7652-102 Chuck Taylor ALL Star Optical White SIZE 11,FBALYB Amazon,12,12,0,0,0,0
,Converse Men M7652-102 Chuck Taylor ALL Star Optical White SIZE 11.5,Converse Men M7652-102 Chuck Taylor ALL Star Optical White SIZE 11.5,Default,0,0,0,0,0,6
,Converse Men M7652-102 Chuck Taylor ALL Star Optical White SIZE 11.5,Converse Men M7652-102 Chuck Taylor ALL Star Optical White SIZE 11.5,FBALYB Amazon,0,-1,1,0,1,0
,Converse Men M7652-102 Chuck Taylor ALL Star Optical White SIZE 12,Converse Men M7652-102 Chuck Taylor ALL Star Optical White SIZE 12,FBALYB Amazon,-3,-3,0,0,0,0
,Converse Men M7652-102 Chuck Taylor ALL Star Optical White SIZE 13,Converse Men M7652-102 Chuck Taylor ALL Star Optical White SIZE 13,Default,0,0,0,0,0,6
,Converse Men M7652-102 Chuck Taylor ALL Star Optical White SIZE 4,Converse Men M7652-102 Chuck Taylor ALL Star Optical White SIZE 4,Default Ridgefield,304,304,0,0,0,0
,Converse Men M7652-102 Chuck Taylor ALL Star Optical White SIZE 4,Converse Men M7652-102 Chuck Taylor ALL Star Optical White SIZE 4,FBALYB Amazon,72,71,1,0,1,0
,Converse Men M7652-102 Chuck Taylor ALL Star Optical White SIZE 4.5,Converse Men M7652-102 Chuck Taylor ALL Star Optical White SIZE 4.5,Default Ridgefield,238,238,0,0,0,0
,Converse Men M7652-102 Chuck Taylor ALL Star Optical White SIZE 4.5,Converse Men M7652-102 Chuck Taylor ALL Star Optical White SIZE 4.5,FBALYB Amazon,45,45,0,0,0,0
,Converse Men M7652-102 Chuck Taylor ALL Star Optical White SIZE 5,Converse Men M7652-102 Chuck Taylor ALL Star Optical White SIZE 5,Default,0,0,0,0,0,6
,Converse Men M7652-102 Chuck Taylor ALL Star Optical White SIZE 5,Converse Men M7652-102 Chuck Taylor ALL Star Optical White SIZE 5,Default Ridgefield,276,276,0,0,0,0
,Converse Men M7652-102 Chuck Taylor ALL Star Optical White SIZE 5,Converse Men M7652-102 Chuck Taylor ALL Star Optical White SIZE 5,FBALYB Amazon,-1,-1,0,0,0,0
,Converse Men M7652-102 Chuck Taylor ALL Star Optical White SIZE 5.5,Converse Men M7652-102 Chuck Taylor ALL Star Optical White SIZE 5.5,Default Ridgefield,84,84,0,0,0,0
,Converse Men M7652-102 Chuck Taylor ALL Star Optical White SIZE 6,Converse Men M7652-102 Chuck Taylor ALL Star Optical White SIZE 6,Default,0,0,0,0,0,12
,Converse Men M7652-102 Chuck Taylor ALL Star Optical White SIZE 6,Converse Men M7652-102 Chuck Taylor ALL Star Optical White SIZE 6,Default Ridgefield,332,332,0,0,0,0
,Converse Men M7652-102 Chuck Taylor ALL Star Optical White SIZE 6,Converse Men M7652-102 Chuck Taylor ALL Star Optical White SIZE 6,FBALYB Amazon,109,107,2,0,2,0
,Converse Men M7652-102 Chuck Taylor ALL Star Optical White SIZE 6.5,Converse Men M7652-102 Chuck Taylor ALL Star Optical White SIZE 6.5,Default,0,0,0,0,0,6
,Converse Men M7652-102 Chuck Taylor ALL Star Optical White SIZE 6.5,Converse Men M7652-102 Chuck Taylor ALL Star Optical White SIZE 6.5,FBALYB Amazon,32,32,0,0,0,0
,Converse Men M7652-102 Chuck Taylor ALL Star Optical White SIZE 7,Converse Men M7652-102 Chuck Taylor ALL Star Optical White SIZE 7,Default,0,0,0,0,0,14
,Converse Men M7652-102 Chuck Taylor ALL Star Optical White SIZE 7,Converse Men M7652-102 Chuck Taylor ALL Star Optical White SIZE 7,Default Ridgefield,96,96,0,0,0,0
,Converse Men M7652-102 Chuck Taylor ALL Star Optical White SIZE 7,Converse Men M7652-102 Chuck Taylor ALL Star Optical White SIZE 7,FBALYB Amazon,-5,-5,0,0,0,0
,Converse Men M7652-102 Chuck Taylor ALL Star Optical White SIZE 7.5,Converse Men M7652-102 Chuck Taylor ALL Star Optical White SIZE 7.5,Default,0,0,0,0,0,6
,Converse Men M7652-102 Chuck Taylor ALL Star Optical White SIZE 7.5,Converse Men M7652-102 Chuck Taylor ALL Star Optical White SIZE 7.5,Default Ridgefield,180,180,0,0,0,0
,Converse Men M7652-102 Chuck Taylor ALL Star Optical White SIZE 7.5,Converse Men M7652-102 Chuck Taylor ALL Star Optical White SIZE 7.5,FBALYB Amazon,21,20,1,0,1,0
,Converse Men M7652-102 Chuck Taylor ALL Star Optical White SIZE 8,Converse Men M7652-102 Chuck Taylor ALL Star Optical White SIZE 8,Default,0,0,0,0,0,6
,Converse Men M7652-102 Chuck Taylor ALL Star Optical White SIZE 8,Converse Men M7652-102 Chuck Taylor ALL Star Optical White SIZE 8,Default Ridgefield,248,248,0,0,0,0
,Converse Men M7652-102 Chuck Taylor ALL Star Optical White SIZE 8,Converse Men M7652-102 Chuck Taylor ALL Star Optical White SIZE 8,FBALYB Amazon,25,25,0,0,0,0
,Converse Men M7652-102 Chuck Taylor ALL Star Optical White SIZE 8.5,Converse Men M7652-102 Chuck Taylor ALL Star Optical White SIZE 8.5,Default,0,0,0,0,0,6
,Converse Men M7652-102 Chuck Taylor ALL Star Optical White SIZE 8.5,Converse Men M7652-102 Chuck Taylor ALL Star Optical White SIZE 8.5,Default Ridgefield,55,55,0,0,0,0
,Converse Men M7652-102 Chuck Taylor ALL Star Optical White SIZE 8.5,Converse Men M7652-102 Chuck Taylor ALL Star Optical White SIZE 8.5,FBALYB Amazon,88,80,8,0,8,0
,Converse Men M7652-102 Chuck Taylor ALL Star Optical White SIZE 9,Converse Men M7652-102 Chuck Taylor ALL Star Optical White SIZE 9,Default,0,0,0,0,0,14
,Converse Men M7652-102 Chuck Taylor ALL Star Optical White SIZE 9,Converse Men M7652-102 Chuck Taylor ALL Star Optical White SIZE 9,Default Ridgefield,249,249,0,0,0,0
,Converse Men M7652-102 Chuck Taylor ALL Star Optical White SIZE 9,Converse Men M7652-102 Chuck Taylor ALL Star Optical White SIZE 9,FBALYB Amazon,108,106,2,0,2,0
,Converse Men M7652-102 Chuck Taylor ALL Star Optical White SIZE 9.5,Converse Men M7652-102 Chuck Taylor ALL Star Optical White SIZE 9.5,Default,0,0,0,0,0,14
,Converse Men M7652-102 Chuck Taylor ALL Star Optical White SIZE 9.5,Converse Men M7652-102 Chuck Taylor ALL Star Optical White SIZE 9.5,Default Ridgefield,378,378,0,0,0,0
,Converse Men M7652-102 Chuck Taylor ALL Star Optical White SIZE 9.5,Converse Men M7652-102 Chuck Taylor ALL Star Optical White SIZE 9.5,FBALYB Amazon,48,48,0,0,0,0
,Converse Men M7652-102 Chuck Taylor ALL Star Optical White SIZE M 3.5/ W 5.5,Converse Men M7652-102 Chuck Taylor ALL Star Optical White SIZE M 3.5/ W 5.5,Default Ridgefield,274,274,0,0,0,0
,Converse Men M7652-102 Chuck Taylor ALL Star Optical White SIZE M 3.5/ W 5.5,Converse Men M7652-102 Chuck Taylor ALL Star Optical White SIZE M 3.5/ W 5.5,FBALYB Amazon,150,150,0,0,0,0
,Converse Men M9160-001 CHUCK TAYLOR ALL STAR HI Black SIZE 10,Converse Men M9160-001 CHUCK TAYLOR ALL STAR HI Black SIZE 10,Default,0,0,0,0,0,27
,Converse Men M9160-001 CHUCK TAYLOR ALL STAR HI Black SIZE 10,Converse Men M9160-001 CHUCK TAYLOR ALL STAR HI Black SIZE 10,Default Ridgefield,103,103,0,0,0,0
,Converse Men M9160-001 CHUCK TAYLOR ALL STAR HI Black SIZE 10,Converse Men M9160-001 CHUCK TAYLOR ALL STAR HI Black SIZE 10,FBALYB Amazon,4,4,0,0,0,0
,Converse Men M9160-001 CHUCK TAYLOR ALL STAR HI Black SIZE 10.5,Converse Men M9160-001 CHUCK TAYLOR ALL STAR HI Black SIZE 10.5,Default,0,0,0,0,0,29
,Converse Men M9160-001 CHUCK TAYLOR ALL STAR HI Black SIZE 11,Converse Men M9160-001 CHUCK TAYLOR ALL STAR HI Black SIZE 11,Default,0,0,0,0,0,5
,Converse Men M9160-001 CHUCK TAYLOR ALL STAR HI Black SIZE 11,Converse Men M9160-001 CHUCK TAYLOR ALL STAR HI Black SIZE 11,Default Ridgefield,2,2,0,0,0,0
,Converse Men M9160-001 CHUCK TAYLOR ALL STAR HI Black SIZE 11,Converse Men M9160-001 CHUCK TAYLOR ALL STAR HI Black SIZE 11,FBALYB Amazon,-2,-2,0,0,0,0
,Converse Men M9160-001 CHUCK TAYLOR ALL STAR HI Black SIZE 12,Converse Men M9160-001 CHUCK TAYLOR ALL STAR HI Black SIZE 12,Default,0,0,0,0,0,3
,Converse Men M9160-001 CHUCK TAYLOR ALL STAR HI Black SIZE 4,Converse Men M9160-001 CHUCK TAYLOR ALL STAR HI Black SIZE 4,Default Ridgefield,218,218,0,0,0,0
,Converse Men M9160-001 CHUCK TAYLOR ALL STAR HI Black SIZE 4,Converse Men M9160-001 CHUCK TAYLOR ALL STAR HI Black SIZE 4,FBALYB Amazon,-1,-1,0,0,0,0
,Converse Men M9160-001 CHUCK TAYLOR ALL STAR HI Black SIZE 5,Converse Men M9160-001 CHUCK TAYLOR ALL STAR HI Black SIZE 5,FBALYB Amazon,-1,-1,0,1,0,0
,Converse Men M9160-001 CHUCK TAYLOR ALL STAR HI Black SIZE 5.5,Converse Men M9160-001 CHUCK TAYLOR ALL STAR HI Black SIZE 5.5,FBALYB Amazon,-1,-1,0,0,0,0
,Converse Men M9160-001 CHUCK TAYLOR ALL STAR HI Black SIZE 6,Converse Men M9160-001 CHUCK TAYLOR ALL STAR HI Black SIZE 6,Default,0,0,0,0,0,3
,Converse Men M9160-001 CHUCK TAYLOR ALL STAR HI Black SIZE 6,Converse Men M9160-001 CHUCK TAYLOR ALL STAR HI Black SIZE 6,FBALYB Amazon,1,1,0,0,0,0
,Converse Men M9160-001 CHUCK TAYLOR ALL STAR HI Black SIZE 6.5,Converse Men M9160-001 CHUCK TAYLOR ALL STAR HI Black SIZE 6.5,Default,0,0,0,0,0,24
,Converse Men M9160-001 CHUCK TAYLOR ALL STAR HI Black SIZE 7,Converse Men M9160-001 CHUCK TAYLOR ALL STAR HI Black SIZE 7,Default,0,0,0,0,0,3
,Converse Men M9160-001 CHUCK TAYLOR ALL STAR HI Black SIZE 7,Converse Men M9160-001 CHUCK TAYLOR ALL STAR HI Black SIZE 7,FBALYB Amazon,-4,-4,0,0,0,0
,Converse Men M9160-001 CHUCK TAYLOR ALL STAR HI Black SIZE 7.5,Converse Men M9160-001 CHUCK TAYLOR ALL STAR HI Black SIZE 7.5,FBALYB Amazon,-3,-3,0,0,0,0
,Converse Men M9160-001 CHUCK TAYLOR ALL STAR HI Black SIZE 8,Converse Men M9160-001 CHUCK TAYLOR ALL STAR HI Black SIZE 8,Default,0,0,0,0,0,27
,Converse Men M9160-001 CHUCK TAYLOR ALL STAR HI Black SIZE 8,Converse Men M9160-001 CHUCK TAYLOR ALL STAR HI Black SIZE 8,FBALYB Amazon,-4,-4,0,0,0,0
,Converse Men M9160-001 CHUCK TAYLOR ALL STAR HI Black SIZE 8.5,Converse Men M9160-001 CHUCK TAYLOR ALL STAR HI Black SIZE 8.5,Default,0,0,0,0,0,29
,Converse Men M9160-001 CHUCK TAYLOR ALL STAR HI Black SIZE 8.5,Converse Men M9160-001 CHUCK TAYLOR ALL STAR HI Black SIZE 8.5,FBALYB Amazon,0,-1,1,0,1,0
,Converse Men M9160-001 CHUCK TAYLOR ALL STAR HI Black SIZE 9,Converse Men M9160-001 CHUCK TAYLOR ALL STAR HI Black SIZE 9,Default,0,0,0,0,0,27
,Converse Men M9160-001 CHUCK TAYLOR ALL STAR HI Black SIZE 9,Converse Men M9160-001 CHUCK TAYLOR ALL STAR HI Black SIZE 9,FBALYB Amazon,-1,-1,0,0,0,0
,Converse Men M9160-001 CHUCK TAYLOR ALL STAR HI Black SIZE 9.5,Converse Men M9160-001 CHUCK TAYLOR ALL STAR HI Black SIZE 9.5,Default,0,0,0,0,0,4
,Converse Men M9160-001 CHUCK TAYLOR ALL STAR HI Black SIZE 9.5,Converse Men M9160-001 CHUCK TAYLOR ALL STAR HI Black SIZE 9.5,Default Ridgefield,1,1,0,0,0,0
,Converse Men M9160-001 CHUCK TAYLOR ALL STAR HI Black SIZE 9.5,Converse Men M9160-001 CHUCK TAYLOR ALL STAR HI Black SIZE 9.5,FBALYB Amazon,-10,-10,0,0,0,0
,Converse Men M9160-001 CHUCK TAYLOR ALL STAR HI Black SIZE M 3.5/ W 5.5,Converse Men M9160-001 CHUCK TAYLOR ALL STAR HI Black SIZE M 3.5/ W 5.5,Default Ridgefield,2,2,0,0,0,0
,Converse Men M9160-001 CHUCK TAYLOR ALL STAR HI Black SIZE M 3.5/ W 5.5,Converse Men M9160-001 CHUCK TAYLOR ALL STAR HI Black SIZE M 3.5/ W 5.5,FBALYB Amazon,-1,-1,0,0,0,0
,Converse Men M9160-001 CHUCK TAYLOR ALL STAR HI Black SIZE M 3/ W 5,Converse Men M9160-001 CHUCK TAYLOR ALL STAR HI Black SIZE M 3/ W 5,Default Ridgefield,21,21,0,0,0,0
,Converse Men M9166-001 Chuck Taylor ALL Star Core OX Black SIZE 10,Converse Men M9166-001 Chuck Taylor ALL Star Core OX Black SIZE 10,Default Ridgefield,181,181,0,0,0,0
,Converse Men M9166-001 Chuck Taylor ALL Star Core OX Black SIZE 10.5,Converse Men M9166-001 Chuck Taylor ALL Star Core OX Black SIZE 10.5,FBALYB Amazon,-3,-3,0,0,0,0
,Converse Men M9166-001 Chuck Taylor ALL Star Core OX Black SIZE 11,Converse Men M9166-001 Chuck Taylor ALL Star Core OX Black SIZE 11,FBALYB Amazon,4,4,0,0,0,0
,Converse Men M9166-001 Chuck Taylor ALL Star Core OX Black SIZE 11.5,Converse Men M9166-001 Chuck Taylor ALL Star Core OX Black SIZE 11.5,FBALYB Amazon,7,7,0,0,0,0
,Converse Men M9166-001 Chuck Taylor ALL Star Core OX Black SIZE 12,Converse Men M9166-001 Chuck Taylor ALL Star Core OX Black SIZE 12,Default Ridgefield,23,23,0,0,0,0
,Converse Men M9166-001 Chuck Taylor ALL Star Core OX Black SIZE 13,Converse Men M9166-001 Chuck Taylor ALL Star Core OX Black SIZE 13,FBALYB Amazon,1,1,0,0,0,0
,Converse Men M9166-001 Chuck Taylor ALL Star Core OX Black SIZE 4,Converse Men M9166-001 Chuck Taylor ALL Star Core OX Black SIZE 4,Default Ridgefield,22,22,0,0,0,0
,Converse Men M9166-001 Chuck Taylor ALL Star Core OX Black SIZE 4,Converse Men M9166-001 Chuck Taylor ALL Star Core OX Black SIZE 4,FBALYB Amazon,24,24,0,0,0,0
,Converse Men M9166-001 Chuck Taylor ALL Star Core OX Black SIZE 4.5,Converse Men M9166-001 Chuck Taylor ALL Star Core OX Black SIZE 4.5,Default Ridgefield,8,8,0,0,0,0
,Converse Men M9166-001 Chuck Taylor ALL Star Core OX Black SIZE 4.5,Converse Men M9166-001 Chuck Taylor ALL Star Core OX Black SIZE 4.5,FBALYB Amazon,25,25,0,0,0,0
,Converse Men M9166-001 Chuck Taylor ALL Star Core OX Black SIZE 5,Converse Men M9166-001 Chuck Taylor ALL Star Core OX Black SIZE 5,Default,0,0,0,0,0,13
,Converse Men M9166-001 Chuck Taylor ALL Star Core OX Black SIZE 5,Converse Men M9166-001 Chuck Taylor ALL Star Core OX Black SIZE 5,Default Ridgefield,4,4,0,0,0,0
,Converse Men M9166-001 Chuck Taylor ALL Star Core OX Black SIZE 5,Converse Men M9166-001 Chuck Taylor ALL Star Core OX Black SIZE 5,FBALYB Amazon,18,18,0,0,0,0
,Converse Men M9166-001 Chuck Taylor ALL Star Core OX Black SIZE 5.5,Converse Men M9166-001 Chuck Taylor ALL Star Core OX Black SIZE 5.5,Default,0,0,0,0,0,2
,Converse Men M9166-001 Chuck Taylor ALL Star Core OX Black SIZE 5.5,Converse Men M9166-001 Chuck Taylor ALL Star Core OX Black SIZE 5.5,Default Ridgefield,23,23,0,0,0,0
,Converse Men M9166-001 Chuck Taylor ALL Star Core OX Black SIZE 5.5,Converse Men M9166-001 Chuck Taylor ALL Star Core OX Black SIZE 5.5,FBALYB Amazon,16,10,6,0,6,0
,Converse Men M9166-001 Chuck Taylor ALL Star Core OX Black SIZE 6,Converse Men M9166-001 Chuck Taylor ALL Star Core OX Black SIZE 6,Default,0,0,0,0,0,28
,Converse Men M9166-001 Chuck Taylor ALL Star Core OX Black SIZE 6,Converse Men M9166-001 Chuck Taylor ALL Star Core OX Black SIZE 6,Default Ridgefield,47,47,0,0,0,0
,Converse Men M9166-001 Chuck Taylor ALL Star Core OX Black SIZE 6,Converse Men M9166-001 Chuck Taylor ALL Star Core OX Black SIZE 6,FBALYB Amazon,-3,-3,0,0,0,0
,Converse Men M9166-001 Chuck Taylor ALL Star Core OX Black SIZE 6.5,Converse Men M9166-001 Chuck Taylor ALL Star Core OX Black SIZE 6.5,Default,0,0,0,0,0,3
,Converse Men M9166-001 Chuck Taylor ALL Star Core OX Black SIZE 6.5,Converse Men M9166-001 Chuck Taylor ALL Star Core OX Black SIZE 6.5,Default Ridgefield,25,25,0,0,0,0
,Converse Men M9166-001 Chuck Taylor ALL Star Core OX Black SIZE 6.5,Converse Men M9166-001 Chuck Taylor ALL Star Core OX Black SIZE 6.5,FBALYB Amazon,50,50,0,0,0,0
,Converse Men M9166-001 Chuck Taylor ALL Star Core OX Black SIZE 7,Converse Men M9166-001 Chuck Taylor ALL Star Core OX Black SIZE 7,Default,0,0,0,0,0,28
,Converse Men M9166-001 Chuck Taylor ALL Star Core OX Black SIZE 7,Converse Men M9166-001 Chuck Taylor ALL Star Core OX Black SIZE 7,Default Ridgefield,18,18,0,0,0,0
,Converse Men M9166-001 Chuck Taylor ALL Star Core OX Black SIZE 7,Converse Men M9166-001 Chuck Taylor ALL Star Core OX Black SIZE 7,FBALYB Amazon,38,38,0,0,0,0
,Converse Men M9166-001 Chuck Taylor ALL Star Core OX Black SIZE 7.5,Converse Men M9166-001 Chuck Taylor ALL Star Core OX Black SIZE 7.5,Default Ridgefield,24,24,0,0,0,0
,Converse Men M9166-001 Chuck Taylor ALL Star Core OX Black SIZE 7.5,Converse Men M9166-001 Chuck Taylor ALL Star Core OX Black SIZE 7.5,FBALYB Amazon,36,34,2,0,2,0
,Converse Men M9166-001 Chuck Taylor ALL Star Core OX Black SIZE 8,Converse Men M9166-001 Chuck Taylor ALL Star Core OX Black SIZE 8,Default,0,0,0,0,0,12
,Converse Men M9166-001 Chuck Taylor ALL Star Core OX Black SIZE 8,Converse Men M9166-001 Chuck Taylor ALL Star Core OX Black SIZE 8,Default Ridgefield,24,24,0,0,0,0
,Converse Men M9166-001 Chuck Taylor ALL Star Core OX Black SIZE 8,Converse Men M9166-001 Chuck Taylor ALL Star Core OX Black SIZE 8,FBALYB Amazon,50,50,0,0,0,0
,Converse Men M9166-001 Chuck Taylor ALL Star Core OX Black SIZE 8.5,Converse Men M9166-001 Chuck Taylor ALL Star Core OX Black SIZE 8.5,Default,0,0,0,0,0,12
,Converse Men M9166-001 Chuck Taylor ALL Star Core OX Black SIZE 8.5,Converse Men M9166-001 Chuck Taylor ALL Star Core OX Black SIZE 8.5,Default Ridgefield,14,14,0,0,0,0
,Converse Men M9166-001 Chuck Taylor ALL Star Core OX Black SIZE 8.5,Converse Men M9166-001 Chuck Taylor ALL Star Core OX Black SIZE 8.5,FBALYB Amazon,44,44,0,0,0,0
,Converse Men M9166-001 Chuck Taylor ALL Star Core OX Black SIZE 9,Converse Men M9166-001 Chuck Taylor ALL Star Core OX Black SIZE 9,Default,0,0,0,0,0,4
,Converse Men M9166-001 Chuck Taylor ALL Star Core OX Black SIZE 9,Converse Men M9166-001 Chuck Taylor ALL Star Core OX Black SIZE 9,Default Ridgefield,64,64,0,0,0,0
,Converse Men M9166-001 Chuck Taylor ALL Star Core OX Black SIZE 9,Converse Men M9166-001 Chuck Taylor ALL Star Core OX Black SIZE 9,FBALYB Amazon,35,35,0,0,0,0
,Converse Men M9166-001 Chuck Taylor ALL Star Core OX Black SIZE 9.5,Converse Men M9166-001 Chuck Taylor ALL Star Core OX Black SIZE 9.5,Default,0,0,0,0,0,4
,Converse Men M9166-001 Chuck Taylor ALL Star Core OX Black SIZE 9.5,Converse Men M9166-001 Chuck Taylor ALL Star Core OX Black SIZE 9.5,Default Ridgefield,72,72,0,0,0,0
,Converse Men M9166-001 Chuck Taylor ALL Star Core OX Black SIZE 9.5,Converse Men M9166-001 Chuck Taylor ALL Star Core OX Black SIZE 9.5,FBALYB Amazon,16,16,0,0,0,0
,Converse Men M9166-001 Chuck Taylor ALL Star Core OX Black SIZE M 3.5/ W 5.5,Converse Men M9166-001 Chuck Taylor ALL Star Core OX Black SIZE M 3.5/ W 5.5,Default Ridgefield,96,96,0,0,0,0
,Converse Men M9166-001 Chuck Taylor ALL Star Core OX Black SIZE M 3/ W 5,Converse Men M9166-001 Chuck Taylor ALL Star Core OX Black SIZE M 3/ W 5,Default Ridgefield,203,203,0,0,0,0
,Converse Men M9621-600 Chuck Taylor ALL Star HI Red SIZE 10,Converse Men M9621-600 Chuck Taylor ALL Star HI Red SIZE 10,Default,0,0,0,0,0,3
,Converse Men M9621-600 Chuck Taylor ALL Star HI Red SIZE 10,Converse Men M9621-600 Chuck Taylor ALL Star HI Red SIZE 10,Default Ridgefield,43,43,0,0,0,0
,Converse Men M9621-600 Chuck Taylor ALL Star HI Red SIZE 10,Converse Men M9621-600 Chuck Taylor ALL Star HI Red SIZE 10,FBALYB Amazon,-1,-1,0,0,0,0
,Converse Men M9621-600 Chuck Taylor ALL Star HI Red SIZE 10.5,Converse Men M9621-600 Chuck Taylor ALL Star HI Red SIZE 10.5,Default,0,0,0,0,0,4
,Converse Men M9621-600 Chuck Taylor ALL Star HI Red SIZE 11,Converse Men M9621-600 Chuck Taylor ALL Star HI Red SIZE 11,Default,0,0,0,0,0,3
,Converse Men M9621-600 Chuck Taylor ALL Star HI Red SIZE 11,Converse Men M9621-600 Chuck Taylor ALL Star HI Red SIZE 11,Default Ridgefield,1,1,0,0,0,0
,Converse Men M9621-600 Chuck Taylor ALL Star HI Red SIZE 11,Converse Men M9621-600 Chuck Taylor ALL Star HI Red SIZE 11,FBALYB Amazon,1,-2,3,0,3,0
,Converse Men M9621-600 Chuck Taylor ALL Star HI Red SIZE 4,Converse Men M9621-600 Chuck Taylor ALL Star HI Red SIZE 4,FBALYB Amazon,-1,-2,1,0,1,0
,Converse Men M9621-600 Chuck Taylor ALL Star HI Red SIZE 4.5,Converse Men M9621-600 Chuck Taylor ALL Star HI Red SIZE 4.5,Default Ridgefield,7,7,0,0,0,0
,Converse Men M9621-600 Chuck Taylor ALL Star HI Red SIZE 4.5,Converse Men M9621-600 Chuck Taylor ALL Star HI Red SIZE 4.5,FBALYB Amazon,9,9,0,0,0,0
,Converse Men M9621-600 Chuck Taylor ALL Star HI Red SIZE 5,Converse Men M9621-600 Chuck Taylor ALL Star HI Red SIZE 5,Default,0,0,0,0,0,28
,Converse Men M9621-600 Chuck Taylor ALL Star HI Red SIZE 5,Converse Men M9621-600 Chuck Taylor ALL Star HI Red SIZE 5,Default Ridgefield,1,1,0,0,0,0
,Converse Men M9621-600 Chuck Taylor ALL Star HI Red SIZE 5,Converse Men M9621-600 Chuck Taylor ALL Star HI Red SIZE 5,FBALYB Amazon,4,4,0,0,0,0
,Converse Men M9621-600 Chuck Taylor ALL Star HI Red SIZE 5.5,Converse Men M9621-600 Chuck Taylor ALL Star HI Red SIZE 5.5,Default,0,0,0,0,0,12
,Converse Men M9621-600 Chuck Taylor ALL Star HI Red SIZE 5.5,Converse Men M9621-600 Chuck Taylor ALL Star HI Red SIZE 5.5,FBALYB Amazon,1,0,1,0,1,0
,Converse Men M9621-600 Chuck Taylor ALL Star HI Red SIZE 6,Converse Men M9621-600 Chuck Taylor ALL Star HI Red SIZE 6,Default,0,0,0,0,0,28
,Converse Men M9621-600 Chuck Taylor ALL Star HI Red SIZE 6,Converse Men M9621-600 Chuck Taylor ALL Star HI Red SIZE 6,FBALYB Amazon,-3,-3,0,0,0,0
,Converse Men M9621-600 Chuck Taylor ALL Star HI Red SIZE 6.5,Converse Men M9621-600 Chuck Taylor ALL Star HI Red SIZE 6.5,Default,0,0,0,0,0,4
,Converse Men M9621-600 Chuck Taylor ALL Star HI Red SIZE 6.5,Converse Men M9621-600 Chuck Taylor ALL Star HI Red SIZE 6.5,FBALYB Amazon,23,22,1,1,1,0
,Converse Men M9621-600 Chuck Taylor ALL Star HI Red SIZE 7,Converse Men M9621-600 Chuck Taylor ALL Star HI Red SIZE 7,Default,0,0,0,0,0,27
,Converse Men M9621-600 Chuck Taylor ALL Star HI Red SIZE 7,Converse Men M9621-600 Chuck Taylor ALL Star HI Red SIZE 7,FBALYB Amazon,9,7,2,0,2,0
,Converse Men M9621-600 Chuck Taylor ALL Star HI Red SIZE 7.5,Converse Men M9621-600 Chuck Taylor ALL Star HI Red SIZE 7.5,Default,0,0,0,0,0,7
,Converse Men M9621-600 Chuck Taylor ALL Star HI Red SIZE 7.5,Converse Men M9621-600 Chuck Taylor ALL Star HI Red SIZE 7.5,Default Ridgefield,4,4,0,0,0,0
,Converse Men M9621-600 Chuck Taylor ALL Star HI Red SIZE 7.5,Converse Men M9621-600 Chuck Taylor ALL Star HI Red SIZE 7.5,FBALYB Amazon,-13,-13,0,0,0,0
,Converse Men M9621-600 Chuck Taylor ALL Star HI Red SIZE 8,Converse Men M9621-600 Chuck Taylor ALL Star HI Red SIZE 8,Default,0,0,0,0,0,6
,Converse Men M9621-600 Chuck Taylor ALL Star HI Red SIZE 8,Converse Men M9621-600 Chuck Taylor ALL Star HI Red SIZE 8,Default Ridgefield,22,22,0,0,0,0
,Converse Men M9621-600 Chuck Taylor ALL Star HI Red SIZE 8,Converse Men M9621-600 Chuck Taylor ALL Star HI Red SIZE 8,FBALYB Amazon,19,19,0,0,0,0
,Converse Men M9621-600 Chuck Taylor ALL Star HI Red SIZE 8.5,Converse Men M9621-600 Chuck Taylor ALL Star HI Red SIZE 8.5,Default,0,0,0,0,0,28
,Converse Men M9621-600 Chuck Taylor ALL Star HI Red SIZE 8.5,Converse Men M9621-600 Chuck Taylor ALL Star HI Red SIZE 8.5,FBALYB Amazon,-18,-18,0,0,0,0
,Converse Men M9621-600 Chuck Taylor ALL Star HI Red SIZE 9,Converse Men M9621-600 Chuck Taylor ALL Star HI Red SIZE 9,Default,0,0,0,0,0,6
,Converse Men M9621-600 Chuck Taylor ALL Star HI Red SIZE 9,Converse Men M9621-600 Chuck Taylor ALL Star HI Red SIZE 9,FBALYB Amazon,-4,-4,0,0,0,0
,Converse Men M9621-600 Chuck Taylor ALL Star HI Red SIZE 9.5,Converse Men M9621-600 Chuck Taylor ALL Star HI Red SIZE 9.5,Default,0,0,0,0,0,1
,Converse Men M9621-600 Chuck Taylor ALL Star HI Red SIZE 9.5,Converse Men M9621-600 Chuck Taylor ALL Star HI Red SIZE 9.5,Default Ridgefield,17,17,0,0,0,0
,Converse Men M9621-600 Chuck Taylor ALL Star HI Red SIZE 9.5,Converse Men M9621-600 Chuck Taylor ALL Star HI Red SIZE 9.5,FBALYB Amazon,9,8,1,0,1,0
,Converse Men M9621-600 Chuck Taylor ALL Star HI Red SIZE M 3.5/ W 5.5,Converse Men M9621-600 Chuck Taylor ALL Star HI Red SIZE M 3.5/ W 5.5,Default Ridgefield,24,24,0,0,0,0
,Converse Men M9621-600 Chuck Taylor ALL Star HI Red SIZE M 3/ W 5,Converse Men M9621-600 Chuck Taylor ALL Star HI Red SIZE M 3/ W 5,Default Ridgefield,21,21,0,0,0,0
,Converse Men M9622 Chuck Taylor High Top Navy Size M 3/ W 5,Converse M9622 Chuck Taylor High Top Navy Size M 3/ W 5,Default Ridgefield,66,66,0,0,0,0
,Converse Men M9696-600 Chuck Taylor ALL Star Core OX Red SIZE 10,Converse Men M9696-600 Chuck Taylor ALL Star Core OX Red SIZE 10,Default,0,0,0,0,0,7
,Converse Men M9696-600 Chuck Taylor ALL Star Core OX Red SIZE 10,Converse Men M9696-600 Chuck Taylor ALL Star Core OX Red SIZE 10,FBALYB Amazon,5,4,1,0,1,0
,Converse Men M9696-600 Chuck Taylor ALL Star Core OX Red SIZE 10.5,Converse Men M9696-600 Chuck Taylor ALL Star Core OX Red SIZE 10.5,Default,0,0,0,0,0,8
,Converse Men M9696-600 Chuck Taylor ALL Star Core OX Red SIZE 10.5,Converse Men M9696-600 Chuck Taylor ALL Star Core OX Red SIZE 10.5,FBALYB Amazon,-1,-1,0,0,0,0
,Converse Men M9696-600 Chuck Taylor ALL Star Core OX Red SIZE 11,Converse Men M9696-600 Chuck Taylor ALL Star Core OX Red SIZE 11,Default,0,0,0,0,0,6
,Converse Men M9696-600 Chuck Taylor ALL Star Core OX Red SIZE 11.5,Converse Men M9696-600 Chuck Taylor ALL Star Core OX Red SIZE 11.5,Default,0,0,0,0,0,10
,Converse Men M9696-600 Chuck Taylor ALL Star Core OX Red SIZE 12,Converse Men M9696-600 Chuck Taylor ALL Star Core OX Red SIZE 12,Default,0,0,0,0,0,6
,Converse Men M9696-600 Chuck Taylor ALL Star Core OX Red SIZE 12,Converse Men M9696-600 Chuck Taylor ALL Star Core OX Red SIZE 12,Default Ridgefield,21,21,0,0,0,0
,Converse Men M9696-600 Chuck Taylor ALL Star Core OX Red SIZE 12,Converse Men M9696-600 Chuck Taylor ALL Star Core OX Red SIZE 12,FBALYB Amazon,-1,-1,0,0,0,0
,Converse Men M9696-600 Chuck Taylor ALL Star Core OX Red SIZE 13,Converse Men M9696-600 Chuck Taylor ALL Star Core OX Red SIZE 13,Default,0,0,0,0,0,6
,Converse Men M9696-600 Chuck Taylor ALL Star Core OX Red SIZE 5,Converse Men M9696-600 Chuck Taylor ALL Star Core OX Red SIZE 5,Default,0,0,0,0,0,13
,Converse Men M9696-600 Chuck Taylor ALL Star Core OX Red SIZE 5,Converse Men M9696-600 Chuck Taylor ALL Star Core OX Red SIZE 5,Default Ridgefield,24,24,0,0,0,0
,Converse Men M9696-600 Chuck Taylor ALL Star Core OX Red SIZE 5.5,Converse Men M9696-600 Chuck Taylor ALL Star Core OX Red SIZE 5.5,Default,0,0,0,0,0,13
,Converse Men M9696-600 Chuck Taylor ALL Star Core OX Red SIZE 5.5,Converse Men M9696-600 Chuck Taylor ALL Star Core OX Red SIZE 5.5,Default Ridgefield,22,22,0,0,0,0
,Converse Men M9696-600 Chuck Taylor ALL Star Core OX Red SIZE 6,Converse Men M9696-600 Chuck Taylor ALL Star Core OX Red SIZE 6,Default,0,0,0,0,0,33
,Converse Men M9696-600 Chuck Taylor ALL Star Core OX Red SIZE 6,Converse Men M9696-600 Chuck Taylor ALL Star Core OX Red SIZE 6,Default Ridgefield,22,22,0,0,0,0
,Converse Men M9696-600 Chuck Taylor ALL Star Core OX Red SIZE 6,Converse Men M9696-600 Chuck Taylor ALL Star Core OX Red SIZE 6,FBALYB Amazon,21,21,0,0,0,0
,Converse Men M9696-600 Chuck Taylor ALL Star Core OX Red SIZE 6.5,Converse Men M9696-600 Chuck Taylor ALL Star Core OX Red SIZE 6.5,Default,0,0,0,0,0,13
,Converse Men M9696-600 Chuck Taylor ALL Star Core OX Red SIZE 6.5,Converse Men M9696-600 Chuck Taylor ALL Star Core OX Red SIZE 6.5,Default Ridgefield,19,19,0,0,0,0
,Converse Men M9696-600 Chuck Taylor ALL Star Core OX Red SIZE 7,Converse Men M9696-600 Chuck Taylor ALL Star Core OX Red SIZE 7,Default,0,0,0,0,0,33
,Converse Men M9696-600 Chuck Taylor ALL Star Core OX Red SIZE 7,Converse Men M9696-600 Chuck Taylor ALL Star Core OX Red SIZE 7,Default Ridgefield,1,1,0,0,0,0
,Converse Men M9696-600 Chuck Taylor ALL Star Core OX Red SIZE 7,Converse Men M9696-600 Chuck Taylor ALL Star Core OX Red SIZE 7,FBALYB Amazon,-6,-6,0,13,0,0
,Converse Men M9696-600 Chuck Taylor ALL Star Core OX Red SIZE 7.5,Converse Men M9696-600 Chuck Taylor ALL Star Core OX Red SIZE 7.5,Default,0,0,0,0,0,13
,Converse Men M9696-600 Chuck Taylor ALL Star Core OX Red SIZE 7.5,Converse Men M9696-600 Chuck Taylor ALL Star Core OX Red SIZE 7.5,Default Ridgefield,24,24,0,0,0,0
,Converse Men M9696-600 Chuck Taylor ALL Star Core OX Red SIZE 7.5,Converse Men M9696-600 Chuck Taylor ALL Star Core OX Red SIZE 7.5,FBALYB Amazon,-1,-1,0,0,0,0
,Converse Men M9696-600 Chuck Taylor ALL Star Core OX Red SIZE 8,Converse Men M9696-600 Chuck Taylor ALL Star Core OX Red SIZE 8,Default,0,0,0,0,0,15
,Converse Men M9696-600 Chuck Taylor ALL Star Core OX Red SIZE 8,Converse Men M9696-600 Chuck Taylor ALL Star Core OX Red SIZE 8,Default Ridgefield,12,12,0,0,0,0
,Converse Men M9696-600 Chuck Taylor ALL Star Core OX Red SIZE 8,Converse Men M9696-600 Chuck Taylor ALL Star Core OX Red SIZE 8,FBALYB Amazon,10,10,0,0,0,0
,Converse Men M9696-600 Chuck Taylor ALL Star Core OX Red SIZE 8.5,Converse Men M9696-600 Chuck Taylor ALL Star Core OX Red SIZE 8.5,Default,0,0,0,0,0,2
,Converse Men M9696-600 Chuck Taylor ALL Star Core OX Red SIZE 8.5,Converse Men M9696-600 Chuck Taylor ALL Star Core OX Red SIZE 8.5,Default Ridgefield,20,20,0,0,0,0
,Converse Men M9696-600 Chuck Taylor ALL Star Core OX Red SIZE 8.5,Converse Men M9696-600 Chuck Taylor ALL Star Core OX Red SIZE 8.5,FBALYB Amazon,-5,-5,0,0,0,0
,Converse Men M9696-600 Chuck Taylor ALL Star Core OX Red SIZE 9,Converse Men M9696-600 Chuck Taylor ALL Star Core OX Red SIZE 9,Default,0,0,0,0,0,14
,Converse Men M9696-600 Chuck Taylor ALL Star Core OX Red SIZE 9,Converse Men M9696-600 Chuck Taylor ALL Star Core OX Red SIZE 9,Default Ridgefield,21,21,0,0,0,0
,Converse Men M9696-600 Chuck Taylor ALL Star Core OX Red SIZE 9,Converse Men M9696-600 Chuck Taylor ALL Star Core OX Red SIZE 9,FBALYB Amazon,-9,-9,0,0,0,0
,Converse Men M9696-600 Chuck Taylor ALL Star Core OX Red SIZE 9.5,Converse Men M9696-600 Chuck Taylor ALL Star Core OX Red SIZE 9.5,Default,0,0,0,0,0,19
,Converse Men M9696-600 Chuck Taylor ALL Star Core OX Red SIZE 9.5,Converse Men M9696-600 Chuck Taylor ALL Star Core OX Red SIZE 9.5,Default Ridgefield,22,22,0,0,0,0
,Converse Men M9696-600 Chuck Taylor ALL Star Core OX Red SIZE 9.5,Converse Men M9696-600 Chuck Taylor ALL Star Core OX Red SIZE 9.5,FBALYB Amazon,-3,-3,0,0,0,0
,Converse Men M9696-600 Chuck Taylor ALL Star Core OX Red SIZE M 4.5/ W 6.5,Converse Men M9696-600 Chuck Taylor ALL Star Core OX Red SIZE M 4.5/ W 6.5,Default Ridgefield,24,24,0,0,0,0
,Converse Men M9696-600 Chuck Taylor ALL Star Core OX Red SIZE M 4/ W 6,Converse Men M9696-600 Chuck Taylor ALL Star Core OX Red SIZE M 4/ W 6,Default Ridgefield,24,24,0,0,0,0
,Converse Women 537080F-410 Chuck Taylor ALL Star Shoreline Slip Navy SIZE 10,Converse Women 537080F-410 Chuck Taylor ALL Star Shoreline Slip Navy SIZE 10,Default,0,0,0,0,0,40
,Converse Women 537080F-410 Chuck Taylor ALL Star Shoreline Slip Navy SIZE 10,Converse Women 537080F-410 Chuck Taylor ALL Star Shoreline Slip Navy SIZE 10,FBALYB Amazon,-3,-3,0,0,0,0
,Converse Women 537080F-410 Chuck Taylor ALL Star Shoreline Slip Navy SIZE 10.5,Converse Women 537080F-410 Chuck Taylor ALL Star Shoreline Slip Navy SIZE 10.5,Default,0,0,0,0,0,40
,Converse Women 537080F-410 Chuck Taylor ALL Star Shoreline Slip Navy SIZE 10.5,Converse Women 537080F-410 Chuck Taylor ALL Star Shoreline Slip Navy SIZE 10.5,FBALYB Amazon,17,17,0,0,0,0
,Converse Women 537080F-410 Chuck Taylor ALL Star Shoreline Slip Navy SIZE 6,Converse Women 537080F-410 Chuck Taylor ALL Star Shoreline Slip Navy SIZE 6,Default,0,0,0,0,0,40
,Converse Women 537080F-410 Chuck Taylor ALL Star Shoreline Slip Navy SIZE 6,Converse Women 537080F-410 Chuck Taylor ALL Star Shoreline Slip Navy SIZE 6,FBALYB Amazon,-7,-7,0,0,0,0
,Converse Women 537080F-410 Chuck Taylor ALL Star Shoreline Slip Navy SIZE 6.5,Converse Women 537080F-410 Chuck Taylor ALL Star Shoreline Slip Navy SIZE 6.5,Default,0,0,0,0,0,40
,Converse Women 537080F-410 Chuck Taylor ALL Star Shoreline Slip Navy SIZE 6.5,Converse Women 537080F-410 Chuck Taylor ALL Star Shoreline Slip Navy SIZE 6.5,FBALYB Amazon,-2,-2,0,0,0,0
,Converse Women 537080F-410 Chuck Taylor ALL Star Shoreline Slip Navy SIZE 7,Converse Women 537080F-410 Chuck Taylor ALL Star Shoreline Slip Navy SIZE 7,Default,0,0,0,0,0,40
,Converse Women 537080F-410 Chuck Taylor ALL Star Shoreline Slip Navy SIZE 7,Converse Women 537080F-410 Chuck Taylor ALL Star Shoreline Slip Navy SIZE 7,FBALYB Amazon,-2,-2,0,0,0,0
,Converse Women 537080F-410 Chuck Taylor ALL Star Shoreline Slip Navy SIZE 7.5,Converse Women 537080F-410 Chuck Taylor ALL Star Shoreline Slip Navy SIZE 7.5,Default,0,0,0,0,0,40
,Converse Women 537080F-410 Chuck Taylor ALL Star Shoreline Slip Navy SIZE 7.5,Converse Women 537080F-410 Chuck Taylor ALL Star Shoreline Slip Navy SIZE 7.5,FBALYB Amazon,-2,-2,0,0,0,0
,Converse Women 537080F-410 Chuck Taylor ALL Star Shoreline Slip Navy SIZE 8,Converse Women 537080F-410 Chuck Taylor ALL Star Shoreline Slip Navy SIZE 8,Default,0,0,0,0,0,40
,Converse Women 537080F-410 Chuck Taylor ALL Star Shoreline Slip Navy SIZE 8,Converse Women 537080F-410 Chuck Taylor ALL Star Shoreline Slip Navy SIZE 8,FBALYB Amazon,-1,-1,0,0,0,0
,Converse Women 537080F-410 Chuck Taylor ALL Star Shoreline Slip Navy SIZE 8.5,Converse Women 537080F-410 Chuck Taylor ALL Star Shoreline Slip Navy SIZE 8.5,Default,0,0,0,0,0,40
,Converse Women 537080F-410 Chuck Taylor ALL Star Shoreline Slip Navy SIZE 8.5,Converse Women 537080F-410 Chuck Taylor ALL Star Shoreline Slip Navy SIZE 8.5,FBALYB Amazon,-2,-2,0,0,0,0
,Converse Women 537080F-410 Chuck Taylor ALL Star Shoreline Slip Navy SIZE 9,Converse Women 537080F-410 Chuck Taylor ALL Star Shoreline Slip Navy SIZE 9,Default,0,0,0,0,0,40
,Converse Women 537080F-410 Chuck Taylor ALL Star Shoreline Slip Navy SIZE 9,Converse Women 537080F-410 Chuck Taylor ALL Star Shoreline Slip Navy SIZE 9,FBALYB Amazon,-2,-2,0,0,0,0
,Converse Women 537080F-410 Chuck Taylor ALL Star Shoreline Slip Navy SIZE 9.5,Converse Women 537080F-410 Chuck Taylor ALL Star Shoreline Slip Navy SIZE 9.5,Default,0,0,0,0,0,40
,Converse Women 537080F-410 Chuck Taylor ALL Star Shoreline Slip Navy SIZE 9.5,Converse Women 537080F-410 Chuck Taylor ALL Star Shoreline Slip Navy SIZE 9.5,FBALYB Amazon,-4,-4,0,0,0,0
,Converse Women 537081F-001 Chuck Taylor ALL Star Shoreline Slip Black SIZE 10,Converse Women 537081F-001 Chuck Taylor ALL Star Shoreline Slip Black SIZE 10,Default,0,0,0,0,0,16
,Converse Women 537081F-001 Chuck Taylor ALL Star Shoreline Slip Black SIZE 10,Converse Women 537081F-001 Chuck Taylor ALL Star Shoreline Slip Black SIZE 10,FBALYB Amazon,-4,-4,0,0,0,0
,Converse Women 537081F-001 Chuck Taylor ALL Star Shoreline Slip Black SIZE 10.5,Converse Women 537081F-001 Chuck Taylor ALL Star Shoreline Slip Black SIZE 10.5,Default,0,0,0,0,0,16
,Converse Women 537081F-001 Chuck Taylor ALL Star Shoreline Slip Black SIZE 10.5,Converse Women 537081F-001 Chuck Taylor ALL Star Shoreline Slip Black SIZE 10.5,FBALYB Amazon,-1,-1,0,0,0,0
,Converse Women 537081F-001 Chuck Taylor ALL Star Shoreline Slip Black SIZE 6,Converse Women 537081F-001 Chuck Taylor ALL Star Shoreline Slip Black SIZE 6,Default,0,0,0,0,0,40
,Converse Women 537081F-001 Chuck Taylor ALL Star Shoreline Slip Black SIZE 6,Converse Women 537081F-001 Chuck Taylor ALL Star Shoreline Slip Black SIZE 6,FBALYB Amazon,-4,-4,0,0,0,0
,Converse Women 537081F-001 Chuck Taylor ALL Star Shoreline Slip Black SIZE 6.5,Converse Women 537081F-001 Chuck Taylor ALL Star Shoreline Slip Black SIZE 6.5,Default,0,0,0,0,0,40
,Converse Women 537081F-001 Chuck Taylor ALL Star Shoreline Slip Black SIZE 6.5,Converse Women 537081F-001 Chuck Taylor ALL Star Shoreline Slip Black SIZE 6.5,FBALYB Amazon,-5,-5,0,0,0,0
,Converse Women 537081F-001 Chuck Taylor ALL Star Shoreline Slip Black SIZE 7,Converse Women 537081F-001 Chuck Taylor ALL Star Shoreline Slip Black SIZE 7,Default,0,0,0,0,0,40
,Converse Women 537081F-001 Chuck Taylor ALL Star Shoreline Slip Black SIZE 7,Converse Women 537081F-001 Chuck Taylor ALL Star Shoreline Slip Black SIZE 7,FBALYB Amazon,-2,-2,0,0,0,0
,Converse Women 537081F-001 Chuck Taylor ALL Star Shoreline Slip Black SIZE 7.5,Converse Women 537081F-001 Chuck Taylor ALL Star Shoreline Slip Black SIZE 7.5,Default,0,0,0,0,0,23
,Converse Women 537081F-001 Chuck Taylor ALL Star Shoreline Slip Black SIZE 7.5,Converse Women 537081F-001 Chuck Taylor ALL Star Shoreline Slip Black SIZE 7.5,FBALYB Amazon,-7,-7,0,0,0,0
,Converse Women 537081F-001 Chuck Taylor ALL Star Shoreline Slip Black SIZE 8,Converse Women 537081F-001 Chuck Taylor ALL Star Shoreline Slip Black SIZE 8,Default,0,0,0,0,0,40
,Converse Women 537081F-001 Chuck Taylor ALL Star Shoreline Slip Black SIZE 8.5,Converse Women 537081F-001 Chuck Taylor ALL Star Shoreline Slip Black SIZE 8.5,Default,0,0,0,0,0,40
,Converse Women 537081F-001 Chuck Taylor ALL Star Shoreline Slip Black SIZE 8.5,Converse Women 537081F-001 Chuck Taylor ALL Star Shoreline Slip Black SIZE 8.5,FBALYB Amazon,-2,-2,0,0,0,0
,Converse Women 537081F-001 Chuck Taylor ALL Star Shoreline Slip Black SIZE 9,Converse Women 537081F-001 Chuck Taylor ALL Star Shoreline Slip Black SIZE 9,Default,0,0,0,0,0,40
,Converse Women 537081F-001 Chuck Taylor ALL Star Shoreline Slip Black SIZE 9,Converse Women 537081F-001 Chuck Taylor ALL Star Shoreline Slip Black SIZE 9,FBALYB Amazon,-2,-2,0,0,0,0
,Converse Women 537081F-001 Chuck Taylor ALL Star Shoreline Slip Black SIZE 9.5,Converse Women 537081F-001 Chuck Taylor ALL Star Shoreline Slip Black SIZE 9.5,Default,0,0,0,0,0,40
,Converse Women 537081F-001 Chuck Taylor ALL Star Shoreline Slip Black SIZE 9.5,Converse Women 537081F-001 Chuck Taylor ALL Star Shoreline Slip Black SIZE 9.5,FBALYB Amazon,-3,-3,0,0,0,0
,Converse Women 537084F-100 Chuck Taylor ALL Star Shoreline Slip White SIZE 10,Converse Women 537084F-100 Chuck Taylor ALL Star Shoreline Slip White SIZE 10,Default,0,0,0,0,0,16
,Converse Women 537084F-100 Chuck Taylor ALL Star Shoreline Slip White SIZE 10,Converse Women 537084F-100 Chuck Taylor ALL Star Shoreline Slip White SIZE 10,FBALYB Amazon,-3,-3,0,0,0,0
,Converse Women 537084F-100 Chuck Taylor ALL Star Shoreline Slip White SIZE 10.5,Converse Women 537084F-100 Chuck Taylor ALL Star Shoreline Slip White SIZE 10.5,Default,0,0,0,0,0,16
,Converse Women 537084F-100 Chuck Taylor ALL Star Shoreline Slip White SIZE 10.5,Converse Women 537084F-100 Chuck Taylor ALL Star Shoreline Slip White SIZE 10.5,FBALYB Amazon,-1,-1,0,0,0,0
,Converse Women 537084F-100 Chuck Taylor ALL Star Shoreline Slip White SIZE 11,Converse Women 537084F-100 Chuck Taylor ALL Star Shoreline Slip White SIZE 11,Default,0,0,0,0,0,16
,Converse Women 537084F-100 Chuck Taylor ALL Star Shoreline Slip White SIZE 6,Converse Women 537084F-100 Chuck Taylor ALL Star Shoreline Slip White SIZE 6,FBALYB Amazon,-4,-4,0,0,0,0
,Converse Women 537084F-100 Chuck Taylor ALL Star Shoreline Slip White SIZE 6.5,Converse Women 537084F-100 Chuck Taylor ALL Star Shoreline Slip White SIZE 6.5,Default,0,0,0,0,0,16
,Converse Women 537084F-100 Chuck Taylor ALL Star Shoreline Slip White SIZE 6.5,Converse Women 537084F-100 Chuck Taylor ALL Star Shoreline Slip White SIZE 6.5,FBALYB Amazon,-4,-4,0,0,0,0
,Converse Women 537084F-100 Chuck Taylor ALL Star Shoreline Slip White SIZE 7,Converse Women 537084F-100 Chuck Taylor ALL Star Shoreline Slip White SIZE 7,Default,0,0,0,0,0,16
,Converse Women 537084F-100 Chuck Taylor ALL Star Shoreline Slip White SIZE 7.5,Converse Women 537084F-100 Chuck Taylor ALL Star Shoreline Slip White SIZE 7.5,Default,0,0,0,0,0,16
,Converse Women 537084F-100 Chuck Taylor ALL Star Shoreline Slip White SIZE 7.5,Converse Women 537084F-100 Chuck Taylor ALL Star Shoreline Slip White SIZE 7.5,FBALYB Amazon,-5,-5,0,0,0,0
,Converse Women 537084F-100 Chuck Taylor ALL Star Shoreline Slip White SIZE 8,Converse Women 537084F-100 Chuck Taylor ALL Star Shoreline Slip White SIZE 8,Default,0,0,0,0,0,16
,Converse Women 537084F-100 Chuck Taylor ALL Star Shoreline Slip White SIZE 8,Converse Women 537084F-100 Chuck Taylor ALL Star Shoreline Slip White SIZE 8,FBALYB Amazon,-2,-2,0,0,0,0
,Converse Women 537084F-100 Chuck Taylor ALL Star Shoreline Slip White SIZE 8.5,Converse Women 537084F-100 Chuck Taylor ALL Star Shoreline Slip White SIZE 8.5,Default,0,0,0,0,0,16
,Converse Women 537084F-100 Chuck Taylor ALL Star Shoreline Slip White SIZE 8.5,Converse Women 537084F-100 Chuck Taylor ALL Star Shoreline Slip White SIZE 8.5,FBALYB Amazon,-3,-3,0,0,0,0
,Converse Women 537084F-100 Chuck Taylor ALL Star Shoreline Slip White SIZE 9,Converse Women 537084F-100 Chuck Taylor ALL Star Shoreline Slip White SIZE 9,Default,0,0,0,0,0,16
,Converse Women 537084F-100 Chuck Taylor ALL Star Shoreline Slip White SIZE 9,Converse Women 537084F-100 Chuck Taylor ALL Star Shoreline Slip White SIZE 9,FBALYB Amazon,-2,-2,0,0,0,0
,Converse Women 537084F-100 Chuck Taylor ALL Star Shoreline Slip White SIZE 9.5,Converse Women 537084F-100 Chuck Taylor ALL Star Shoreline Slip White SIZE 9.5,Default,0,0,0,0,0,16
,Converse Women 537084F-100 Chuck Taylor ALL Star Shoreline Slip White SIZE 9.5,Converse Women 537084F-100 Chuck Taylor ALL Star Shoreline Slip White SIZE 9.5,FBALYB Amazon,-3,-3,0,0,0,0
,Converse Women 560250C-001 Chuck Taylor ALL Star Lift OX Black White White SIZE 10,Converse Women 560250C-001 Chuck Taylor ALL Star Lift OX Black White White SIZE 10,Default,0,0,0,0,0,20
,Converse Women 560250C-001 Chuck Taylor ALL Star Lift OX Black White White SIZE 10,Converse Women 560250C-001 Chuck Taylor ALL Star Lift OX Black White White SIZE 10,FBALYB Amazon,-1,-1,0,0,0,0
,Converse Women 560250C-001 Chuck Taylor ALL Star Lift OX Black White White SIZE 11,Converse Women 560250C-001 Chuck Taylor ALL Star Lift OX Black White White SIZE 11,Default,0,0,0,0,0,10
,Converse Women 560250C-001 Chuck Taylor ALL Star Lift OX Black White White SIZE 5.5,Converse Women 560250C-001 Chuck Taylor ALL Star Lift OX Black White White SIZE 5.5,Default,0,0,0,0,0,6
,Converse Women 560250C-001 Chuck Taylor ALL Star Lift OX Black White White SIZE 5.5,Converse Women 560250C-001 Chuck Taylor ALL Star Lift OX Black White White SIZE 5.5,FBALYB Amazon,-2,-2,0,0,0,0
,Converse Women 560250C-001 Chuck Taylor ALL Star Lift OX Black White White SIZE 6,Converse Women 560250C-001 Chuck Taylor ALL Star Lift OX Black White White SIZE 6,Default,0,0,0,0,0,6
,Converse Women 560250C-001 Chuck Taylor ALL Star Lift OX Black White White SIZE 6,Converse Women 560250C-001 Chuck Taylor ALL Star Lift OX Black White White SIZE 6,FBALYB Amazon,-2,-2,0,0,0,0
,Converse Women 560250C-001 Chuck Taylor ALL Star Lift OX Black White White SIZE 6.5,Converse Women 560250C-001 Chuck Taylor ALL Star Lift OX Black White White SIZE 6.5,Default,0,0,0,0,0,20
,Converse Women 560250C-001 Chuck Taylor ALL Star Lift OX Black White White SIZE 6.5,Converse Women 560250C-001 Chuck Taylor ALL Star Lift OX Black White White SIZE 6.5,FBALYB Amazon,-4,-4,0,0,0,0
,Converse Women 560250C-001 Chuck Taylor ALL Star Lift OX Black White White SIZE 7,Converse Women 560250C-001 Chuck Taylor ALL Star Lift OX Black White White SIZE 7,Default,0,0,0,0,0,40
,Converse Women 560250C-001 Chuck Taylor ALL Star Lift OX Black White White SIZE 7,Converse Women 560250C-001 Chuck Taylor ALL Star Lift OX Black White White SIZE 7,FBALYB Amazon,-7,-7,0,0,0,0
,Converse Women 560250C-001 Chuck Taylor ALL Star Lift OX Black White White SIZE 7.5,Converse Women 560250C-001 Chuck Taylor ALL Star Lift OX Black White White SIZE 7.5,Default,0,0,0,0,0,40
,Converse Women 560250C-001 Chuck Taylor ALL Star Lift OX Black White White SIZE 7.5,Converse Women 560250C-001 Chuck Taylor ALL Star Lift OX Black White White SIZE 7.5,FBALYB Amazon,-3,-3,0,0,0,0
,Converse Women 560250C-001 Chuck Taylor ALL Star Lift OX Black White White SIZE 8,Converse Women 560250C-001 Chuck Taylor ALL Star Lift OX Black White White SIZE 8,Default,0,0,0,0,0,40
,Converse Women 560250C-001 Chuck Taylor ALL Star Lift OX Black White White SIZE 8,Converse Women 560250C-001 Chuck Taylor ALL Star Lift OX Black White White SIZE 8,FBALYB Amazon,-4,-4,0,0,0,0
,Converse Women 560250C-001 Chuck Taylor ALL Star Lift OX Black White White SIZE 8.5,Converse Women 560250C-001 Chuck Taylor ALL Star Lift OX Black White White SIZE 8.5,Default,0,0,0,0,0,10
,Converse Women 560250C-001 Chuck Taylor ALL Star Lift OX Black White White SIZE 9,Converse Women 560250C-001 Chuck Taylor ALL Star Lift OX Black White White SIZE 9,Default,0,0,0,0,0,10
,Converse Women 560250C-001 Chuck Taylor ALL Star Lift OX Black White White SIZE 9,Converse Women 560250C-001 Chuck Taylor ALL Star Lift OX Black White White SIZE 9,FBALYB Amazon,-1,-1,0,0,0,0
,Converse Women 560250C-001 Chuck Taylor ALL Star Lift OX Black White White SIZE 9.5,Converse Women 560250C-001 Chuck Taylor ALL Star Lift OX Black White White SIZE 9.5,Default,0,0,0,0,0,10
,Converse Women 560250C-001 Chuck Taylor ALL Star Lift OX Black White White SIZE 9.5,Converse Women 560250C-001 Chuck Taylor ALL Star Lift OX Black White White SIZE 9.5,FBALYB Amazon,-1,-1,0,0,0,0
,Cookina Oven Guard,Cookina Oven Guard,Default Ridgefield,50,-70,120,0,0,0
,Cookina Oven Guard,Cookina Oven Guard,FBALYB Amazon,197,197,0,0,0,0
,Copper Chef 5-Piece Deep 9.5-Inch Square,Copper Chef 5-Piece Deep 9.5-Inch Square Pan Set,Default,0,0,0,0,0,3
,Copper Chef 5-Piece Deep 9.5-Inch Square,Copper Chef 5-Piece Deep 9.5-Inch Square Pan Set,FBAAP Amazon,1,1,0,0,0,0
,Copper Chef 5-Piece Deep 9.5-Inch Square,Copper Chef 5-Piece Deep 9.5-Inch Square Pan Set,FBALYB Amazon,-4,-4,0,0,0,0
,Copper Chef 7 Piece Cookware Set,7-Piece Heavy Duty Oven Safe Cookware Set Tempered Glass Lid,FBALYB Amazon,21,21,0,3,0,0
,Coppertone Sport 222ml Single Can,Coppertone Sport 222ml Single Can,Default Ridgefield,14,14,0,0,0,0
,Coppertone Spray Sunscreen 4ct,Coppertone Spray Sunscreen 4ct,FBALYB Amazon,75,60,15,67,15,0
,"Coralife Slimline Fixture Super Uv 18""","Coralife Slimline Fixture Super Uv 18""",Default,0,0,0,0,0,17
,"Coralife Slimline Fixture Super Uv 18""","Coralife Slimline Fixture Super Uv 18""",FBALYB Amazon,-2,-2,0,0,0,0
,Corega Cream Extra Strong 3pk,Corega Cream Extra Strong 3pk,FBALYB Amazon,160,155,5,0,5,0
,Corega Fixing Cream Extra Strong,Corega Fixing Cream Extra Strong,Default CT,753,753,0,0,0,0
,Corega Fixing Cream Extra Strong,Corega Fixing Cream Extra Strong,Default Ridgefield,6,6,0,0,0,0
,Corner Litter Pan for Critters,Ware Manufacturing Corner Litter Pan for Critters,FBALYB Amazon,-1,-1,0,0,0,0
,Corrugated Reversible Scratcher Pads,"Ware Corrugated Reversible Regular Scratcher Pads, Natural",Default Ridgefield,50,50,0,0,0,0
,Corsair K65 Gaming Keyboard,Corsair K65 Gaming Keyboard CH-9110010-NA,FBALYB Amazon,-1,-1,0,1,0,0
,Cosamin DS 230 Capsules,Cosamin DS Double Strength Joint Care (230 Capsules,FBALYB Amazon,1,1,0,0,0,0
,Cosamin DS 230 Capsules 2pk,Cosamin DS 230 Capsules 2pk,FBALYB Amazon,-1,-1,0,0,0,0
,Cosequin Joint Health for Dogs 2pk,Cosequin Joint Health for Dogs 2pk,FBALYB Amazon,0,0,0,1,0,0
,Cosmic Pet Shuttle Cardboard Carrier,Cosmic Pet Shuttle Cardboard Carrier,FBALYB Amazon,-1,-1,0,0,0,0
,Covered Espresso Beans,Trader Joe's Covered Espresso Beans,Default,0,0,0,0,0,2
,Covered Espresso Beans,Trader Joe's Covered Espresso Beans,FBALYB Amazon,1,1,0,0,0,0
,"CoverGirl Eye Pencil, Espresso 3pk","CoverGirl Eye Pencil, Espresso 3pk",FBALYB Amazon,3,3,0,0,0,0
,Craisins Original Dried Cranberries 48 Oz,Craisins Original Dried Cranberries 48 Oz,FBALYB Amazon,3,3,0,0,0,0
,Crayola Broad Point 8/set,Crayola Broad Point 8/set,FBALYB Amazon,-19,-20,1,0,1,0
,Crayola Chalk Colored 144Ct Drawing,Crayola Chalk Colored 144Ct Drawing,Default Ridgefield,3,3,0,0,0,0
,Crayola Chalk Colored 144Ct Drawing,Crayola Chalk Colored 144Ct Drawing,FBALYB Amazon,334,334,0,0,0,0
,Crayola Chalk Colored 144Ct Drawing,Crayola Chalk Colored 144Ct Drawing,FBALYB Canada,21,20,1,0,1,0
,Crayola Chalk SFX Glitter 5CT,Crayola Chalk SFX Glitter 5CT,Default Ridgefield,1,1,0,0,0,0
,Crayola Chalk SFX Glitter 5CT,Crayola Chalk SFX Glitter 5CT,FBALYB Amazon,35,6,29,1,29,0
,Crayola Chalk SFX Neon 5 CT,Crayola Chalk SFX Neon 5 CT,Default Ridgefield,56,56,0,0,0,0
,Crayola Chalk SFX Neon 5 CT,Crayola Chalk SFX Neon 5 CT,FBALYB Amazon,34,24,10,0,10,0
,Crayola Chalk SFX Neon 5 CT 4 pack,Crayola Chalk SFX Neon 5 CT 4 pack,FBALYB Amazon,47,47,0,0,0,0
,Crayola Classic Fine Line 10ct 24pk,Crayola Classic Fine Line 10ct 24pk,FBALYB Amazon,22,22,0,0,0,0
,Crayola Colored Pencils 50ct Long,Crayola Colored Pencils 50ct Long,FBALYB Amazon,1,1,0,12,0,0
,Crayola Colored Pencils Long 12Ct,Crayola Colored Pencils Long 12Ct,Default Ridgefield,124757,124757,0,0,0,0
,Crayola Colored Pencils Long 12Ct,Crayola Colored Pencils Long 12Ct,FBALYB Amazon,2744,2719,25,0,25,0
,Crayola Colored Pencils Long 12Ct,Crayola Colored Pencils Long 12Ct,FBALYB Canada,-1,-1,0,209,0,0
,Crayola Colored Pencils Long 12Ct 12pk,Crayola Colored Pencils Long 12Ct 12pk,FBALYB Amazon,604,591,13,44,13,0
,Crayola Colored Pencils Long 12Ct 12pk,Crayola Colored Pencils Long 12Ct 12pk,FBALYB Canada,0,0,0,50,0,0
,Crayola Colored Pencils Long 12Ct 24pk,Crayola Colored Pencils Long 12Ct 24pk,FBALYB Amazon,1159,1095,64,243,64,0
,Crayola Colored Pencils Long 12Ct 2pk,Crayola Colored Pencils Long 12Ct 2pk,FBALYB Amazon,2944,2813,131,125,131,0
,Crayola Colored Pencils Long 12Ct 2pk,Crayola Colored Pencils Long 12Ct 2pk,FBALYB Canada,15,15,0,0,0,0
,Crayola Colored Pencils Long 12Ct 3pk,Crayola Colored Pencils Long 12Ct 3pk,FBALYB Amazon,1957,1957,0,683,0,0
,Crayola Colored Pencils Long 12Ct 4pk,Crayola Colored Pencils Long 12Ct 4pk,FBALYB Amazon,-11,-11,0,0,0,0
,Crayola Colored Pencils Long 12Ct 6pk,Crayola Colored Pencils Long 12Ct 6pk,FBALYB Amazon,374,374,0,0,0,0
,Crayola Crayons 16Ct,Crayola Crayons 16Ct,Default Ridgefield,8402,8402,0,0,0,0
,Crayola Crayons 16Ct,Crayola Crayons 16Ct,FBALYB Amazon,0,0,0,200,0,0
,Crayola Crayons 16Ct 24pk,Crayola Crayons 16Ct 24pk,FBALYB Amazon,127,127,0,0,0,0
,Crayola Crayons 16Ct 2PK,Crayola Crayons 16Ct 2PK,FBALYB Amazon,198,198,0,0,0,0
,Crayola Crayons 16Ct 6pk,Crayola Crayons 16Ct 6pk,FBALYB Amazon,278,272,6,0,6,0
,Crayola Crayons 16Ct PACK OF 12,Crayola Crayons 16Ct PACK OF 12,FBALYB Amazon,49,48,1,0,1,0
,Crayola Crayons 24 ct,Crayola Crayons 24 ct,FBALYB Amazon,-7,-7,0,1,0,0
,Crayola Crayons 24 ct 12PK,Crayola Crayons 24 ct 12PK,FBALYB Amazon,-22,-22,0,0,0,0
,Crayola Crayons 24 ct 24PK,Crayola Crayons 24 ct 24PK,FBALYB Amazon,10,4,6,2,6,0
,Crayola Crayons 24 ct 2pk,Crayola Crayons 24 ct 2pk,FBALYB Amazon,-8,-8,0,0,0,0
,Crayola Crayons 24 ct 48pk,Crayola Crayons 24 ct 48pk,FBALYB Amazon,26,23,3,0,3,0
,Crayola Crayons 24 ct 4PK,Crayola Crayons 24 ct 4PK,FBALYB Amazon,-95,-95,0,0,0,0
,Crayola Crayons 24 ct 6PK,Crayola Crayons 24 ct 6PK,FBALYB Amazon,-38,-38,0,0,0,0
,Crayola Crayons 8Ct,Crayola Crayons 8Ct,Default Ridgefield,50,50,0,0,0,0
,Crayola Crayons 8Ct 12pk,Crayola Crayons 8Ct 12pk,Default Ridgefield,1,0,1,0,0,0
,Crayola Crayons 8Ct 12pk,Crayola Crayons 8Ct 12pk,FBALYB Amazon,756,743,13,0,13,0
,Crayola Crayons 8Ct 2PK,Crayola Crayons 8Ct 2PK,FBALYB Amazon,2335,2330,5,0,5,0
,Crayola Crayons 8Ct 3pk,Crayola Crayons 8Ct 3pk,FBALYB Amazon,2095,2095,0,0,0,0
,Crayola Crayons 8Ct 48pk,Crayola Crayons 8Ct 48pk,FBALYB Amazon,-6,-6,0,360,0,0
,Crayola Erasable Colored Pencils 24ct,Crayola Erasable Colored Pencils 24ct,FBALYB Amazon,-1,-1,0,0,0,0
,Crayola fabulous art kit,Crayola Fabulous Art Kit,FBALYB Amazon,-2,-2,0,0,0,0
,Crayola Fine Line Washable 12/set,Crayola Fine Line Washable 12/set,FBALYB Amazon,2,2,0,0,0,0
,Crayola Glitter Markers 6 Ct,Crayola Glitter Markers 6 Ct,Default Ridgefield,5259,5259,0,0,0,0
,Crayola Glitter Markers 6 Ct 2pk,Crayola Glitter Markers 6 Ct 2pk,FBALYB Amazon,60,60,0,0,0,0
,Crayola Jumbo Crayons 8 Ct.,Crayola Jumbo Crayons 8 Ct.,Default Ridgefield,100,100,0,0,0,0
,Crayola Jumbo Crayons 8 Ct. 2 Pack,Crayola Jumbo Crayons 8 Ct. 2 Pack,FBALYB Amazon,11,-3,14,0,14,0
,Crayola Jumbo Crayons 8 Ct. 4PK,Crayola Jumbo Crayons 8 Ct. 4PK,FBALYB Amazon,-2,-2,0,0,0,0
,Crayola Jumbo Crayons 8 Ct. 6PK,Crayola Jumbo Crayons 8 Ct. 6PK,FBALYB Amazon,5,4,1,0,1,0
,Crayola Marker Broad Line 10Ct,Crayola Marker Broad Line 10Ct,Default Ridgefield,48,48,0,0,0,0
,Crayola Marker Broad Line 10Ct 24PK,Crayola Marker Broad Line 10Ct 24PK,Default Ridgefield,63,63,0,0,0,0
,Crayola Marker Broad Line 10Ct 24PK,Crayola Marker Broad Line 10Ct 24PK,FBALYB Amazon,-1,-1,0,0,0,0
,Crayola Marker Broad Line 10Ct 2pk,Crayola Marker Broad Line 10Ct 2pk,FBALYB Amazon,10,5,5,9,5,0
,Crayola Marker Broad Line 10Ct 3 Pack,Crayola Marker Broad Line 10Ct 3 Pack,FBALYB Amazon,1,0,1,0,1,0
,Crayola Markers Washable Classic 8ct,Crayola Markers Washable Classic 8ct,FBALYB Amazon,2,1,1,0,1,0
,Crayola Metallic Markers 8 Ct,Crayola Metallic Markers 8 Ct,Default Ridgefield,2862,2862,0,0,0,0
,Crayola Metallic Markers 8 Ct,Crayola Metallic Markers 8 Ct,FBALYB Amazon,85,82,3,0,3,0
,Crayola Metallic Markers 8 Ct,Crayola Metallic Markers 8 Ct,FBALYB Canada,81,81,0,0,0,0
,Crayola Metallic Markers 8 Ct 2pk,Crayola Metallic Markers 8 Ct 2pk,Default Ridgefield,89,89,0,0,0,0
,Crayola Metallic Markers 8 Ct 2pk,Crayola Metallic Markers 8 Ct 2pk,FBALYB Amazon,96,96,0,1,0,0
,Crayola Metallic Markers 8 Ct + Crayola Glitter Markers 6 Ct Set,Crayola Metallic Markers 8 Ct + Crayola Glitter Markers 6 Ct Set,FBALYB Amazon,147,129,18,51,18,0
,Crayola Metallic Markers 8 Ct + Crayola Glitter Markers 6 Ct Set,Crayola Metallic Markers 8 Ct + Crayola Glitter Markers 6 Ct Set,FBALYB Canada,134,134,0,0,0,0
,Crayola Paint Black Washable 16Oz EU2,Crayola Paint Black Washable 16Oz EU2,Default Ridgefield,2640,2640,0,0,0,0
,Crayola Paint Turqoise Blue Washable 16Oz EU2,Crayola Paint Turqoise Blue Washable 16Oz EU2,Default Ridgefield,2640,2640,0,0,0,0
,Crayola Paint White Washable 16Oz EU2,Crayola Paint White Washable 16Oz EU2,Default Ridgefield,2640,2640,0,0,0,0
,Crayola Pint Wash Blue 16 oz,Crayola Pint Wash Blue 16 oz,Default Ridgefield,2640,2640,0,0,0,0
,Crayola Pint Wash Green 16 oz,Crayola Pint Wash Green 16 oz,Default Ridgefield,2640,2640,0,0,0,0
,Crayola Pint Wash Orange 16 oz,Crayola Pint Wash Orange 16 oz,Default Ridgefield,2640,2640,0,0,0,0
,Crayola Pint Wash Peach 16 oz,Crayola Pint Wash Peach 16 oz,Default Ridgefield,2640,2640,0,0,0,0
,Crayola Twistable Colored Pencils 12Ct,Crayola Twistable Colored Pencils 12Ct,Default Ridgefield,818,818,0,0,0,0
,Crayola Twistable Colored Pencils 12Ct,Crayola Twistable Colored Pencils 12Ct,FBALYB Amazon,229,226,3,0,3,0
,Crayola Twistable Colored Pencils 12Ct 3pk,Crayola Twistable Colored Pencils 12Ct 3pk,FBALYB Amazon,100,100,0,0,0,0
,Crayola Twistable Colored Pencils 12Ct 6pk,Crayola Twistable Colored Pencils 12Ct 6pk,FBALYB Amazon,-1,-1,0,0,0,0
,Crayola Washable Paint Maker Mix & Shake Color Set 73ml,Crayola Washable Paint Maker Mix & Shake Color Set 73ml,Default Ridgefield,11,11,0,0,0,0
,Crayola Watercolor Paints with Brush,Crayola Watercolor Paints with Brush,Default Ridgefield,10550,10549,1,0,0,0
,Crayola Watercolor Paints with Brush,Crayola Watercolor Paints with Brush,FBALYB Amazon,200,200,0,0,0,0
,Crayola Watercolor Paints with Brush  20 pack,Crayola Watercolor Paints with Brush  20 pack ,FBALYB Amazon,24,24,0,0,0,0
,Crayola Watercolor Paints with Brush  24 pack,Crayola Watercolor Paints with Brush  24 pack ,FBALYB Amazon,100,97,3,0,3,0
,Crayola Watercolor Paints with Brush  2 pack,Crayola Watercolor Paints with Brush  2 pack ,FBALYB Amazon,149,149,0,0,0,0
,Crayola Watercolor Paints with Brush  3 pack,Crayola Watercolor Paints with Brush  3 pack ,FBALYB Amazon,0,0,0,50,0,0
,Crayola Watercolor Paints with Brush 4pk,Crayola Watercolor Paints with Brush 4pk,FBALYB Amazon,691,687,4,0,4,0
,Crayola Watercolor Paints with Brush  6 pack,Crayola Watercolor Paints with Brush  6 pack ,FBALYB Amazon,440,440,0,10,0,0
,Creative System Rack Organizer Large,Creative System Rack Organizer Large,FBALYB Amazon,-67,-67,0,59,0,0
,Creative Ware Ceramic Set,Creative Ware Ceramic Serving Set,FBALYB Amazon,1,1,0,0,0,0
,Crest 3D Glamorous White 32oz 2pk,Crest 3D Glamorous White 32oz 2pk,FBALYB Amazon,-2,-10,8,4,8,0
,Crest Complete Whitening Plus Scope Mint Toothpaste,Crest Complete Whitening Plus Scope Mint Toothpaste,Default,0,-1008,1008,0,0,0
,Crest Complete Whitening Plus Scope Mint Toothpaste 3pk,Crest Complete Whitening Plus Scope Mint Toothpaste 3pk,FBALYB Amazon,-2,-2,0,11,0,0
,CREST PRO-HEALTH 1L,CREST PRO-HEALTH 1L ,FBALYB Amazon,105,105,0,7,0,0
,CREST PRO-HEALTH 1L 2 Pack,CREST PRO-HEALTH 1L 2 Pack,FBALYB Amazon,-123,-123,0,5,0,0
,Crest ProHealth Advantage Rinse 3pk,Crest ProHealth Advantage Rinse 3pk,FBALYB Amazon,38,38,0,2,0,0
,Crest Pro health Adv Enamel Care 1L,Crest Pro health Advanced Enamel Care 1L,Default Ridgefield,7927,7927,0,0,0,0
,Crest Pro health Adv Enamel Care 1L,Crest Pro health Advanced Enamel Care 1L,FBALYB Amazon,81,81,0,19,0,0
,Crest Pro health Adv Enamel Care 1L 2pack,Crest Pro health Adv Enamel Care 1L 2pack,FBALYB Amazon,69,67,2,0,2,0
,Crest Pro health Adv Enamel Care 1L 3 pack,Crest Pro health Adv Enamel Care 1L 3 pack,FBALYB Amazon,226,222,4,14,4,0
,Crest Pro Health Deep Clean 3ct,Crest Pro Health Deep Clean 3ct,FBALYB Amazon,114,114,0,0,0,0
,Crest Pro Health Deep Clean 4ct,Crest Pro Health Deep Clean 4ct,FBALYB Amazon,-81,-81,0,0,0,0
,Crest Pro Health Mouthwash Mint 1ct,Crest Pro Health Mouthwash Mint 1ct,Default,0,-324,324,0,0,0
,Crest Pro Health Mouthwash Mint 2ct,Crest Pro Health Mouthwash Mint 2ct,FBALYB Amazon,-17,-17,0,8,0,0
,Crest Toothpaste with Scope,Crest Toothpaste with Scope 5ct,Default,0,0,0,0,0,22
,Crest Whitening Cool Mint Paste 4pk,Crest Whitening Cool Mint Paste 4pk,FBALYB Amazon,-1,-1,0,1,0,0
,Crispy Coconut Rolls,Crispy Coconut Rolls,Default Ridgefield,1,1,0,0,0,0
,Crispy Coconut Rolls,Crispy Coconut Rolls,FBALYB Amazon,24,23,1,0,1,0
,Crispy Coconut Rolls,Crispy Coconut Rolls,FBALYB Canada,0,0,0,39,0,0
,Crittertrail Habitat One Level Pink,Crittertrail Habitat One Level Pink,FBALYB Amazon,-1,-1,0,0,0,0
,CRO-10126-100-M12 Crocs Baya Clog White US Size M12 W14,CRO-10126-100-M12 Crocs Baya Clog White US Size M12 W14,FBALYB Amazon,-3,-3,0,0,0,0
,CRO-10126-100-M5W7 Crocs Baya Clog White US Size M5 W7,CRO-10126-100-M5W7 Crocs Baya Clog White US Size M5 W7,Default Ridgefield,1,1,0,0,0,203
,CRO-10126-100-M5W7 Crocs Baya Clog White US Size M5 W7,CRO-10126-100-M5W7 Crocs Baya Clog White US Size M5 W7,FBALYB Amazon,-1,-1,0,0,0,0
,CRO-11999-001-M10W12 Crocs Baya Flip Black US Size M10 W12,CRO-11999-001-M10W12 Crocs Baya Flip Black US Size M10 W12,Default Ridgefield,0,0,0,0,0,18
,CRO-11999-001-M10W12 Crocs Baya Flip Black US Size M10 W12,CRO-11999-001-M10W12 Crocs Baya Flip Black US Size M10 W12,FBALYB Amazon,-1,-1,0,0,0,0
,CRO-11999-001-M11 Crocs Baya Flip Black US Size M11 W13,CRO-11999-001-M11 Crocs Baya Flip Black US Size M11 W13,FBALYB Amazon,1,1,0,0,0,0
,CRO-11999-001-M6W8 Crocs Baya Flip Black US Size M6 W8,CRO-11999-001-M6W8 Crocs Baya Flip Black US Size M6 W8,Default Ridgefield,0,0,0,0,0,29
,CRO-11999-001-M6W8 Crocs Baya Flip Black US Size M6 W8,CRO-11999-001-M6W8 Crocs Baya Flip Black US Size M6 W8,FBALYB Amazon,-4,-4,0,0,0,0
,CRO-11999-001-M7W9 Crocs Baya Flip Black US Size M7 W9,CRO-11999-001-M7W9 Crocs Baya Flip Black US Size M7 W9,Default Ridgefield,0,0,0,0,0,29
,CRO-11999-001-M7W9 Crocs Baya Flip Black US Size M7 W9,CRO-11999-001-M7W9 Crocs Baya Flip Black US Size M7 W9,FBALYB Amazon,4,4,0,0,0,0
,CRO-11999-001-M8W10 Crocs Baya Flip Black US Size M8 W10,CRO-11999-001-M8W10 Crocs Baya Flip Black US Size M8 W10,Default Ridgefield,0,0,0,0,0,29
,CRO-11999-001-M8W10 Crocs Baya Flip Black US Size M8 W10,CRO-11999-001-M8W10 Crocs Baya Flip Black US Size M8 W10,FBALYB Amazon,-6,-6,0,0,0,0
,CRO-11999-001-M9W11 Crocs Baya Flip Black US Size M9 W11,CRO-11999-001-M9W11 Crocs Baya Flip Black US Size M9 W11,Default Ridgefield,0,0,0,0,0,29
,CRO-11999-001-M9W11 Crocs Baya Flip Black US Size M9 W11,CRO-11999-001-M9W11 Crocs Baya Flip Black US Size M9 W11,FBALYB Amazon,8,8,0,0,0,0
,CRO-11999-410-M10W12 Crocs Baya Flip Navy US Size M10 W12,CRO-11999-410-M10W12 Crocs Baya Flip Navy US Size M10 W12,FBALYB Amazon,2,2,0,0,0,0
,CRO-11999-410-M6W8 Crocs Baya Flip Navy US Size M6 W8,CRO-11999-410-M6W8 Crocs Baya Flip Navy US Size M6 W8,FBALYB Amazon,-2,-2,0,0,0,0
,CRO-11999-410-M7W9 Crocs Baya Flip Navy US Size M7 W9,CRO-11999-410-M7W9 Crocs Baya Flip Navy US Size M7 W9,FBALYB Amazon,2,2,0,0,0,0
,CRO-11999-410-M8W10 Crocs Baya Flip Navy US Size M8 W10,CRO-11999-410-M8W10 Crocs Baya Flip Navy US Size M8 W10,FBALYB Amazon,-1,-1,0,0,0,0
,CRO-11999-410-M9W11 Crocs Baya Flip Navy US Size M9 W11,CRO-11999-410-M9W11 Crocs Baya Flip Navy US Size M9 W11,FBALYB Amazon,3,3,0,0,0,0
,CRO-205392-066-M10W12 Crocs Bayaband Slide Black/White US Size M10 W12,CRO-205392-066-M10W12 Crocs Bayaband Slide Black/White US Size M10 W12,Default Ridgefield,10,10,0,0,0,22
,CRO-205392-066-M11 Crocs Bayaband Slide Black/White US Size M11 W13,CRO-205392-066-M11 Crocs Bayaband Slide Black/White US Size M11 W13,Default Ridgefield,8,8,0,0,0,12
,CRO-205392-066-M5W7 Crocs Bayaband Slide Black/White US Size M5 W7,CRO-205392-066-M5W7 Crocs Bayaband Slide Black/White US Size M5 W7,Default Ridgefield,10,10,0,0,0,23
,CRO-205392-066-M6W8 Crocs Bayaband Slide Black/White US Size M6 W8,CRO-205392-066-M6W8 Crocs Bayaband Slide Black/White US Size M6 W8,Default Ridgefield,0,0,0,0,0,22
,CRO-205392-066-M6W8 Crocs Bayaband Slide Black/White US Size M6 W8,CRO-205392-066-M6W8 Crocs Bayaband Slide Black/White US Size M6 W8,FBALYB Amazon,0,0,0,10,0,0
,CRO-205392-066-M7W9 Crocs Bayaband Slide Black/White US Size M7 W9,CRO-205392-066-M7W9 Crocs Bayaband Slide Black/White US Size M7 W9,Default Ridgefield,10,10,0,0,0,22
,CRO-205392-066-M8W10 Crocs Bayaband Slide Black/White US Size M8 W10,CRO-205392-066-M8W10 Crocs Bayaband Slide Black/White US Size M8 W10,Default Ridgefield,10,10,0,0,0,22
,CRO-205392-066-M9W11 Crocs Bayaband Slide Black/White US Size M9 W11,CRO-205392-066-M9W11 Crocs Bayaband Slide Black/White US Size M9 W11,Default Ridgefield,10,10,0,0,0,44
,CRO-205392-4CC-M10W12 Crocs Bayaband Slide Navy/Pepper US Size M10 W12,CRO-205392-4CC-M10W12 Crocs Bayaband Slide Navy/Pepper US Size M10 W12,Default Ridgefield,10,10,0,0,0,12
,CRO-205392-4CC-M11 Crocs Bayaband Slide Navy/Pepper US Size M11 W13,CRO-205392-4CC-M11 Crocs Bayaband Slide Navy/Pepper US Size M11 W13,FBALYB Amazon,0,0,0,10,0,0
,CRO-205392-4CC-M5W7 Crocs Bayaband Slide Navy/Pepper US Size M5 W7,CRO-205392-4CC-M5W7 Crocs Bayaband Slide Navy/Pepper US Size M5 W7,Default Ridgefield,0,0,0,0,0,11
,CRO-205392-4CC-M5W7 Crocs Bayaband Slide Navy/Pepper US Size M5 W7,CRO-205392-4CC-M5W7 Crocs Bayaband Slide Navy/Pepper US Size M5 W7,FBALYB Amazon,0,0,0,10,0,0
,CRO-205392-4CC-M6W8 Crocs Bayaband Slide Navy/Pepper US Size M6 W8,CRO-205392-4CC-M6W8 Crocs Bayaband Slide Navy/Pepper US Size M6 W8,Default Ridgefield,0,0,0,0,0,11
,CRO-205392-4CC-M6W8 Crocs Bayaband Slide Navy/Pepper US Size M6 W8,CRO-205392-4CC-M6W8 Crocs Bayaband Slide Navy/Pepper US Size M6 W8,FBALYB Amazon,0,0,0,10,0,0
,CRO-205392-4CC-M7W9 Crocs Bayaband Slide Navy/Pepper US Size M7 W9,CRO-205392-4CC-M7W9 Crocs Bayaband Slide Navy/Pepper US Size M7 W9,Default Ridgefield,10,10,0,0,0,10
,CRO-205392-4CC-M8W10 Crocs Bayaband Slide Navy/Pepper US Size M8 W10,CRO-205392-4CC-M8W10 Crocs Bayaband Slide Navy/Pepper US Size M8 W10,Default Ridgefield,1,1,0,0,0,10
,CRO-205392-4CC-M8W10 Crocs Bayaband Slide Navy/Pepper US Size M8 W10,CRO-205392-4CC-M8W10 Crocs Bayaband Slide Navy/Pepper US Size M8 W10,FBALYB Amazon,0,0,0,9,0,0
,CRO-205392-4CC-M9W11 Crocs Bayaband Slide Navy/Pepper US Size M9 W11,CRO-205392-4CC-M9W11 Crocs Bayaband Slide Navy/Pepper US Size M9 W11,Default Ridgefield,0,0,0,0,0,22
,CRO-205392-4CC-M9W11 Crocs Bayaband Slide Navy/Pepper US Size M9 W11,CRO-205392-4CC-M9W11 Crocs Bayaband Slide Navy/Pepper US Size M9 W11,FBALYB Amazon,0,0,0,10,0,0
,CRO-206081-060-W11 Crocs Women's LiteRideTM Stretch Sandal Black/Black US Size: M9 W11,CRO-206081-060-W11 Crocs Women's LiteRideTM Stretch Sandal Black/Black US Size: M9 W11,FBALYB Amazon,-8,-9,1,0,1,0
,CRO-206081-066-W11 Crocs Women's LiteRideTM Stretch SandalBlack/White US Size M9 W11,CRO-206081-066-W11 Crocs Women's LiteRideTM Stretch SandalBlack/White US Size M9 W11,FBALYB Amazon,1,0,1,0,1,0
,Crock-Pot 7-qt. Slow Cooker (Red) (2nd),Crock-Pot 7-qt. Slow Cooker (Red),FBAAP Amazon,-1,-1,0,0,0,0
,Crock‑Pot ‑ 8‑Quart Slow Cooker ‑ Black Stainless,Crock‑Pot ‑ 8‑Quart Slow Cooker ‑ Black Stainless,FBALYB Amazon,-1,-1,0,0,0,0
,Crocs Baya Black Size M10/W12 10126-001,Crocs Baya Black Size M10/W12 10126-001,FBALYB Amazon,-3,-3,0,0,0,0
,Crocs Baya Black Size M11 10126-001,Crocs Baya Black Size M11 10126-001,Default Ridgefield,20,20,0,0,0,0
,Crocs Baya Black Size M12 10126-001,Crocs Baya Black Size M12 10126-001,Default Ridgefield,66,66,0,0,0,0
,Crocs Baya Black Size M12 10126-001,Crocs Baya Black Size M12 10126-001,FBALYB Amazon,-1,-1,0,0,0,0
,Crocs Baya Black Size M13 10126-001,Crocs Baya Black Size M13 10126-001,Default Ridgefield,13,13,0,0,0,0
,Crocs Baya Black Size M13 10126-001,Crocs Baya Black Size M13 10126-001,FBALYB Amazon,-1,-1,0,0,0,0
,Crocs Baya Black Size M7/W9 10126-001,Crocs Baya Black Size M7/W9 10126-001,FBALYB Amazon,-1,-1,0,0,0,0
,Crocs Baya Black Size M8/W10 10126-001,Crocs Baya Black Size M8/W10 10126-001,FBALYB Amazon,-3,-3,0,0,0,0
,Crocs Baya Slide Black Size M10/W12 12000-001,Crocs Baya Slide Black Size M10/W12 12000-001,Default Ridgefield,0,0,0,0,0,47
,Crocs Baya Slide Black Size M10/W12 12000-001,Crocs Baya Slide Black Size M10/W12 12000-001,FBALYB Amazon,8,0,8,0,8,0
,Crocs Baya Slide Black Size M11 12000-001,Crocs Baya Slide Black Size M11 12000-001,Default Ridgefield,0,0,0,0,0,24
,Crocs Baya Slide Black Size M11 12000-001,Crocs Baya Slide Black Size M11 12000-001,FBALYB Amazon,6,-1,7,0,7,0
,Crocs Baya Slide Black Size M12 12000-001,Crocs Baya Slide Black Size M12 12000-001,Default Oxford,1,1,0,0,0,0
,Crocs Baya Slide Black Size M12 12000-001,Crocs Baya Slide Black Size M12 12000-001,Default Ridgefield,19,19,0,0,0,0
,Crocs Baya Slide Black Size M13 12000-001,Crocs Baya Slide Black Size M13 12000-001,Default Ridgefield,10,10,0,0,0,0
,Crocs Baya Slide Black Size M7/W9 12000-001,Crocs Baya Slide Black Size M7/W9 12000-001,Default Ridgefield,1,1,0,0,0,47
,Crocs Baya Slide Black Size M7/W9 12000-001,Crocs Baya Slide Black Size M7/W9 12000-001,FBALYB Amazon,0,0,0,8,0,0
,Crocs Baya Slide Black Size M8/W10 12000-001,Crocs Baya Slide Black Size M8/W10 12000-001,Default Ridgefield,10,10,0,0,0,47
,Crocs Baya Slide Black Size M9/W11 12000-001,Crocs Baya Slide Black Size M9/W11 12000-001,Default Ridgefield,10,10,0,0,0,83
,Crocs Baya White Size M10/W12 10126-100,Crocs Baya White Size M10/W12 10126-100,FBALYB Amazon,-1,-1,0,0,0,0
,Crocs Baya White Size M7/W9 10126-100,Crocs Baya White Size M7/W9 10126-100,FBALYB Amazon,-1,-1,0,0,0,0
,Crocs Baya White Size M8/W10 10126-100,Crocs Baya White Size M8/W10 10126-100,FBALYB Amazon,-4,-4,0,0,0,0
,Crocs Classic Ballerina Pink Size M10/W12 10001-6GD,Crocs Classic Ballerina Pink Size M10/W12 10001-6GD,FBALYB Amazon,-5,-5,0,0,0,0
,Crocs Classic Ballerina Pink Size M11 10001-6GD,Crocs Classic Ballerina Pink Size M11 10001-6GD,FBALYB Amazon,-3,-3,0,0,0,0
,Crocs Classic Ballerina Pink Size M12 10001-6GD,Crocs Classic Ballerina Pink Size M12 10001-6GD,FBALYB Amazon,-2,-2,0,0,0,0
,Crocs Classic Ballerina Pink Size M13 10001-6GD,Crocs Classic Ballerina Pink Size M13 10001-6GD,FBALYB Amazon,-1,-1,0,0,0,0
,Crocs Classic Ballerina Pink Size M6/W8 10001-6GD,Crocs Classic Ballerina Pink Size M6/W8 10001-6GD,FBALYB Amazon,-1,-1,0,0,0,0
,Crocs Classic Ballerina Pink Size M7/W9 10001-6GD,Crocs Classic Ballerina Pink Size M7/W9 10001-6GD,FBALYB Amazon,-13,-13,0,0,0,0
,Crocs Classic Ballerina Pink Size M8/W10 10001-6GD,Crocs Classic Ballerina Pink Size M8/W10 10001-6GD,FBALYB Amazon,-14,-14,0,0,0,0
,Crocs Classic Ballerina Pink Size M9/W11 10001-6GD,Crocs Classic Ballerina Pink Size M9/W11 10001-6GD,FBALYB Amazon,-7,-7,0,0,0,0
,Crocs Classic Black Size M10/W12 10001-001,Crocs Classic Black Size M10/W12 10001-001,FBALYB Amazon,-16,-17,1,0,1,0
,Crocs Classic Black Size M11 10001-001,Crocs Classic Black Size M11 10001-001,FBALYB Amazon,-8,-8,0,0,0,0
,Crocs Classic Black Size M12 10001-001,Crocs Classic Black Size M12 10001-001,Default Ridgefield,4,4,0,0,0,0
,Crocs Classic Black Size M12 10001-001,Crocs Classic Black Size M12 10001-001,FBALYB Amazon,-11,-12,1,0,1,0
,Crocs Classic Black Size M13 10001-001,Crocs Classic Black Size M13 10001-001,FBALYB Amazon,-5,-5,0,0,0,0
,Crocs Classic Black Size M14 10001-001,Crocs Classic Black Size M14 10001-001,FBALYB Amazon,-6,-6,0,0,0,0
,Crocs Classic Black Size M5/W7 10001-001,Crocs Classic Black Size M5/W7 10001-001,FBALYB Amazon,-2,-2,0,0,0,0
,Crocs Classic Black Size M6/W8 10001-001,Crocs Classic Black Size M6/W8 10001-001,Default,0,0,0,0,0,60
,Crocs Classic Black Size M6/W8 10001-001,Crocs Classic Black Size M6/W8 10001-001,FBALYB Amazon,-4,-4,0,0,0,0
,Crocs Classic Black Size M7/W9 10001-001,Crocs Classic Black Size M7/W9 10001-001,FBALYB Amazon,-10,-45,35,0,35,0
,Crocs Classic Black Size M8/W10 10001-001,Crocs Classic Black Size M8/W10 10001-001,Default Ridgefield,-3,-3,0,0,0,0
,Crocs Classic Black Size M8/W10 10001-001,Crocs Classic Black Size M8/W10 10001-001,FBALYB Amazon,33,33,0,0,0,0
,Crocs Classic Black Size M9/W11 10001-001,Crocs Classic Black Size M9/W11 10001-001,Default Ridgefield,4,4,0,0,0,0
,Crocs Classic Black Size M9/W11 10001-001,Crocs Classic Black Size M9/W11 10001-001,FBALYB Amazon,-22,-25,3,0,3,0
,Crocs Classic Bright Cobalt Size M11 10001-4JL,Crocs Classic Bright Cobalt Size M11 10001-4JL,FBALYB Amazon,-1,-1,0,0,0,0
,Crocs Classic Bright Cobalt Size M12 10001-4JL,Crocs Classic Bright Cobalt Size M12 10001-4JL,FBALYB Amazon,-9,-9,0,0,0,0
,Crocs Classic Bright Cobalt Size M14 10001-4JL,Crocs Classic Bright Cobalt Size M14 10001-4JL,FBALYB Amazon,-2,-2,0,0,0,0
,Crocs Classic Bright Cobalt Size M1/W12 10001-4JL,Crocs Classic Bright Cobalt Size M1/W12 10001-4JL,FBALYB Amazon,-2,-2,0,0,0,0
,Crocs Classic Bright Cobalt Size M7/W9 10001-4JL,Crocs Classic Bright Cobalt Size M7/W9 10001-4JL,FBALYB Amazon,-8,-8,0,0,0,0
,Crocs Classic Bright Cobalt Size M8/W10 10001-4JL,Crocs Classic Bright Cobalt Size M8/W10 10001-4JL,FBALYB Amazon,-5,-5,0,0,0,0
,Crocs Classic Bright Cobalt Size M9/W11 10001-4JL,Crocs Classic Bright Cobalt Size M9/W11 10001-4JL,FBALYB Amazon,-4,-4,0,0,0,0
,Crocs Classic Chocolate Size M11 10001-200,Crocs Classic Chocolate Size M11 10001-200,FBALYB Amazon,1,1,0,0,0,0
,Crocs Classic Chocolate Size M12 10001-200,Crocs Classic Chocolate Size M12 10001-200,FBALYB Amazon,-2,-2,0,0,0,0
,Crocs Classic Chocolate Size M7/W9 10001-200,Crocs Classic Chocolate Size M7/W9 10001-200,FBALYB Amazon,-2,-2,0,0,0,0
,Crocs Classic Chocolate Size M8/W10 10001-200,Crocs Classic Chocolate Size M8/W10 10001-200,FBALYB Amazon,-3,-3,0,0,0,0
,Crocs Classic Chocolate Size M9/W11 10001-200,Crocs Classic Chocolate Size M9/W11 10001-200,FBALYB Amazon,-1,-1,0,0,0,0
,Crocs Classic Clog K Black Children's Size C5 204536-001,Crocs Classic Clog K Black Children's Size C5 204536-001,FBALYB Amazon,-4,-4,0,0,0,0
,Crocs Classic Clog K Black Children's Size C6 204536-001,Crocs Classic Clog K Black Children's Size C6 204536-001,FBALYB Amazon,-1,-1,0,0,0,0
,Crocs Classic Clog K Black Junior's Size J1 204536-001,Crocs Classic Clog K Black Junior's Size J1 204536-001,FBALYB Amazon,-14,-14,0,1,0,0
,Crocs Classic Clog K Black Junior's Size J2 204536-001,Crocs Classic Clog K Black Junior's Size J2 204536-001,FBALYB Amazon,-2,-2,0,0,0,0
,Crocs Classic Clog K Black Junior's Size J3 204536-001,Crocs Classic Clog K Black Junior's Size J3 204536-001,FBALYB Amazon,-10,-10,0,0,0,0
,Crocs Classic Clog K Black Junior's Size J4 204536-001,Crocs Classic Clog K Black Junior's Size J4 204536-001,FBALYB Amazon,-1,-1,0,0,0,0
,Crocs Classic Clog K Black Junior's Size J5 204536-001,Crocs Classic Clog K Black Junior's Size J5 204536-001,FBALYB Amazon,-8,-8,0,0,0,0
,Crocs Classic Clog K Black Junior's Size J6 204536-001,Crocs Classic Clog K Black Junior's Size J6 204536-001,FBALYB Amazon,-2,-4,2,0,2,0
,Crocs Classic Clog K Bright Cobalt Children's Size C10 204536-4JL,Crocs Classic Clog K Bright Cobalt Children's Size C10 204536-4JL,Default Ridgefield,1,1,0,0,0,0
,Crocs Classic Clog K Bright Cobalt Children's Size C10 204536-4JL,Crocs Classic Clog K Bright Cobalt Children's Size C10 204536-4JL,FBALYB Amazon,0,0,0,8,0,0
,Crocs Classic Clog K Bright Cobalt Children's Size C11 204536-4JL,Crocs Classic Clog K Bright Cobalt Children's Size C11 204536-4JL,Default Ridgefield,39,39,0,0,0,0
,Crocs Classic Clog K Bright Cobalt Children's Size C12 204536-4JL,Crocs Classic Clog K Bright Cobalt Children's Size C12 204536-4JL,FBALYB Amazon,0,0,0,9,0,0
,Crocs Classic Clog K Bright Cobalt Children's Size C13 204536-4JL,Crocs Classic Clog K Bright Cobalt Children's Size C13 204536-4JL,FBALYB Amazon,0,0,0,9,0,0
,Crocs Classic Clog K Bright Cobalt Children's Size C5 204536-4JL,Crocs Classic Clog K Bright Cobalt Children's Size C5 204536-4JL,Default Ridgefield,44,44,0,0,0,0
,Crocs Classic Clog K Bright Cobalt Children's Size C5 204536-4JL,Crocs Classic Clog K Bright Cobalt Children's Size C5 204536-4JL,FBALYB Amazon,-1,-1,0,0,0,0
,Crocs Classic Clog K Bright Cobalt Children's Size C6 204536-4JL,Crocs Classic Clog K Bright Cobalt Children's Size C6 204536-4JL,Default Ridgefield,9,9,0,0,0,0
,Crocs Classic Clog K Bright Cobalt Children's Size C6 204536-4JL,Crocs Classic Clog K Bright Cobalt Children's Size C6 204536-4JL,FBALYB Amazon,0,0,0,29,0,0
,Crocs Classic Clog K Bright Cobalt Children's Size C7 204536-4JL,Crocs Classic Clog K Bright Cobalt Children's Size C7 204536-4JL,FBALYB Amazon,0,0,0,9,0,0
,Crocs Classic Clog K Bright Cobalt Children's Size C8 204536-4JL,Crocs Classic Clog K Bright Cobalt Children's Size C8 204536-4JL,Default Ridgefield,9,9,0,0,0,0
,Crocs Classic Clog K Bright Cobalt Children's Size C9 204536-4JL,Crocs Classic Clog K Bright Cobalt Children's Size C9 204536-4JL,Default Ridgefield,25,25,0,0,0,0
,Crocs Classic Clog K Bright Cobalt Junior's Size J1 204536-4JL,Crocs Classic Clog K Bright Cobalt Junior's Size J1 204536-4JL,Default Ridgefield,513,513,0,0,0,0
,Crocs Classic Clog K Bright Cobalt Junior's Size J2 204536-4JL,Crocs Classic Clog K Bright Cobalt Junior's Size J2 204536-4JL,FBALYB Amazon,-3,-3,0,132,0,0
,Crocs Classic Clog K Bright Cobalt Junior's Size J3 204536-4JL,Crocs Classic Clog K Bright Cobalt Junior's Size J3 204536-4JL,Default Ridgefield,405,405,0,0,0,0
,Crocs Classic Clog K Bright Cobalt Junior's Size J4 204536-4JL,Crocs Classic Clog K Bright Cobalt Junior's Size J4 204536-4JL,Default Ridgefield,250,250,0,0,0,0
,Crocs Classic Clog K Bright Cobalt Junior's Size J5 204536-4JL,Crocs Classic Clog K Bright Cobalt Junior's Size J5 204536-4JL,Default Ridgefield,424,424,0,0,0,0
,Crocs Classic Clog K Bright Cobalt Junior's Size J5 204536-4JL,Crocs Classic Clog K Bright Cobalt Junior's Size J5 204536-4JL,FBALYB Amazon,125,123,2,0,2,0
,Crocs Classic Clog K Bright Cobalt Junior's Size J6 204536-4JL,Crocs Classic Clog K Bright Cobalt Junior's Size J6 204536-4JL,Default Ridgefield,421,421,0,0,0,0
,Crocs Classic Clog K Electric Pink Junior's Size J1 204536-6QQ,Crocs Classic Clog K Electric Pink Junior's Size J1 204536-6QQ,FBALYB Amazon,-11,-11,0,0,0,0
,Crocs Classic Clog K Electric Pink Junior's Size J2 204536-6QQ,Crocs Classic Clog K Electric Pink Junior's Size J2 204536-6QQ,FBALYB Amazon,-4,-4,0,0,0,0
,Crocs Classic Clog K Electric Pink Junior's Size J3 204536-6QQ,Crocs Classic Clog K Electric Pink Junior's Size J3 204536-6QQ,Default Ridgefield,60,60,0,0,0,0
,Crocs Classic Clog K Electric Pink Junior's Size J4 204536-6QQ,Crocs Classic Clog K Electric Pink Junior's Size J4 204536-6QQ,FBALYB Amazon,-1,-1,0,0,0,0
,Crocs Classic Clog K Electric Pink Junior's Size J5 204536-6QQ,Crocs Classic Clog K Electric Pink Junior's Size J5 204536-6QQ,FBALYB Amazon,-6,-6,0,0,0,0
,Crocs Classic Clog K Electric Pink Junior's Size J6 204536-6QQ,Crocs Classic Clog K Electric Pink Junior's Size J6 204536-6QQ,Default Oxford,48,48,0,0,0,0
,Crocs Classic Clog K Electric Pink Junior's Size J6 204536-6QQ,Crocs Classic Clog K Electric Pink Junior's Size J6 204536-6QQ,Default Ridgefield,22,22,0,0,0,0
,Crocs Classic Clog K Lavender Children's Size C12 204536-530,Crocs Classic Clog K Lavender Children's Size C12 204536-530,FBALYB Amazon,-1,-1,0,0,0,0
,Crocs Classic Clog K Lavender Junior's Size J1 204536-530,Crocs Classic Clog K Lavender Junior's Size J1 204536-530,FBALYB Amazon,-5,-5,0,0,0,0
,Crocs Classic Clog K Lavender Junior's Size J3 204536-530,Crocs Classic Clog K Lavender Junior's Size J3 204536-530,FBALYB Amazon,-3,-3,0,0,0,0
,Crocs Classic Clog K Lavender Junior's Size J5 204536-530,Crocs Classic Clog K Lavender Junior's Size J5 204536-530,FBALYB Amazon,-9,-9,0,0,0,0
,Crocs Classic Clog K Lavender Junior's Size J6 204536-530,Crocs Classic Clog K Lavender Junior's Size J6 204536-530,FBALYB Amazon,-5,-5,0,0,0,0
,Crocs Classic Clog K Lemon Children's Size C11 204536-7C1,Crocs Classic Clog K Lemon Children's Size C11 204536-7C1,FBALYB Amazon,-1,-1,0,0,0,0
,Crocs Classic Clog K Lemon Children's Size C12 204536-7C1,Crocs Classic Clog K Lemon Children's Size C12 204536-7C1,FBALYB Amazon,-1,-1,0,0,0,0
,Crocs Classic Clog K Lemon Junior's Size J1 204536-7C1,Crocs Classic Clog K Lemon Junior's Size J1 204536-7C1,FBALYB Amazon,-2,-2,0,0,0,0
,Crocs Classic Clog K Lemon Junior's Size J2 204536-7C1,Crocs Classic Clog K Lemon Junior's Size J2 204536-7C1,FBALYB Amazon,-1,-1,0,0,0,0
,Crocs Classic Clog K Lemon Junior's Size J3 204536-7C1,Crocs Classic Clog K Lemon Junior's Size J3 204536-7C1,FBALYB Amazon,-4,-4,0,0,0,0
,Crocs Classic Clog K Lemon Junior's Size J4 204536-7C1,Crocs Classic Clog K Lemon Junior's Size J4 204536-7C1,FBALYB Amazon,-2,-2,0,0,0,0
,Crocs Classic Clog K Lemon Junior's Size J5 204536-7C1,Crocs Classic Clog K Lemon Junior's Size J5 204536-7C1,FBALYB Amazon,-2,-2,0,0,0,0
,Crocs Classic Clog K Lemon Junior's Size J6 204536-7C1,Crocs Classic Clog K Lemon Junior's Size J6 204536-7C1,FBALYB Amazon,-1,-1,0,0,0,0
,Crocs Classic Clog K Navy Junior's Size J1 204536-410,Crocs Classic Clog K Navy Junior's Size J1 204536-410,FBALYB Amazon,-2,-2,0,0,0,0
,Crocs Classic Clog K Navy Junior's Size J3 204536-410,Crocs Classic Clog K Navy Junior's Size J3 204536-410,FBALYB Amazon,-1,-1,0,0,0,0
,Crocs Classic Clog K Navy Junior's Size J5 204536-410,Crocs Classic Clog K Navy Junior's Size J5 204536-410,FBALYB Amazon,-3,-3,0,0,0,0
,Crocs Classic Clog K Navy Junior's Size J6 204536-410,Crocs Classic Clog K Navy Junior's Size J6 204536-410,FBALYB Amazon,-4,-4,0,0,0,0
,Crocs Classic Clog K Ocean Junior's Size J1 204536-456,Crocs Classic Clog K Ocean Junior's Size J1 204536-456,FBALYB Amazon,-2,-2,0,0,0,0
,Crocs Classic Clog K Ocean Junior's Size J2 204536-456,Crocs Classic Clog K Ocean Junior's Size J2 204536-456,FBALYB Amazon,-1,-1,0,0,0,0
,Crocs Classic Clog K Ocean Junior's Size J4 204536-456,Crocs Classic Clog K Ocean Junior's Size J4 204536-456,Default Ridgefield,10,10,0,0,0,0
,Crocs Classic Clog K Ocean Junior's Size J5 204536-456,Crocs Classic Clog K Ocean Junior's Size J5 204536-456,Default Ridgefield,20,20,0,0,0,0
,Crocs Classic Clog K Pepper Children's Size C11 204536-6EN,Crocs Classic Clog K Pepper Children's Size C11 204536-6EN,FBALYB Amazon,-2,-2,0,0,0,0
,Crocs Classic Clog K Pepper Children's Size C12 204536-6EN,Crocs Classic Clog K Pepper Children's Size C12 204536-6EN,FBALYB Amazon,-2,-2,0,0,0,0
,Crocs Classic Clog K Pepper Junior's Size J1 204536-6EN,Crocs Classic Clog K Pepper Junior's Size J1 204536-6EN,FBALYB Amazon,-2,-2,0,0,0,0
,Crocs Classic Clog K Pepper Junior's Size J2 204536-6EN,Crocs Classic Clog K Pepper Junior's Size J2 204536-6EN,FBALYB Amazon,-2,-2,0,0,0,0
,Crocs Classic Clog K Pepper Junior's Size J3 204536-6EN,Crocs Classic Clog K Pepper Junior's Size J3 204536-6EN,FBALYB Amazon,-1,-1,0,0,0,0
,Crocs Classic Clog K Pepper Junior's Size J4 204536-6EN,Crocs Classic Clog K Pepper Junior's Size J4 204536-6EN,FBALYB Amazon,-1,-1,0,0,0,0
,Crocs Classic Clog K Pepper Junior's Size J5 204536-6EN,Crocs Classic Clog K Pepper Junior's Size J5 204536-6EN,FBALYB Amazon,-2,-2,0,0,0,0
,Crocs Classic Clog K Pepper Junior's Size J6 204536-6EN,Crocs Classic Clog K Pepper Junior's Size J6 204536-6EN,FBALYB Amazon,-2,-2,0,0,0,0
,Crocs Classic Clog K Pink Lemonade Children's Size C12 204536-669,Crocs Classic Clog K Pink Lemonade Children's Size C12 204536-669,FBALYB Amazon,-3,-3,0,0,0,0
,Crocs Classic Clog K Pink Lemonade Children's Size C13 204536-669,Crocs Classic Clog K Pink Lemonade Children's Size C13 204536-669,FBALYB Amazon,-1,-1,0,0,0,0
,Crocs Classic Clog K Pink Lemonade Junior's Size J1 204536-669,Crocs Classic Clog K Pink Lemonade Junior's Size J1 204536-669,FBALYB Amazon,72,71,1,0,1,0
,Crocs Classic Clog K Pink Lemonade Junior's Size J2 204536-669,Crocs Classic Clog K Pink Lemonade Junior's Size J2 204536-669,Default Ridgefield,24,24,0,0,0,0
,Crocs Classic Clog K Pink Lemonade Junior's Size J2 204536-669,Crocs Classic Clog K Pink Lemonade Junior's Size J2 204536-669,FBALYB Amazon,-3,-3,0,0,0,0
,Crocs Classic Clog K Pink Lemonade Junior's Size J3 204536-669,Crocs Classic Clog K Pink Lemonade Junior's Size J3 204536-669,Default Ridgefield,131,131,0,0,0,0
,Crocs Classic Clog K Pink Lemonade Junior's Size J3 204536-669,Crocs Classic Clog K Pink Lemonade Junior's Size J3 204536-669,FBALYB Amazon,-2,-2,0,0,0,0
,Crocs Classic Clog K Pink Lemonade Junior's Size J4 204536-669,Crocs Classic Clog K Pink Lemonade Junior's Size J4 204536-669,Default Ridgefield,37,37,0,0,0,0
,Crocs Classic Clog K Pink Lemonade Junior's Size J4 204536-669,Crocs Classic Clog K Pink Lemonade Junior's Size J4 204536-669,FBALYB Amazon,-4,-4,0,0,0,0
,Crocs Classic Clog K Pink Lemonade Junior's Size J5 204536-669,Crocs Classic Clog K Pink Lemonade Junior's Size J5 204536-669,Default Ridgefield,86,86,0,0,0,0
,Crocs Classic Clog K Pink Lemonade Junior's Size J5 204536-669,Crocs Classic Clog K Pink Lemonade Junior's Size J5 204536-669,FBALYB Amazon,48,48,0,0,0,0
,Crocs Classic Clog K Pink Lemonade Junior's Size J6 204536-669,Crocs Classic Clog K Pink Lemonade Junior's Size J6 204536-669,Default Ridgefield,66,66,0,0,0,0
,Crocs Classic Clog K Pink Lemonade Junior's Size J6 204536-669,Crocs Classic Clog K Pink Lemonade Junior's Size J6 204536-669,FBALYB Amazon,57,57,0,0,0,0
,Crocs Classic Clog K Slate Grey Children's Size C11 204536-0DA,Crocs Classic Clog K Slate Grey Children's Size C11 204536-0DA,FBALYB Amazon,0,0,0,1,0,0
,Crocs Classic Clog K Slate Grey Children's Size C5 204536-0DA,Crocs Classic Clog K Slate Grey Children's Size C5 204536-0DA,FBALYB Amazon,-1,-1,0,0,0,0
,Crocs Classic Clog K Slate Grey Children's Size C6 204536-0DA,Crocs Classic Clog K Slate Grey Children's Size C6 204536-0DA,FBALYB Amazon,-2,-2,0,0,0,0
,Crocs Classic Clog K Slate Grey Children's Size C9 204536-0DA,Crocs Classic Clog K Slate Grey Children's Size C9 204536-0DA,Default Ridgefield,9,9,0,0,0,0
,Crocs Classic Clog K Slate Grey Junior's Size J1 204536-0DA,Crocs Classic Clog K Slate Grey Junior's Size J1 204536-0DA,FBALYB Amazon,21,16,5,0,5,0
,Crocs Classic Clog K Slate Grey Junior's Size J2 204536-0DA,Crocs Classic Clog K Slate Grey Junior's Size J2 204536-0DA,FBALYB Amazon,-7,-7,0,0,0,0
,Crocs Classic Clog K Slate Grey Junior's Size J3 204536-0DA,Crocs Classic Clog K Slate Grey Junior's Size J3 204536-0DA,Default Ridgefield,80,80,0,0,0,0
,Crocs Classic Clog K Slate Grey Junior's Size J4 204536-0DA,Crocs Classic Clog K Slate Grey Junior's Size J4 204536-0DA,FBALYB Amazon,-1,-1,0,0,0,0
,Crocs Classic Clog K Slate Grey Junior's Size J5 204536-0DA,Crocs Classic Clog K Slate Grey Junior's Size J5 204536-0DA,FBALYB Amazon,-4,-4,0,0,0,0
,Crocs Classic Clog K Slate Grey Junior's Size J6 204536-0DA,Crocs Classic Clog K Slate Grey Junior's Size J6 204536-0DA,FBALYB Amazon,-8,-8,0,0,0,0
,Crocs Classic Clog K White Children's Size C11 204536-100,Crocs Classic Clog K White Children's Size C11 204536-100,FBALYB Amazon,-3,-3,0,0,0,0
,Crocs Classic Clog K White Children's Size C5 204536-100,Crocs Classic Clog K White Children's Size C5 204536-100,FBALYB Amazon,-3,-3,0,0,0,0
,Crocs Classic Clog K White Junior's Size J1 204536-100,Crocs Classic Clog K White Junior's Size J1 204536-100,FBALYB Amazon,-12,-12,0,0,0,0
,Crocs Classic Clog K White Junior's Size J2 204536-100,Crocs Classic Clog K White Junior's Size J2 204536-100,FBALYB Amazon,-2,-2,0,0,0,0
,Crocs Classic Clog K White Junior's Size J3 204536-100,Crocs Classic Clog K White Junior's Size J3 204536-100,FBALYB Amazon,-4,-4,0,0,0,0
,Crocs Classic Clog K White Junior's Size J4 204536-100,Crocs Classic Clog K White Junior's Size J4 204536-100,FBALYB Amazon,-5,-5,0,0,0,0
,Crocs Classic Clog K White Junior's Size J5 204536-100,Crocs Classic Clog K White Junior's Size J5 204536-100,FBALYB Amazon,-8,-8,0,0,0,0
,Crocs Classic Clog K White Junior's Size J6 204536-100,Crocs Classic Clog K White Junior's Size J6 204536-100,FBALYB Amazon,-6,-6,0,0,0,0
,Crocs Classic Crocs Slide Black Size M10/W12 206121-001,Crocs Classic Crocs Slide Black Size M10/W12 206121-001,FBALYB Amazon,-1,-1,0,0,0,0
,Crocs Classic Crocs Slide Black Size M11 206121-001,Crocs Classic Crocs Slide Black Size M11 206121-001,FBALYB Amazon,-2,-2,0,0,0,0
,Crocs Classic Crocs Slide Black Size M12 206121-001,Crocs Classic Crocs Slide Black Size M12 206121-001,FBALYB Amazon,-2,-2,0,0,0,0
,Crocs Classic Crocs Slide Black Size M13 206121-001,Crocs Classic Crocs Slide Black Size M13 206121-001,Default Ridgefield,0,-14,14,0,0,0
,Crocs Classic Crocs Slide Black Size M13 206121-001,Crocs Classic Crocs Slide Black Size M13 206121-001,FBALYB Amazon,-2,-2,0,0,0,0
,Crocs Classic Crocs Slide Black Size M6/W8 206121-001,Crocs Classic Crocs Slide Black Size M6/W8 206121-001,FBALYB Amazon,-2,-2,0,0,0,0
,Crocs Classic Crocs Slide Black Size M7/W9 206121-001,Crocs Classic Crocs Slide Black Size M7/W9 206121-001,FBALYB Amazon,-6,-6,0,0,0,0
,Crocs Classic Crocs Slide Black Size M8/W10 206121-001,Crocs Classic Crocs Slide Black Size M8/W10 206121-001,FBALYB Amazon,-6,-6,0,0,0,0
,Crocs Classic Crocs Slide Black Size M9/W11 206121-001,Crocs Classic Crocs Slide Black Size M9/W11 206121-001,FBALYB Amazon,-9,-9,0,0,0,0
,Crocs Classic Deep Green Size M10/W12 10001-3TJ,Crocs Classic Deep Green Size M10/W12 10001-3TJ,FBALYB Amazon,-1,-1,0,0,0,0
,Crocs Classic Deep Green Size M11 10001-3TJ,Crocs Classic Deep Green Size M11 10001-3TJ,FBALYB Amazon,-2,-2,0,0,0,0
,Crocs Classic Deep Green Size M12 10001-3TJ,Crocs Classic Deep Green Size M12 10001-3TJ,FBALYB Amazon,-1,-1,0,0,0,0
,Crocs Classic Deep Green Size M7/W9 10001-3TJ,Crocs Classic Deep Green Size M7/W9 10001-3TJ,FBALYB Amazon,-5,-5,0,0,0,0
,Crocs Classic Deep Green Size M8/W10 10001-3TJ,Crocs Classic Deep Green Size M8/W10 10001-3TJ,FBALYB Amazon,-2,-2,0,0,0,0
,Crocs Classic Electric Pink Size M10/W12 10001-6QQ,Crocs Classic Electric Pink Size M10/W12 10001-6QQ,FBALYB Amazon,-1,-1,0,1,0,0
,Crocs Classic Electric Pink Size M12 10001-6QQ,Crocs Classic Electric Pink Size M12 10001-6QQ,FBALYB Amazon,-1,-1,0,0,0,0
,Crocs Classic Electric Pink Size M13 10001-6QQ,Crocs Classic Electric Pink Size M13 10001-6QQ,FBALYB Amazon,-1,-1,0,0,0,0
,Crocs Classic Electric Pink Size M7/W9 10001-6QQ,Crocs Classic Electric Pink Size M7/W9 10001-6QQ,FBALYB Amazon,-6,-6,0,0,0,0
,Crocs Classic Electric Pink Size M8/W10 10001-6QQ,Crocs Classic Electric Pink Size M8/W10 10001-6QQ,FBALYB Amazon,-2,-2,0,0,0,0
,Crocs Classic Electric Pink Size M9/W11 10001-6QQ,Crocs Classic Electric Pink Size M9/W11 10001-6QQ,FBALYB Amazon,-1,-1,0,0,0,0
,Crocs Classic Ice Blue Size M10/W12 10001-4O9,Crocs Classic Ice Blue Size M10/W12 10001-4O9,FBALYB Amazon,-1,-1,0,0,0,0
,Crocs Classic Ice Blue Size M12 10001-4O9,Crocs Classic Ice Blue Size M12 10001-4O9,FBALYB Amazon,-1,-1,0,0,0,0
,Crocs Classic Ice Blue Size M6/W8 10001-4O9,Crocs Classic Ice Blue Size M6/W8 10001-4O9,FBALYB Amazon,-1,-1,0,0,0,0
,Crocs Classic Ice Blue Size M7/W9 10001-4O9,Crocs Classic Ice Blue Size M7/W9 10001-4O9,FBALYB Amazon,-5,-5,0,0,0,0
,Crocs Classic Ice Blue Size M8/W10 10001-4O9,Crocs Classic Ice Blue Size M8/W10 10001-4O9,FBALYB Amazon,-3,-3,0,0,0,0
,Crocs Classic Ice Blue Size M9/W11 10001-4O9,Crocs Classic Ice Blue Size M9/W11 10001-4O9,FBALYB Amazon,-5,-5,0,0,0,0
,Crocs Classic Lavender Size M10/W12 10001-530,Crocs Classic Lavender Size M10/W12 10001-530,FBALYB Amazon,-2,-2,0,0,0,0
,Crocs Classic Lavender Size M11 10001-530,Crocs Classic Lavender Size M11 10001-530,FBALYB Amazon,-3,-3,0,0,0,0
,Crocs Classic Lavender Size M12 10001-530,Crocs Classic Lavender Size M12 10001-530,FBALYB Amazon,-9,-9,0,0,0,0
,Crocs Classic Lavender Size M7/W9 10001-530,Crocs Classic Lavender Size M7/W9 10001-530,FBALYB Amazon,-15,-15,0,0,0,0
,Crocs Classic Lavender Size M8/W10 10001-530,Crocs Classic Lavender Size M8/W10 10001-530,FBALYB Amazon,-5,-5,0,0,0,0
,Crocs Classic Lavender Size M9/W11 10001-530,Crocs Classic Lavender Size M9/W11 10001-530,FBALYB Amazon,-9,-9,0,0,0,0
,Crocs Classic Lemon Size M10/W12 10001-7C1,Crocs Classic Lemon Size M10/W12 10001-7C1,FBALYB Amazon,-5,-5,0,0,0,0
,Crocs Classic Lemon Size M11 10001-7C1,Crocs Classic Lemon Size M11 10001-7C1,FBALYB Amazon,-2,-2,0,0,0,0
,Crocs Classic Lemon Size M12 10001-7C1,Crocs Classic Lemon Size M12 10001-7C1,FBALYB Amazon,-4,-4,0,0,0,0
,Crocs Classic Lemon Size M13 10001-7C1,Crocs Classic Lemon Size M13 10001-7C1,FBALYB Amazon,-4,-4,0,0,0,0
,Crocs Classic Lemon Size M7/W9 10001-7C1,Crocs Classic Lemon Size M7/W9 10001-7C1,FBALYB Amazon,-6,-6,0,0,0,0
,Crocs Classic Lemon Size M8/W10 10001-7C1,Crocs Classic Lemon Size M8/W10 10001-7C1,FBALYB Amazon,-11,-11,0,0,0,0
,Crocs Classic Lemon Size M9/W11 10001-7C1,Crocs Classic Lemon Size M9/W11 10001-7C1,FBALYB Amazon,-5,-5,0,0,0,0
,Crocs Classic Navy Size M10/W12 10001-410,Crocs Classic Navy Size M10/W12 10001-410,FBALYB Amazon,-4,-4,0,0,0,0
,Crocs Classic Navy Size M11 10001-410,Crocs Classic Navy Size M11 10001-410,FBALYB Amazon,-1,-1,0,0,0,0
,Crocs Classic Navy Size M12 10001-410,Crocs Classic Navy Size M12 10001-410,Default Ridgefield,3,3,0,0,0,0
,Crocs Classic Navy Size M12 10001-410,Crocs Classic Navy Size M12 10001-410,FBALYB Amazon,-8,-8,0,0,0,0
,Crocs Classic Navy Size M13 10001-410,Crocs Classic Navy Size M13 10001-410,FBALYB Amazon,-2,-2,0,0,0,0
,Crocs Classic Navy Size M14 10001-410,Crocs Classic Navy Size M14 10001-410,FBALYB Amazon,-2,-2,0,0,0,0
,Crocs Classic Navy Size M5/W7 10001-410,Crocs Classic Navy Size M5/W7 10001-410,Default,0,0,0,0,0,10
,Crocs Classic Navy Size M6/W8 10001-410,Crocs Classic Navy Size M6/W8 10001-410,FBALYB Amazon,-3,-3,0,0,0,0
,Crocs Classic Navy Size M7/W9 10001-410,Crocs Classic Navy Size M7/W9 10001-410,FBALYB Amazon,-14,-14,0,0,0,0
,Crocs Classic Navy Size M8/W10 10001-410,Crocs Classic Navy Size M8/W10 10001-410,Default,0,0,0,0,0,12
,Crocs Classic Navy Size M8/W10 10001-410,Crocs Classic Navy Size M8/W10 10001-410,FBALYB Amazon,-15,-15,0,0,0,0
,Crocs Classic Navy Size M9/W11 10001-410,Crocs Classic Navy Size M9/W11 10001-410,FBALYB Amazon,-14,-14,0,0,0,0
,Crocs Classic Neon Purple Size M10/W12 10001-518,Crocs Classic Neon Purple Size M10/W12 10001-518,FBALYB Amazon,-3,-3,0,0,0,0
,Crocs Classic Neon Purple Size M12 10001-518,Crocs Classic Neon Purple Size M12 10001-518,FBALYB Amazon,-5,-5,0,0,0,0
,Crocs Classic Neon Purple Size M13 10001-518,Crocs Classic Neon Purple Size M13 10001-518,FBALYB Amazon,-1,-1,0,0,0,0
,Crocs Classic Neon Purple Size M6/W8 10001-518,Crocs Classic Neon Purple Size M6/W8 10001-518,FBALYB Amazon,-1,-1,0,0,0,0
,Crocs Classic Neon Purple Size M7/W9 10001-518,Crocs Classic Neon Purple Size M7/W9 10001-518,FBALYB Amazon,-9,-9,0,0,0,0
,Crocs Classic Neon Purple Size M8/W10 10001-518,Crocs Classic Neon Purple Size M8/W10 10001-518,FBALYB Amazon,-11,-11,0,0,0,0
,Crocs Classic Neon Purple Size M9/W11 10001-518,Crocs Classic Neon Purple Size M9/W11 10001-518,FBALYB Amazon,-5,-5,0,0,0,0
,Crocs Classic Pepper Size M10/W12 10001-6EN,Crocs Classic Pepper Size M10/W12 10001-6EN,Default Ridgefield,305,305,0,0,0,0
,Crocs Classic Pepper Size M10/W12 10001-6EN,Crocs Classic Pepper Size M10/W12 10001-6EN,FBALYB Amazon,114,103,11,150,11,0
,Crocs Classic Pepper Size M11 10001-6EN,Crocs Classic Pepper Size M11 10001-6EN,FBALYB Amazon,85,82,3,0,3,0
,Crocs Classic Pepper Size M12 10001-6EN,Crocs Classic Pepper Size M12 10001-6EN,FBALYB Amazon,16,14,2,34,2,0
,Crocs Classic Pepper Size M13 10001-6EN,Crocs Classic Pepper Size M13 10001-6EN,FBALYB Amazon,-2,-2,0,0,0,0
,Crocs Classic Pepper Size M4/W6 10001-6EN,Crocs Classic Pepper Size M4/W6 10001-6EN,Default Ridgefield,181,181,0,0,0,0
,Crocs Classic Pepper Size M5/W7 10001-6EN,Crocs Classic Pepper Size M5/W7 10001-6EN,Default Ridgefield,477,477,0,0,0,0
,Crocs Classic Pepper Size M5/W7 10001-6EN,Crocs Classic Pepper Size M5/W7 10001-6EN,FBALYB Amazon,266,241,25,111,25,0
,Crocs Classic Pepper Size M6/W8 10001-6EN,Crocs Classic Pepper Size M6/W8 10001-6EN,Default Ridgefield,493,493,0,0,0,0
,Crocs Classic Pepper Size M6/W8 10001-6EN,Crocs Classic Pepper Size M6/W8 10001-6EN,FBALYB Amazon,110,102,8,264,8,0
,Crocs Classic Pepper Size M7/W9 10001-6EN,Crocs Classic Pepper Size M7/W9 10001-6EN,Default Oxford,1,1,0,0,0,0
,Crocs Classic Pepper Size M7/W9 10001-6EN,Crocs Classic Pepper Size M7/W9 10001-6EN,Default Ridgefield,784,784,0,0,0,0
,Crocs Classic Pepper Size M7/W9 10001-6EN,Crocs Classic Pepper Size M7/W9 10001-6EN,FBALYB Amazon,-13,-13,0,0,0,0
,Crocs Classic Pepper Size M8/W10 10001-6EN,Crocs Classic Pepper Size M8/W10 10001-6EN,Default Ridgefield,1,1,0,0,0,0
,Crocs Classic Pepper Size M8/W10 10001-6EN,Crocs Classic Pepper Size M8/W10 10001-6EN,FBALYB Amazon,136,123,13,21,13,0
,Crocs Classic Pepper Size M9/W11 10001-6EN,Crocs Classic Pepper Size M9/W11 10001-6EN,Default Ridgefield,61,61,0,0,0,0
,Crocs Classic Pepper Size M9/W11 10001-6EN,Crocs Classic Pepper Size M9/W11 10001-6EN,FBALYB Amazon,53,45,8,0,8,0
,Crocs Classic Slate Grey Size M10/W12 10001-0DA,Crocs Classic Slate Grey Size M10/W12 10001-0DA,FBALYB Amazon,-8,-8,0,0,0,0
,Crocs Classic Slate Grey Size M11 10001-0DA,Crocs Classic Slate Grey Size M11 10001-0DA,FBALYB Amazon,-2,-2,0,0,0,0
,Crocs Classic Slate Grey Size M12 10001-0DA,Crocs Classic Slate Grey Size M12 10001-0DA,FBALYB Amazon,-9,-9,0,0,0,0
,Crocs Classic Slate Grey Size M13 10001-0DA,Crocs Classic Slate Grey Size M13 10001-0DA,FBALYB Amazon,-2,-2,0,0,0,0
,Crocs Classic Slate Grey Size M14 10001-0DA,Crocs Classic Slate Grey Size M14 10001-0DA,FBALYB Amazon,-1,-1,0,0,0,0
,Crocs Classic Slate Grey Size M5/W7 10001-0DA,Crocs Classic Slate Grey Size M5/W7 10001-0DA,FBALYB Amazon,-2,-2,0,0,0,0
,Crocs Classic Slate Grey Size M6/W8 10001-0DA,Crocs Classic Slate Grey Size M6/W8 10001-0DA,FBALYB Amazon,-4,-4,0,0,0,0
,Crocs Classic Slate Grey Size M7/W9 10001-0DA,Crocs Classic Slate Grey Size M7/W9 10001-0DA,FBALYB Amazon,-8,-8,0,0,0,0
,Crocs Classic Slate Grey Size M8/W10 10001-0DA,Crocs Classic Slate Grey Size M8/W10 10001-0DA,FBALYB Amazon,-17,-17,0,0,0,0
,Crocs Classic Slate Grey Size M9/W11 10001-0DA,Crocs Classic Slate Grey Size M9/W11 10001-0DA,FBALYB Amazon,-14,-14,0,0,0,0
,Crocs Classic White Size M10/W12 10001-100,Crocs Classic White Size M10/W12 10001-100,FBALYB Amazon,-23,-23,0,0,0,0
,Crocs Classic White Size M11 10001-100,Crocs Classic White Size M11 10001-100,FBALYB Amazon,-8,-8,0,0,0,0
,Crocs Classic White Size M12 10001-100,Crocs Classic White Size M12 10001-100,Default Ridgefield,5,5,0,0,0,0
,Crocs Classic White Size M12 10001-100,Crocs Classic White Size M12 10001-100,FBALYB Amazon,-9,-13,4,0,4,0
,Crocs Classic White Size M13 10001-100,Crocs Classic White Size M13 10001-100,FBALYB Amazon,-5,-5,0,0,0,0
,Crocs Classic White Size M14 10001-100,Crocs Classic White Size M14 10001-100,FBALYB Amazon,-3,-3,0,0,0,0
,Crocs Classic White Size M6/W8 10001-100,Crocs Classic White Size M6/W8 10001-100,FBALYB Amazon,-1,-1,0,0,0,0
,Crocs Classic White Size M7/W9 10001-100,Crocs Classic White Size M7/W9 10001-100,Default Ridgefield,4,4,0,0,0,0
,Crocs Classic White Size M7/W9 10001-100,Crocs Classic White Size M7/W9 10001-100,FBALYB Amazon,-22,-24,2,0,2,0
,Crocs Classic White Size M8/W10 10001-100,Crocs Classic White Size M8/W10 10001-100,Default Ridgefield,20,20,0,0,0,0
,Crocs Classic White Size M8/W10 10001-100,Crocs Classic White Size M8/W10 10001-100,FBALYB Amazon,-19,-22,3,35,3,0
,Crocs Classic White Size M9/W11 10001-100,Crocs Classic White Size M9/W11 10001-100,Default Ridgefield,4,4,0,0,0,0
,Crocs Classic White Size M9/W11 10001-100,Crocs Classic White Size M9/W11 10001-100,FBALYB Amazon,-10,-13,3,0,3,0
,Crocs Crocband Black Size M10/W12 11016-001,Crocs Crocband Black Size M10/W12 11016-001,FBALYB Amazon,-3,-3,0,0,0,0
,Crocs Crocband Black Size M11 11016-001,Crocs Crocband Black Size M11 11016-001,FBALYB Amazon,-5,-5,0,0,0,0
,Crocs Crocband Black Size M12 11016-001,Crocs Crocband Black Size M12 11016-001,FBALYB Amazon,-1,-1,0,0,0,0
,Crocs Crocband Black Size M13 11016-001,Crocs Crocband Black Size M13 11016-001,Default Ridgefield,14,14,0,0,0,0
,Crocs Crocband Black Size M6/W8 11016-001,Crocs Crocband Black Size M6/W8 11016-001,FBALYB Amazon,-2,-2,0,0,0,0
,Crocs Crocband Black Size M8/W10 11016-001,Crocs Crocband Black Size M8/W10 11016-001,FBALYB Amazon,-6,-6,0,0,0,0
,Crocs Crocband Black Size M9/W11 11016-001,Crocs Crocband Black Size M9/W11 11016-001,FBALYB Amazon,-4,-4,0,0,0,0
,Crocs Crocband Charcoal/Ocean Size M11 11016-07W,Crocs Crocband Charcoal/Ocean Size M11 11016-07W,FBALYB Amazon,-4,-4,0,0,0,0
,Crocs Crocband Charcoal/Ocean Size M12 11016-07W,Crocs Crocband Charcoal/Ocean Size M12 11016-07W,FBALYB Amazon,-3,-3,0,0,0,0
,Crocs Crocband Charcoal/Ocean Size M13 11016-07W,Crocs Crocband Charcoal/Ocean Size M13 11016-07W,Default Ridgefield,10,10,0,0,0,0
,Crocs Crocband Charcoal/Ocean Size M6/W8 11016-07W,Crocs Crocband Charcoal/Ocean Size M6/W8 11016-07W,FBALYB Amazon,-3,-3,0,0,0,0
,Crocs Crocband Charcoal/Ocean Size M7/W9 11016-07W,Crocs Crocband Charcoal/Ocean Size M7/W9 11016-07W,FBALYB Amazon,-1,-1,0,0,0,0
,Crocs Crocband Charcoal/Ocean Size M8/W10 11016-07W,Crocs Crocband Charcoal/Ocean Size M8/W10 11016-07W,FBALYB Amazon,-1,-1,0,0,0,0
,Crocs Crocband Charcoal/Ocean Size M9/W11 11016-07W,Crocs Crocband Charcoal/Ocean Size M9/W11 11016-07W,FBALYB Amazon,-2,-2,0,0,0,0
,Crocs Crocband Clog K Bright Cobalt/Charcoal Children's Size C10 204537-4JN,Crocs Crocband Clog K Bright Cobalt/Charcoal Children's Size C10 204537-4JN,FBALYB Amazon,-1,-1,0,0,0,0
,Crocs Crocband Clog K Bright Cobalt/Charcoal Children's Size C12 204537-4JN,Crocs Crocband Clog K Bright Cobalt/Charcoal Children's Size C12 204537-4JN,Default,0,0,0,0,0,5
,Crocs Crocband Clog K Bright Cobalt/Charcoal Children's Size C12 204537-4JN,Crocs Crocband Clog K Bright Cobalt/Charcoal Children's Size C12 204537-4JN,Default Ridgefield,5,5,0,0,0,0
,Crocs Crocband Clog K Bright Cobalt/Charcoal Children's Size C5 204537-4JN,Crocs Crocband Clog K Bright Cobalt/Charcoal Children's Size C5 204537-4JN,FBALYB Amazon,-3,-3,0,0,0,0
,Crocs Crocband Clog K Bright Cobalt/Charcoal Children's Size C6 204537-4JN,Crocs Crocband Clog K Bright Cobalt/Charcoal Children's Size C6 204537-4JN,FBALYB Amazon,-2,-2,0,0,0,0
,Crocs Crocband Clog K Bright Cobalt/Charcoal Children's Size C7 204537-4JN,Crocs Crocband Clog K Bright Cobalt/Charcoal Children's Size C7 204537-4JN,FBALYB Amazon,1,1,0,0,0,0
,Crocs Crocband Clog K Bright Cobalt/Charcoal Children's Size C8 204537-4JN,Crocs Crocband Clog K Bright Cobalt/Charcoal Children's Size C8 204537-4JN,FBALYB Amazon,-2,-2,0,0,0,0
,Crocs Crocband Clog K Bright Cobalt/Charcoal Children's Size C9 204537-4JN,Crocs Crocband Clog K Bright Cobalt/Charcoal Children's Size C9 204537-4JN,FBALYB Amazon,-2,-2,0,0,0,0
,Crocs Crocband Clog K Bright Cobalt/Charcoal Junior's Size J1 204537-4JN,Crocs Crocband Clog K Bright Cobalt/Charcoal Junior's Size J1 204537-4JN,FBALYB Amazon,-1,-1,0,0,0,0
,Crocs Crocband Clog K Bright Cobalt/Charcoal Junior's Size J5 204537-4JN,Crocs Crocband Clog K Bright Cobalt/Charcoal Junior's Size J5 204537-4JN,FBALYB Amazon,-1,-1,0,0,0,0
,Crocs Crocband Clog K Lavender/Neon Purple Children's Size C10 204537-5P8,Crocs Crocband Clog K Lavender/Neon Purple Children's Size C10 204537-5P8,FBALYB Amazon,-3,-3,0,0,0,0
,Crocs Crocband Clog K Lavender/Neon Purple Children's Size C13 204537-5P8,Crocs Crocband Clog K Lavender/Neon Purple Children's Size C13 204537-5P8,FBALYB Amazon,-1,-1,0,0,0,0
,Crocs Crocband Clog K Lavender/Neon Purple Children's Size C9 204537-5P8,Crocs Crocband Clog K Lavender/Neon Purple Children's Size C9 204537-5P8,FBALYB Amazon,-1,-1,0,0,0,0
,Crocs Crocband Clog K Lavender/Neon Purple Junior's Size J1 204537-5P8,Crocs Crocband Clog K Lavender/Neon Purple Junior's Size J1 204537-5P8,FBALYB Amazon,-1,-1,0,0,0,0
,Crocs Crocband Clog K Lavender/Neon Purple Junior's Size J5 204537-5P8,Crocs Crocband Clog K Lavender/Neon Purple Junior's Size J5 204537-5P8,FBALYB Amazon,-1,-1,0,0,0,0
,Crocs Crocband Clog K Lavender/Neon Purple Junior's Size J6 204537-5P8,Crocs Crocband Clog K Lavender/Neon Purple Junior's Size J6 204537-5P8,Default,0,0,0,0,0,1
,Crocs Crocband Clog K Lavender/Neon Purple Junior's Size J6 204537-5P8,Crocs Crocband Clog K Lavender/Neon Purple Junior's Size J6 204537-5P8,FBALYB Amazon,-1,-1,0,0,0,0
,Crocs Crocband Clog K Light Blue/White Children's Size C10 204537-4S3,Crocs Crocband Clog K Light Blue/White Children's Size C10 204537-4S3,FBALYB Amazon,-2,-2,0,0,0,0
,Crocs Crocband Clog K Light Blue/White Children's Size C12 204537-4S3,Crocs Crocband Clog K Light Blue/White Children's Size C12 204537-4S3,FBALYB Amazon,-4,-4,0,0,0,0
,Crocs Crocband Clog K Light Blue/White Children's Size C13 204537-4S3,Crocs Crocband Clog K Light Blue/White Children's Size C13 204537-4S3,FBALYB Amazon,-1,-1,0,0,0,0
,Crocs Crocband Clog K Light Blue/White Children's Size C5 204537-4S3,Crocs Crocband Clog K Light Blue/White Children's Size C5 204537-4S3,FBALYB Amazon,-1,-1,0,0,0,0
,Crocs Crocband Clog K Light Blue/White Children's Size C6 204537-4S3,Crocs Crocband Clog K Light Blue/White Children's Size C6 204537-4S3,FBALYB Amazon,-1,-1,0,0,0,0
,Crocs Crocband Clog K Light Blue/White Children's Size C7 204537-4S3,Crocs Crocband Clog K Light Blue/White Children's Size C7 204537-4S3,FBALYB Amazon,-1,-1,0,0,0,0
,Crocs Crocband Clog K Light Blue/White Children's Size C8 204537-4S3,Crocs Crocband Clog K Light Blue/White Children's Size C8 204537-4S3,FBALYB Amazon,-3,-3,0,0,0,0
,Crocs Crocband Clog K Light Blue/White Children's Size C9 204537-4S3,Crocs Crocband Clog K Light Blue/White Children's Size C9 204537-4S3,FBALYB Amazon,-1,-1,0,0,0,0
,Crocs Crocband Clog K Light Blue/White Junior's Size J1 204537-4S3,Crocs Crocband Clog K Light Blue/White Junior's Size J1 204537-4S3,FBALYB Amazon,-7,-7,0,0,0,0
,Crocs Crocband Clog K Light Blue/White Junior's Size J2 204537-4S3,Crocs Crocband Clog K Light Blue/White Junior's Size J2 204537-4S3,FBALYB Amazon,-1,-1,0,0,0,0
,Crocs Crocband Clog K Light Blue/White Junior's Size J3 204537-4S3,Crocs Crocband Clog K Light Blue/White Junior's Size J3 204537-4S3,Default Ridgefield,89,89,0,0,0,0
,Crocs Crocband Clog K Light Blue/White Junior's Size J4 204537-4S3,Crocs Crocband Clog K Light Blue/White Junior's Size J4 204537-4S3,FBALYB Amazon,-3,-3,0,0,0,0
,Crocs Crocband Clog K Light Blue/White Junior's Size J5 204537-4S3,Crocs Crocband Clog K Light Blue/White Junior's Size J5 204537-4S3,FBALYB Amazon,-3,-3,0,0,0,0
,Crocs Crocband Clog K Light Blue/White Junior's Size J6 204537-4S3,Crocs Crocband Clog K Light Blue/White Junior's Size J6 204537-4S3,FBALYB Amazon,-1,-1,0,0,0,0
,Crocs Crocband Clog K Navy/Red Children's Size C10 204537-485,Crocs Crocband Clog K Navy/Red Children's Size C10 204537-485,FBALYB Amazon,-13,-13,0,0,0,0
,Crocs Crocband Clog K Navy/Red Children's Size C11 204537-485,Crocs Crocband Clog K Navy/Red Children's Size C11 204537-485,FBALYB Amazon,-2,-2,0,0,0,0
,Crocs Crocband Clog K Navy/Red Children's Size C12 204537-485,Crocs Crocband Clog K Navy/Red Children's Size C12 204537-485,FBALYB Amazon,-6,-6,0,0,0,0
,Crocs Crocband Clog K Navy/Red Children's Size C13 204537-485,Crocs Crocband Clog K Navy/Red Children's Size C13 204537-485,FBALYB Amazon,-3,-3,0,0,0,0
,Crocs Crocband Clog K Navy/Red Children's Size C5 204537-485,Crocs Crocband Clog K Navy/Red Children's Size C5 204537-485,FBALYB Amazon,-17,-17,0,0,0,0
,Crocs Crocband Clog K Navy/Red Children's Size C6 204537-485,Crocs Crocband Clog K Navy/Red Children's Size C6 204537-485,FBALYB Amazon,-13,-13,0,0,0,0
,Crocs Crocband Clog K Navy/Red Children's Size C7 204537-485,Crocs Crocband Clog K Navy/Red Children's Size C7 204537-485,FBALYB Amazon,-5,-5,0,0,0,0
,Crocs Crocband Clog K Navy/Red Children's Size C8 204537-485,Crocs Crocband Clog K Navy/Red Children's Size C8 204537-485,Default Ridgefield,76,76,0,0,0,0
,Crocs Crocband Clog K Navy/Red Children's Size C8 204537-485,Crocs Crocband Clog K Navy/Red Children's Size C8 204537-485,FBALYB Amazon,-11,-11,0,0,0,0
,Crocs Crocband Clog K Navy/Red Children's Size C9 204537-485,Crocs Crocband Clog K Navy/Red Children's Size C9 204537-485,FBALYB Amazon,-13,-13,0,0,0,0
,Crocs Crocband Clog K Navy/Red Junior's Size J1 204537-485,Crocs Crocband Clog K Navy/Red Junior's Size J1 204537-485,FBALYB Amazon,-14,-14,0,0,0,0
,Crocs Crocband Clog K Navy/Red Junior's Size J2 204537-485,Crocs Crocband Clog K Navy/Red Junior's Size J2 204537-485,FBALYB Amazon,-2,-2,0,0,0,0
,Crocs Crocband Clog K Navy/Red Junior's Size J3 204537-485,Crocs Crocband Clog K Navy/Red Junior's Size J3 204537-485,FBALYB Amazon,-2,-2,0,0,0,0
,Crocs Crocband Clog K Navy/Red Junior's Size J4 204537-485,Crocs Crocband Clog K Navy/Red Junior's Size J4 204537-485,FBALYB Amazon,-4,-4,0,0,0,0
,Crocs Crocband Clog K Navy/Red Junior's Size J5 204537-485,Crocs Crocband Clog K Navy/Red Junior's Size J5 204537-485,FBALYB Amazon,-5,-5,0,0,0,0
,Crocs Crocband Clog K Navy/Red Junior's Size J6 204537-485,Crocs Crocband Clog K Navy/Red Junior's Size J6 204537-485,FBALYB Amazon,-9,-9,0,0,0,0
,Crocs Crocband Clog K Smoke/Navy Children's Size C10 204537-05H,Crocs Crocband Clog K Smoke/Navy Children's Size C10 204537-05H,FBALYB Amazon,-2,-2,0,0,0,0
,Crocs Crocband Clog K Smoke/Navy Children's Size C11 204537-05H,Crocs Crocband Clog K Smoke/Navy Children's Size C11 204537-05H,FBALYB Amazon,-5,-5,0,0,0,0
,Crocs Crocband Clog K Smoke/Navy Children's Size C12 204537-05H,Crocs Crocband Clog K Smoke/Navy Children's Size C12 204537-05H,FBALYB Amazon,-1,-1,0,0,0,0
,Crocs Crocband Clog K Smoke/Navy Children's Size C13 204537-05H,Crocs Crocband Clog K Smoke/Navy Children's Size C13 204537-05H,FBALYB Amazon,-2,-2,0,0,0,0
,Crocs Crocband Clog K Smoke/Navy Children's Size C5 204537-05H,Crocs Crocband Clog K Smoke/Navy Children's Size C5 204537-05H,FBALYB Amazon,-6,-6,0,0,0,0
,Crocs Crocband Clog K Smoke/Navy Children's Size C6 204537-05H,Crocs Crocband Clog K Smoke/Navy Children's Size C6 204537-05H,FBALYB Amazon,-6,-6,0,0,0,0
,Crocs Crocband Clog K Smoke/Navy Children's Size C7 204537-05H,Crocs Crocband Clog K Smoke/Navy Children's Size C7 204537-05H,FBALYB Amazon,-3,-3,0,0,0,0
,Crocs Crocband Clog K Smoke/Navy Children's Size C8 204537-05H,Crocs Crocband Clog K Smoke/Navy Children's Size C8 204537-05H,FBALYB Amazon,-12,-12,0,0,0,0
,Crocs Crocband Clog K Smoke/Navy Children's Size C9 204537-05H,Crocs Crocband Clog K Smoke/Navy Children's Size C9 204537-05H,FBALYB Amazon,-6,-6,0,0,0,0
,Crocs Crocband Clog K Smoke/Navy Junior's Size J1 204537-05H,Crocs Crocband Clog K Smoke/Navy Junior's Size J1 204537-05H,FBALYB Amazon,-5,-5,0,0,0,0
,Crocs Crocband Clog K Smoke/Navy Junior's Size J2 204537-05H,Crocs Crocband Clog K Smoke/Navy Junior's Size J2 204537-05H,FBALYB Amazon,-6,-6,0,0,0,0
,Crocs Crocband Clog K Smoke/Navy Junior's Size J3 204537-05H,Crocs Crocband Clog K Smoke/Navy Junior's Size J3 204537-05H,FBALYB Amazon,-2,-2,0,0,0,0
,Crocs Crocband Clog K Smoke/Navy Junior's Size J5 204537-05H,Crocs Crocband Clog K Smoke/Navy Junior's Size J5 204537-05H,FBALYB Amazon,-1,-1,0,0,0,0
,Crocs Crocband Clog K Smoke/Navy Junior's Size J6 204537-05H,Crocs Crocband Clog K Smoke/Navy Junior's Size J6 204537-05H,FBALYB Amazon,-2,-2,0,0,0,0
,Crocs Crocband Navy Size M10/W12 11016-410,Crocs Crocband Navy Size M10/W12 11016-410,FBALYB Amazon,-5,-5,0,0,0,0
,Crocs Crocband Navy Size M11 11016-410,Crocs Crocband Navy Size M11 11016-410,FBALYB Amazon,-7,-7,0,0,0,0
,Crocs Crocband Navy Size M12 11016-410,Crocs Crocband Navy Size M12 11016-410,FBALYB Amazon,-3,-3,0,0,0,0
,Crocs Crocband Navy Size M13 11016-410,Crocs Crocband Navy Size M13 11016-410,Default Ridgefield,25,25,0,0,0,0
,Crocs Crocband Navy Size M13 11016-410,Crocs Crocband Navy Size M13 11016-410,FBALYB Amazon,-2,-2,0,0,0,0
,Crocs Crocband Navy Size M6/W8 11016-410,Crocs Crocband Navy Size M6/W8 11016-410,FBALYB Amazon,-3,-3,0,0,0,0
,Crocs Crocband Navy Size M7/W9 11016-410,Crocs Crocband Navy Size M7/W9 11016-410,FBALYB Amazon,-6,-6,0,0,0,0
,Crocs Crocband Navy Size M9/W11 11016-410,Crocs Crocband Navy Size M9/W11 11016-410,FBALYB Amazon,-8,-8,0,0,0,0
,Crocs Crocband Pearl Pink/Wild Orchid Size M10/W12 11016-6MB,Crocs Crocband Pearl Pink/Wild Orchid Size M10/W12 11016-6MB,FBALYB Amazon,4,4,0,0,0,0
,Crocs Crocband Pearl Pink/Wild Orchid Size M11 11016-6MB,Crocs Crocband Pearl Pink/Wild Orchid Size M11 11016-6MB,FBALYB Amazon,69,68,1,0,1,0
,Crocs Crocband Pearl Pink/Wild Orchid Size M12 11016-6MB,Crocs Crocband Pearl Pink/Wild Orchid Size M12 11016-6MB,FBALYB Amazon,2,2,0,0,0,0
,Crocs Crocband Pearl Pink/Wild Orchid Size M13 11016-6MB,Crocs Crocband Pearl Pink/Wild Orchid Size M13 11016-6MB,FBALYB Amazon,-2,-2,0,0,0,0
,Crocs Crocband Pearl Pink/Wild Orchid Size M4/W6 11016-6MB,Crocs Crocband Pearl Pink/Wild Orchid Size M4/W6 11016-6MB,Default Ridgefield,158,158,0,0,0,0
,Crocs Crocband Pearl Pink/Wild Orchid Size M5/W7 11016-6MB,Crocs Crocband Pearl Pink/Wild Orchid Size M5/W7 11016-6MB,Default Ridgefield,361,361,0,0,0,0
,Crocs Crocband Pearl Pink/Wild Orchid Size M6/W8 11016-6MB,Crocs Crocband Pearl Pink/Wild Orchid Size M6/W8 11016-6MB,Default Ridgefield,187,187,0,0,0,0
,Crocs Crocband Pearl Pink/Wild Orchid Size M6/W8 11016-6MB,Crocs Crocband Pearl Pink/Wild Orchid Size M6/W8 11016-6MB,FBALYB Amazon,-6,-6,0,150,0,0
,Crocs Crocband Pearl Pink/Wild Orchid Size M7/W9 11016-6MB,Crocs Crocband Pearl Pink/Wild Orchid Size M7/W9 11016-6MB,Default Ridgefield,519,519,0,0,0,0
,Crocs Crocband Pearl Pink/Wild Orchid Size M7/W9 11016-6MB,Crocs Crocband Pearl Pink/Wild Orchid Size M7/W9 11016-6MB,FBALYB Amazon,-1,-1,0,0,0,0
,Crocs Crocband Pearl Pink/Wild Orchid Size M8/W10 11016-6MB,Crocs Crocband Pearl Pink/Wild Orchid Size M8/W10 11016-6MB,Default Ridgefield,383,383,0,0,0,0
,Crocs Crocband Pearl Pink/Wild Orchid Size M8/W10 11016-6MB,Crocs Crocband Pearl Pink/Wild Orchid Size M8/W10 11016-6MB,FBALYB Amazon,-12,-12,0,0,0,0
,Crocs Crocband Pearl Pink/Wild Orchid Size M9/W11 11016-6MB,Crocs Crocband Pearl Pink/Wild Orchid Size M9/W11 11016-6MB,Default Ridgefield,234,234,0,0,0,0
,Crocs Crocband Pearl Pink/Wild Orchid Size M9/W11 11016-6MB,Crocs Crocband Pearl Pink/Wild Orchid Size M9/W11 11016-6MB,FBALYB Amazon,134,134,0,135,0,0
,Crocs Crocband White Size M10/W12 11016-100,Crocs Crocband White Size M10/W12 11016-100,FBALYB Amazon,-1,-1,0,0,0,0
,Crocs Crocband White Size M11 11016-100,Crocs Crocband White Size M11 11016-100,FBALYB Amazon,-2,-2,0,0,0,0
,Crocs Crocband White Size M13 11016-100,Crocs Crocband White Size M13 11016-100,FBALYB Amazon,11,10,1,0,1,0
,Crocs Crocband White Size M7/W9 11016-100,Crocs Crocband White Size M7/W9 11016-100,FBALYB Amazon,-3,-3,0,0,0,0
,Crocs Crocband White Size M8/W10 11016-100,Crocs Crocband White Size M8/W10 11016-100,FBALYB Amazon,-3,-3,0,0,0,0
,Crocs Crocband White Size M9/W11 11016-100,Crocs Crocband White Size M9/W11 11016-100,FBALYB Amazon,1,1,0,0,0,0
,Crocs Patricia Black/Black Size W10 10386-060,Crocs Patricia Black/Black Size W10 10386-060,FBALYB Amazon,16,13,3,0,3,0
,Crocs Patricia Black/Black Size W6 10386-060,Crocs Patricia Black/Black Size W6 10386-060,FBALYB Amazon,-1,-1,0,0,0,0
,Crocs Patricia Black/Black Size W7 10386-060,Crocs Patricia Black/Black Size W7 10386-060,Default Ridgefield,10,10,0,0,0,0
,Crocs Patricia Black/Black Size W8 10386-060,Crocs Patricia Black/Black Size W8 10386-060,FBALYB Amazon,-2,-2,0,0,0,0
,Crocs Patricia Black/Black Size W9 10386-060,Crocs Patricia Black/Black Size W9 10386-060,FBALYB Amazon,-4,-4,0,0,0,0
,"CROOKED RIVER,AXIS FOLDER,STUD B15080-2","CROOKED RIVER,AXIS FOLDER,STUD B15080-2",FBALYB Amazon,-9,-25,16,0,16,0
,Cross action refill 8pc,Cross action refill 8pc,Avrami - Ebay,92,92,0,0,0,0
,Cross action refill 8pc,Cross action refill 8pc,Default Ridgefield,6,6,0,0,0,0
,Cross action refill 8pc,Cross action refill 8pc,FBALYB Amazon,-249,-261,12,226,12,0
,Cross action refill 8pc,Cross action refill 8pc,WFS,-24,-24,0,0,0,0
,"Crunchmaster Crackers, 3 pk","Crunchmaster Multi-Grain Crackers, 3 pk./7 oz.",Default,0,0,0,0,0,21
,"Crunchmaster Crackers, 3 pk","Crunchmaster Multi-Grain Crackers, 3 pk./7 oz.",FBALYB Amazon,27,27,0,1,0,0
,Crunchmaster Multi-Grain 28oz,"Crunchmaster Oven Baked Crunchy Multi-Grain Crackers, 28 Ounce",Default,0,0,0,0,0,203
,Crunchmaster Multi-Grain 28oz,"Crunchmaster Oven Baked Crunchy Multi-Grain Crackers, 28 Ounce",FBALYB Amazon,29,29,0,0,0,0
,Crunchmaster Multi-Grain 6 Seed 567g,Crunchmaster Multi-Grain 6 Seed 567g,FBALYB Amazon,2,2,0,0,0,0
,"Crunchmaster, Multi-Grain, Original Crackers","Crunchmaster, Multi-Grain, Original Crackers",FBALYB Amazon,11,11,0,1,0,0
,Crunchmaster Rice Crackers 595g,Crunchmaster Rice Crackers 595g,FBALYB Amazon,166,166,0,2,0,0
,CRYODERM ROLL ON 3 oz,CRYODERM ROLL ON 3 oz,Default Ridgefield,4,4,0,0,0,0
,CRYODERM ROLL ON 3 oz,CRYODERM ROLL ON 3 oz,FBALYB Amazon,2,1,1,0,1,0
,CRYODERM ROLL ON 3 oz 2 PK,CRYODERM ROLL ON 3 oz 2 PK,Default,0,-2,2,0,0,0
,CRYODERM ROLL ON 3 oz 2 PK,CRYODERM ROLL ON 3 oz 2 PK,FBALYB Amazon,95,90,5,58,5,0
,CRYODERM ROLL ON 3 oz 3 PK,CRYODERM ROLL ON 3 oz 3 PK,FBALYB Amazon,43,43,0,0,0,0
,CRYODERM ROLL ON 3 oz 4 PK,CRYODERM ROLL ON 3 oz 4 PK,FBALYB Amazon,40,36,4,0,4,0
,CRYODERM ROLL ON 3 oz 5 PK,CRYODERM ROLL ON 3 oz 5 PK,FBALYB Amazon,42,41,1,0,1,0
,Crystal Light 16  ct. 3 Pack,Crystal Light 16  ct. 3 Pack,FBALYB Amazon,162,152,10,0,10,0
,Crystal Light Lemonade Stix,Crystal Light Lemonade Stix 16C/32Q,FBALYB Amazon,-1,-2,1,0,1,0
,Crystal Light Lemonade Stix 16C/32Q 2pk,Crystal Light Lemonade Stix 16C/32Q 2pk,FBALYB Amazon,17,17,0,3,0,0
,Crystal light peach mango green tea 4 pa,"Crystal Light On The Go Green Tea Peach Mango, 10-Count Boxes (Pack of 4)",FBALYB Amazon,-1,-1,0,0,0,0
,C&S Wild Bird Nuggets 27oz 6pk,C&S Wild Bird Nuggets 27oz 6pk,FBALYB Amazon,4,4,0,0,0,0
,Cuisinart Air Fryer Toaster,Cuisinart Air Fryer Toaster Oven 2862957,Default,0,0,0,0,0,1
,Cuisinart Air Fryer Toaster,Cuisinart Air Fryer Toaster Oven 2862957,FBALYB Amazon,-12,-12,0,0,0,0
,Cuisinart Compact automatic Bread Maker - 1443918,Cuisinart Compact automatic Bread Maker - 1443918,FBALYB Amazon,194,167,27,0,27,0
,Cuisinart Compact automatic Bread Maker - 1443918,Cuisinart Compact automatic Bread Maker - 1443918,FBALYB Canada,20,20,0,0,0,0
,Cuisinart Spiralizer,Cuisinart Spiralizer ,FBALYB Amazon,-8,-8,0,8,0,0
,Culinary Treasures Apple Dressing 2pk,Culinary Treasures Apple Dressing 2pk,FBALYB Amazon,25,25,0,0,0,0
,"Current USA 36‑48"" Orbit Marine Aquarium Accessory","Current USA 36‑48"" Orbit Marine IC Reef Aquarium Accessory",FBALYB Amazon,1,1,0,0,0,0
,"Current USA Orbit Marine Light Fixture 48""-60""","Current USA Orbit Marine IC Accessory Light Fixture Only 48""-60""",FBALYB Amazon,-1,-1,0,1,0,0
,"Cut Heal Pad Heal For Dogs, 8 Oz","Cut Heal Pad Heal For Dogs, 8 Oz",FBALYB Amazon,1,1,0,1,0,0
,"Cutter 32-Oz. Backyard Bug Control Spray Concentrate, 2 pk.","Cutter 32-Oz. Backyard Bug Control Spray Concentrate, 2 pk.",FBALYB Amazon,4,4,0,0,0,0
,CytoSport Chocolate Whey Powder 6lb,CytoSport Chocolate Whey Powder 6lb,FBALYB Amazon,3,3,0,0,0,0
,Daconil Fungicide 16oz,Daconil Fungicide 16oz,FBALYB Amazon,2,2,0,0,0,0
,Daily Shield Lotion Tinted SPF 50 1.7 fl oz,Daily Shield Lotion Tinted SPF 50 1.7 fl oz,Default Ridgefield,204,204,0,0,0,0
,Dallmayr Crema D'oro 2pk,Dallmayr Crema D'oro 2pk,FBALYB Amazon,211,211,0,0,0,0
,Dallmayr Crema d`Oro Beans 500g,Dallmayr Crema d`Oro Beans 500g,Default Ridgefield,0,-12,12,0,0,0
,Dallmayr Prodomo Decaf Ground Coffee 500g,Dallmayr Prodomo Decaf Ground Coffee 500g,FBALYB Amazon,-2,-2,0,0,0,0
,Dallmayr Prodomo Ground 500g,Dallmayr Prodomo Ground 500g,Default,0,-2088,2088,0,0,0
,Dallmayr Prodomo Ground 500g,Dallmayr Prodomo Ground 500g,Default Ridgefield,72,-6,78,0,0,0
,Dallmayr Prodomo Ground 500g,Dallmayr Prodomo Ground 500g,FBALYB Amazon,3,3,0,0,0,0
,Dallmayr Prodomo Ground 500g 2pk,Dallmayr Prodomo Ground 500g 2pk ,FBALYB Amazon,287,286,1,3,1,0
,Dallmayr Prodomo Ground 500g 3PK,Dallmayr Prodomo Ground 500g 3PK,FBALYB Amazon,10,10,0,0,0,0
,Dallmayr Prodomo Ground 500g 6pk,Dallmayr Prodomo Ground 500g 6pk,FBALYB Amazon,8,8,0,1,0,0
,Dallmayr Prodomo Ground Coffee 250g,Dallmayr Prodomo Ground Coffee 250g,FBALYB Amazon,1,1,0,0,0,0
,Dallmayr Prodomo Ground Coffee 250g 3pk,Dallmayr Prodomo Ground Coffee 250g 3pk,FBALYB Amazon,2,2,0,0,0,0
,Dallmayr Prodomo Whole Bean 500g,Dallmayr Prodomo Whole Bean 500g,Default,0,-396,396,0,0,0
,Dallmayr Prodomo Whole Bean 500g,Dallmayr Prodomo Whole Bean 500g,FBALYB Amazon,58,58,0,0,0,0
,Dallmayr Prodomo Whole Bean 500g 2pk,Dallmayr Prodomo Whole Bean 500g 2pk,FBALYB Amazon,60,60,0,6,0,0
,Damp Rid Drop In MA Refills FG97 15.8 oz,Damp Rid Drop In MA Refills FG97 15.8 oz,Default CT,1,1,0,0,0,0
,Damp Rid Drop In MA Refills FG97 15.8 oz,Damp Rid Drop In MA Refills FG97 15.8 oz,Default Ridgefield,650,650,0,0,0,0
,Damp Rid Drop In MA Refills FG97 15.8 oz,Damp Rid Drop In MA Refills FG97 15.8 oz,FBALYB Amazon,365,362,3,0,3,0
,Damp Rid FG118 Disposable Moisture Absorber Charcoal 18oz,Damp Rid FG118 Disposable Moisture Absorber Charcoal 18oz,Default CT,13,13,0,0,0,0
,Damp Rid FG118 Disposable Moisture Absorber Charcoal 18oz,Damp Rid FG118 Disposable Moisture Absorber Charcoal 18oz,Default Ridgefield,6,6,0,0,0,0
,Damp Rid FG118 Disposable Moisture Absorber Charcoal 18oz 2PK,Damp Rid FG118 Disposable Moisture Absorber Charcoal 18oz 2PK,FBALYB Amazon,1394,1378,16,0,16,0
,Damp Rid FG118 Disposable Moisture Absorber Charcoal 18oz 3PK,Damp Rid FG118 Disposable Moisture Absorber Charcoal 18oz 3PK,Default,0,-6,6,0,0,0
,Damp Rid FG118 Disposable Moisture Absorber Charcoal 18oz 3PK,Damp Rid FG118 Disposable Moisture Absorber Charcoal 18oz 3PK,Default Ridgefield,0,-6,6,0,0,0
,Damp Rid FG118 Disposable Moisture Absorber Charcoal 18oz 3PK,Damp Rid FG118 Disposable Moisture Absorber Charcoal 18oz 3PK,FBALYB Amazon,2473,2275,198,60,198,0
,Damp Rid FG118RV Moisture Absorber Charcoal 18oz,Damp Rid FG118RV Moisture Absorber Charcoal 18oz,Default CT,240,240,0,0,0,0
,Damp Rid FG118RV Moisture Absorber Charcoal 18oz,Damp Rid FG118RV Moisture Absorber Charcoal 18oz,Default Ridgefield,7,7,0,0,0,0
,Damp Rid FG30k Fragrance Free Refill Bag 42oz,Damp Rid FG30k Fragrance Free Refill Bag 42oz,Default CT,900,900,0,0,0,0
,Damp Rid FG30k Fragrance Free Refill Bag 42oz,Damp Rid FG30k Fragrance Free Refill Bag 42oz,Default Ridgefield,268,268,0,0,0,186
,Damp Rid FG30k Fragrance Free Refill Bag 42oz,Damp Rid FG30k Fragrance Free Refill Bag 42oz,FBALYB Amazon,327,324,3,6,3,0
,Damp Rid FG30k Fragrance Free Refill Bag 42oz 2pk,Damp Rid FG30k Fragrance Free Refill Bag 42oz 2pk,FBALYB Amazon,116,115,1,0,1,0
,Damp Rid FG60 Refillable Moisture Absorber 2-10.5oz,,Default Ridgefield,7,7,0,0,0,0
,Damp Rid FG60 Refillable Moisture Absorber 2-10.5oz(2 pack  4 total pieces),Damp Rid FG60 Refillable Moisture Absorber 2-10.5oz(2 pack  4 total pieces),FBALYB Amazon,20,19,1,0,1,0
,Damp Rid FG80FF Fragrance Free Hanging Moisture Absorber 14 oz,Damp Rid FG80FF Fragrance Free Hanging Moisture Absorber 14 oz,Default CT,0,-2280,2280,0,0,0
,Damp Rid FG80FF Fragrance Free Hanging Moisture Absorber 14 oz,Damp Rid FG80FF Fragrance Free Hanging Moisture Absorber 14 oz,Default Ridgefield,267,267,0,0,0,0
,Damp Rid FG80FF Fragrance Free Hanging Moisture Absorber 14 oz 2pk,Damp Rid FG80FF Fragrance Free Hanging Moisture Absorber 14 oz 2pk,FBALYB Amazon,-5,-5,0,0,0,0
,Damp Rid FG80FF Fragrance Free Hanging Moisture Absorber 14 oz 3pk,Damp Rid FG80FF Fragrance Free Hanging Moisture Absorber 14 oz 3pk,Default,0,-7,7,0,0,0
,Damp Rid FG80FF Fragrance Free Hanging Moisture Absorber 14 oz 3pk,Damp Rid FG80FF Fragrance Free Hanging Moisture Absorber 14 oz 3pk,FBALYB Amazon,-290,-290,0,169,0,0
,Damp Rid FG80FF Fragrance Free Hanging Moisture Absorber 14 oz 6pk,Damp Rid FG80FF Fragrance Free Hanging Moisture Absorber 14 oz 6pk,FBALYB Amazon,761,760,1,75,1,0
,Damp Rid FG80LV Lavender Vanilla Scent Hanging Moisture Absorber 14oz,Damp Rid FG80LV Lavender Vanilla Scent Hanging Moisture Absorber 14oz,Default Oxford,6,6,0,0,0,0
,Damp Rid FG80LV Lavender Vanilla Scent Hanging Moisture Absorber 14oz,Damp Rid FG80LV Lavender Vanilla Scent Hanging Moisture Absorber 14oz,Default Ridgefield,9,9,0,0,0,0
,Damp Rid FG80LV Lavender Vanilla Scent Hanging Moisture Absorber 14oz 6pk,Damp Rid FG80LV Lavender Vanilla Scent Hanging Moisture Absorber 14oz 6pk,FBALYB Amazon,1,1,0,2,0,0
,Damp Rid FG80 Powder Fresh Scent Hanging Moisture Absorber 14 oz,Damp Rid FG80 Powder Fresh Scent Hanging Moisture Absorber 14 oz,Default Ridgefield,0,0,0,0,0,19800
,Damp Rid FG80 Powder Fresh Scent Hanging Moisture Absorber 14 oz 6PK,Damp Rid FG80 Powder Fresh Scent Hanging Moisture Absorber 14 oz 6PK,FBALYB Amazon,838,833,5,165,5,0
,Damp Rid FG80 Powder Fresh Scent Hanging Moisture Absorber 14 oz 9pk,Damp Rid FG80 Powder Fresh Scent Hanging Moisture Absorber 14 oz 9pk,Default,0,-4,4,0,0,0
,Damp Rid FG80 Powder Fresh Scent Hanging Moisture Absorber 14 oz 9pk,Damp Rid FG80 Powder Fresh Scent Hanging Moisture Absorber 14 oz 9pk,FBALYB Amazon,61,50,11,291,11,0
,Damprid fresh scent 2pk,Damprid fresh scent 2pk,FBALYB Amazon,177,177,0,1,0,0
,Damp Rid Fresh Scent Bucket 4PK,Damp Rid Fresh Scent Bucket 4PK,FBALYB Amazon,60,57,3,0,3,0
,Damp Rid Fresh Scent Bucket 4PK,Damp Rid Fresh Scent Bucket 4PK,FBALYB Canada,0,0,0,14,0,0
,Damprid Fresh Scent Buckets 6pk,Damprid Fresh Scent Buckets 6pk,FBALYB Amazon,94,82,12,190,12,0
,Damp Rid Fresh Scent Bucket Single,Damp Rid Fresh Scent Bucket Single,Default Ridgefield,540,540,0,0,0,0
,Damp Rid Fresh Scent Bucket Single 2pk,Damp Rid Fresh Scent Bucket Single 2pk,FBALYB Amazon,57,39,18,0,18,0
,Damp Rid Lavender Bucket 3pk,Damp Rid Lavender Bucket 3pk,FBALYB Amazon,29,24,5,0,5,0
,Damp Rid Lavender Bucket Single,Damp Rid Lavender Vanilla Bucket Single,Default Ridgefield,9,9,0,0,0,0
,Damprid Lavender Vanilla 6pk,Damprid Lavender Vanilla Bucket 6pk,FBALYB Amazon,-173,-178,5,127,5,0
,DampRid Moisture Absorber 2pk (8ct total),DampRid Moisture Absorber 2pk (8ct total),FBALYB Amazon,173,145,28,0,28,0
,DampRid Moisture Absorber 4 pk,"DampRid Hanging Moisture Absorber, Fresh Scent, 4 pk.",FBALYB Amazon,-17,-17,0,23,0,0
,Damp Rid Refillable Moisture Absorber Frag Free FG01K 10.5 Oz,Damp Rid Refillable Moisture Absorber Frag Free FG01K 10.5 Oz,Default CT,700,700,0,0,0,0
,Damp Rid Refillable Moisture Absorber Frag Free FG01K 10.5 Oz,Damp Rid Refillable Moisture Absorber Frag Free FG01K 10.5 Oz,FBALYB Amazon,562,560,2,0,2,0
,Damp Rid Refillable Moisture Absorber Frag Free FG01K 10.5 Oz 6PK,Damp Rid Refillable Moisture Absorber Frag Free FG01K 10.5 Oz 6PK,FBALYB Amazon,20,20,0,0,0,0
,Damp Rid Super Refill Frag Free FG37 7.5 lb,Damp Rid Super Refill Frag Free FG37 7.5 lb,Default CT,2,2,0,0,0,0
,Damp Rid Super Refill Frag Free FG37 7.5 lb,Damp Rid Super Refill Frag Free FG37 7.5 lb,Default Ridgefield,19,19,0,0,0,516
,Damp Rid Super Refill Frag Free FG37 7.5 lb,Damp Rid Super Refill Frag Free FG37 7.5 lb,FBALYB Amazon,345,303,42,6,42,0
,Damp Rid Super Refill Frag Free FG37 7.5 lb,Damp Rid Super Refill Frag Free FG37 7.5 lb,FBALYB Canada,0,0,0,100,0,0
,Damp Rid Super Refill Frag Free FG37 7.5 lb 2pk,Damp Rid Super Refill Frag Free FG37 7.5 lb 2pk,Default Ridgefield,0,-1,1,0,0,0
,Damp Rid Super Refill Frag Free FG37 7.5 lb 2pk,Damp Rid Super Refill Frag Free FG37 7.5 lb 2pk,FBALYB Amazon,146,89,57,2,57,0
,Danner 500gph Pump With 18' Cord,Danner Pondmaster 500gph Pump With 18' Cord,FBALYB Amazon,0,-2,2,0,2,0
,Danner Mfg Pond Mag 9.5 Pump 950GPH,Danner Mfg Pond Mag 9.5 Pump 950GPH,FBALYB Amazon,1,1,0,0,0,0
,Danner Part Impeller/mag For Pump Md 1.9,Danner Part Impeller/mag For Pump Md 1.9,FBALYB Amazon,-5,-5,0,6,0,0
,Danner Supreme 18 1800 GPH Pump,Danner Mag-Drive Supreme 18 1800 GPH Pump,FBALYB Amazon,0,-1,1,0,1,0
,DANSK 4 LB BUTTER COOKIES,DANSK 4 LB BUTTER COOKIES BJ's,FBALYB Amazon,10,9,1,2,1,0
,Dark Magic Extra Bold K Cups 24ct,Dark Magic Extra Bold K Cups 24ct ,Default,0,0,0,0,0,120
,Dark + Medium Espresso Ground 250G 6PK,Dark + Medium Espresso Ground 250G 6PK,FBALYB Amazon,1,1,0,0,0,0
,Darth Vader Waffle Maker,Darth Vader Waffle Maker,FBALYB Amazon,1,1,0,0,0,0
,DaVinci A.D.K,DaVinci A.D.K,Default Ridgefield,8,8,0,0,0,0
,DaVinci A.D.K,DaVinci A.D.K,FBALYB Amazon,503,503,0,1,0,0
,DaVinci Hair Effects,DaVinci Hair Effects,FBALYB Amazon,-1,-1,0,0,0,0
,DaVinci Iron Bis-Glycinate,DaVinci Iron Bis-Glycinate,FBALYB Amazon,2,2,0,0,0,0
,DaVinci Liposomal C,DaVinci Liposomal C,Default,0,-154,154,0,0,0
,DaVinci Liposomal C,DaVinci Liposomal C,FBALYB Amazon,-4,-4,0,0,0,0
,DaVinci Mega Probiotic ND,DaVinci Mega Probiotic ND,FBALYB Amazon,1,1,0,0,0,0
,DaVinci Tri-Mag 300,DaVinci Tri-Mag 300,Default,0,-12,12,0,0,0
,DaVinci Tri-Mag 300,DaVinci Tri-Mag 300,FBALYB Amazon,9,9,0,0,0,0
,Dawn Dish Soap 3pk,Dawn Dish Soap Original 3pk,FBALYB Amazon,46,46,0,269,0,0
,Dawn Dish Soap Platinum 3pk,Dawn Dish Soap Platinum 3pk,FBALYB Amazon,1296,1180,116,1050,116,0
,Dawn Dish Soap Platinum 3pk,Dawn Dish Soap Platinum 3pk,FBALYB Canada,0,0,0,100,0,0
,Dawn Platinum Advanced 709 ml,Dawn Platinum Advanced 709 ml,Default,0,-10206,10206,0,0,0
,Dawn Platinum Advanced 709 ml,Dawn Platinum Advanced 709 ml,Default Ridgefield,3847,3559,288,0,0,0
,Dawn Platinum Dish Detergent,Dawn Platinum Advanced Power Dish Detergent,Default,0,0,0,0,0,7
,Dawn Platinum Dish Detergent,Dawn Platinum Advanced Power Dish Detergent,FBALYB Amazon,3,3,0,0,0,0
,Dawn Pomegranate Soap 75oz,"Dawn Hand Renewal with Olay, Pomegranate Splash, 75 oz.",FBALYB Amazon,34,30,4,41,4,0
,DAWN POWERWASH 1 PLUS 2 16OZ,DAWN POWERWASH 1 PLUS 2 16OZ,Default,0,-20,20,0,0,0
,DAWN POWERWASH 1 PLUS 2 16OZ,DAWN POWERWASH 1 PLUS 2 16OZ,FBALYB Amazon,716,716,0,429,0,0
,Dawn Powerwash 473ml Refill,Dawn Powerwash 473ml Refill,Default Ridgefield,50,50,0,0,0,0
,Dawn Powerwash 473ml Refill 3PK,Dawn Powerwash 473ml Refill 3PK,FBALYB Amazon,-2,-3,1,0,1,0
,Dawn Powerwash 473ml Refill 4PK,Dawn Powerwash 473ml Refill 4PK,FBALYB Amazon,-1,-1,0,0,0,0
,Dawn Powerwash 473ml Refill 5 pack,Dawn Powerwash 473ml Refill 5 pack,FBALYB Amazon,5,1,4,0,4,0
,DAWN POWERWASH Spray + 1 Refill,DAWN POWERWASH Spray + 1 Refill,FBALYB Amazon,484,482,2,168,2,0
,DAWN POWERWASH Spray + 2 Refills,DAWN POWERWASH Spray + 2 Refills,FBALYB Amazon,1065,910,155,5,155,0
,Dawn Powerwash Spray Bottle 473ml,Dawn Powerwash Spray Bottle 473ml,Default Ridgefield,334,334,0,0,0,0
,Dawn Powerwash Spray Bottle 473ml,Dawn Powerwash Spray Bottle 473ml,FBALYB Amazon,143,142,1,2,1,0
,Dawn Powerwash Spray Bottle 473ml 6PK,Dawn Powerwash Spray Bottle 473ml 6PK,FBALYB Amazon,56,54,2,0,2,0
,Dawn Professional Dish Detergent - 1 gallon,Dawn Professional Dish Detergent - 1 gallon,Default Ridgefield,1,1,0,0,0,0
,Dawn Professional Dish Detergent - 1 gallon,Dawn Professional Dish Detergent - 1 gallon,FBALYB Amazon,2292,2263,29,919,29,0
,Dawn Professional Dish Detergent - 1 gallon,Dawn Professional Dish Detergent - 1 gallon,FBALYB Canada,1,1,0,8,0,0
,Day Repair SPF 30 1.75oz,Day Repair SPF 30 1.75oz,FBALYB Amazon,0,0,0,1,0,0
,Del Monte Tomatoes 6 Ct,"Del Monte Stewed Tomatoes 14.5 Oz, 6 Count",FBALYB Amazon,1,1,0,0,0,0
,Delon Cotton Rounds 3 x 100,Delon Cotton Rounds 3 x 100,FBALYB Amazon,-7,-10,3,0,3,0
,Delon Cotton Rounds 4 x 100,Delon Cotton Rounds 4 x 100,FBALYB Amazon,-14,-14,0,16,0,0
,Delon Cotton Rounds 5 x 100,Delon Cotton Rounds 5 x 100,FBALYB Amazon,-27,-29,2,26,2,0
,Delon Cotton Rounds 9 x 100,Delon Cotton Rounds 9 x 100,FBALYB Amazon,2,-8,10,0,10,0
,Delon Facial Cleansing Cotton 2 x 100,Delon Facial Cleansing Cotton 2 x 100,FBALYB Amazon,-2,-2,0,0,0,0
,Delon Facial Cleansing Cotton 8 x 100,Delon Facial Cleansing Cotton 8 x 100,FBALYB Amazon,215,215,0,0,0,0
,DeLonghi Livenza 5 in 1 Grill Silver CGH912C,DeLonghi Livenza 5 in 1 Grill Silver CGH912C,Default,0,-4,4,0,0,1
,DeLonghi Livenza 5 in 1 Grill Silver CGH912C,DeLonghi Livenza 5 in 1 Grill Silver CGH912C,Default Ridgefield,0,-2,2,0,0,0
,DeLonghi Livenza 5 in 1 Grill Silver CGH912C,DeLonghi Livenza 5 in 1 Grill Silver CGH912C,FBALYB Amazon,2,2,0,0,0,0
,Demet's Original Turtles 2pk,Demet's Original Turtles 2pk,FBALYB Amazon,2,2,0,3,0,0
,Dental Chew Catnip 11 oz,Dental Chew Catnip 11 oz,Default Ridgefield,0,-27,27,0,0,0
,Dentyne  Ice Peppermint,Dentyne  Ice Peppermint 12 CT,FBALYB Amazon,67,67,0,0,0,0
,Deodorant Spray Grapefruit &lemongra 6pk,Deodorant Spray Grapefruit &lemongra 6pk,FBALYB Amazon,785,779,6,2,6,0
,Dermacol Dermacol Make-up Cover 209 30g,Dermacol Dermacol Make-up Cover 209 30g,Avrami - Ebay,40,40,0,0,0,0
,Dermacol Dermacol Make-up  Cover 218 30g,Dermacol Dermacol Make-up  Cover 218 30g,Avrami - Ebay,25,25,0,0,0,0
,Dermacol Dermacol Make-up  Cover 221 30g,Dermacol Dermacol Make-up  Cover 221 30g,Avrami - Ebay,2,2,0,0,0,0
,Dermacol Dermacol Make-up  Cover 222 30g,Dermacol Dermacol Make-up  Cover 222 30g,Avrami - Ebay,39,39,0,0,0,0
,Dermacol Dermacol Make-up  Cover 223 30g,Dermacol Dermacol Make-up  Cover 223 30g,Avrami - Ebay,53,53,0,0,0,0
,Dermacol Make-up Cover 207,Dermacol Make-up Cover 207,Avrami - Ebay,151,151,0,0,0,0
,Dermacol Make-up Cover 208,Dermacol Make-up Cover 208,Avrami - Ebay,284,284,0,0,0,0
,Dermacol Make-up Cover 210,Dermacol Make-up Cover 210,Avrami - Ebay,203,203,0,0,0,0
,Dermacol Make-up Cover 215,Dermacol Make-up Cover 215,Avrami - Ebay,77,77,0,0,0,0
,Dermal Therapy Heel Cream 8oz,Dermal Therapy Heel Cream 8oz,FBALYB Amazon,5,5,0,0,0,0
,Desk jet 3634,HP DeskJet 3634 Compact All-in-One Photo Printer with Wireless & Mobile Print...,FBALYB Amazon,11,11,0,0,0,0
,Dettol Antiseptic Liquid 750m 4PK,Dettol Antiseptic Liquid 750m 4PK,Default,0,-5,5,0,0,0
,Dettol Antiseptic Liquid 750m 4PK,Dettol Antiseptic Liquid 750m 4PK,FBALYB Amazon,-1,-3,2,0,2,0
,Dettol Antiseptic Liquid 750ml,Dettol Antiseptic Liquid 750ml,Default,0,-1968,1968,0,0,0
,Dettol Antiseptic Liquid 750ml,Dettol Antiseptic Liquid 750ml,FBALYB Amazon,285,277,8,13,8,0
,Dettol Antiseptic Liquid 750ml 2PK,Dettol Antiseptic Liquid 750ml 2PK,Default,0,-2,2,0,0,0
,Dettol Antiseptic Liquid 750ml 2PK,Dettol Antiseptic Liquid 750ml 2PK,FBALYB Amazon,2,-19,21,10,21,0
,Dettol Antiseptic Liquid 750ml 3PK,Dettol Antiseptic Liquid 750ml 3PK,FBALYB Amazon,-1,-6,5,1,5,0
,Dettol Antiseptic Liquid 750ml 6pk,Dettol Antiseptic Liquid 750ml 6pk,FBALYB Amazon,6,6,0,0,0,0
,Dial Soap 4pk,Dial Soap 4pk,FBALYB Amazon,117,117,0,0,0,0
,"Dingo Rawhide Bones Ringo, 5ct 4pk","Dingo Rawhide Bones Ringo, 5ct 4pk",FBALYB Amazon,1,1,0,0,0,0
,Disney Cinderella Hair Styling,Disney Princess Cinderella Majestic Hair Styling Head,Default,95,95,0,0,0,0
,Disney Cinderella Hair Styling,Disney Princess Cinderella Majestic Hair Styling Head,Default Ridgefield,4,4,0,0,0,0
,Disney Descendants Evie Doll,Disney Descendants Signature Doll Evie,Default Ridgefield,2,2,0,0,0,0
,Disney Descendants Jordan,Disney Descendants Genie Chic Jordan of Auradon Prep,FBALYB Amazon,1,1,0,0,0,0
,Disney Descendants Mal Doll,"Disney Descendants Signature Mal 11"" Doll",Default Ridgefield,1,1,0,0,0,0
,Disney Frozen Anna Majestic Hair Styling 944972,Disney Frozen Anna Majestic Hair Styling 944972,Default Ridgefield,4,4,0,0,0,0
,Disney Frozen Elsa Small Doll,Disney Frozen Elsa Small Doll,FBALYB Amazon,0,0,0,1,0,0
,Disney frozen workbench,Disney Frozen 24 Multi-Functional Folding Storage Bench with 200 lb Weight Su...,FBALYB Amazon,8,8,0,0,0,0
,Disney Incredibles 2 Family Pack,Disney Pixar Incredibles 2 Family Pack with Super Vehicles,Default,0,0,0,0,0,12
,Disney Incredibles 2 Family Pack,Disney Pixar Incredibles 2 Family Pack with Super Vehicles,FBALYB Amazon,-7,-7,0,1,0,0
,Disney Mal of Isle of The Lost,Disney Descendants Genie Chic Mal of Isle of The Lost,FBALYB Amazon,-1,-1,0,0,0,0
,Disney Pixar Toy Story 4 Blast-Off Buzz Lightyear Figure,Disney Pixar Toy Story 4 Blast-Off Buzz Lightyear Figure,FBALYB Amazon,-32,-32,0,16,0,0
,Disney/Pixar Toy Story 4 True Talkers Rex Figure,Disney/Pixar Toy Story 4 True Talkers Rex Figure,FBALYB Amazon,-44,-44,0,1,0,0
,Disney Pixar Toy Story True Talkers Forky Figure,Disney Pixar Toy Story True Talkers Forky Figure,FBALYB Amazon,-3,-3,0,0,0,0
,Disney Pixar Toy Story True Talkers Woody,Disney Pixar Toy Story True Talkers Woody,Default,8,-192,200,0,0,0
,Disney Pixar Toy Story True Talkers Woody,Disney Pixar Toy Story True Talkers Woody,FBALYB Amazon,-129,-131,2,88,2,0
,"Dixie Ultra Paper Bowls, 20 oz, 108 Count","Dixie Ultra Paper Bowls, 20 oz, 108 Count",Default,0,-87,87,0,0,0
,"Dixie Ultra Paper Bowls, 20 oz, 108 Count","Dixie Ultra Paper Bowls, 20 oz, 108 Count",FBALYB Amazon,-2,-5,3,2,3,0
,Dog Rocks Lawn Burn Prevention 2 month,Dog Rocks Lawn Burn Prevention 2 month,FBALYB Amazon,7,7,0,0,0,0
,Dog Rocks Lawn Burn Prevention 6 month supply,"Dog RocksDog Rocks Lawn Burn Prevention 600g 6 month supply,1Case",FBALYB Amazon,14,9,5,0,5,0
,Dogswell Hip/Joint Chicken Jerky 24oz,Dogswell Hip/Joint Chicken Jerky 24oz,Default,0,0,0,0,0,1
,Dogswell Hip/Joint Duck Jerky 10oz,Dogswell Hip/Joint Duck Jerky 10oz,FBALYB Amazon,0,0,0,50,0,0
,Dolce Gusto Au Lait 3pk,Dolce Gusto Au Lait 3pk,Default,0,-1,1,0,0,0
,Dolce Gusto Au Lait 3pk,Dolce Gusto Au Lait 3pk,FBALYB Amazon,1212,1099,113,233,113,0
,Dolce Gusto Au Lait 3pk,Dolce Gusto Au Lait 3pk,FBALYB Canada,0,0,0,30,0,0
,Dolce Gusto Au Lait 3pk,Dolce Gusto Au Lait 3pk,WFS,-268,-277,9,0,9,0
,DOLCE GUSTO CAFE AU LAIT  16ct,DOLCE GUSTO CAFE AU LAIT  16ct,Avrami - Ebay,862,862,0,0,0,0
,Dolce Gusto Cafe Au Lait Decaf 16 ct 3pk,Dolce Gusto Cafe Au Lait Decaf 16 ct 3pk,FBALYB Amazon,2,2,0,0,0,0
,Dolce Gusto Caffe Lungo 16ct 3pk,Dolce Gusto Caffe Lungo 16ct 3pk,Default,0,-6,6,0,0,0
,Dolce Gusto Caffe Lungo 16ct 3pk,Dolce Gusto Caffe Lungo 16ct 3pk,FBALYB Amazon,619,550,69,137,69,0
,Dolce Gusto Caffe Lungo 16ct 3pk,Dolce Gusto Caffe Lungo 16ct 3pk,FBALYB Canada,34,34,0,0,0,0
,Dolce Gusto Cappuccino Capsules 16ct 3pk,Dolce Gusto Cappuccino Capsules 16ct 3pk,Default,0,-364,364,0,0,0
,Dolce Gusto Cappuccino Capsules 16ct 3pk,Dolce Gusto Cappuccino Capsules 16ct 3pk,FBALYB Amazon,194,145,49,979,49,0
,Dolce Gusto Cappuccino Capsules 16ct 3pk,Dolce Gusto Cappuccino Capsules 16ct 3pk,FBALYB Canada,0,0,0,281,0,0
,"Dolce Gusto Cappucino ""16ct""","Dolce Gusto Cappucino ""16ct""	",Default,0,-10707,10707,0,0,0
,"Dolce Gusto Cappucino ""16ct""","Dolce Gusto Cappucino ""16ct""	",Default Ridgefield,2392,2392,0,0,0,0
,Dolce Gusto Cappucino & Cafe Au Lait,Dolce Gusto Cappucino & Cafe Au Lait ,FBALYB Amazon,2,-7,9,1,9,0
,Dolce Gusto Caramel Latte Macchiato 16ct,Dolce Gusto Caramel Latte Macchiato 16ct,Default Ridgefield,7193,7193,0,0,0,0
,Dolce Gusto Caramel Latte Macchiato 16ct 3pk,Dolce Gusto Caramel Latte Macchiato 16ct 3pk,FBALYB Amazon,179,179,0,0,0,0
,Dolce Gusto Caramel Latte Macchiato 16ct 3pk,Dolce Gusto Caramel Latte Macchiato 16ct 3pk,FBALYB Canada,20,20,0,0,0,0
,Dolce Gusto Chai Tea Latte Cpsl 16ct 3pk,Dolce Gusto Chai Tea Latte Cpsl 16ct 3pk,FBALYB Amazon,24,23,1,2,1,0
,"Dolce Gusto Chocochino Caramel ""16 ct""","Dolce Gusto Chocochino Caramel ""16 ct""",Default CT,0,-3,3,0,0,0
,"Dolce Gusto Chocochino Caramel ""16 ct"" 3pk","Dolce Gusto Chocochino Caramel ""16 ct"" 3pk",FBALYB Amazon,2,2,0,5,0,0
,Dolce Gusto Chococino 16 caps,Dolce Gusto Chococino 16 caps,Default Ridgefield,573,573,0,0,0,0
,Dolce Gusto Chococino Capsules 16ct 3pk,Dolce Gusto Chococino Capsules 16ct 3pk,FBALYB Amazon,71,66,5,40,5,0
,Dolce Gusto Chococino Capsules 16ct 3pk,Dolce Gusto Chococino Capsules 16ct 3pk,FBALYB Canada,0,0,0,25,0,0
,"Dolce Gusto Cortado ""16ct""","Dolce Gusto Cortado Espresso Macchiato ""16ct""",Default Ridgefield,737,377,360,0,0,0
,"Dolce Gusto Cortado ""16ct""","Dolce Gusto Cortado Espresso Macchiato ""16ct""",FBALYB Amazon,135,127,8,0,8,0
,Dolce Gusto Cortado 16ct 3pk,Dolce Gusto Cortado 16ct 3pk,FBALYB Amazon,351,312,39,2,39,0
,Dolce Gusto Cortado 48ct 3pk,Dolce Gusto Cortado 48ct 3pk,FBALYB Amazon,12,12,0,20,0,0
,Dolce Gusto Cortado 48ct 3pk,Dolce Gusto Cortado 48ct 3pk,FBALYB Canada,1,1,0,0,0,0
,Dolce GustoCrmlLatteMacchiato16ct3pk,Dolce GustoCrmlLatteMacchiato16ct3pk,FBALYB Amazon,514,499,15,332,15,0
,Dolce GustoCrtdoEprsoMachiatoCpsl16ct3pk,Dolce GustoCrtdoEprsoMachiatoCpsl16ct3pk,FBALYB Amazon,36,28,8,53,8,0
,Dolce Gusto Dallmayr Crema d'Oro 16 Ct 3PK,Dolce Gusto Dallmayr Crema d'Oro 16 Ct 3PK,FBALYB Amazon,4,3,1,0,1,0
,Dolce Gusto Dallmayr Prodomo 16 Ct 3pk,Dolce Gusto Dallmayr Prodomo 16 Ct 3pk,FBALYB Amazon,5,5,0,0,0,0
,"Dolce Gusto Espresso ""16ct""","Dolce Gusto Espresso ""16ct""",Default,0,-1725,1725,0,0,0
,"Dolce Gusto Espresso ""16ct""","Dolce Gusto Espresso ""16ct""",Default Oxford,57,57,0,0,0,0
,"Dolce Gusto Espresso ""16ct""","Dolce Gusto Espresso ""16ct""",Default Ridgefield,2622,2622,0,0,0,0
,Dolce Gusto Espresso Ardenzo 16 Ct,Dolce Gusto Espresso Ardenza 16 Ct,Default,0,-450,450,0,0,0
,Dolce Gusto Espresso Ardenzo 16 Ct,Dolce Gusto Espresso Ardenza 16 Ct,Default Oxford,54,54,0,0,0,0
,Dolce Gusto Espresso Ardenzo 16 Ct 3PK,Dolce Gusto Espresso Ardenzo 16 Ct 3PK,Default,0,-162,162,0,0,0
,Dolce Gusto Espresso Ardenzo 16 Ct 3PK,Dolce Gusto Espresso Ardenzo 16 Ct 3PK,FBALYB Amazon,12,12,0,4,0,0
,Dolce Gusto Espresso Barista Cpsl16ct3pk,Dolce Gusto Espresso Barista Cpsl16ct3pk,FBALYB Amazon,-128,-134,6,246,6,0
,Dolce Gusto Espresso Capsules 16ct 3pk,Dolce Gusto Espresso Capsules 16ct 3pk,FBALYB Amazon,108,104,4,63,4,0
,Dolce Gusto Espresso Capsules 16ct 3pk,Dolce Gusto Espresso Capsules 16ct 3pk,FBALYB Canada,-1,-1,0,50,0,0
,Dolce Gusto Espresso Decaffeinato 16 caps 3pk,Dolce Gusto Espresso Decaffeinato 16 caps 3pk,FBALYB Amazon,6,6,0,0,0,0
,Dolce Gusto EspressoIntensoCpsl16ct3pk,Dolce Gusto EspressoIntensoCpsl16ct3pk,FBALYB Amazon,745,735,10,390,10,0
,Dolce Gusto Flat White 16 ct,Dolce Gusto Flat White 16 ct,Default Ridgefield,2,2,0,0,0,0
,Dolce Gusto Flat White 16 ct,Dolce Gusto Flat White 16 ct,FBALYB Amazon,3,1,2,0,2,0
,Dolce Gusto Flat White 48 ct (3pk),Dolce Gusto Flat White 48 ct (3pk),FBALYB Amazon,195,185,10,24,10,0
,DOLCE GUSTO GRANDE INTENSO 16CT,DOLCE GUSTO GRANDE INTENSO 16CT,FBALYB Amazon,5,4,1,1,1,0
,DOLCE GUSTO GRANDE INTENSO 16CT 3pk,DOLCE GUSTO GRANDE INTENSO 16CT 3pk,FBALYB Amazon,187,187,0,5,0,0
,DOLCE GUSTO GRANDE INTENSO 16CT 3pk,DOLCE GUSTO GRANDE INTENSO 16CT 3pk,WFS,-78,-78,0,0,0,0
,"Dolce Gusto Intenso Espreso ""16ct""","DOLCE GUSTO ESPRESSO INTENSO ""16ct""",Default Ridgefield,6,6,0,0,0,0
,"Dolce Gusto Latte Machiato ""16ct""","Dolce Gusto Latte Machiato ""16ct""",Default Ridgefield,30,30,0,0,0,0
,"Dolce Gusto Latte Machiato ""16ct"" 3PK","Dolce Gusto Latte Machiato ""16ct"" 3PK",FBALYB Amazon,101,78,23,34,23,0
,"Dolce Gusto Lungo ""16ct""","Dolce Gusto Lungo ""16ct""",Default,0,-4038,4038,0,0,0
,"Dolce Gusto Lungo ""16ct""","Dolce Gusto Lungo ""16ct""",Default Oxford,129,129,0,0,0,0
,"Dolce Gusto Lungo ""16ct""","Dolce Gusto Lungo ""16ct""",Default Ridgefield,6,6,0,0,0,0
,Dolce Gusto Lungo Decaffeinato 16 Ct,Dolce Gusto Lungo Decaffeinato 16 Ct,Default Ridgefield,6,6,0,0,0,0
,Dolce Gusto Lungo Decaffeinato 16 Ct 3PK,Dolce Gusto Lungo Decaffeinato 16 Ct 3PK,Default,0,-6,6,0,0,0
,Dolce Gusto Lungo Decaffeinato 16 Ct 3PK,Dolce Gusto Lungo Decaffeinato 16 Ct 3PK,FBALYB Amazon,252,247,5,16,5,0
,Dolce Gusto Lungo Intenso 16 Ct 3 pk,Dolce Gusto Lungo Intenso 16 Ct 3 pk,FBALYB Amazon,4,4,0,0,0,0
,"Dolce Gusto Mocha ""16ct""","Dolce Gusto Mocha ""16ct""",Default,0,-864,864,0,0,0
,"Dolce Gusto Mocha ""16ct""","Dolce Gusto Mocha ""16ct""",Default Ridgefield,1609,1609,0,0,0,0
,"Dolce Gusto Mocha ""16ct"" 2pk","Dolce Gusto Mocha ""16ct"" 2pk",FBALYB Amazon,367,367,0,202,0,0
,Dolce Gusto Mocha Capsules 16ct 3pk,Dolce Gusto Mocha Capsules 16ct 3pk,FBALYB Amazon,23,21,2,9,2,0
,Dolce Gusto Mocha Capsules 16ct 3pk,Dolce Gusto Mocha Capsules 16ct 3pk,FBALYB Canada,0,0,0,22,0,0
,"Dolce Gusto Nesquik ""16ct""","Dolce Gusto Nesquik ""16ct""",Default Oxford,30,30,0,0,0,0
,"Dolce Gusto Nesquik ""16ct""","Dolce Gusto Nesquik ""16ct""",FBALYB Amazon,123,123,0,6,0,0
,"Dolce Gusto Nesquik ""16ct""","Dolce Gusto Nesquik ""16ct""",WFS,-38,-42,4,0,4,0
,Dolce Gusto Vanilla Latte Macchiato 16 Ct,Dolce Gusto Vanilla Latte Macchiato 16 Ct,Default Ridgefield,4198,4198,0,0,0,0
,Dolce Gusto Vanilla Latte Macchiato 16 Ct,Dolce Gusto Vanilla Latte Macchiato 16 Ct,FBALYB Amazon,274,273,1,2,1,0
,Dolce Gusto Vanilla Latte Macchiato 16 Ct 3pk,Dolce Gusto Vanilla Latte Macchiato 16 Ct 3pk,FBALYB Amazon,80,73,7,0,7,0
,Dolce Gusto Variety Macchiatto 3PK,Dolce Gusto Variety Macchiatto 3PK,FBALYB Amazon,361,358,3,6,3,0
,Dolce GustoVnilaLatteMachiatoCpsl16ct3pk,Dolce GustoVnilaLatteMachiatoCpsl16ct3pk,FBALYB Amazon,202,195,7,3,7,0
,Dole Pineapple Juice 24 cans,"Dole 100% Pineapple Juice ‑ 24 cans, 8.4 fl oz each",FBALYB Amazon,16,16,0,0,0,0
,Domino 4lb Confection Sugar,Domino 4lb Confection Sugar,FBALYB Amazon,2,2,0,0,0,0
,Domino Sugar Packets 1000 pack,Domino Sugar Packets 1000 pack,FBALYB Amazon,8,8,0,0,0,0
,Domino Sugar Resealable 10 lb,"Domino Sugar, Granulated, Plastic Resealable Bag, 10 lb. ",Default,0,0,0,0,0,2
,Domino Sugar Resealable 10 lb,"Domino Sugar, Granulated, Plastic Resealable Bag, 10 lb. ",FBALYB Amazon,92,91,1,4,1,0
,Donut house coffee k cups 8 pack,Donut House Coffee - K Carafe - 8 ct,FBALYB Amazon,1,1,0,0,0,0
,Donut shop k cup 8 pack,Keurig 2.0 the Original Donut Shop Coffee K-carafe Packs (8),FBALYB Amazon,1,1,0,0,0,0
,Dove 10 Pc Variety 10 pk Deoderant,Dove Variety 10 pk Deoderant,Default,0,-391,391,0,0,0
,Dove 10 Pc Variety 10 pk Deoderant,Dove Variety 10 pk Deoderant,FBALYB Amazon,7165,7165,0,14,0,0
,Dove 10 Pc Variety 10 pk Deoderant,Dove Variety 10 pk Deoderant,WFS,-3,-3,0,0,0,0
,Dove 500 ml Coconut Oil Almond Milk 3pk,Dove 500 ml Coconut Oil Almond Milk 3pk,FBALYB Amazon,34,34,0,0,0,0
,Dove 500 ml coconut oil Almond milk Bodywash,Dove 500 ml coconut oil Almond milk Bodywash,Default Ridgefield,3557,3557,0,0,0,0
,Dove Anti-Perspirant Aerosol 150ml Female original 10 pk,Dove Anti-Perspirant Aerosol 150ml Female original 10 pk,Default,0,-6,6,0,0,0
,Dove Anti-Perspirant Aerosol 150ml Female original 10 pk,Dove Anti-Perspirant Aerosol 150ml Female original 10 pk,Default Ridgefield,0,-13,13,0,0,0
,Dove Anti-Perspirant Aerosol 150ml Female original 10 pk,Dove Anti-Perspirant Aerosol 150ml Female original 10 pk,FBALYB Amazon,-9,-9,0,2,0,0
,Dove Anti-Perspirant Aerosol 150ml Female original 3pk,Dove Anti-Perspirant Aerosol 150ml Female original 3pk,Default,0,-2,2,0,0,0
,Dove Anti-Perspirant Aerosol 150ml Female original 3pk,Dove Anti-Perspirant Aerosol 150ml Female original 3pk,FBALYB Amazon,-3,-3,0,1,0,0
,Dove Anti-Perspirant Aerosol 150ml Invisible 6pk,Dove Anti-Perspirant Aerosol 150ml Invisible 6pk,FBALYB Amazon,-427,-427,0,158,0,0
,Dove Anti-Perspirant Beauty Finish 6pk,Dove Anti-Perspirant Beauty Finish 6pk,FBALYB Amazon,8,8,0,1,0,0
,Dove Antiperspirant Original 2pk,Dove Antiperspirant Original 2pk,FBALYB Amazon,58,0,58,0,58,0
,Dove Antiperspirant Sensitive 6pk,Dove Antiperspirant Sensitive 6pk,FBALYB Amazon,-149,-163,14,161,14,0
,Dove Antiperspirant Spray Mineral Touch 150ml 3pk,Dove Antiperspirant Spray Mineral Touch 150ml 3pk,FBALYB Amazon,1,-1,2,0,2,0
,Dove Antiperspirant Spray Mineral Touch 150ml 6pk,Dove Antiperspirant Spray Mineral Touch 150ml 6pk,FBALYB Amazon,-19,-19,0,0,0,0
,"Dove Antiperspirant Spray, Mix of Different Flavors (Pack of 10)","Dove Antiperspirant Spray, Mix of Different Flavors (Pack of 10)",FBALYB Amazon,-1400,-1704,304,0,304,0
,Dove Antiperspirant Spray Talco 150ml,Dove Antiperspirant Spray Talco 150ml,Default Ridgefield,7,7,0,0,0,0
,Dove APA Invisible Care 150ML,Dove APA Invisible Care 150ML,Avrami - Ebay,240,240,0,0,0,0
,Dove APA Invisible Care 150ML,Dove APA Invisible Care 150ML,Default Oxford,20,20,0,0,0,0
,Dove APA Invisible Care 150ML 6pk,Dove APA Invisible Care 150ML 6pk,FBALYB Amazon,1271,1269,2,0,2,0
,Dove APA Matcha 150ML 3pk,Dove APA Matcha 150ML 3pk,FBALYB Amazon,32,31,1,0,1,0
,Dove APA Talc Feel Fresh 150ml,Dove APA Talc Feel Fresh 150ml,Default Ridgefield,1451,1451,0,0,0,0
,Dove Baby Wipes 50ct 6pk,Dove Baby Wipes 50ct 6pk,FBALYB Amazon,199,197,2,1,2,0
,Dove Baby Wipes Rich Moist 50pc,Dove Baby Wipes Rich Moist 50pc,Default Ridgefield,5183,5183,0,0,0,0
,Dove Baby Wipes Rich Moist 50pc 12pk,Dove Baby Wipes Rich Moist 50pc 12pk,FBALYB Amazon,74,74,0,5,0,0
,Dove Baby Wipes Rich Moist 50pc 3PK,Dove Baby Wipes Rich Moist 50pc 3PK,FBALYB Amazon,150,150,0,0,0,0
,Dove Baby Wipes Rich Moist 50pc 3PK,Dove Baby Wipes Rich Moist 50pc 3PK,FBALYB Canada,20,20,0,5,0,0
,Dove Baby Wipes Rich Moist 50pc 4pk,Dove Baby Wipes Rich Moist 50pc 4pk,FBALYB Amazon,146,145,1,0,1,0
,Dove Baby Wipes Sensitive,Dove Baby Wipes Sensitive,Default Ridgefield,2523,2523,0,0,0,0
,Dove Baby Wipes Sensitive 3pk,Dove Baby Wipes Sensitive 3pk,FBALYB Canada,0,0,0,54,0,0
,Dove Baby Wipes Sensitive 6PK,Dove Baby Wipes Sensitive 6PK,Default Ridgefield,8,8,0,0,0,0
,Dove Baby Wipes Sensitive 6PK,Dove Baby Wipes Sensitive 6PK,FBALYB Amazon,195,191,4,0,4,0
,Dove bath gel 500 ml. Original 3PK,Dove bath gel 500 ml. Original 3PK,FBALYB Amazon,32,32,0,0,0,0
,Dove Beauty Bar Soap Pink 6pk,Dove Beauty Bar Soap Pink 6pk,FBALYB Amazon,-1,-1,0,2,0,0
,Dove Beauty Bar Soap Revive 12pk,Dove Beauty Bar Soap Revive 12pk,FBALYB Amazon,-2,-6,4,0,4,0
,Dove Beauty Cream Bar Soaps Pink 16pk,Dove Beauty Cream Bar Soaps Pink 16pk,FBALYB Amazon,-1,-1,0,0,0,0
,Dove Beauty Cream Soap Bar 12pk,Dove Beauty Cream Soap Bar 12pk,FBALYB Amazon,-19,-19,0,87,0,0
,Dove Body & Face Wash Sport Active & Fresh For Men 400ml,Dove Body & Face Wash Sport Active & Fresh For Men 400ml,Default Ridgefield,236,236,0,0,0,0
,"Dove Bodywash 3pk (Shea Butter Warm Vanilla, Nourish + Restore Shower Gel, Cucumber)","Dove Bodywash 3pk (Shea Butter Warm Vanilla, Nourish + Restore Shower Gel, Cucumber)",FBALYB Amazon,6188,5928,260,6601,260,0
,Dove Body Wash 500ml go fresh 3 Pk,Dove Body Wash 500ml go fresh 3 Pk,FBALYB Amazon,-15,-15,0,112,0,0
,Dove BodyWash 500ml Shea butter,Dove BodyWash 500ml Shea butter ,FBALYB Amazon,5,5,0,0,0,0
,Dove BodyWash 500ml Shea butter 3PK,Dove BodyWash 500ml Shea butter 3PK,FBALYB Amazon,-49,-57,8,60,8,0
,Dove Body Wash Avocado 500ml,Dove Body Wash Avocado 500ml,Default Ridgefield,1109,1109,0,0,0,0
,Dove Body Wash Lotus Flower 500ml,Dove Body Wash Lotus Flower 500ml,Default Ridgefield,2304,2304,0,0,0,0
,Dove Body Wash Milk & Honey 500ml,Dove Body Wash Milk & Honey 500ml,Default Ridgefield,2395,2395,0,0,0,0
,Dove Bodywash Variety 3 Pack,Dove Bodywash Variety 3 Pack,Default,0,-360,360,0,0,0
,Dove Bodywash Variety 3 Pack,Dove Bodywash Variety 3 Pack,FBALYB Amazon,-548,-599,51,2254,51,0
,Dove Body Wash Velvet Soft 500ml 3pk,Dove Body Wash Velvet Soft 500ml 3pk,FBALYB Amazon,-101,-101,0,122,0,0
,Dove Clinical 3pk,Dove Clinical 3pk,FBALYB Amazon,2,2,0,0,0,0
,Dove Coconut Milk &Jasmine Body Wash 4pk,Dove Coconut Milk &Jasmine Body Wash 4pk,FBALYB Amazon,-86,-90,4,91,4,0
,Dove Conditioner 40oz,Dove Conditioner 40oz,Default,0,-2649,2649,0,0,0
,Dove Conditioner 40oz,Dove Conditioner 40oz,Default Ridgefield,722,722,0,0,0,0
,Dove Conditioner 40oz,Dove Conditioner 40oz,FBALYB Amazon,3,3,0,0,0,0
,Dove Cotton Soft 150ml 6pk,Dove Cotton Soft 150ml 6pk,FBALYB Amazon,1083,1066,17,3,17,0
,Dove Cotton Soft Anti-Perspirant Deodorant Spray Dry 48 Hour Protection 150 Ml,Dove Cotton Soft Anti-Perspirant Deodorant Spray Dry 48 Hour Protection 150 Ml,Default Ridgefield,6297,6297,0,0,0,14256
,Dove Cotton Soft Deodorant 3pk,Dove Cotton Soft Deodorant 3pk,FBALYB Amazon,10,10,0,0,0,0
,Dove Cream Bath Almond 500ml,Dove Cream Bath Almond 500ml,Default Ridgefield,541,541,0,0,0,0
,Dove Cucumber&GreenTea DeodorStick 4pk,Dove Cucumber&GreenTea DeodorStick 4pk,FBALYB Amazon,2,-1,3,1,3,0
,Dove Deeply Nourishing & Restore Bath Body Wash Shower Gel 16.9 Fl.  3 PK,Dove Deeply Nourishing & Restore Bath Body Wash Shower Gel 16.9 Fl.  3 PK,FBALYB Amazon,-57,-57,0,112,0,0
,Dove Deeply Nourishing & Restore Bath Body Wash Shower Gel 16.9 Fl. Oz/500 ml,Dove Deeply Nourishing & Restore Bath Body Wash Shower Gel 16.9 Fl. Oz/500 ml,Default Ridgefield,-1,-1,0,0,0,0
,Dove Deeply Nourishing & Restore Bath Body Wash Shower Gel 16.9 Fl. Oz/500 ml,Dove Deeply Nourishing & Restore Bath Body Wash Shower Gel 16.9 Fl. Oz/500 ml,FBAAP Amazon,3,3,0,0,0,0
,DOVE DEO ADV CLR TONE SHER TCH,DOVE DEO ADV CLR TONE SHER TCH,FBALYB Amazon,19,19,0,0,0,0
,DOVE DEO ADV CLR TONE SHER TCH 2pk,DOVE DEO ADV CLR TONE SHER TCH 2pk,FBALYB Amazon,419,419,0,0,0,0
,DOVE DEO ADV CLR TONE SHER TCH 2pk,DOVE DEO ADV CLR TONE SHER TCH 2pk,WFS,-9,-9,0,0,0,0
,Dove Deodorant Spray Apple & White Tea 150ml,Dove Deodorant Spray Apple & White Tea 150ml,Default Ridgefield,6,6,0,0,0,0
,Dove Dry Spray Beauty Finish 150 Ml,Dove Dry Spray Beauty Finish 150 Ml,Default Ridgefield,150,150,0,0,0,0
,Dove Dry Spray Beauty Finish 150 Ml 3pk,Dove Dry Spray Beauty Finish 150 Ml 3pk,FBALYB Amazon,17,16,1,0,1,0
,Dove For Men Invisible Dry APA Spray 150ml,Dove For Men Invisible Dry APA Spray 150ml,Default Ridgefield,1724,1724,0,0,0,0
,Dove For Men Invisible Dry APA Spray 150ml 6pk,Dove For Men Invisible Dry APA Spray 150ml 6pk,FBALYB Amazon,46,35,11,0,11,0
,Dove Gentle Exfo Beauty Cream Soap 12pk,Dove Gentle Exfo Beauty Cream Soap 12pk,FBALYB Amazon,-11,-15,4,15,4,0
,Dove Gentle Exfoliating 16.9oz 3pk,Dove Gentle Exfoliating 16.9oz 3pk,FBALYB Amazon,-598,-600,2,721,2,0
,Dove Gentle Exfoliating Body Wash 2pack,Dove Gentle Exfoliating Body Wash 2pack,FBALYB Amazon,-16,-16,0,0,0,0
,Dove Gentle Exfoliating Body Wash with Nutrium Moisture 16.9 Oz / 500 Ml,Dove Gentle Exfoliating Body Wash with Nutrium Moisture 16.9 Oz / 500 Ml,Default Ridgefield,3895,3895,0,0,0,0
,Dove Go Cucumber Green Tea 16.9pz 4pk,Dove Go Cucumber Green Tea 16.9 oz  4pk,FBALYB Amazon,-245,-245,0,240,0,0
,Dove Go Cucumber Spray 6pk,Dove Go Cucumber Spray 6pk,Default,185,-185,370,0,0,0
,Dove Go Cucumber Spray 6pk,Dove Go Cucumber Spray 6pk,Default Ridgefield,0,-7,7,0,0,0
,Dove Go Cucumber Spray 6pk,Dove Go Cucumber Spray 6pk,FBALYB Amazon,787,776,11,129,11,0
,Dove Go Fresh APA Pear & Aloe 150ml Spray,Dove Go Fresh APA Pear & Aloe 150ml Spray,Default Ridgefield,665,665,0,0,0,9816
,Dove Go Fresh APA Pear & Aloe 150ml Spray 3pk,Dove Go Fresh APA Pear & Aloe 150ml Spray 3pk,FBALYB Amazon,42,41,1,0,1,0
,Dove Go Fresh APA Pear & Aloe 150ml Spray 6pk,Dove Go Fresh APA Pear & Aloe 150ml Spray 6pk,Default,0,-2,2,0,0,0
,Dove Go Fresh APA Pear & Aloe 150ml Spray 6pk,Dove Go Fresh APA Pear & Aloe 150ml Spray 6pk,FBALYB Amazon,791,787,4,0,4,0
,Dove Go Fresh Body Wash Mandarin 16.9oz,Dove Go Fresh Body Wash Mandarin 16.9oz,FBALYB Amazon,-1,-1,0,0,0,0
,Dove Go Fresh Cucumber & Green Tea Deodorant 48h Spray 150 ml / 5 fl oz,Dove Go Fresh Cucumber & Green Tea Deodorant 48h Spray 150 ml / 5 fl oz,Default Ridgefield,6532,6532,0,0,0,0
,Dove Go Fresh Fresh Touch 100g Soap,Dove Go Fresh Fresh Touch 100g Soap,Default,204,204,0,0,0,0
,Dove Go Fresh Grapefruit / Lemongrass Deodorant Spray 150 ml,Dove Go Fresh Grapefruit / Lemongrass Deodorant Spray 150 ml,Default,0,-8940,8940,0,0,0
,Dove Go Fresh Grapefruit / Lemongrass Deodorant Spray 150 ml,Dove Go Fresh Grapefruit / Lemongrass Deodorant Spray 150 ml,Default Ridgefield,477,477,0,0,0,8244
,Dove Go Fresh Pomegranate 500 ML,Dove Go Fresh Pomegranate 500 ML,Default Ridgefield,55,55,0,0,0,0
,Dove Go Fresh Pomegranate & Lemon Verbena Deodorant Spray 150 ml,Dove Go Fresh Pomegranate & Lemon Verbena Deodorant Spray 150 ml,Default Oxford,227,227,0,0,0,0
,Dove Go Fresh Pomegranate & Lemon Verbena Deodorant Spray 150 ml,Dove Go Fresh Pomegranate & Lemon Verbena Deodorant Spray 150 ml,Default Ridgefield,1450,1450,0,0,0,2688
,Dove Go Fresh Revive Body Wash 3pack,Dove Go Fresh Revive Body Wash 3pack,FBALYB Amazon,23,2,21,0,21,0
,Dove GoFresh Revive Cream Bar Soap 8pk,Dove GoFresh Revive Cream Bar Soap 8pk,FBALYB Amazon,1,1,0,0,0,0
,Dove GoFresh Soap Touch Cucumber 12pk,Dove GoFresh Soap Touch Cucumber 12pk,FBALYB Amazon,1,1,0,0,0,0
,Dove Go Mandarin 16.9oz 3pk,Dove Go Mandarin 16.9oz 3pk,FBALYB Amazon,-1,-1,0,0,0,0
,Dove Hand Wash Cucumber&Green Tea 6pk,Dove Hand Wash Cucumber&Green Tea 6pk,FBALYB Amazon,54,52,2,1,2,0
,Dove Hand Wash Fine Silk 250ML/8.45oz,Dove Hand Wash Fine Silk 250ML/8.45oz,Default Ridgefield,6,6,0,0,0,0
,Dove Hand Wash Fine Silk 6PK,Dove Hand Wash Fine Silk 6PK,Default Ridgefield,5,5,0,0,0,0
,Dove Hand Wash Fine Silk 6PK,Dove Hand Wash Fine Silk 6PK,FBALYB Amazon,30,25,5,0,5,0
,Dove Hand Wash Fresh Touch Cucumber Green Tea 250ML,Dove Hand Wash Fresh Touch Cucumber Green Tea 250ML,Default Ridgefield,168,168,0,0,0,0
,Dove Hand Wash Original 250ML,Dove Hand Wash Original 250ML,Default Ridgefield,46,46,0,0,0,0
,Dove Hand Wash Original 6pk,Dove Hand Wash Original 6pk,FBALYB Amazon,8,7,1,1,1,0
,Dove invisible dry 150ml 2pk,Dove invisible dry 150ml 2pk,Default,0,-1,1,0,0,0
,Dove invisible dry 150ml 2pk,Dove invisible dry 150ml 2pk,Default Ridgefield,0,-2,2,0,0,0
,Dove invisible dry 150ml 2pk,Dove invisible dry 150ml 2pk,FBALYB Amazon,-7,-7,0,0,0,0
,Dove Invisible Dry 48Hs Deodorant 3pk,Dove Invisible Dry 48Hs Deodorant 3pk,FBALYB Amazon,2,1,1,2,1,0
,"Dove Invisible Dry Anti White Marks Antiperspirant Deodorant, 150 Ml","Dove Invisible Dry Anti White Marks Antiperspirant Deodorant, 150 Ml",Default Ridgefield,217,217,0,0,0,0
,"Dove Invisible Dry Anti White Marks Antiperspirant Deodorant, 150 Ml","Dove Invisible Dry Anti White Marks Antiperspirant Deodorant, 150 Ml",FBALYB Amazon,-1,-1,0,0,0,0
,"Dove Invisible Dry Anti White Marks Antiperspirant Deodorant, 150 Ml 3pk","Dove Invisible Dry Anti White Marks Antiperspirant Deodorant, 150 Ml 3pk",FBALYB Amazon,-289,-296,7,22,7,0
,Dove Invisible Dry Spray 10 Pack,Dove Invisible Dry Spray 10 Pack,Default Ridgefield,0,-1,1,0,0,0
,Dove Invisible Dry Spray 10 Pack,Dove Invisible Dry Spray 10 Pack,FBALYB Amazon,520,513,7,0,7,0
,DoveMen Antiperspir Minera&Sandalwood 6p,DoveMen Antiperspir Minera&Sandalwood 6p,FBALYB Amazon,406,401,5,1,5,0
,Dove Men Body&Face Wash CleanComfort 2pk,Dove Men Body&Face Wash CleanComfort 2pk,FBALYB Amazon,300,294,6,0,6,0
,Dove Men Body&Face Wash CleanComfort 2pk,Dove Men Body&Face Wash CleanComfort 2pk,FBALYB Canada,20,20,0,0,0,0
,Dove Men Body&Face Wash CleanComfort 3pk,Dove Men Body&Face Wash CleanComfort 3pk,FBALYB Amazon,56,52,4,590,4,0
,Dove Men Body&Face Wash CleanComfort 3pk,Dove Men Body&Face Wash CleanComfort 3pk,FBALYB Canada,19,19,0,0,0,0
,Dove Men Body&Face Wash Cool Fresh 3pk,Dove Men Body&Face Wash Cool Fresh 3pk,FBALYB Amazon,-1,-2,1,1,1,0
,Dove Men Body Wash Extra Fresh 2pk,Dove Men Body Wash Extra Fresh 2pk,FBALYB Amazon,122,74,48,0,48,0
,Dove Men BodyWash Minerals and Sage 3pk,Dove Men BodyWash Minerals and Sage 3pk,FBALYB Amazon,10,5,5,3,5,0
,Dove MenCare Body Wash Extra Fresh 3pk,Dove MenCare Body Wash Extra Fresh 3pk,FBALYB Amazon,1,1,0,2,0,0
,Dove Men Care Clean Comfort 150ml 9pk,Dove Men Care Clean Comfort 150ml 9pk,FBALYB Amazon,934,928,6,0,6,0
,Dove Men Care clean comfort 6pk,Dove Men Care clean comfort 6pk,FBALYB Amazon,1069,956,113,11,113,0
,Dove Men Care Clean Comfort Body Wash 400ML,Dove Men Care Clean Comfort Body Wash 400ML,Default,0,-72,72,0,0,0
,Dove Men Care Clean Comfort Body Wash 400ML,Dove Men Care Clean Comfort Body Wash 400ML,Default Ridgefield,12717,12717,0,0,0,0
,Dove Men Care Clean Comfort Body Wash 400ML 6 PACK,Dove Men Care Clean Comfort Body Wash 400ML 6 PACK,FBALYB Amazon,100,100,0,0,0,0
,Dove Men + Care Clean Comfort Spray Deodorant & Anti-Perspirant 150ML / 5.07 Oz,Dove Men + Care Clean Comfort Spray Deodorant & Anti-Perspirant 150ML / 5.07 Oz,Default Ridgefield,924,924,0,0,0,66828
,Dove Men Care Cool Fresh 6pk,Dove Men Care Cool Fresh 6pk,FBALYB Amazon,208,208,0,1,0,0
,Dove Men Care Cool Fresh Body Wash 400ML,Dove Men Care Cool Fresh Body Wash 400ML,Default Ridgefield,27,27,0,0,0,0
,Dove Men + Care Cool Fresh Spray Deodorant & Anti-Perspirant 150ml / 5.07 Oz,Dove Men + Care Cool Fresh Spray Deodorant & Anti-Perspirant 150ml / 5.07 Oz,Default Ridgefield,8482,8482,0,0,0,7122
,Dove Men Care Fresh Clean 2 in 1 Shampoo Conditioner,Dove Men Care Fresh Clean 2 in 1 Shampoo Conditioner,FBALYB Amazon,-32,-33,1,61,1,0
,Dove Men Care Mineral+Sagebody Wash 400ML,Dove Men Care Mineral+Sagebody Wash 400ML,Default Ridgefield,3623,1823,1800,0,0,0
,Dove Men Care Mineral+Sagebody Wash 400ML 6PK,Dove Men Care Mineral+Sagebody Wash 400ML 6PK,FBALYB Amazon,92,91,1,0,1,0
,Dove Men+Care Minerals + Sage Deodorant 150ML 5.07oz,Dove Men+Care Minerals + Sage Deodorant 150ML 5.07oz,Default Ridgefield,2163,2163,0,0,0,0
,Dove Men+Care Minerals+Sandlewood Talco Deodorant 150ML/5.07oz,Dove Men+Care Minerals+Sandlewood Talco Deodorant 150ML/5.07oz,Default Ridgefield,4275,4275,0,0,0,0
,Dove Men Care Sage Deodorant 6pk,Dove Men Care Sage Deodorant 6pk,FBALYB Amazon,-3,-3,0,0,0,0
,DoveMenCare SilverControl 48hr Spray 6pk,DoveMenCare SilverControl 48hr Spray 6pk,FBALYB Amazon,13,13,0,0,0,0
,Dove Men Charcoal and Clay 400ml Body Wash,Dove Men Charcoal and Clay 400ml Body Wash,Default Ridgefield,11401,11401,0,0,0,0
,Dove Men Charcoal and Clay 400ml Body Wash,Dove Men Charcoal and Clay 400ml Body Wash,FBALYB Amazon,159,159,0,0,0,0
,Dove Men Charcoal and Clay 400ml Body Wash 4pk,Dove Men Charcoal and Clay 400ml Body Wash 4pk,FBALYB Amazon,-6,-18,12,0,12,0
,Dove Men Charcoal and Clay 400ml Body Wash 6pk,Dove Men Charcoal and Clay 400ml Body Wash 6pk,FBALYB Amazon,430,429,1,71,1,0
,Dove Men Charcoal Clay Body Wash 3pk,Dove Men Charcoal Clay Body Wash 3pk,FBALYB Amazon,33,25,8,0,8,0
,Dove Men Clean Comfort Roll-on 3 pk,Dove Men Clean Comfort Roll-on 3 pk,FBALYB Amazon,6,-2,8,0,8,0
,"Dove Men Deodorant, Cool Silver 3oz 3pk","Dove Men Deodorant, Cool Silver 3oz 3pk",FBALYB Amazon,-6,-6,0,5,0,0
,Dove Men Extra Fresh 12pack,Dove Men Extra Fresh 12pack,FBALYB Amazon,-6,-6,0,0,0,0
,Dove men extra fresh 150ml 6pk,Dove men extra fresh 150ml 6pk,FBALYB Amazon,802,784,18,7,18,0
,Dove Men Extra Fresh 400ml Body Wash,Dove Men Extra Fresh 400ml Body Wash,Default,0,-420,420,0,0,0
,Dove Men Extra Fresh 400ml Body Wash,Dove Men Extra Fresh 400ml Body Wash,Default Ridgefield,10,10,0,0,0,0
,Dove Men Extra Fresh Antiperspirant Deodorant 48h Spray 150 ml,Dove Men Extra Fresh Antiperspirant Deodorant 48h Spray 150 ml,Default Ridgefield,2073,2073,0,0,0,31440
,Dove Men Extra Fresh Deodorant 3pk,Dove Men Extra Fresh Deodorant 3pk,FBALYB Amazon,-39,-39,0,1,0,0
,Dove Men Invisible Spray Deodorant 3pk,Dove Men Invisible Spray Deodorant 3pk,FBALYB Amazon,69,69,0,0,0,0
,Dove Men Spray Deodorant Invisible 6pk,Dove Men Spray Deodorant Invisible 6pk,FBALYB Amazon,1033,1033,0,5,0,0
,Dove Men Spray Deodorant Invisible 6pk,Dove Men Spray Deodorant Invisible 6pk,WFS,-109,-109,0,0,0,0
,Dove Natural Touch Dead Sea Minerals Deodorant Spray 150ml,Dove Natural Touch Dead Sea Minerals Deodorant Spray 150ml ,Default Ridgefield,36,36,0,0,0,0
,Dove original 3pk and men 3pk bundle,Dove original 3pk and men 3pk bundle,Default,0,-1,1,0,0,0
,Dove original 3pk and men 3pk bundle,Dove original 3pk and men 3pk bundle,FBALYB Amazon,-4,-5,1,4,1,0
,Dove Original 48Hs Anti-Perspirant 3pk,Dove Original 48Hs Anti-Perspirant 3pk,FBALYB Amazon,-2,-2,0,4,0,0
,Dove Original Anti-Perspirant 2pk,Dove Original Anti-Perspirant 2pk,Default Ridgefield,41,41,0,0,0,0
,Dove Original Anti-Perspirant 2pk,Dove Original Anti-Perspirant 2pk,FBALYB Amazon,74,68,6,0,6,0
,Dove Original Antiperspirant Deodorant 150 ml,Dove Original Antiperspirant Deodorant 150 ml,Avrami - Ebay,33,33,0,0,0,0
,Dove Original Antiperspirant Deodorant 150 ml,Dove Original Antiperspirant Deodorant 150 ml,Default,0,-9576,9576,0,0,0
,Dove Original Antiperspirant Deodorant 150 ml,Dove Original Antiperspirant Deodorant 150 ml,Default Oxford,663,663,0,0,0,0
,Dove Original Antiperspirant Deodorant 150 ml,Dove Original Antiperspirant Deodorant 150 ml,Default Ridgefield,7356,7356,0,0,0,7128
,Dove Original Antiperspirant Deodorant 150 ml,Dove Original Antiperspirant Deodorant 150 ml,WFS,2847,2847,0,0,0,0
,Dove Original Antiperspirant Deodorant 150 ml - 3pk,Dove Original Antiperspirant Deodorant 150 ml - 3pk,WFS,-96,-96,0,0,0,0
,Dove Original Spray 6pack,Dove Original Spray 6pack,Default,13,-3,16,0,0,0
,Dove Original Spray 6pack,Dove Original Spray 6pack,Default Ridgefield,-2,-13,11,0,0,0
,Dove Original Spray 6pack,Dove Original Spray 6pack,FBALYB Amazon,690,663,27,73,27,0
,Dove Original Spray 6pack,Dove Original Spray 6pack,WFS,-76,-76,0,0,0,0
,Dove Pistachio Cream Body Wash 6pk,Dove Pistachio Cream Body Wash 6pk,FBALYB Amazon,1,1,0,0,0,0
,Dove Pistachio Cream with Magnolia Body Wash 16.9oz/500ml,Dove Pistachio Cream with Magnolia Body Wash 16.9oz/500ml,Default Ridgefield,3762,3762,0,0,0,0
,Dove Pomegranate 150ml 6pk,Dove Pomegranate 150ml 6pk,FBALYB Amazon,-226,-227,1,4,1,0
,Dove Purely Coconut Milk Jasmine 3pk,Dove Purely Coconut Milk Jasmine 3pk,FBALYB Amazon,-1749,-1750,1,1364,1,0
,"Dove Purely Pampering Body Wash, Coconut Milk with Jasmine 16.9 Oz / 500 Ml","Dove Purely Pampering Body Wash, Coconut Milk with Jasmine 16.9 Oz / 500 Ml",Default Ridgefield,3746,3746,0,0,0,0
,"Dove Purely Pampering Body Wash, Shea Butter with Warm Vanilla, 16.9 Ounce/500 Ml","Dove Purely Pampering Body Wash, Shea Butter with Warm Vanilla, 16.9 Ounce/500 Ml",FBALYB Amazon,358,322,36,0,36,0
,Dove Purely Pistachio 16.9oz 3pk,Dove Purely Pistachio 16.9oz 3pk,FBALYB Amazon,4,4,0,2,0,0
,Dove Purely Pistachio 16.9oz 4pk,Dove Purely Pistachio 16.9oz 4pk,FBALYB Amazon,276,276,0,10,0,0
,Dove Purely Shea Butter Vanilla 16.9oz 4,Dove Purely Shea Butter Vanilla 16.9oz 4pk,FBALYB Amazon,287,285,2,66,2,0
,Dove restoring Care Castor Oil 500 ml,Dove restoring Care Castor Oil 500 ml,Default Ridgefield,10,10,0,0,0,0
,Dove rich nourishing cream 75ml 3 pk,Dove rich nourishing cream 75ml 3 pk,FBALYB Amazon,380,380,0,0,0,0
,Dove rich nourishing cream 75ml 3 pk,Dove rich nourishing cream 75ml 3 pk,WFS,-20,-20,0,0,0,0
,Dove Roll-On Go Fresh Pomegranate 4pk,Dove Roll-On Go Fresh Pomegranate 4pk,FBALYB Amazon,-1,-1,0,0,0,0
,Dove Roll On Men Care Clean Comfort 50ML,Dove Roll On Men Care Clean Comfort 50ML,Default Ridgefield,3600,3600,0,0,0,0
,Dove Roll On Original 50ML,Dove Roll On Original 50ML,Default,0,-378,378,0,0,0
,Dove Roll On Original 50ML,Dove Roll On Original 50ML,Default Ridgefield,1474,1474,0,0,0,0
,Dove Sensitive for Men 150ml APA Spray,Dove Sensitive for Men 150ml APA Spray,Default Ridgefield,359,359,0,0,0,0
,Dove Sensitive Skin Beauty Bar 100g/3.5oz x 2 x 24,Dove Sensitive Skin Beauty Bar 100g/3.5oz x 2 x 24,Default Ridgefield,16,16,0,0,0,0
,Dove SensitiveSkin SoapBar Unscented 12p,Dove SensitiveSkin SoapBar Unscented 12p,FBALYB Amazon,-10,-12,2,12,2,0
,Dove Sensitive Spray Anti-Perspirant 48h Protection 150 Ml,Dove Sensitive Spray Anti-Perspirant 48h Protection 150 Ml ,Default Ridgefield,18,18,0,0,0,0
,Dove Shampoo 40oz,Dove Shampoo 40oz,Default,0,-2649,2649,0,0,1
,Dove Shampoo 40oz,Dove Shampoo 40oz,Default Ridgefield,133,133,0,0,0,0
,Dove Shampoo & Conditioner 40oz,Dove Shampoo & Conditioner 40oz,Default,0,-30,30,0,0,0
,Dove Shampoo & Conditioner 40oz,Dove Shampoo & Conditioner 40oz,FBALYB Amazon,3,-97,100,689,100,0
,Dove Shea Butter Bar Soap 12pk,Dove Shea Butter Bar Soap 12pk,FBALYB Amazon,198,1,197,0,197,0
,Dove Shower Foam 13.5oz 1ct,Dove Shower Foam 13.5oz 1ct,Default,0,0,0,0,0,575
,Dove Shower Foam 13.5oz 1ct 2pk,Dove Shower Foam 13.5oz 1ct 2pk,FBALYB Amazon,17,17,0,1,0,0
,Dove Shower Foam 13.5oz 1ct 3pk,Dove Shower Foam 13.5oz 1ct 3pk,FBALYB Amazon,-1,-1,0,7,0,0
,Dove Silk Glow Body Wash 16.9oz,Dove Silk Glow Body Wash 16.9oz,Default Ridgefield,133,133,0,0,0,0
,Dove Silk Glow BodyWash 3pack 16.9oz,Dove Silk Glow BodyWash 3pack 16.9oz,FBALYB Amazon,2,2,0,0,0,0
,Dove Silky Cream 300 ML 4pk,Dove Silky Cream 300 ML 4pk,Default Ridgefield,0,-13,13,0,0,0
,"Dove Silky Nourishing Body Cream, 300m","Dove Silky Nourishing Body Cream, 300m",Default,0,-58,58,0,0,0
,"Dove Silky Nourishing Body Cream, 300m 2pk","Dove Silky Nourishing Body Cream, 300m 2pk",FBALYB Amazon,-2,-2,0,0,0,0
,Dove Silver Spray APA 150ml for Men,Dove Silver Spray APA 150ml for Men,Default Ridgefield,5020,5020,0,0,0,0
,dove soap 100g coconut 1 bar,dove soap 100g coconut 1 bar,Default Ridgefield,1611,1611,0,0,0,0
,Dove soap 100g White Beauty Bar,Dove soap 100g White Beauty Bar,Default Ridgefield,7,7,0,0,0,0
,Dove Soap Bar Moroccan Argan Oil 12pk,Dove Soap Bar Moroccan Argan Oil 12pk,FBALYB Amazon,3,2,1,0,1,0
,Dove Soap Cream Oil 100g,Dove Soap Cream Oil 100g,Default Ridgefield,676,676,0,0,0,0
,dove soap exfoliating 1 bar 100g,dove soap exfoliating 1 bar 100g,Default Ridgefield,1456,1456,0,0,0,0
,dove soap exfoliating 1 bar 100g 24PK,dove soap exfoliating 1 bar 100g 24PK,FBALYB Amazon,2,2,0,0,0,0
,Dove Soap GoFresh Revive Pomegranate 100g,Dove Soap GoFresh Revive Pomegranate 100g,Default Ridgefield,48,48,0,0,0,0
,Dove Soap GoFresh Touch Cucumber 100g,Dove Soap GoFresh Touch Cucumber 100g,Default Ridgefield,1190,1190,0,0,0,0
,Dove Soap Pampering Coconut Milk 12pk,Dove Soap Pampering Coconut Milk 12pk,FBALYB Amazon,-2,-5,3,0,3,0
,Dove Soap Pink 100g,Dove Soap Pink 100g,Default Ridgefield,1445,1445,0,0,0,0
,Dove Soap Pink 100g 8pk,Dove Soap Pink 100g 8pk,FBALYB Amazon,-3,-3,0,0,0,0
,Dove Soft Feel Antiperspirant Deodorant Spray 150 Ml,Dove Soft Feel Antiperspirant Deodorant Spray 150 Ml,Default Ridgefield,3539,3539,0,0,0,0
,Dove Spray Grapefruit &Lemongrass 2pk,Dove Spray Grapefruit &Lemongrass 2pk,Default,0,-1,1,0,0,0
,Dove Spray Grapefruit &Lemongrass 2pk,Dove Spray Grapefruit &Lemongrass 2pk,FBALYB Amazon,216,215,1,2,1,0
,Dove Spray Original+Extra Fresh 6pk,Dove Spray Original+Extra Fresh 6pk,Default Ridgefield,0,-2,2,0,0,0
,Dove Stick Deodorant 40ml Beauty Finish,Dove Stick Deodorant 40ml Beauty Finish ,Default Ridgefield,426,426,0,0,0,0
,Dove Stick Deodorant 40ml Invisible Dry,Dove Stick Deodorant 40ml Invisible Dry,Default Ridgefield,480,480,0,0,0,0
,Dove Stick Deodorant 40ml Mineral Touch,Dove Stick Deodorant 40ml Mineral Touch,Default Ridgefield,480,480,0,0,0,0
,Dove Stick Deodorant 40ml Original,Dove Stick Deodorant 40ml Original ,Default Ridgefield,432,432,0,0,0,0
,Dove Stick Deodorant 40ml Pear & Aloe Vera,Dove Stick Deodorant 40ml Pear & Aloe Vera,Default Ridgefield,480,480,0,0,0,0
,Dove Stick Deodorant 40ml Soft Powder,Dove Stick Deodorant 40ml Soft Powder ,Default Ridgefield,186,186,0,0,0,0
,Dove Stick Deodorant GoFresh Cucumber Green Tea 40ML,Dove Stick Deodorant GoFresh Cucumber Green Tea 40ML ,Default Ridgefield,12,12,0,0,0,0
,Dove Talco Deodorant Spray 6pk,Dove Talco Deodorant Spray 6pk,Default,0,-1,1,0,0,0
,Dove Variety 16.9oz 6 Pack,Dove Variety 16.9oz 6 Pack,Default,0,-11,11,0,0,0
,Dove Variety 16.9oz 6 Pack,Dove Variety 16.9oz 6 Pack,FBALYB Amazon,2314,1877,437,1522,437,0
,Dove Variety 16.9oz 6 Pack,Dove Variety 16.9oz 6 Pack,FBALYB Canada,-1,-1,0,0,0,0
,Dove Variety 6 pack,Dove Men Variety 6 pack,Default,0,-6150,6150,0,0,0
,Dove Variety 6 pack,Dove Men Variety 6 pack,FBALYB Amazon,5761,5710,51,36,51,0
,Dove Variety Pack of Soaps 2each 16 bars,Dove Variety Pack of Soaps 2each 16 bars,FBALYB Amazon,21,21,0,0,0,0
,DR 10 L,DR 10 L,FBALYB Amazon,-11,-11,0,1,0,0
,DR 60 MK2,DR 60 MK2,FBALYB Amazon,-6,-6,0,2,0,0
,"Dr. Andrew Weil for Mega-Bright SPF 30 Skin Tone Correcting Oil-Free Moisturizer, 1.7 oz","Dr. Andrew Weil for Mega-Bright SPF 30 Skin Tone Correcting Oil-Free Moisturizer, 1.7 oz",Default Ridgefield,295,295,0,0,0,0
,"Dr. Andrew Weil for Mega-Bright SPF 30 Skin Tone Correcting Oil-Free Moisturizer, 1.7 oz","Dr. Andrew Weil for Mega-Bright SPF 30 Skin Tone Correcting Oil-Free Moisturizer, 1.7 oz",FBALYB Amazon,113,112,1,0,1,0
,Dr. Dennis Gross - All-In-One Facial Cleanser w/ Toner 6.0 fl oz/180ml,Dr. Dennis Gross - All-In-One Facial Cleanser w/ Toner 6.0 fl oz/180ml,Default Ridgefield,24,24,0,0,0,0
,Dr. Dennis Gross - All-In-One Facial Cleanser w/ Toner 6.0 fl oz/180ml,Dr. Dennis Gross - All-In-One Facial Cleanser w/ Toner 6.0 fl oz/180ml,FBALYB Amazon,0,-1,1,0,1,0
,Dr. Dennis Gross - Alpha Beta Glow Pad for Body 8 application,Dr. Dennis Gross - Alpha Beta Glow Pad for Body 8 application,Default Ridgefield,120,120,0,0,0,0
,Dr. Dennis Gross - Alpha Beta® Peel Extra Strength Formula 30 app jars,Dr. Dennis Gross - Alpha Beta® Peel Extra Strength Formula 30 app jars,FBALYB Amazon,16,16,0,0,0,0
,Dr. Dennis Gross - Alpha Beta® Peel Extra Strength Formula 30 app jars,Dr. Dennis Gross - Alpha Beta® Peel Extra Strength Formula 30 app jars,WFS,-11,-11,0,0,0,0
,Dr. Dennis Gross - Alpha Beta® Peel Extra Strength Formula 30 packettes,Dr. Dennis Gross - Alpha Beta® Peel Extra Strength Formula 30 packettes,FBALYB Amazon,1,1,0,0,0,0
,Dr. Dennis Gross - Alpha Beta® Peel Extra Strength Formula 5 applications,Dr. Dennis Gross - Alpha Beta® Peel Extra Strength Formula 5 applications,FBALYB Amazon,-3,-3,0,0,0,0
,Dr. Dennis Gross - Alpha Beta® Peel Extra Strength Formula 60 Packettes,Dr. Dennis Gross - Alpha Beta® Peel Extra Strength Formula 60 Packettes,FBALYB Amazon,8,2,6,0,6,0
,Dr. Dennis Gross - Alpha Beta®  Peel Original Formula 30 app jars,Dr. Dennis Gross - Alpha Beta®  Peel Original Formula 30 app jars,Avrami - Ebay,10,10,0,0,0,0
,Dr. Dennis Gross - Alpha Beta®  Peel Original Formula 30 app jars,Dr. Dennis Gross - Alpha Beta®  Peel Original Formula 30 app jars,FBALYB Amazon,1,0,1,0,1,0
,Dr. Dennis Gross - Alpha Beta® Peel Original Formula 60 Packettes,Dr. Dennis Gross - Alpha Beta® Peel Original Formula 60 Packettes,FBALYB Amazon,-1,-1,0,0,0,0
,Dr. Dennis Gross - Alpha Beta®  Peel Ultra Gentle 30 packettes,Dr. Dennis Gross - Alpha Beta®  Peel Ultra Gentle 30 packettes,Default Ridgefield,165,165,0,0,0,0
,Dr. Dennis Gross - Alpha Beta®  Peel Ultra Gentle 30 packettes,Dr. Dennis Gross - Alpha Beta®  Peel Ultra Gentle 30 packettes,FBALYB Amazon,20,13,7,0,7,0
,Dr Dennis Gross - Alpha Beta Pore Perfecting & Refining Serum,Dr Dennis Gross - Alpha Beta Pore Perfecting & Refining Serum,Default Ridgefield,177,177,0,0,0,0
,Dr Dennis Gross - B3 Adaptive Superfoods Stress Rescue Super Serum,Dr Dennis Gross - B3 Adaptive Superfoods Stress Rescue Super Serum,FBALYB Amazon,7,6,1,0,1,0
,Dr. Dennis Gross - C+ Collagen Brighten + Firm Eye Cream 0.5 fl oz/15ml,Dr. Dennis Gross - C+ Collagen Brighten + Firm Eye Cream 0.5 fl oz/15ml,FBALYB Amazon,9,9,0,0,0,0
,Dr. Dennis Gross - C+ Collagen Brighten + Firm Serum 1.0 fl oz/30ml,Dr. Dennis Gross - C+ Collagen Brighten + Firm Serum 1.0 fl oz/30ml,FBALYB Amazon,0,-5,5,0,5,0
,Dr. Dennis Gross - C+ Collagen  Deep Cream 1.7 fl oz/50ml,Dr. Dennis Gross - C+ Collagen  Deep Cream 1.7 fl oz/50ml,Default Ridgefield,1,1,0,0,0,0
,Dr. Dennis Gross - C+ Collagen  Deep Cream 1.7 fl oz/50ml,Dr. Dennis Gross - C+ Collagen  Deep Cream 1.7 fl oz/50ml,FBALYB Amazon,2,-1,3,1,3,0
,Dr. Dennis Gross - Dark Spot Sun  Defense SPF50 1.7oz/50ml,Dr. Dennis Gross - Dark Spot Sun  Defense SPF50 1.7oz/50ml,FBALYB Amazon,-1,-1,0,0,0,0
,Dr. Dennis Gross - Ferulic + Retinol anti-aging moisturizer 1.7oz / 50ml,Dr. Dennis Gross - Ferulic + Retinol anti-aging moisturizer 1.7oz / 50ml,FBALYB Amazon,-1,-1,0,28,0,0
,Dr. Dennis Gross - Ferulic + Retinol anti-aging moisturizer 1.7oz / 50ml,Dr. Dennis Gross - Ferulic + Retinol anti-aging moisturizer 1.7oz / 50ml,WFS,-6,-6,0,0,0,0
,Dr. Dennis Gross - Ferulic + Retinol Brightening Solution 1.0 fl oz/30ml,Dr. Dennis Gross - Ferulic + Retinol Brightening Solution 1.0 fl oz/30ml,FBALYB Amazon,110,110,0,0,0,0
,Dr. Dennis Gross - Ferulic + Retinol Brightening Solution 1.0 fl oz/30ml,Dr. Dennis Gross - Ferulic + Retinol Brightening Solution 1.0 fl oz/30ml,WFS,-17,-17,0,0,0,0
,Dr. Dennis Gross - Ferulic +  Retinol Eye Serum 0.5 oz/15 ml,Dr. Dennis Gross - Ferulic +  Retinol Eye Serum 0.5 oz/15 ml,Default Ridgefield,0,-99,99,0,0,0
,Dr. Dennis Gross - Ferulic+Retinol Fortifying Neck Emulsion 1.7oz / 50ml,Dr. Dennis Gross - Ferulic+Retinol Fortifying Neck Emulsion 1.7oz / 50ml,Default Ridgefield,40,40,0,0,0,0
,Dr. Dennis Gross - Ferulic+Retinol Wrinkle Recovery Overnight Serum 1oz / 30ml,Dr. Dennis Gross - Ferulic+Retinol Wrinkle Recovery Overnight Serum 1oz / 30ml,FBALYB Amazon,-1,-1,0,0,0,0
,Dr. Dennis Gross - Ferulic+Retinol Wrinkle Recovery Peel 16 packettes,Dr. Dennis Gross - Ferulic+Retinol Wrinkle Recovery Peel 16 packettes,FBALYB Amazon,-1,-1,0,0,0,0
,Dr. Dennis Gross - Hyaluronic Marine Hydration Booster 1oz / 30ml,Dr. Dennis Gross - Hyaluronic Marine Hydration Booster 1oz / 30ml,FBALYB Amazon,1,-2,3,4,3,0
,Dr. Dennis Gross - Hyaluronic Marine Infusion Modeling Mask 4 Treatments w/4 Bowls + Spatula,Dr. Dennis Gross - Hyaluronic Marine Infusion Modeling Mask 4 Treatments w/4 Bowls + Spatula,FBALYB Amazon,49,47,2,0,2,0
,Dr. Dennis Gross - Hyaluronic Marine Moisture Cushion 1.7oz / 50ml,Dr. Dennis Gross - Hyaluronic Marine Moisture Cushion 1.7oz / 50ml,FBALYB Amazon,1,1,0,0,0,0
,Dr. Dennis Gross - Instant Radiance Spf 40 Light Medium 50Ml,Dr. Dennis Gross - Instant Radiance Spf 40 Light Medium 50Ml,FBALYB Amazon,49,49,0,0,0,0
,"DreamTab HD8 16GB 8"" Tablet",Nabi DreamTab HD8 16GB 8 inch Tablet,Default,0,0,0,0,0,3
,"Dreamworks Dragons, Deathgripper and Grimmel","Dreamworks Dragons, Deathgripper and Grimmel",Default Ridgefield,1,1,0,0,0,0
,"Dreamworks Dragons, Deathgripper and Grimmel","Dreamworks Dragons, Deathgripper and Grimmel",FBALYB Amazon,110,110,0,1,0,0
,Dreamworks Dragons Deluxe Dragon,,Default Ridgefield,1,1,0,0,0,0
,"Dreamworks Dragons, Hookfang and Snotlout","Dreamworks Dragons, Hookfang and Snotlout",FBALYB Amazon,-98,-98,0,3,0,0
,"Dreamworks Dragons, Lightfury and Hiccup","Dreamworks Dragons, Lightfury and Hiccup",FBALYB Amazon,-4,-5,1,21,1,0
,"Dreamworks Dragons, Lightfury Deluxe Dragon Lights and Sounds","Dreamworks Dragons, Lightfury Deluxe Dragon Lights and Sounds",FBALYB Amazon,-101,-102,1,98,1,0
,DreamWorks Dragons Stormfly and Astrid Dragon with Armored Viking Figure,DreamWorks Dragons Stormfly and Astrid Dragon with Armored Viking Figure,FBALYB Amazon,-5,-5,0,0,0,0
,"Dreamworks Dragons, Toothless and Hiccup","Dreamworks Dragons, Toothless and Hiccup",Default Ridgefield,5,5,0,0,0,0
,"Dreamworks Dragons, Toothless and Hiccup","Dreamworks Dragons, Toothless and Hiccup",FBALYB Amazon,-21,-22,1,0,1,0
,"Dreamworks Dragons, Toothless and Hiccup","Dreamworks Dragons, Toothless and Hiccup",FBALYB Canada,-3,-3,0,30,0,0
,Dreamworks Dragons Toothless and Hiccup Toy,Dreamworks Dragons Toothless and Hiccup Toy,Default Ridgefield,-2,-2,0,0,0,0
,"Dreamworks Dragons, Toothless Deluxe Dragon Lights and Sounds","Dreamworks Dragons, Toothless Deluxe Dragon Lights and Sounds",Default Ridgefield,2,2,0,0,0,0
,"Dreamworks Dragons, Toothless Deluxe Dragon Lights and Sounds","Dreamworks Dragons, Toothless Deluxe Dragon Lights and Sounds",FBALYB Amazon,-15,-19,4,3,4,0
,Dr. Elsey's Long Haired Cat Litter 8lb,Dr. Elsey's Precious Cat Long Haired Cat Litter ‑ 8 lb jug,FBALYB Amazon,1,1,0,0,0,0
,Dr. Elsey's Precious Cat Classic Litter 18‑lb,Dr. Elsey's Precious Cat Classic Litter 18‑lb,FBALYB Amazon,11,11,0,2,0,0
,Dr. Elsey's Respiratory Relief Cat Litter 7.5lb,Dr. Elsey's Respiratory Relief Cat Litter 7.5lb,Default,0,0,0,0,0,4
,Dr. Elsey's Respiratory Relief Cat Litter 7.5lb,Dr. Elsey's Respiratory Relief Cat Litter 7.5lb,FBALYB Amazon,3,3,0,10,0,0
,Dr. Elsey's Ultra Cat Scoopable Litter 18lb,Dr. Elsey's Ultra Cat Scoopable Litter 18lb,FBALYB Amazon,2,2,0,0,0,0
,Dried Mangoes 30oz,Phillippine Brand Naturally Delicious Dried Mangoes Tree Ripened Value Bag 30 Ounces,FBALYB Amazon,0,0,0,10,0,0
,Dried Mangoes 30oz 3pk,Dried Mangoes 30oz 3pk,FBALYB Amazon,1,1,0,0,0,0
,Dr. Numb 5% Lidocaine Topical Anesthetic Numbing Cream 1.1oz,Dr. Numb 5% Lidocaine Topical Anesthetic Numbing Cream 1.1oz,Default Ridgefield,1,1,0,0,0,0
,Dr. Numb 5% Lidocaine Topical Anesthetic Numbing Cream 1.1oz,Dr. Numb 5% Lidocaine Topical Anesthetic Numbing Cream 1.1oz,FBALYB Amazon,-10,-10,0,0,0,0
,DrTim's Aquatics 2oz,DrTim's Aquatics Ammonium chloride 2oz,Default,0,0,0,0,0,5
,DrTim's Aquatics 2oz,DrTim's Aquatics Ammonium chloride 2oz,FBALYB Amazon,1,1,0,0,0,0
,"Dubble Bubble Bubble Gum Tub, 340 ct.","Dubble Bubble Bubble Gum Tub, 340 ct.",FBALYB Amazon,588,588,0,5,0,0
,Dulcolax Tablets 200,Dulcolax Tablets 200,Default,0,-102,102,0,0,0
,Dulcolax Tablets 200,Dulcolax Tablets 200,FBALYB Amazon,5,5,0,0,0,0
,Dumb Blonde Reconstructor 6.76 oz,Dumb Blonde Reconstructor 6.76 oz,Default Ridgefield,494,494,0,0,0,0
,Dumb Blonde Reconstructor 6.76 oz,Dumb Blonde Reconstructor 6.76 oz,FBALYB Amazon,136,134,2,3,2,0
,Dum Dums pops 2pk,Dum Dums pops 2pk,FBALYB Amazon,-14,-24,10,26,10,0
,Dump Pulling Excavator Vehicle,Toy State Light and Sound CAT Truck N' Trailer Dump Pulling Excavator Vehicle,FBALYB Amazon,8,8,0,0,0,0
,Dunkin Donuts Original 90oz (45 x 2),Dunkin Donuts Original 90oz (45 x 2),FBALYB Amazon,1,1,0,0,0,0
,Dunkin' Donuts Original Blend 2 pk,Dunkin' Donuts Original Blend 2 pk,FBALYB Amazon,89,89,0,74,0,0
,Dunkin French Vanilla 12 Oz bag,"Dunkin' Donuts Ground Coffee, French Vanilla, 12-Ounce Bag",FBALYB Amazon,-1,-1,0,0,0,0
,Duracell 9V Batteries 8ct,Duracell 9V Batteries 8ct,Default,0,0,0,0,0,1
,Duracell 9V Batteries 8ct,Duracell 9V Batteries 8ct,FBALYB Amazon,12,11,1,2,1,0
,Duracell AA -36pk,Duracell Quantum Alkaline AA Batteries - 36 pk,Default,0,-384,384,0,0,0
,Duracell AA -36pk,Duracell Quantum Alkaline AA Batteries - 36 pk,FBALYB Amazon,5,3,2,1,2,0
,Duracell AA -48pk,Duracell AA -48pk,Default,0,-2503,2503,0,0,0
,Duracell AA -48pk,Duracell AA -48pk,Default Oxford,4,4,0,0,0,0
,Duracell AA -48pk,Duracell AA -48pk,Default Ridgefield,1944,1944,0,0,0,0
,Duracell AA -48pk,Duracell AA -48pk,FBALYB Amazon,-263,-263,0,422,0,0
,Duracell AAA 28 ct,Duracell AAA 28 ct,Default,0,-2119,2119,0,0,0
,Duracell AAA 28 ct,Duracell AAA 28 ct,Default Oxford,35,35,0,0,0,0
,Duracell AAA 28 ct,Duracell AAA 28 ct,Default Ridgefield,1510,1510,0,0,0,0
,Duracell AAA 28 ct,Duracell AAA 28 ct,FBALYB Amazon,71,71,0,0,0,0
,Duracell Batteries D 12 Pack,Duracell Batteries D 12 Pack,Default Oxford,336,336,0,0,0,0
,Duracell Batteries D 12 Pack,Duracell Batteries D 12 Pack,FBALYB Amazon,-308,-314,6,252,6,0
,Duracell CopperTop 12 x C Batteries,Duracell CopperTop 12 x C Batteries,Default Ridgefield,11,11,0,0,0,0
,Duracell CopperTop 12 x C Batteries,Duracell CopperTop 12 x C Batteries,FBALYB Amazon,9,-10,19,9,19,0
,Duracell D Batteries 14ct,Duracell D Batteries 14ct,FBALYB Amazon,2,2,0,0,0,0
,Duracell Durabeam,Duracell Durabeam Ultra 1000 Lumens,FBALYB Amazon,-3,-3,0,0,0,0
,Duracell Durabeam Ultra 380 Lumens 3ct,Duracell Durabeam Ultra 380 Lumens 3ct,FBALYB Amazon,-1,-2,1,0,1,0
,Duracell Durabeam Ultra 700 Flashlight (2 Pk),Duracell Durabeam Ultra 700 Heavy‑duty Led Flashlight (2 Pk),Default,0,0,0,0,0,9
,Duracell Durabeam Ultra 700 Flashlight (2 Pk),Duracell Durabeam Ultra 700 Heavy‑duty Led Flashlight (2 Pk),FBALYB Amazon,-2,-2,0,0,0,0
,Duraflame DFI-5010-01 Fireplace,Duraflame DFI-5010-01 Infrared Quartz Fireplace Stovev,FBALYB Amazon,4,4,0,1,0,0
,Duraflame Quick Start 40ct,Duraflame Quick Start 40ct,Default,0,-200,200,0,0,0
,Duraflame Quick Start 40ct,Duraflame Quick Start 40ct,FBALYB Amazon,-247,-250,3,257,3,0
,DURALEX - 1016A B06 x 6,DURALEX - 1016A B06 x 6,Default,0,-6,6,0,0,0
,DURALEX - 1016A B06 x 6,DURALEX - 1016A B06 x 6,Default Ridgefield,90,90,0,0,0,0
,DURALEX - 1016A B06 x 6,DURALEX - 1016A B06 x 6,FBALYB Amazon,15,15,0,75,0,0
,DURALEX - 1017A B06 x 6,DURALEX - 1017A B06 x 6,FBALYB Amazon,-1,-1,0,1,0,0
,DURALEX - 1023A B06 x 6,DURALEX - 1023A B06 x 6,Default Ridgefield,27,27,0,0,0,0
,DURALEX - 1023A B06 x 6,DURALEX - 1023A B06 x 6,FBALYB Amazon,-4,-4,0,0,0,0
,DURALEX - 1024A B06 x 6,DURALEX - 1024A B06 x 6,Default Ridgefield,110,110,0,0,0,0
,DURALEX - 1024A B06 x 6,DURALEX - 1024A B06 x 6,FBALYB Amazon,552,552,0,0,0,0
,DURALEX - 1025A B06 x 6,DURALEX - 1025A B06 x 6,Default Ridgefield,370,370,0,0,0,0
,DURALEX - 1025A B06 x 6,DURALEX - 1025A B06 x 6,FBALYB Amazon,557,557,0,35,0,0
,DURALEX  - 1026A B06 - Picardie Tumbler - 220ml 7.75oz (Box 6),DURALEX  - 1026A B06 - Picardie Tumbler - 220ml 7.75oz (Box 6),Default Ridgefield,219,219,0,0,0,0
,DURALEX  - 1026A B06 - Picardie Tumbler - 220ml 7.75oz (Box 6),DURALEX  - 1026A B06 - Picardie Tumbler - 220ml 7.75oz (Box 6),FBALYB Amazon,126,126,0,24,0,0
,DURALEX - 1027A B06 x 6,DURALEX - 1027A B06 x 6,Default Ridgefield,399,399,0,0,0,0
,DURALEX - 1027A B06 x 6,DURALEX - 1027A B06 x 6,FBALYB Amazon,-320,-326,6,337,6,0
,DURALEX - 1028A B06 - Picardie Tall Rocks Glass - 310ml 10oz (Box 6),DURALEX - 1028A B06 - Picardie Tall Rocks Glass - 310ml 10oz (Box 6),Default Ridgefield,12,12,0,0,0,0
,DURALEX - 1028A B06 - Picardie Tall Rocks Glass - 310ml 10oz (Box 6),DURALEX - 1028A B06 - Picardie Tall Rocks Glass - 310ml 10oz (Box 6),FBALYB Amazon,174,174,0,0,0,0
,DURALEX - 1028A B06 - Picardie Tall Rocks Glass - 310ml 10oz (Box 6),DURALEX - 1028A B06 - Picardie Tall Rocks Glass - 310ml 10oz (Box 6),WFS,-13,-13,0,0,0,0
,DURALEX - 1029A B06 Picardie Beverage Glass - 360ml 12oz (Box 6),DURALEX - 1029A B06 Picardie Beverage Glass - 360ml 12oz (Box 6),Default Ridgefield,561,561,0,0,0,0
,DURALEX - 1029A B06 Picardie Beverage Glass - 360ml 12oz (Box 6),DURALEX - 1029A B06 Picardie Beverage Glass - 360ml 12oz (Box 6),FBALYB Amazon,1005,1005,0,42,0,0
,DURALEX - 1041A B06 x 6,DURALEX - 1041A B06 x 6,Default,0,-215,215,0,0,0
,DURALEX - 1041A B06 x 6,DURALEX - 1041A B06 x 6,Default Ridgefield,175,175,0,0,0,0
,DURALEX - 1041A B06 x 6,DURALEX - 1041A B06 x 6,FBALYB Amazon,189,189,0,0,0,0
,DURALEX - 1045A B06 x 6,DURALEX - 1045A B06 x 6,Default Ridgefield,167,167,0,0,0,0
,DURALEX - 1045A B06 x 6,DURALEX - 1045A B06 x 6,FBALYB Amazon,168,168,0,0,0,0
,DURALEX - 2020A C04 x 4,DURALEX - 2020A C04 x 4,FBALYB Amazon,-10,-10,0,1,0,0
,"DURALEX - 2022A F06 Lys Stackable Clear Glass Bowl, 4 Oz - 3 1/2 Inches Set of 6","DURALEX - 2022A F06 Lys Stackable Clear Glass Bowl, 4 Oz - 3 1/2 Inches Set of 6",Default,2,2,0,0,0,0
,"DURALEX - 2022A F06 Lys Stackable Clear Glass Bowl, 4 Oz - 3 1/2 Inches Set of 6","DURALEX - 2022A F06 Lys Stackable Clear Glass Bowl, 4 Oz - 3 1/2 Inches Set of 6",FBALYB Amazon,-15,-15,0,0,0,0
,"DURALEX - 2023A F06 Lys Stackable Clear Glass Bowl, 6 Oz - 4 1/8 Inches Set of 6","DURALEX - 2023A F06 Lys Stackable Clear Glass Bowl, 6 Oz - 4 1/8 Inches Set of 6",Default Ridgefield,68,68,0,0,0,0
,"DURALEX - 2023A F06 Lys Stackable Clear Glass Bowl, 6 Oz - 4 1/8 Inches Set of 6","DURALEX - 2023A F06 Lys Stackable Clear Glass Bowl, 6 Oz - 4 1/8 Inches Set of 6",FBALYB Amazon,105,105,0,0,0,0
,"DURALEX - 2024A F06  Lys Stackable Clear Glass Bowl, 10 Oz - 4 3/4 Inches Set of 6","DURALEX - 2024A F06  Lys Stackable Clear Glass Bowl, 10 Oz - 4 3/4 Inches Set of 6",Default Ridgefield,155,155,0,0,0,0
,"DURALEX - 2024A F06  Lys Stackable Clear Glass Bowl, 10 Oz - 4 3/4 Inches Set of 6","DURALEX - 2024A F06  Lys Stackable Clear Glass Bowl, 10 Oz - 4 3/4 Inches Set of 6",FBALYB Amazon,342,342,0,1,0,0
,"DURALEX - 2025A F06 - Lys Stackable Clear Glass Bowl, 1/2 Qt - 5 1/2 Inches Set of 6","DURALEX - 2025A F06 - Lys Stackable Clear Glass Bowl, 1/2 Qt - 5 1/2 Inches Set of 6",Default Ridgefield,1829,1829,0,0,0,0
,"DURALEX - 2025A F06 - Lys Stackable Clear Glass Bowl, 1/2 Qt - 5 1/2 Inches Set of 6","DURALEX - 2025A F06 - Lys Stackable Clear Glass Bowl, 1/2 Qt - 5 1/2 Inches Set of 6",FBALYB Amazon,377,377,0,9,0,0
,"DURALEX - 2026A F06 - Lys Stackable Clear Glass Bowl, 1 Qt - 6 3/4 Inches Set of 6","DURALEX - 2026A F06 - Lys Stackable Clear Glass Bowl, 1 Qt - 6 3/4 Inches Set of 6",Default Ridgefield,282,282,0,0,0,0
,"DURALEX - 2026A F06 - Lys Stackable Clear Glass Bowl, 1 Qt - 6 3/4 Inches Set of 6","DURALEX - 2026A F06 - Lys Stackable Clear Glass Bowl, 1 Qt - 6 3/4 Inches Set of 6",FBALYB Amazon,-85,-85,0,225,0,0
,"DURALEX - 3006A F06 - Lys Clear Dinner Plate 23,5 cm (9 1-4 in) Set Of 6","DURALEX - 3006A F06 - Lys Clear Dinner Plate 23,5 cm (9 1-4 in) Set Of 6",FBALYB Amazon,37,37,0,11,0,0
,DURALEX - 3014A F06 Lys Calotte Plate 21 cm (8 1/4 inch )Set Of 6,DURALEX - 3014A F06 Lys Calotte Plate 21 cm (8 1/4 inch )Set Of 6,FBALYB Amazon,-7,-7,0,15,0,0
,"DURALEX - 3015A F06 - Lys Clear Calotte Plate 17,5 cm (6 7/8 in) Set Of 6","DURALEX - 3015A F06 - Lys Clear Calotte Plate 17,5 cm (6 7/8 in) Set Of 6",FBALYB Amazon,-1,-1,0,0,0,0
,"DURALEX - 4029A R06 - Cosy Glass Mug (Set of 6), 12 3/8 oz, Clear","DURALEX - 4029A R06 - Cosy Glass Mug (Set of 6), 12 3/8 oz, Clear",Default Ridgefield,27,27,0,0,0,0
,"DURALEX - 4029A R06 - Cosy Glass Mug (Set of 6), 12 3/8 oz, Clear","DURALEX - 4029A R06 - Cosy Glass Mug (Set of 6), 12 3/8 oz, Clear",FBALYB Amazon,50,50,0,0,0,0
,Dynatrap 1/2 Acre Insect Trap,Dynatrap DT1050 1/2 Acre Insect Trap,Default Ridgefield,1,1,0,0,0,0
,Dynatrap 1/2 Acre Insect Trap,Dynatrap DT1050 1/2 Acre Insect Trap,FBALYB Amazon,-46,-46,0,0,0,0
,Dyson AM11,Dyson AM11,Default,0,0,0,0,0,1
,Dyson AM11,Dyson AM11,FBASKCK Amazon,136,136,0,0,0,0
,Dyson Ball Animal 2 Purple,"Dyson Ball Animal 2 Upright Vacuum, Iron/Purple 227635‑01",FBALYB Amazon,0,0,0,1,0,0
,Dyson Ball Orange 227633‑01,Dyson Ball Multi Floor 2 Upright Bagless Vacuum Orange 227633‑01,FBALYB Amazon,-1,-1,0,0,0,0
,Dyson Cinetic Big Ball,Dyson Cinetic Big Ball  Animal+Allergy,FBALYB Amazon,-3,-3,0,1,0,0
,Dyson DC50 Alllergy,Dyson DC50 Alllergy,Default,0,0,0,0,0,1
,Dyson DC65 Yellow Vaccum,Dyson DC65 Yellow Vaccum,FBALYB Amazon,-1,-1,0,0,0,0
,Dyson V6 Animal Vacuum,Dyson V6 Animal Vacuum,Default,0,0,0,0,0,2
,Dyson V6 Motorhead,Dyson V6 Motorhead Cordless Vacuum ‑ Bagless ‑ Fuschia/Iron,Default,0,0,0,0,0,1
,Dyson V6 Motorhead Plus,Dyson V6 Motorhead Plus ,Default,0,0,0,0,0,23
,Dyson V6 Motorhead Plus,Dyson V6 Motorhead Plus ,FBASKCK Amazon,45,45,0,0,0,0
,Dyson V6 Motorhead White,Dyson V6 Motorhead Cordless Vacuum ‑ Bagless ‑ White/Iron,FBALYB Amazon,-1,-1,0,0,0,0
,Dyson V7 Animal,Dyson V7 Animal Stick/handheld Vacuum,Default,0,0,0,0,0,6
,Dyson V7 Motorhead,Dyson V7 Motorhead Stick Vacuum ‑ Bagless,Default,0,0,0,0,0,1
,Dyson V7 Motorhead,Dyson V7 Motorhead Stick Vacuum ‑ Bagless,FBALYB Amazon,-1,-1,0,0,0,0
,Dyson V8 Animal,Dyson V8 Animal Cord-Free Vacuum,FBALYB Amazon,0,0,0,1,0,0
,DZ-BAAW-V6T6,Fisher-Price Thomas the Train: Take-n-Play Connor,FBALYB Amazon,2,2,0,0,0,0
,Eartbath Grooming Wipes Puppy Grooming Wipes 100 Ct.,Eartbath Grooming Wipes Puppy Grooming Wipes 100 Ct.,Default,0,0,0,0,0,150
,Earthbath 100ct Grooming Wipes,Earthbath 100ct Grooming Wipes,Default,0,0,0,0,0,5
,Earthbath 100ct Grooming Wipes 2pk,Earthbath 100ct Grooming Wipes 2pk,FBALYB Amazon,-1,-1,0,0,0,0
,Earthbath 100ct Grooming Wipes 6pk,Earthbath 100ct Grooming Wipes 6pk,FBALYB Amazon,-1,-1,0,0,0,0
,Earthbath Cat Shampoo and Conditioner 16oz,Earthbath Cat Shampoo and Conditioner 16oz,FBALYB Amazon,1,1,0,1,0,0
,Earthbath Cat Wipes,Earthbath Cat Wipes,Default,0,0,0,0,0,50
,Earthbath Cat Wipes 2PK,Earthbath Cat Wipes 2PK,FBALYB Amazon,-2,-2,0,0,0,0
,Earthbath Coat Brightener Shampoo 16oz,Earthbath Coat Brightener Shampoo 16oz,FBALYB Amazon,-1,-1,0,0,0,0
,"Earthbath Green Tea Dog Grooming Wipes, 2 Pack","Earthbath Green Tea Dog Grooming Wipes, 2 Pack	",FBALYB Amazon,3,3,0,0,0,0
,Earthbath Green Tea Shampoo 16oz,Earthbath Green Tea Shampoo 16oz,FBALYB Amazon,-2,-2,0,0,0,0
,Earthbath Green Tea Shampoo 16oz 2pk,Earthbath Green Tea Shampoo 16oz 2pk,FBALYB Amazon,9,9,0,0,0,0
,Earthbath Grooming Wipes,Earthbath Grooming Wipes,Default,0,0,0,0,0,100
,Earthbath Hypo-Allergenic Shampoo 16oz,Earthbath Hypo-Allergenic Shampoo 16oz,FBALYB Amazon,3,3,0,0,0,0
,Earthbath Mango Tango Sham & Cond 16oz,Earthbath Mango Tango Sham & Cond 16oz,FBALYB Amazon,3,3,0,0,0,0
,Earthbath Mango Tango Sham & Cond 16oz 2pk,Earthbath Mango Tango Sham & Cond 16oz 2pk,FBALYB Amazon,12,12,0,0,0,0
,Earthbath Oatmeal & Aloe Pet Conditioner,Earthbath Oatmeal & Aloe Totally Natural Pet Care Conditioner,FBALYB Amazon,1,1,0,0,0,0
,Earthbath Oatmeal & Aloe Pet Shampoo,Earthbath Oatmeal & Aloe Totally Natural Pet Shampoo,FBALYB Amazon,2,2,0,0,0,0
,Earthbath Oatmeal & Aloe Pet Shampoo 2pk,Earthbath Oatmeal & Aloe Pet Shampoo 2pk,FBALYB Amazon,2,2,0,0,0,0
,Earthbath Oatmeal & Aloe Shampoo & Conditioner,Earthbath Oatmeal & Aloe Shampoo & Conditioner,FBALYB Amazon,4,4,0,0,0,0
,"Earthbath Oatmeal and Aloe Conditioner, 16 oz","Earthbath Oatmeal and Aloe Conditioner, 16 oz",FBALYB Amazon,-1,-1,0,0,0,0
,"Earthbath Oatmeal and Aloe Shampoo, 16 oz","Earthbath Oatmeal and Aloe Shampoo, 16 oz",FBALYB Amazon,5,5,0,0,0,0
,Earthbath Orange Peel Shampoo 16oz,Earthbath Orange Peel Shampoo 16oz,FBALYB Amazon,1,1,0,0,0,0
,Earthbath Puppy Shampoo Tearless 16oz,Earthbath Puppy Shampoo Tearless 16oz,FBALYB Amazon,-1,-1,0,0,0,0
,"Earthbath Vanilla Spray, 8oz","Earthbath Vanilla Almond Dog Spray, 8oz",FBALYB Amazon,10,10,0,0,0,0
,Earthrise Spirulina Powder 6.4 oz,Earthrise Spirulina Powder 6.4 oz,FBALYB Amazon,-1,-1,0,0,0,0
,ECLIPSE 18 CT MINT VTY PACK,ECLIPSE 18 CT MINT VTY PACK,FBALYB Amazon,15,15,0,0,0,0
,Eclipse Cartridge Rite-Size K 3ct 2pk,Eclipse Cartridge Rite-Size K 3ct 2pk,FBALYB Amazon,-1,-1,0,0,0,0
,Eclipse Rite-Size H 3ct,Eclipse Rite-Size H 3ct,Default,0,0,0,0,0,49
,Eclipse Rite-Size H 3ct,Eclipse Rite-Size H 3ct,Default Oxford,49,49,0,0,0,0
,Eclipse Rite-Size H 3ct,Eclipse Rite-Size H 3ct,Default Ridgefield,416,416,0,0,0,0
,Eclipse Rite-Size H 3ct 2pk,Eclipse Rite-Size H 3ct 2pk,FBALYB Amazon,-5,-5,0,0,0,0
,Eco Kyrstal Gel 8oz,Eco Kyrstal Gel 8oz,FBALYB Amazon,29,29,0,0,0,0
,Ecos 2X Ultra Laundry Detergent,Ecos 2X Ultra Laundry Detergent,FBALYB Amazon,11,11,0,0,0,0
,Edamame Spaghetti 2.2lb,Edamame Spaghetti 2.2lb,Default,0,0,0,0,0,1
,Edamame Spaghetti 2.2lb,Edamame Spaghetti 2.2lb,FBALYB Amazon,-1,-1,0,1,0,0
,Edge Shave Gel 9.5oz 3pack,Edge Shave Gel 9.5oz 3pack,Default,0,-2,2,0,0,0
,Edge Shave Gel 9.5oz 3pack,Edge Shave Gel 9.5oz 3pack,FBALYB Amazon,-68,-68,0,5,0,0
,Efferdent 252 denture cleaner,Efferdent 252 denture cleaner,FBALYB Amazon,67,44,23,88,23,0
,Egg mold Ring 2ct 2pk,Egg mold Ring 2ct 2pk,FBALYB Amazon,122,122,0,1,0,0
,Egg ring Mold 2 ct,Egg ring Mold 2 ct,Default Ridgefield,50,34,16,0,0,0
,Egg ring Mold 2 ct,Egg ring Mold 2 ct,FBALYB Amazon,54,53,1,0,1,0
,Egg ring Mold 2 ct 3pk,Egg ring Mold 2 ct 3pk,FBALYB Amazon,17,17,0,0,0,0
,Eheim 6664 PreFilter,Eheim 6664 PreFilter,FBALYB Amazon,-1,-1,0,0,0,0
,Eight o Clock Coffee 42oz 2pk,Eight o Clock Coffee 42oz 2pk,FBALYB Amazon,-7,-7,0,8,0,0
,Einstein kit,"INSTEON Home Control Starter Kit, 1 Hub & 2 Dimmer Modules  2244-372",FBALYB Amazon,-3,-3,0,0,0,0
,EK-XK77-CKYT,"Milk-Bone Brushing Chews Daily Dental Treats, Large (30 ct.) ,40.4 oz (1.15kg)",Default,0,0,0,0,0,155
,EK-XK77-CKYT,"Milk-Bone Brushing Chews Daily Dental Treats, Large (30 ct.) ,40.4 oz (1.15kg)",FBALYB Amazon,-701,-703,2,804,2,0
,Elmer's All-Purpose Glue Sticks 3ct 4pk,Elmer's All-Purpose Glue Sticks 3ct 4pk,FBALYB Amazon,-1,-1,0,14,0,0
,Elmers School Glue 4 oz 12pk,Elmers School Glue 4 oz 12pk,FBALYB Canada,58,58,0,0,0,0
,Elmers School Glue 4 oz 2pk,Elmers School Glue 4 oz 2pk,Default Ridgefield,20,20,0,0,0,0
,Elmers School Glue 4 oz 2pk,Elmers School Glue 4 oz 2pk,FBALYB Amazon,-28,-28,0,0,0,0
,Elmers School Glue 4 oz 2pk,Elmers School Glue 4 oz 2pk,FBALYB Canada,-2,-2,0,0,0,0
,Elmers School Glue 4 oz 5pk,Elmers School Glue 4 oz 5pk,FBALYB Amazon,7,1,6,0,6,0
,Elmers School Glue 4 oz 6pk,Elmers School Glue 4 oz 6pk,FBALYB Amazon,-81,-81,0,86,0,0
,EM-9OQ7-LPMN,"Levis Men's Stan Buck Fashion Sneaker, Navy/Brown, 9 M US",FBALYB Amazon,-3,-3,0,0,0,0
,Embryolisse Concentrated 24hr Cream 2pk,Embryolisse Concentrated 24hr Cream 2pk,FBALYB Amazon,134,134,0,0,0,0
,Embryolisse Concentrated Lait Cream 2pk,Embryolisse Concentrated Lait Cream 2pk,FBALYB Amazon,3,3,0,0,0,0
,Embryolisse FILADERME EMULSION 75ML,Embryolisse FILADERME EMULSION 75ML,FBALYB Amazon,33,33,0,0,0,0
,Embryolisse LAIT CRÈME FLUID 500ML,Embryolisse LAIT CRÈME FLUID 500ML,FBALYB Amazon,292,292,0,0,0,0
,Embryolisse MOISTURISING CREAM WITH ORANGE 50ML,Embryolisse MOISTURISING CREAM WITH ORANGE 50ML,FBALYB Amazon,47,47,0,0,0,0
,Embryolisse SMOOTHING EYE CONTOUR CARE 15ML,Embryolisse SMOOTHING EYE CONTOUR CARE 15ML,Avrami - Ebay,3,3,0,0,0,0
,Embryolisse SMOOTHING EYE CONTOUR CARE 15ML,Embryolisse SMOOTHING EYE CONTOUR CARE 15ML,FBALYB Amazon,25,25,0,0,0,0
,"Emergen-C Vitamin C Supplement, 90 ct.","Emergen-C Vitamin C Supplement, 90 ct.",Default,0,0,0,0,0,34
,"Emergen-C Vitamin C Supplement, 90 ct.","Emergen-C Vitamin C Supplement, 90 ct.",FBALYB Amazon,-1,-1,0,0,0,0
,Emeril's Big Easy Bold 24 kcups 2pk,Emeril's Big Easy Bold 24 kcups 2pk,FBALYB Amazon,3,3,0,6,0,0
,Emeril's Jazzed Up K Cups 48ct,Emeril's Jazzed Up K Cups 48ct,FBALYB Amazon,10,10,0,0,0,0
,Eminencce - Blueberry Soy Night Recovery Cream  8.4oz,Eminencce - Blueberry Soy Night Recovery Cream  8.4oz,FBALYB Amazon,2,2,0,0,0,0
,Eminence - Acne Advanced Clarifying hydrator 1.2oz,Eminence - Acne Advanced Clarifying hydrator 1.2oz,Default Ridgefield,72,72,0,0,0,0
,Eminence - Age Corrective Starter Set oz,Eminence - Age Corrective Starter Set oz,Default Ridgefield,257,257,0,0,0,0
,Eminence - Age Corrective Starter Set oz,Eminence - Age Corrective Starter Set oz,FBALYB Amazon,163,162,1,0,1,0
,Eminence - Apricot Body Oil 8.2oz,Eminence - Apricot Body Oil 8.2oz,FBALYB Amazon,210,194,16,30,16,0
,Eminence - Apricot Body Oil 8.2oz,Eminence - Apricot Body Oil 8.2oz,FBALYB Canada,12,12,0,0,0,0
,Eminence - Apricot Calendula Nourishing Cream 1oz,Eminence - Apricot Calendula Nourishing Cream 1oz,FBALYB Amazon,-6,-6,0,0,0,0
,Eminence - Arctic Berry Enzyme Exfoliant 8.4 oz,Eminence - Arctic Berry Enzyme Exfoliant 8.4 oz,Avrami - Ebay,5,5,0,0,0,0
,Eminence - Arctic Berry Peptide Radiance Cream 2oz,Eminence - Arctic Berry Peptide Radiance Cream 2oz,Default Ridgefield,240,240,0,0,0,0
,Eminence - Arctic Berry Peptide Radiance Cream 2oz,Eminence - Arctic Berry Peptide Radiance Cream 2oz,FBALYB Amazon,130,126,4,0,4,0
,Eminence - Arctic Berry Peptide Radiance Cream 4.2  oz,Eminence - Arctic Berry Peptide Radiance Cream 4.2  oz,FBALYB Amazon,3,3,0,0,0,0
,Eminence - Bamboo Age Corrective Masque 2oz,Eminence - Bamboo Age Corrective Masque 2oz,Default Ridgefield,103,103,0,0,0,0
,Eminence - Bamboo Age Corrective Masque 2oz,Eminence - Bamboo Age Corrective Masque 2oz,FBALYB Amazon,18,17,1,1,1,0
,Eminence - Bamboo Firming Fluid 1.2oz,Eminence - Bamboo Firming Fluid 1.2oz,Default Ridgefield,100,100,0,0,0,0
,Eminence - Bamboo Firming Fluid 1.2oz,Eminence - Bamboo Firming Fluid 1.2oz,FBALYB Amazon,372,354,18,0,18,0
,Eminence - Bamboo Firming Fluid 1.2oz,Eminence - Bamboo Firming Fluid 1.2oz,FBALYB Canada,7,6,1,0,1,0
,Eminence - Blueberry Soy Night Recovery Cream 2oz,Eminence - Blueberry Soy Night Recovery Cream 2oz,Default Ridgefield,5,5,0,0,0,0
,Eminence - Blueberry Soy Night Recovery Cream 2oz,Eminence - Blueberry Soy Night Recovery Cream 2oz,FBALYB Amazon,179,177,2,0,2,0
,Eminence - Bright Skin Cleanser 8.4oz,Eminence - Bright Skin Cleanser 8.4oz,Default Ridgefield,10,10,0,0,0,0
,Eminence - Bright Skin Cleanser 8.4oz,Eminence - Bright Skin Cleanser 8.4oz,FBALYB Amazon,240,240,0,0,0,0
,Eminence - Bright Skin Cleanser 8.4oz,Eminence - Bright Skin Cleanser 8.4oz,WFS,-9,-9,0,0,0,0
,Eminence Bright Skin Masque 2 OZ,Eminence Bright Skin Masque 2 OZ,FBALYB Amazon,10,9,1,0,1,0
,Eminence - Bright Skin Masque 8.4 oz,Eminence - Bright Skin Masque 8.4 oz,FBALYB Amazon,22,22,0,0,0,0
,Eminence - Bright Skin Moisturizer Spf 30 2oz,Eminence - Bright Skin Moisturizer Spf 30 2oz,Default Ridgefield,320,320,0,0,0,0
,Eminence - Bright Skin Moisturizer Spf 30 2oz,Eminence - Bright Skin Moisturizer Spf 30 2oz,FBALYB Amazon,114,111,3,1,3,0
,Eminence - Bright Skin Moisturizer Spf 30 2oz,Eminence - Bright Skin Moisturizer Spf 30 2oz,FBALYB Canada,10,10,0,0,0,0
,Eminence - Bright Skin Moisturizer Spf 30 2oz,Eminence - Bright Skin Moisturizer Spf 30 2oz,WFS,-70,-70,0,0,0,0
,Eminence - Bright Skin Starter Set oz,Eminence - Bright Skin Starter Set oz,FBALYB Amazon,-1,-1,0,0,0,0
,Eminence - Calm Skin Arnica Booster-Serum 1oz,Eminence - Calm Skin Arnica Booster-Serum 1oz,Default Ridgefield,150,150,0,0,0,0
,Eminence - Calm Skin Arnica Booster-Serum 1oz,Eminence - Calm Skin Arnica Booster-Serum 1oz,FBALYB Amazon,93,92,1,0,1,0
,Eminence Calm Skin Arnica Masque 2 oz,Eminence Calm Skin Arnica Masque 2 oz,FBALYB Amazon,-3,-3,0,0,0,0
,Eminence - Calm Skin Chamomile Cleanser 8.4oz,Eminence - Calm Skin Chamomile Cleanser 8.4oz,Default Ridgefield,404,404,0,0,0,0
,Eminence - Calm Skin Chamomile Cleanser 8.4oz,Eminence - Calm Skin Chamomile Cleanser 8.4oz,FBALYB Amazon,284,270,14,6,14,0
,Eminence - Calm Skin Chamomile Cleanser 8.4oz,Eminence - Calm Skin Chamomile Cleanser 8.4oz,WFS,-12,-12,0,0,0,0
,Eminence - Calm Skin Chamomile Exfoliating Peel 1.7  oz / 50 ml,Eminence - Calm Skin Chamomile Exfoliating Peel 1.7  oz / 50 ml,FBALYB Amazon,0,0,0,3,0,0
,Eminence - Calm Skin Chamomile Moisturizer 2oz,Eminence - Calm Skin Chamomile Moisturizer 2oz,Default Ridgefield,63,63,0,0,0,0
,Eminence - Calm Skin Chamomile Moisturizer 2oz,Eminence - Calm Skin Chamomile Moisturizer 2oz,FBALYB Amazon,355,349,6,0,6,0
,Eminence - Calm Skin Chamomile Moisturizer 2oz,Eminence - Calm Skin Chamomile Moisturizer 2oz,FBALYB Canada,9,9,0,0,0,0
,Eminence - Calm Skin Chamomile Moisturizer 8.4oz,Eminence - Calm Skin Chamomile Moisturizer 8.4oz,FBALYB Amazon,0,0,0,1,0,0
,Eminence - Calm Skin Starter Set oz,Eminence - Calm Skin Starter Set oz,Default Ridgefield,150,150,0,0,0,0
,Eminence - Calm Skin Starter Set oz,Eminence - Calm Skin Starter Set oz,FBALYB Amazon,74,73,1,0,1,0
,Eminence - Citrus Exfoliating Wash 4.2oz,Eminence - Citrus Exfoliating Wash 4.2oz,Default Ridgefield,325,325,0,0,0,0
,Eminence - Citrus Exfoliating Wash 4.2oz,Eminence - Citrus Exfoliating Wash 4.2oz,FBALYB Amazon,140,128,12,38,12,0
,Eminence - Citrus & Kale Potent C + E Masque 2oz,Eminence - Citrus & Kale Potent C + E Masque 2oz,FBALYB Amazon,1,1,0,0,0,0
,Eminence - Citrus & Kale Potent C + E Serum 1oz,Eminence - Citrus & Kale Potent C + E Serum 1oz,FBALYB Amazon,81,76,5,0,5,0
,Eminence - Citrus Lip Balm 0.27oz,Eminence - Citrus Lip Balm 0.27oz,Default Ridgefield,255,255,0,0,0,0
,Eminence - Citrus Lip Balm 0.27oz,Eminence - Citrus Lip Balm 0.27oz,FBALYB Amazon,43,43,0,201,0,0
,Eminence - Clear Skin Probiotic Cleanser 8.4oz,Eminence - Clear Skin Probiotic Cleanser 8.4oz,Default Ridgefield,446,446,0,0,0,0
,Eminence - Clear Skin Probiotic Cleanser 8.4oz,Eminence - Clear Skin Probiotic Cleanser 8.4oz,FBALYB Amazon,768,746,22,0,22,0
,Eminence - Clear Skin Probiotic Masque 2oz,Eminence - Clear Skin Probiotic Masque 2oz,Default Ridgefield,1162,1161,1,0,0,0
,Eminence - Clear Skin Probiotic Masque 2oz,Eminence - Clear Skin Probiotic Masque 2oz,FBALYB Amazon,183,178,5,7,5,0
,Eminence - Clear Skin Probiotic Masque 8.4oz,Eminence - Clear Skin Probiotic Masque 8.4oz,Avrami - Ebay,60,60,0,0,0,0
,Eminence - Clear Skin Starter Set oz,Eminence - Clear Skin Starter Set oz,Default Ridgefield,108,38,70,0,0,0
,Eminence - Clear Skin Starter Set oz,Eminence - Clear Skin Starter Set oz,FBALYB Amazon,113,113,0,0,0,0
,Eminence - Clear Skin Targeted Acne Treatment 0.5oz,Eminence - Clear Skin Targeted Acne Treatment 0.5oz,Avrami - Ebay,72,72,0,0,0,0
,Eminence - Clear Skin Targeted Acne Treatment 0.5oz,Eminence - Clear Skin Targeted Acne Treatment 0.5oz,WFS,-18,-18,0,0,0,0
,Eminence - Clear Skin Willow Bark Booster-Serum  1oz,Eminence - Clear Skin Willow Bark Booster-Serum  1oz,FBALYB Amazon,4,0,4,0,4,0
,Eminence - Coconut Age Corrective Moisturizer 2oz,Eminence - Coconut Age Corrective Moisturizer 2oz,FBALYB Amazon,1,-8,9,1,9,0
,Eminence - Coconut Firming Body Lotion 8.4oz,Eminence - Coconut Firming Body Lotion 8.4oz,FBALYB Amazon,11,6,5,2,5,0
,Eminence - Coconut Milk Cleanser 8.4oz,Eminence - Coconut Milk Cleanser 8.4oz,Default Ridgefield,420,420,0,0,0,0
,Eminence - Coconut Milk Cleanser 8.4oz,Eminence - Coconut Milk Cleanser 8.4oz,FBALYB Amazon,479,472,7,2,7,0
,Eminence - Eight Greens Phyto Masque (Hot) 2oz,Eminence - Eight Greens Phyto Masque (Hot) 2oz,FBALYB Amazon,0,0,0,1,0,0
,Eminence - Eight Greens Phyto Masque (Not Hot)  2oz,Eminence - Eight Greens Phyto Masque (Not Hot)  2oz,Default Ridgefield,51,51,0,0,0,0
,Eminence - Eight Greens Phyto Masque (Not Hot)  2oz,Eminence - Eight Greens Phyto Masque (Not Hot)  2oz,FBALYB Amazon,25,23,2,0,2,0
,Eminence - Eight Greens Youth Serum 1oz,Eminence - Eight Greens Youth Serum 1oz,Default Ridgefield,358,358,0,0,0,0
,Eminence - Eight Greens Youth Serum 1oz,Eminence - Eight Greens Youth Serum 1oz,FBALYB Amazon,339,336,3,52,3,0
,"Eminence - ""Eminence Bright Skin Licorice Root  Exfoliating Peel 1.7 oz / 50ml""","Eminence - ""Eminence Bright Skin Licorice Root  Exfoliating Peel 1.7 oz / 50ml""",Default Ridgefield,1,1,0,0,0,0
,"Eminence - ""Eminence Bright Skin Licorice Root  Exfoliating Peel 1.7 oz / 50ml""","Eminence - ""Eminence Bright Skin Licorice Root  Exfoliating Peel 1.7 oz / 50ml""",FBALYB Amazon,-1,-1,0,0,0,0
,"Eminence - ""Eminence Bright Skin Targeted Dark  Spot Treatment 0.5 oz / 15 ml""","Eminence - ""Eminence Bright Skin Targeted Dark  Spot Treatment 0.5 oz / 15 ml""",FBALYB Amazon,0,0,0,24,0,0
,"Eminence - ""Eminence Clear Skin Willow Bark  Exfoliating Peel 1.7 oz / 50ml""","Eminence - ""Eminence Clear Skin Willow Bark  Exfoliating Peel 1.7 oz / 50ml""",FBALYB Amazon,-2,-2,0,0,0,0
,Eminence - Eminence Must Have Minis Starter Set,Eminence - Eminence Must Have Minis Starter Set,Default Ridgefield,100,100,0,0,0,0
,Eminence - Eminence Must Have Minis Starter Set,Eminence - Eminence Must Have Minis Starter Set,FBALYB Amazon,68,68,0,0,0,0
,Eminence Eucalyptus Cleansing Concentrate 4.2 OZ,Eminence Eucalyptus Cleansing Concentrate 4.2 OZ,Default Ridgefield,250,250,0,0,0,0
,Eminence Eucalyptus Cleansing Concentrate 4.2 OZ,Eminence Eucalyptus Cleansing Concentrate 4.2 OZ,FBALYB Amazon,330,328,2,0,2,0
,Eminence - Facial Recovery Oil 0.5oz,Eminence - Facial Recovery Oil 0.5oz,Default Ridgefield,40,40,0,0,0,0
,Eminence - Facial Recovery Oil 0.5oz,Eminence - Facial Recovery Oil 0.5oz,FBALYB Amazon,318,296,22,10,22,0
,Eminence Firm Skin Acai Booster-Serum 1 OZ,Eminence Firm Skin Acai Booster-Serum 1 OZ,Default Ridgefield,300,300,0,0,0,0
,Eminence Firm Skin Acai Booster-Serum 1 OZ,Eminence Firm Skin Acai Booster-Serum 1 OZ,FBALYB Amazon,375,375,0,0,0,0
,Eminence - Firm Skin Acai Cleanser 8.4oz,Eminence - Firm Skin Acai Cleanser 8.4oz,Default Ridgefield,1,1,0,0,0,0
,Eminence - Firm Skin Acai Cleanser 8.4oz,Eminence - Firm Skin Acai Cleanser 8.4oz,FBALYB Amazon,97,97,0,1,0,0
,Eminence - Firm Skin Acai Masque 2oz,Eminence - Firm Skin Acai Masque 2oz,FBALYB Amazon,-3,-3,0,0,0,0
,Eminence Firm Skin Acai Moisturizer 2oz,Eminence Firm Skin Acai Moisturizer 2oz,FBALYB Amazon,212,199,13,0,13,0
,Eminence - Firm Skin Starter Set oz,Eminence - Firm Skin Starter Set oz,Default Ridgefield,50,50,0,0,0,0
,Eminence - Firm Skin Starter Set oz,Eminence - Firm Skin Starter Set oz,FBALYB Amazon,90,89,1,0,1,0
,Eminence - Firm Skin Targeted Anti-Wrinkle  Treatment 0.5 oz,Eminence - Firm Skin Targeted Anti-Wrinkle  Treatment 0.5 oz,Default Ridgefield,1,1,0,0,0,0
,Eminence - Firm Skin Targeted Anti-Wrinkle  Treatment 0.5 oz,Eminence - Firm Skin Targeted Anti-Wrinkle  Treatment 0.5 oz,FBALYB Amazon,8,8,0,0,0,0
,Eminence - Guava & Bamboo Age-Defying  Moisturizer 2oz,Eminence - Guava & Bamboo Age-Defying  Moisturizer 2oz,Default Ridgefield,2,2,0,0,0,0
,Eminence - Guava & Bamboo Age-Defying  Moisturizer 2oz,Eminence - Guava & Bamboo Age-Defying  Moisturizer 2oz,FBALYB Amazon,312,297,15,0,15,0
,Eminence - Hawthorn Tonique 1.7oz,Eminence - Hawthorn Tonique 1.7oz,Avrami - Ebay,12,12,0,0,0,0
,Eminence - Hawthorn Tonique 1.7oz,Eminence - Hawthorn Tonique 1.7oz,WFS,-4,-4,0,0,0,0
,Eminence - Herbal Eye Make-Up Remover 5.07oz,Eminence - Herbal Eye Make-Up Remover 5.07oz,FBALYB Amazon,77,77,0,2,0,0
,Eminence - Hibiscus Ultra Lift Eye Cream 0.5oz.,Eminence - Hibiscus Ultra Lift Eye Cream 0.5oz.,FBALYB Amazon,-1,-1,0,2,0,0
,Eminence - Hibiscus Ultra Lift Neck Cream 1.7oz.,Eminence - Hibiscus Ultra Lift Neck Cream 1.7oz.,FBALYB Amazon,6,6,0,1,0,0
,Eminence - Hungarian Herbal Mud Treatment 2oz,Eminence - Hungarian Herbal Mud Treatment 2oz,FBALYB Amazon,0,0,0,2,0,0
,Eminence - Hungarian Herbal Mud Treatment 2oz,Eminence - Hungarian Herbal Mud Treatment 2oz,WFS,-39,-39,0,0,0,0
,Eminence - Jasmine Tangerine Age-Defying Night  Cream 2oz,Eminence - Jasmine Tangerine Age-Defying Night  Cream 2oz,Default Ridgefield,452,452,0,0,0,0
,Eminence - Jasmine Tangerine Age-Defying Night  Cream 2oz,Eminence - Jasmine Tangerine Age-Defying Night  Cream 2oz,FBALYB Amazon,153,145,8,0,8,0
,Eminence - Lavender Age Corrective Night  Concentrate 1.2oz,Eminence - Lavender Age Corrective Night  Concentrate 1.2oz,Default Ridgefield,386,386,0,0,0,0
,Eminence - Lavender Age Corrective Night  Concentrate 1.2oz,Eminence - Lavender Age Corrective Night  Concentrate 1.2oz,FBALYB Amazon,150,148,2,22,2,0
,Eminence - Lavender Age Corrective Night Eye Cream 1.05oz,Eminence - Lavender Age Corrective Night Eye Cream 1.05oz,FBALYB Amazon,112,106,6,0,6,0
,Eminence - Lemon Grass Cleanser 1.7oz,Eminence - Lemon Grass Cleanser 1.7oz,Default Ridgefield,3,3,0,0,0,0
,Eminence - Lemon Grass Cleanser 1.7oz,Eminence - Lemon Grass Cleanser 1.7oz,FBALYB Amazon,5,5,0,0,0,0
,Eminence - Lime Stimulating Treatment Masque 2oz,Eminence - Lime Stimulating Treatment Masque 2oz,FBALYB Amazon,58,58,0,2,0,0
,Eminence - Lime Stimulating Treatment Masque 2oz,Eminence - Lime Stimulating Treatment Masque 2oz,WFS,-14,-14,0,0,0,0
,Eminence - Linden Calendula Treatment 2oz,Eminence - Linden Calendula Treatment 2oz,FBALYB Amazon,-2,-2,0,0,0,0
,Eminence - Marine Flower Peptide Eye Cream 1.05oz.,Eminence - Marine Flower Peptide Eye Cream 1.05oz.,Default Ridgefield,525,525,0,0,0,0
,Eminence - Marine Flower Peptide Eye Cream 1.05oz.,Eminence - Marine Flower Peptide Eye Cream 1.05oz.,FBALYB Amazon,288,287,1,0,1,0
,Eminence - Monoi Age Corrective Exfoliating  Cleanser 8.4oz,Eminence - Monoi Age Corrective Exfoliating  Cleanser 8.4oz,Default Ridgefield,346,346,0,0,0,0
,Eminence - Monoi Age Corrective Exfoliating  Cleanser 8.4oz,Eminence - Monoi Age Corrective Exfoliating  Cleanser 8.4oz,FBALYB Amazon,311,258,53,0,53,0
,Eminence - Monoi Age Corrective Night Body Cream  5oz,Eminence - Monoi Age Corrective Night Body Cream  5oz,FBALYB Amazon,-2,-2,0,2,0,0
,Eminence - Monoi Age Corrective Night Cream For  Face & Neck 2oz,Eminence - Monoi Age Corrective Night Cream For  Face & Neck 2oz,Default,0,0,0,0,0,1
,Eminence - Monoi Age Corrective Night Cream For  Face & Neck 2oz,Eminence - Monoi Age Corrective Night Cream For  Face & Neck 2oz,FBALYB Amazon,-10,-10,0,1,0,0
,Eminence - Monoi Age Corrective Night Cream For  Face & Neck 2oz,Eminence - Monoi Age Corrective Night Cream For  Face & Neck 2oz,FBALYB Canada,1,1,0,0,0,0
,Eminence - Neroli Age Corrective Eye Serum 1oz,Eminence - Neroli Age Corrective Eye Serum 1oz,Default,0,0,0,0,0,1
,Eminence - Neroli Age Corrective Eye Serum 1oz,Eminence - Neroli Age Corrective Eye Serum 1oz,Default Ridgefield,458,458,0,0,0,0
,Eminence - Neroli Age Corrective Eye Serum 1oz,Eminence - Neroli Age Corrective Eye Serum 1oz,FBALYB Amazon,882,869,13,1,13,0
,Eminence - Neroli Age Corrective Hydrating Mist  4.2oz,Eminence - Neroli Age Corrective Hydrating Mist  4.2oz,Default Ridgefield,7,7,0,0,0,0
,Eminence - Neroli Age Corrective Hydrating Mist  4.2oz,Eminence - Neroli Age Corrective Hydrating Mist  4.2oz,FBALYB Amazon,206,186,20,0,20,0
,Eminence - No. 0 (Translucent) 0.28oz,Eminence - No. 0 (Translucent) 0.28oz,FBALYB Amazon,-1,-1,0,0,0,0
,Eminence - No. 1 (Honey Apple) 0.28oz,Eminence - No. 1 (Honey Apple) 0.28oz,FBALYB Amazon,-1,-1,0,0,0,0
,Eminence - No. 2 (Cherries And Berries) 0.28oz,Eminence - No. 2 (Cherries And Berries) 0.28oz,Default Ridgefield,3,3,0,0,0,0
,Eminence - No. 2 (Cherries And Berries) 0.28oz,Eminence - No. 2 (Cherries And Berries) 0.28oz,FBALYB Amazon,3,3,0,0,0,0
,Eminence - No. 4 (Calendula Spice) 0.28oz,Eminence - No. 4 (Calendula Spice) 0.28oz,FBALYB Amazon,-1,-1,0,0,0,0
,"Eminence- Organic Skincare Stone Crop Cleansing  Oil, 5 Fluid Ounce","Eminence- Organic Skincare Stone Crop Cleansing  Oil, 5 Fluid Ounce",FBALYB Amazon,340,324,16,4,16,0
,"Eminence- Organic Skincare Stone Crop Cleansing  Oil, 5 Fluid Ounce","Eminence- Organic Skincare Stone Crop Cleansing  Oil, 5 Fluid Ounce",FBALYB Canada,12,12,0,0,0,0
,Eminence Pear & Poppy Seed  Microderm Polisher 2 OZ,Eminence Pear & Poppy Seed  Microderm Polisher 2 OZ,Default,0,0,0,0,0,3
,Eminence Pear & Poppy Seed  Microderm Polisher 2 OZ,Eminence Pear & Poppy Seed  Microderm Polisher 2 OZ,Default Ridgefield,77,77,0,0,0,0
,Eminence Pear & Poppy Seed  Microderm Polisher 2 OZ,Eminence Pear & Poppy Seed  Microderm Polisher 2 OZ,FBALYB Amazon,10,6,4,0,4,0
,Eminence - Rice Milk 3 In 1 Cleansing Water 4.2oz,Eminence - Rice Milk 3 In 1 Cleansing Water 4.2oz,FBALYB Amazon,1,1,0,0,0,0
,Eminence - Rosehip & Lemongrass Shooting  Hydrator,Eminence - Rosehip & Lemongrass Shooting  Hydrator,FBALYB Amazon,12,12,0,0,0,0
,Eminence - Rosehip & Lemongrass Shooting  Hydrator,Eminence - Rosehip & Lemongrass Shooting  Hydrator,WFS,-3,-3,0,0,0,0
,Eminence - Rosehip & Maize Exfoliating Masque 2oz,Eminence - Rosehip & Maize Exfoliating Masque 2oz,FBALYB Amazon,-1,-1,0,0,0,0
,Eminence - Rosehip Triple C+E Firming Oil 1oz,Eminence - Rosehip Triple C+E Firming Oil 1oz,Default Ridgefield,10,10,0,0,0,0
,Eminence - Rosehip Triple C+E Firming Oil 1oz,Eminence - Rosehip Triple C+E Firming Oil 1oz,FBALYB Amazon,335,317,18,1,18,0
,Eminence - Rosehip Triple C+E Firming Oil 1oz,Eminence - Rosehip Triple C+E Firming Oil 1oz,FBALYB Canada,20,20,0,0,0,0
,Eminence - Rosehip Whip Moisturizer 2oz,Eminence - Rosehip Whip Moisturizer 2oz,FBALYB Amazon,-2,-2,0,0,0,0
,Eminence - Soothing Chamomile Tonique 4.2oz,Eminence - Soothing Chamomile Tonique 4.2oz,Default,0,0,0,0,0,3
,Eminence - Soothing Chamomile Tonique 4.2oz,Eminence - Soothing Chamomile Tonique 4.2oz,Default Ridgefield,200,200,0,0,0,0
,Eminence - Soothing Chamomile Tonique 4.2oz,Eminence - Soothing Chamomile Tonique 4.2oz,FBALYB Amazon,60,58,2,1,2,0
,Eminence - Soothing Chamomile Tonique 4.2oz,Eminence - Soothing Chamomile Tonique 4.2oz,FBALYB Canada,25,25,0,0,0,0
,Eminence Stone Crop Body Lotion 8.4 OZ,Eminence Stone Crop Body Lotion 8.4 OZ,FBALYB Amazon,2,2,0,0,0,0
,Eminence - Stone Crop Gel Wash 4.2oz,Eminence - Stone Crop Gel Wash 4.2oz,Default Ridgefield,42,42,0,0,0,0
,Eminence - Stone Crop Gel Wash 4.2oz,Eminence - Stone Crop Gel Wash 4.2oz,FBALYB Amazon,710,680,30,81,30,0
,Eminence - Stone Crop Gel Wash 4.2oz,Eminence - Stone Crop Gel Wash 4.2oz,FBALYB Canada,0,0,0,35,0,0
,Eminence - Stone Crop Hydrating Gel 1.2oz,Eminence - Stone Crop Hydrating Gel 1.2oz,Avrami - Ebay,4,4,0,0,0,0
,Eminence - Stone Crop Hydrating Gel 1.2oz,Eminence - Stone Crop Hydrating Gel 1.2oz,Default Ridgefield,5,5,0,0,0,0
,Eminence - Stone Crop Hydrating Gel 1.2oz,Eminence - Stone Crop Hydrating Gel 1.2oz,FBALYB Amazon,43,43,0,0,0,0
,Eminence - Stone Crop Hydrating Mist 4.2oz,Eminence - Stone Crop Hydrating Mist 4.2oz,Default Ridgefield,199,199,0,0,0,0
,Eminence - Stone Crop Hydrating Mist 4.2oz,Eminence - Stone Crop Hydrating Mist 4.2oz,FBALYB Amazon,521,494,27,1,27,0
,Eminence - Stone Crop Hydrating Mist 4.2oz,Eminence - Stone Crop Hydrating Mist 4.2oz,FBALYB Canada,0,0,0,30,0,0
,Eminence - Stone Crop Masque 2oz,Eminence - Stone Crop Masque 2oz,Default Ridgefield,2,2,0,0,0,0
,Eminence - Stone Crop Masque 2oz,Eminence - Stone Crop Masque 2oz,FBALYB Amazon,7,5,2,0,2,0
,Eminence - Stone Crop Masque 2oz,Eminence - Stone Crop Masque 2oz,WFS,-11,-11,0,0,0,0
,Eminence - Stone Crop Serum 1oz,Eminence - Stone Crop Serum 1oz,FBALYB Amazon,1,1,0,0,0,0
,Eminence - Stone Crop Whip Moisturizer 2oz,Eminence - Stone Crop Whip Moisturizer 2oz,FBALYB Amazon,3,3,0,0,0,0
,Eminence - Strawberry Rhubarb Dermafoliant 4.2oz,Eminence - Strawberry Rhubarb Dermafoliant 4.2oz,FBALYB Amazon,-6,-7,1,2,1,0
,Eminence - Strawberry Rhubarb Hyaluronic Serum  1oz,Eminence - Strawberry Rhubarb Hyaluronic Serum  1oz,Default Ridgefield,9,9,0,0,0,0
,Eminence - Strawberry Rhubarb Hyaluronic Serum  1oz,Eminence - Strawberry Rhubarb Hyaluronic Serum  1oz,FBALYB Amazon,472,465,7,0,7,0
,Eminence - Strawberry Rhubarb Masque 2oz,Eminence - Strawberry Rhubarb Masque 2oz,Default Ridgefield,30,30,0,0,0,0
,Eminence - Strawberry Rhubarb Masque 2oz,Eminence - Strawberry Rhubarb Masque 2oz,FBALYB Amazon,174,174,0,0,0,0
,Eminence - Strawberry Rhubarb Masque 8.4 oz,Eminence - Strawberry Rhubarb Masque 8.4 oz,Avrami - Ebay,21,21,0,0,0,0
,Eminence - Strawberry Rhubarb Masque 8.4 oz,Eminence - Strawberry Rhubarb Masque 8.4 oz,WFS,-9,-11,2,0,2,0
,Eminence Tropical Vanilla Day Cream SPF 32 2 OZ,Eminence Tropical Vanilla Day Cream SPF 32 2 OZ,Default Ridgefield,200,200,0,0,0,0
,Eminence Tropical Vanilla Day Cream SPF 32 2 OZ,Eminence Tropical Vanilla Day Cream SPF 32 2 OZ,FBALYB Amazon,-3,-3,0,1,0,0
,Eminence - Wild Plum Eye Cream 1.05oz,Eminence - Wild Plum Eye Cream 1.05oz,FBALYB Amazon,250,242,8,0,8,0
,Eminence - Yellow Sweet Clover Anti-Redness  Masque 1oz,Eminence - Yellow Sweet Clover Anti-Redness  Masque 1oz,FBALYB Amazon,2,2,0,0,0,0
,Energizer ENC4A 4 Amp Battery Charger,Energizer ENC4A 4 Amp Battery Charger,FBALYB Amazon,-1,-1,0,6,0,0
,"Enstrom Candies Almond Toffee in Milk Chocolate, 22 oz","Enstrom Candies Almond Toffee in Milk Chocolate, 22 oz",FBALYB Amazon,11,11,0,12,0,0
,EOS Lasting Hydration Lip 6ct,EOS Lasting Hydration Lip 6ct,FBALYB Amazon,10,10,0,188,0,0
,EOS Lasting Hydration Lip 6ct,EOS Lasting Hydration Lip 6ct,WFS,-13,-13,0,0,0,0
,Eos Lasting Hydration Lip Balm US,Eos Lasting Hydration Lip Balm US,Default,0,-8,8,0,0,0
,Eos Lasting Hydration Lip Balm US,Eos Lasting Hydration Lip Balm US,Default Ridgefield,101,101,0,0,0,0
,Eos Lasting Hydration Lip Balm US,Eos Lasting Hydration Lip Balm US,FBALYB Amazon,258,256,2,0,2,0
,Eos Organic 6ct Ontario,"Eos Organic 6ct Ontario Strawberry, Vanilla, Honey, Mint, Mango, Chamomille",Avrami - Ebay,120,120,0,0,0,0
,Eos Organic 6ct Ontario,"Eos Organic 6ct Ontario Strawberry, Vanilla, Honey, Mint, Mango, Chamomille",Default Ridgefield,67,67,0,0,0,0
,Eos Organic 6ct Ontario,"Eos Organic 6ct Ontario Strawberry, Vanilla, Honey, Mint, Mango, Chamomille",FBALYB Amazon,9,5,4,35,4,0
,Eos Organic 6ct Ontario,"Eos Organic 6ct Ontario Strawberry, Vanilla, Honey, Mint, Mango, Chamomille",WFS,-81,-81,0,0,0,0
,"EOS Organic Vanilla, strawberry, Mint 9 ct sticks","EOS Organic Vanilla, strawberry, Mint 9 ct sticks",Avrami - Ebay,8,8,0,0,0,0
,"EOS Organic Vanilla, strawberry, Mint 9 ct sticks","EOS Organic Vanilla, strawberry, Mint 9 ct sticks",Default Oxford,4,4,0,0,0,0
,"EOS Organic Vanilla, strawberry, Mint 9 ct sticks","EOS Organic Vanilla, strawberry, Mint 9 ct sticks",Default Ridgefield,601,601,0,0,0,0
,"EOS Organic Vanilla, strawberry, Mint 9 ct sticks","EOS Organic Vanilla, strawberry, Mint 9 ct sticks",FBALYB Amazon,1053,1050,3,2,3,0
,"EOS Organic Vanilla, strawberry, Mint 9 ct sticks","EOS Organic Vanilla, strawberry, Mint 9 ct sticks",FBALYB Canada,47,47,0,0,0,0
,"EOS Organic Vanilla, strawberry, Mint 9 ct sticks","EOS Organic Vanilla, strawberry, Mint 9 ct sticks",WFS,400,400,0,0,0,0
,"EOS Super Soft Shea Lip Balm 8ct (Strawberry, Marshmallow, Pineapple, Coconut Milk)","EOS Super Soft Shea Lip Balm 8ct (Strawberry, Marshmallow, Pineapple, Coconut Milk)",Default Ridgefield,4389,4389,0,0,0,0
,"EOS Super Soft Shea Lip Balm 8ct (Strawberry, Marshmallow, Pineapple, Coconut Milk)","EOS Super Soft Shea Lip Balm 8ct (Strawberry, Marshmallow, Pineapple, Coconut Milk)",FBALYB Amazon,478,470,8,18,8,0
,EOS Tropical,EOS Tropical ,FBALYB Amazon,99,99,0,0,0,0
,"EOS Watermellon Frose, Lyche Matini, Beach cocnut, Lavendar Latte 8 ct","EOS Watermellon Frose, Lyche Matini, Beach cocnut, Lavendar Latte 8 ct",Default Ridgefield,1911,1911,0,0,0,0
,"EOS Watermellon Frose, Lyche Matini, Beach cocnut, Lavendar Latte 8 ct","EOS Watermellon Frose, Lyche Matini, Beach cocnut, Lavendar Latte 8 ct",FBALYB Amazon,2976,2970,6,0,6,0
,Epionce Balancing Toner 4.0 fl oz,Epionce Balancing Toner 4.0 fl oz,Default Ridgefield,168,168,0,0,0,0
,Epionce Enriched Firming Mask 2.5 oz,Epionce Enriched Firming Mask 2.5 oz,FBALYB Amazon,1,1,0,0,0,0
,Epionce Epionce Enriched Body Cream,Epionce Epionce Enriched Body Cream,FBALYB Amazon,1,1,0,0,0,0
,Epionce Gentle Foaming Cleanser 6.0 fl oz,Epionce Gentle Foaming Cleanser 6.0 fl oz,FBALYB Amazon,2,2,0,0,0,0
,Epionce Intensive Nourishing Cream 1.7 oz,Epionce Intensive Nourishing Cream 1.7 oz,Default Ridgefield,3,3,0,0,0,0
,Epionce Intensive Nourishing Cream 1.7 oz,Epionce Intensive Nourishing Cream 1.7 oz,FBALYB Amazon,-4,-4,0,0,0,0
,Epionce Lite Lytic Tx 1.7 fl oz,Epionce Lite Lytic Tx 1.7 fl oz,Default Ridgefield,1,1,0,0,0,0
,Epionce Lite Lytic Tx 1.7 fl oz,Epionce Lite Lytic Tx 1.7 fl oz,FBALYB Amazon,14,14,0,0,0,0
,Epionce Lytic Tx 1.7 fl oz,Epionce Lytic Tx 1.7 fl oz,FBALYB Amazon,28,28,0,0,0,0
,Epionce Milky Lotion Cleanser 6.0 fl oz,Epionce Milky Lotion Cleanser 6.0 fl oz,FBALYB Amazon,-2,-2,0,0,0,0
,Epionce Purifying Spot Gel 0.34 oz,Epionce Purifying Spot Gel 0.34 oz,FBALYB Amazon,-9,-9,0,0,0,0
,Epionce Renewal Calming Cream 8.0 oz,Epionce Renewal Calming Cream 8.0 oz,Default Ridgefield,0,-45,45,0,0,0
,Epionce Renewal Facial Cream 1.7 oz,Epionce Renewal Facial Cream 1.7 oz,FBALYB Amazon,-2,-2,0,0,0,0
,Epionce Renewal Facial Lotion 1.7 fl oz,Epionce Renewal Facial Lotion 1.7 fl oz,Default Ridgefield,11,11,0,0,0,0
,Epionce Renewal Facial Lotion 1.7 fl oz,Epionce Renewal Facial Lotion 1.7 fl oz,FBALYB Amazon,-8,-8,0,35,0,0
,Epionce Restorative Hand Cream 2.5 oz,Epionce Restorative Hand Cream 2.5 oz,FBALYB Amazon,1,1,0,0,0,0
,"Epson T220 (2 Black, 3 Color)","Epson T220 Series Ink (2 Black, 3 Color) 452354",FBALYB Amazon,2,2,0,0,0,0
,Equiderma Horse Skin Lotion 16oz,Equiderma Horse Skin Lotion 16oz,FBALYB Amazon,1,1,0,0,0,0
,Erratic Molding Clay 3.4 oz,Erratic Molding Clay 3.4 oz ,Default,0,-103,103,0,0,1
,Erratic Molding Clay 3.4 oz,Erratic Molding Clay 3.4 oz ,Default Ridgefield,103,103,0,0,0,0
,Erratic Molding Clay 3.4 oz,Erratic Molding Clay 3.4 oz ,FBALYB Amazon,-4,-14,10,3,10,0
,Escort - PASSPORT Max2 Black,Escort - PASSPORT Max2 Radar and Laser Detector - Black,FBALYB Amazon,-2,-2,0,0,0,0
,Eshop Flex Hose 1inX3ft,Eshop Flex Hose 1inX3ft,Default,0,0,0,0,0,25
,ESHOPPS 3 in 1 4inch Micron Bag,ESHOPPS 3 in 1 4inch Micron Bag,Default Ridgefield,30,30,0,0,0,0
,Eshopps Micron Bag ‑ 3 PK,Eshopps Rectangular Micron Bag ‑ 3 PK,FBALYB Amazon,0,0,0,31,0,0
,Eshopps Micron Circle Bag - 3pk,Eshopps Circle Micron Bags 3pk,Default,-12,-12,0,0,0,0
,Eshopps PF‑800 Overflow Box,Eshopps PF‑800 Overflow Box,FBALYB Amazon,-1,-1,0,0,0,0
,"Espree Kitten Shampoo, 12 oz","Espree Kitten Shampoo, 12 oz",FBALYB Amazon,2,2,0,0,0,0
,Essential Daily Defense Crème SPF 20 1.75oz,Essential Daily Defense Crème SPF 20 1.75oz,FBALYB Amazon,1,1,0,0,0,0
,Estee Lauder Advanced Night Repair Synchronized Recovery Complex II 50ml,Estee Lauder Advanced Night Repair Synchronized Recovery Complex II 50ml,Default,0,0,0,0,0,3
,Estee Lauder Advanced Night Repair Synchronized Recovery Complex II 50ml,Estee Lauder Advanced Night Repair Synchronized Recovery Complex II 50ml,Default Ridgefield,129,129,0,0,0,0
,Estee Lauder Advanced Night Repair Synchronized Recovery Complex II 50ml,Estee Lauder Advanced Night Repair Synchronized Recovery Complex II 50ml,FBALYB Amazon,-10,-12,2,0,2,0
,Estee Lauder Double Wear Stay-in-place Makeup Spf10 30 ml,Estee Lauder Double Wear Stay-in-place Makeup Spf10 30 ml,Default,0,0,0,0,0,1
,Estee Lauder Revitalizing Supreme Global Plus Moist 50ml,Estee Lauder Revitalizing Supreme Global Plus Moist 50ml,Default,0,0,0,0,0,2
,Estee Lauder Revitalizing Supreme Global Plus Moist 50ml,Estee Lauder Revitalizing Supreme Global Plus Moist 50ml,FBALYB Amazon,-9,-9,0,1,0,0
,ES-YAGN-7WZJ,Disney Star Wars Mr Potato Head 30 Piece Set Luke Frywalker Darth Tater & Spu...,FBALYB Amazon,-1,-1,0,1,0,0
,Ethical Products Crock Dog Dish 7.5in,Ethical Products Crock Dog Dish 7.5in,FBALYB Amazon,1,0,1,0,1,0
,Ethical Stoneware Pet Dish 9.5inch,Ethical Stoneware Pet Dish 9.5inch,Default,0,-150,150,0,0,8
,Ethical Stoneware Pet Dish 9.5inch,Ethical Stoneware Pet Dish 9.5inch,Default Ridgefield,58,58,0,0,0,0
,Ethical Stoneware Pet Dish 9.5inch,Ethical Stoneware Pet Dish 9.5inch,FBALYB Amazon,144,144,0,0,0,0
,etmate Cafe Feeder Pearl White .75 Gal,etmate Cafe Feeder Pearl White .75 Gal,Default,0,0,0,0,0,18
,etmate Cafe Feeder Pearl White .75 Gal,etmate Cafe Feeder Pearl White .75 Gal,FBALYB Amazon,-6,-6,0,2,0,0
,Eucerin Plus Intensive Repair Lotion 2 Pk,Eucerin Plus Intensive Repair Lotion ‑ 21 Fl. Oz. 2 Pk.,FBALYB Amazon,11,11,0,0,0,0
,Eufora Beautifying Elixirs Bodifying Shampoo and conditioner Duo 8.5 Oz,Eufora Beautifying Elixirs Bodifying Shampoo and conditioner Duo 8.5 Oz,FBALYB Amazon,2,2,0,0,0,0
,"Eufora Beautifying Elixirs Moisture Intense Shampoo and Conditioner, 8.5 Ounce","Eufora Beautifying Elixirs Moisture Intense Shampoo and Conditioner, 8.5 Ounce",FBALYB Amazon,79,76,3,0,3,0
,Eufora - Beautifying Serum 4.2 Oz. (124 mL),Eufora - Beautifying Serum 4.2 Oz. (124 mL),Default Ridgefield,40,40,0,0,0,0
,Eufora - Beautifying Serum 4.2 Oz. (124 mL),Eufora - Beautifying Serum 4.2 Oz. (124 mL),FBALYB Amazon,90,79,11,0,11,0
,Eufora - Behave 6.8 Oz. (200 mL),Eufora - Behave 6.8 Oz. (200 mL),FBALYB Amazon,-1,-3,2,0,2,0
,Eufora - Bodifying Conditioner 8.45 Oz. (250 mL),Eufora - Bodifying Conditioner 8.45 Oz. (250 mL),Default Ridgefield,400,400,0,0,0,0
,Eufora - Bodifying Conditioner 8.45 Oz. (250 mL),Eufora - Bodifying Conditioner 8.45 Oz. (250 mL),FBALYB Amazon,64,64,0,0,0,0
,Eufora - Bodifying Conditioner 8.45 Oz. (250 mL),Eufora - Bodifying Conditioner 8.45 Oz. (250 mL),FBALYB Canada,18,18,0,0,0,0
,Eufora - Bodifying Shampoo 8.45 Oz. (250 mL),Eufora - Bodifying Shampoo 8.45 Oz. (250 mL),Default Ridgefield,204,204,0,0,0,0
,Eufora - Bodifying Shampoo 8.45 Oz. (250 mL),Eufora - Bodifying Shampoo 8.45 Oz. (250 mL),FBALYB Amazon,118,118,0,1,0,0
,Eufora Cleansing Treatment 6.8 OZ. (200 ML),Eufora Cleansing Treatment 6.8 OZ. (200 ML),FBALYB Amazon,2,2,0,0,0,0
,Eufora Complete Shampoo 10.1 Fl. OZ. (300 ML),Eufora Complete Shampoo 10.1 Fl. OZ. (300 ML),FBALYB Amazon,1,0,1,0,1,0
,Eufora - CONCEAL ? Blonde .21 Oz. (6g),Eufora - CONCEAL ? Blonde .21 Oz. (6g),Default Ridgefield,88,88,0,0,0,0
,Eufora - CONCEAL ? Blonde .21 Oz. (6g),Eufora - CONCEAL ? Blonde .21 Oz. (6g),FBALYB Amazon,64,63,1,0,1,0
,Eufora - CONCEAL ? Blonde .21 Oz. (6g),Eufora - CONCEAL ? Blonde .21 Oz. (6g),FBALYB Canada,17,16,1,0,1,0
,Eufora - Defining Solution 6 Oz. (180 mL),Eufora - Defining Solution 6 Oz. (180 mL),Default Ridgefield,1,1,0,0,0,0
,Eufora - Defining Solution 6 Oz. (180 mL),Eufora - Defining Solution 6 Oz. (180 mL),FBALYB Amazon,-3,-3,0,0,0,0
,Eufora - Details 4.4 Oz. (175 mL),Eufora - Details 4.4 Oz. (175 mL),Default,0,0,0,0,0,1
,Eufora - Details 4.4 Oz. (175 mL),Eufora - Details 4.4 Oz. (175 mL),Default Ridgefield,510,510,0,0,0,0
,Eufora - Details 4.4 Oz. (175 mL),Eufora - Details 4.4 Oz. (175 mL),FBALYB Amazon,63,59,4,0,4,0
,Eufora - Elevate 10 Oz. (330 mL),Eufora - Elevate 10 Oz. (330 mL),Default,0,0,0,0,0,160
,Eufora - Elevate 10 Oz. (330 mL),Eufora - Elevate 10 Oz. (330 mL),Default Ridgefield,190,190,0,0,0,0
,Eufora - Elevate 10 Oz. (330 mL),Eufora - Elevate 10 Oz. (330 mL),FBALYB Amazon,-4,-4,0,0,0,0
,Eufora - Elevate 10 Oz. (330 mL),Eufora - Elevate 10 Oz. (330 mL),FBALYB Canada,21,21,0,0,0,0
,Eufora - ElixirONE 4.2 Oz. (125 mL),Eufora - ElixirONE 4.2 Oz. (125 mL),FBALYB Amazon,19,18,1,0,1,0
,Eufora - ElixirONE 4.2 Oz. (125 mL),Eufora - ElixirONE 4.2 Oz. (125 mL),FBALYB Canada,18,18,0,0,0,0
,Eufora - Enhancing Conditioner 8.45 Oz. (250 mL),Eufora - Enhancing Conditioner 8.45 Oz. (250 mL),FBALYB Amazon,10,10,0,0,0,0
,Eufora - Formation 8 Oz. (230 mL),Eufora - Formation 8 Oz. (230 mL),Default Ridgefield,49,49,0,0,0,0
,Eufora - Forming Cream 5 Oz. (148 mL),Eufora - Forming Cream 5 Oz. (148 mL),Default Ridgefield,37,37,0,0,0,0
,Eufora - Forming Cream 5 Oz. (148 mL),Eufora - Forming Cream 5 Oz. (148 mL),FBALYB Amazon,3,2,1,0,1,0
,Eufora - Fortifi Keratin Repair 8.45 Oz. (250 mL),Eufora - Fortifi Keratin Repair 8.45 Oz. (250 mL),Default Ridgefield,216,216,0,0,0,0
,Eufora - Fortifi Keratin Repair 8.45 Oz. (250 mL),Eufora - Fortifi Keratin Repair 8.45 Oz. (250 mL),FBALYB Amazon,117,113,4,0,4,0
,Eufora Frizz Control Conditioner 8.45 OZ. (250 ML),Eufora Frizz Control Conditioner 8.45 OZ. (250 ML),Default,1,1,0,0,0,0
,Eufora Frizz Control Conditioner 8.45 OZ. (250 ML),Eufora Frizz Control Conditioner 8.45 OZ. (250 ML),FBALYB Amazon,-2,-2,0,0,0,0
,Eufora - Full Effect 5 Oz. (175 mL),Eufora - Full Effect 5 Oz. (175 mL),Default Ridgefield,2,2,0,0,0,0
,Eufora - Full Effect 5 Oz. (175 mL),Eufora - Full Effect 5 Oz. (175 mL),FBALYB Amazon,44,36,8,0,8,0
,Eufora - Full Effect 5 Oz. (175 mL),Eufora - Full Effect 5 Oz. (175 mL),FBALYB Canada,18,18,0,0,0,0
,Eufora Grooming Cream 4.2 Fl. OZ. (125 ML),Eufora Grooming Cream 4.2 Fl. OZ. (125 ML),FBALYB Amazon,-1,-1,0,0,0,0
,Eufora - Hydrating Shampoo 16.9 Oz. (500 mL),Eufora - Hydrating Shampoo 16.9 Oz. (500 mL),FBALYB Amazon,117,117,0,0,0,0
,Eufora - Hydrating Shampoo 16.9 Oz. (500 mL),Eufora - Hydrating Shampoo 16.9 Oz. (500 mL),FBALYB Canada,15,15,0,0,0,0
,Eufora - Illuminate 5.1 Oz. (150 mL),Eufora - Illuminate 5.1 Oz. (150 mL),Default,0,0,0,0,0,1
,Eufora - Illuminate 5.1 Oz. (150 mL),Eufora - Illuminate 5.1 Oz. (150 mL),Default Ridgefield,99,99,0,0,0,0
,Eufora - Illuminate 5.1 Oz. (150 mL),Eufora - Illuminate 5.1 Oz. (150 mL),FBALYB Amazon,16,4,12,0,12,0
,Eufora - Illuminate 5.1 Oz. (150 mL),Eufora - Illuminate 5.1 Oz. (150 mL),FBALYB Canada,9,9,0,0,0,0
,Eufora - Leave-In Hydration 6 Oz. (180 mL),Eufora - Leave-In Hydration 6 Oz. (180 mL),Default Ridgefield,72,72,0,0,0,0
,Eufora - Leave-In Hydration 6 Oz. (180 mL),Eufora - Leave-In Hydration 6 Oz. (180 mL),FBALYB Amazon,3,3,0,0,0,0
,Eufora - Leave-In Hydration 6 Oz. (180 mL),Eufora - Leave-In Hydration 6 Oz. (180 mL),FBALYB Canada,5,5,0,0,0,0
,Eufora - Leave-In Repair Treatment 6.8 Oz. (200 mL),Eufora - Leave-In Repair Treatment 6.8 Oz. (200 mL),Default Ridgefield,41,41,0,0,0,0
,Eufora - Leave-In Repair Treatment 6.8 Oz. (200 mL),Eufora - Leave-In Repair Treatment 6.8 Oz. (200 mL),FBALYB Amazon,26,26,0,0,0,0
,Eufora - Moisture Intense Conditioner 8.45 Oz. (250 mL),Eufora - Moisture Intense Conditioner 8.45 Oz. (250 mL),Default Ridgefield,29,-415,444,0,0,0
,Eufora - Moisture Intense Conditioner 8.45 Oz. (250 mL),Eufora - Moisture Intense Conditioner 8.45 Oz. (250 mL),FBALYB Amazon,19,19,0,0,0,0
,Eufora - Moisture Intense Shampoo 8.45 Oz. (250 mL),Eufora - Moisture Intense Shampoo 8.45 Oz. (250 mL),Default Ridgefield,29,-415,444,0,0,0
,Eufora - Moisture Intense Shampoo 8.45 Oz. (250 mL),Eufora - Moisture Intense Shampoo 8.45 Oz. (250 mL),FBALYB Amazon,59,59,0,0,0,0
,Eufora - Moisture Masque 6.75 Oz. (200 mL),Eufora - Moisture Masque 6.75 Oz. (200 mL),Default Ridgefield,0,-1,1,0,0,0
,Eufora - Moisture Masque 6.75 Oz. (200 mL),Eufora - Moisture Masque 6.75 Oz. (200 mL),FBALYB Amazon,26,26,0,0,0,0
,Eufora - Moisture Masque 6.75 Oz. (200 mL),Eufora - Moisture Masque 6.75 Oz. (200 mL),FBALYB Canada,6,6,0,10,0,0
,Eufora - Moisture Solution Conditioner 16.9 Oz. (500 mL),Eufora - Moisture Solution Conditioner 16.9 Oz. (500 mL),FBALYB Amazon,26,26,0,0,0,0
,Eufora - Moisture Solution Conditioner 16.9 Oz. (500 mL),Eufora - Moisture Solution Conditioner 16.9 Oz. (500 mL),FBALYB Canada,20,20,0,0,0,0
,Eufora Molding Paste 2 Fl. OZ (60 ML),Eufora Molding Paste 2 Fl. OZ (60 ML),Default Ridgefield,0,-28,28,0,0,0
,Eufora Molding Paste 2 Fl. OZ (60 ML),Eufora Molding Paste 2 Fl. OZ (60 ML),FBALYB Amazon,-1,-1,0,0,0,0
,Eufora - Perfect Curl Activator 6.8 Oz. (180 mL),Eufora - Perfect Curl Activator 6.8 Oz. (180 mL),FBALYB Amazon,4,4,0,0,0,0
,Eufora - Piece Works 4.2 Oz. (125 mL),Eufora - Piece Works 4.2 Oz. (125 mL),Default Ridgefield,28,28,0,0,0,0
,Eufora - Piece Works 4.2 Oz. (125 mL),Eufora - Piece Works 4.2 Oz. (125 mL),FBALYB Amazon,2,2,0,0,0,0
,Eufora - Piece Works 4.2 Oz. (125 mL),Eufora - Piece Works 4.2 Oz. (125 mL),FBALYB Canada,9,9,0,0,0,0
,Eufora - Pure Polish 5.1 Oz. (150 mL),Eufora - Pure Polish 5.1 Oz. (150 mL),Default Ridgefield,184,184,0,0,0,0
,Eufora - Pure Polish 5.1 Oz. (150 mL),Eufora - Pure Polish 5.1 Oz. (150 mL),FBALYB Amazon,149,146,3,1,3,0
,Eufora - Scalp Treatment 3.4 Oz. (100 mL),Eufora - Scalp Treatment 3.4 Oz. (100 mL),Default Ridgefield,108,108,0,0,0,0
,Eufora - Scalp Treatment 3.4 Oz. (100 mL),Eufora - Scalp Treatment 3.4 Oz. (100 mL),FBALYB Amazon,84,83,1,0,1,0
,Eufora - Sculpture 10.1 Oz. (300 mL),Eufora - Sculpture 10.1 Oz. (300 mL),Default Ridgefield,59,59,0,0,0,0
,Eufora - Sculpture 10.1 Oz. (300 mL),Eufora - Sculpture 10.1 Oz. (300 mL),FBALYB Amazon,-29,-35,6,24,6,0
,Eufora - Sculpture 10.1 Oz. (300 mL),Eufora - Sculpture 10.1 Oz. (300 mL),FBALYB Canada,14,14,0,0,0,0
,Eufora Soothing Hair & Body Cleanse 8.45 OZ. (250 ML),Eufora Soothing Hair & Body Cleanse 8.45 OZ. (250 ML),FBALYB Amazon,1,1,0,0,0,0
,Eufora - Straightening Balm 6.8 Oz. (200 mL),Eufora - Straightening Balm 6.8 Oz. (200 mL),FBALYB Amazon,-1,-1,0,0,0,0
,Eufora - Thickening Serum 5.1 Oz. (150 mL),Eufora - Thickening Serum 5.1 Oz. (150 mL),Default Ridgefield,3,3,0,0,0,0
,Eufora - Thickening Serum 5.1 Oz. (150 mL),Eufora - Thickening Serum 5.1 Oz. (150 mL),FBALYB Amazon,140,140,0,0,0,0
,Eufora - Urgent Repair Treatment 6 Oz. (180 mL),Eufora - Urgent Repair Treatment 6 Oz. (180 mL),Default,0,0,0,0,0,161
,Eufora - Urgent Repair Treatment 6 Oz. (180 mL),Eufora - Urgent Repair Treatment 6 Oz. (180 mL),Default Ridgefield,516,516,0,0,0,0
,Eufora - Urgent Repair Treatment 6 Oz. (180 mL),Eufora - Urgent Repair Treatment 6 Oz. (180 mL),FBALYB Amazon,145,143,2,0,2,0
,Euthymol Original Toothpaste 75 Ml,Euthymol Original Toothpaste 75 Ml,Default,0,-750,750,0,0,0
,Euthymol Original Toothpaste 75 Ml 3PK,Euthymol Original Toothpaste 75 Ml 3PK,FBALYB Amazon,0,-2,2,5,2,0
,Euthymol Original Toothpaste 75 Ml 6PK,Euthymol Original Toothpaste 75 Ml 6PK,FBALYB Amazon,-15,-15,0,13,0,0
,Evangers Beef/Bacon 13oz 12pk,Evangers Beef/Bacon 13oz 12pk,FBALYB Amazon,2,2,0,0,0,0
,Evangers Beef/Chicken 13oz 12pk,Evangers Beef/Chicken 13oz 12pk,FBALYB Amazon,4,4,0,0,0,0
,Evanger's Beef Dinner for Dogs 13oz 12pk,Evanger's Beef Dinner for Dogs 13oz 12pk,FBALYB Amazon,1,1,0,0,0,0
,Evangers Chicken 22oz 12pk,Evangers Chicken 22oz 12pk,FBALYB Amazon,3,3,0,1,0,0
,"Evangers Chicken Brown Rice Dry Dog Food, 4.4 lb","Evangers Chicken Brown Rice Dry Dog Food, 4.4 lb",Default,0,0,0,0,0,150
,"Evangers Chicken Brown Rice Dry Dog Food, 4.4 lb","Evangers Chicken Brown Rice Dry Dog Food, 4.4 lb",Joes Playground (Testing),3,2,1,0,0,7
,Evangers Chicken Drummette 13oz 12pk,Evangers Chicken Drummette 13oz 12pk,FBALYB Amazon,4,-1,5,0,5,0
,Evangers Chicken/Rice 13oz 12pk,Evangers Chicken/Rice 13oz 12pk,FBALYB Amazon,1,1,0,0,0,0
,Evangers Chicken Thighs 12oz 12pk,Evangers Chicken Thighs 12oz 12pk,Default,0,0,0,0,0,6
,Evangers Classic Puppy 13oz 12pk,Evangers Classic Puppy 13oz 12pk,FBALYB Amazon,1,1,0,0,0,0
,Evangers Cooked Chicken 13oz 12pk,Evangers Cooked Chicken 13oz 12pk,FBALYB Amazon,1,1,0,0,0,0
,Evanger's Duck Dinner for Dogs 13oz 12pk,Evanger's Duck Dinner for Dogs 13oz 12pk,FBALYB Amazon,-1,-1,0,0,0,0
,Evanger's Lamb Dinner for Dogs 13oz 12pk,Evanger's Lamb Dinner for Dogs 13oz 12pk,FBALYB Amazon,2,2,0,0,0,0
,Evangers Natural Buffalo 4.5oz,Evangers Natural Buffalo 4.5oz,Default,0,0,0,0,0,50
,Evangers Natural Venison 4.5oz,Evangers Natural Venison 4.5oz,FBALYB Amazon,14,14,0,0,0,0
,Evangers Rabbit 13oz 12pk,Evangers Rabbit 13oz 12pk,FBALYB Amazon,3,3,0,0,0,0
,Evangers Rabbit 6oz 24pk,Evangers Rabbit 6oz 24pk,FBALYB Amazon,-17,-17,0,18,0,0
,"Evangers Sweet Potato Dry Dog Food, 4 lb","Evangers Grain Free Whitefish Sweet Potato Dry Dog Food, 4 lb",FBALYB Amazon,109,109,0,0,0,0
,Evangers Turkey Dinner 13oz 12pk,Evangers Turkey Dinner 13oz 12pk,FBALYB Amazon,1,1,0,0,0,0
,Evangers Wild Salmon 12oz 12pk,Evangers Wild Salmon 12oz 12pk,FBALYB Amazon,7,7,0,0,0,0
,EVERCARE PET+ LINT REFILL 60 XTREME STIK LYR,EVERCARE PET+ LINT REFILL 60 XTREME STIK LYR,Default,0,0,0,0,0,94
,EVERCARE PET+ LINT REFILL 60 XTREME STIK LYR,EVERCARE PET+ LINT REFILL 60 XTREME STIK LYR,Default Ridgefield,324,324,0,0,0,0
,EVERCARE PET+ LINT REFILL 60 XTREME STIK LYR 4PK,EVERCARE PET+ LINT REFILL 60 XTREME STIK LYR 4PK,FBALYB Amazon,-4,-4,0,0,0,0
,EVERCARE PET+ LINT REFILL 60 XTREME STIK LYR 4PK,EVERCARE PET+ LINT REFILL 60 XTREME STIK LYR 4PK,FBALYB Canada,9,9,0,0,0,0
,EVERCARE PET+ LINT REFILL 60 XTREME STIK LYR 6PK,EVERCARE PET+ LINT REFILL 60 XTREME STIK LYR 6PK,FBALYB Amazon,-13,-13,0,0,0,0
,"Everlasting Treat Chicken, Small 2pk","Everlasting Treat Chicken, Small 2pk",FBALYB Amazon,-8,-8,0,0,0,0
,Everyone Soap 3-n-1 Lavender/Aloe 16oz,Everyone Soap 3-n-1 Lavender/Aloe 16oz,FBALYB Amazon,10,10,0,0,0,0
,Evo 18oz Internet Blue,Evo 18oz Internet Blue,Default CT,560,560,0,0,0,0
,Evo 18oz Internet Blue,Evo 18oz Internet Blue,Default Ridgefield,560,560,0,0,0,0
,Evo 18oz Internet Blue,Evo 18oz Internet Blue,FBALYB Amazon,15,15,0,12,0,0
,Evo 18oz Internet Green,Evo 18oz Internet Green,Default CT,310,310,0,0,0,0
,Evo 18oz Internet Green,Evo 18oz Internet Green,Default Ridgefield,10,10,0,0,0,0
,Evo 18oz Internet Green,Evo 18oz Internet Green,FBALYB Amazon,40,40,0,0,0,0
,Evo 18oz Internet Green,Evo 18oz Internet Green,FBALYB Canada,0,0,0,40,0,0
,Evo 18oz Internet Purple,Evo 18oz Internet Purple,Default CT,50,50,0,0,0,0
,Evo 18oz Internet Purple,Evo 18oz Internet Purple,Default Ridgefield,50,50,0,0,0,0
,Evo 18oz Internet Purple,Evo 18oz Internet Purple,FBALYB Amazon,3,3,0,0,0,0
,Evo 18oz Internet Red,Evo 18oz Internet Red,Default CT,160,160,0,0,0,0
,Evo 18oz Internet Red,Evo 18oz Internet Red,Default Ridgefield,100,100,0,0,0,0
,Evo 18oz Internet Red,Evo 18oz Internet Red,FBALYB Amazon,58,57,1,2,1,0
,Evo 18oz Internet Red,Evo 18oz Internet Red,FBALYB Canada,0,0,0,50,0,0
,Evo 18oz Internet Yellow,Evo 18oz Internet Yellow,Avrami - Ebay,270,270,0,0,0,0
,Evo 18oz Internet Yellow,Evo 18oz Internet Yellow,Default CT,2100,2100,0,0,0,0
,Evo 18oz Internet Yellow,Evo 18oz Internet Yellow,Default Oxford,731,731,0,0,0,0
,Evo 18oz Internet Yellow,Evo 18oz Internet Yellow,Default Ridgefield,2259,2259,0,0,0,0
,Evo 18oz Internet Yellow,Evo 18oz Internet Yellow,FBALYB Amazon,881,877,4,0,4,0
,Evo 18oz Internet Yellow,Evo 18oz Internet Yellow,WFS,-179,-180,1,0,1,0
,Evo 18oz Internet Yellow 2PK,Evo 18oz Internet Yellow 2PK,FBALYB Amazon,43,43,0,0,0,0
,Evo 6oz Glass Single Packed Blue,Evo 6oz Glass Single Packed Blue,Default CT,265,265,0,0,0,0
,Evo 6oz Glass Single Packed Blue,Evo 6oz Glass Single Packed Blue,Default Oxford,52,52,0,0,0,0
,Evo 6oz Glass Single Packed Blue,Evo 6oz Glass Single Packed Blue,FBALYB Amazon,110,109,1,0,1,0
,Evo 6oz Glass Single Packed Blue,Evo 6oz Glass Single Packed Blue,FBALYB Canada,19,19,0,0,0,0
,Evo 6oz Glass Single Packed Green,Evo 6oz Glass Single Packed Green,Default CT,1840,1840,0,0,0,0
,Evo 6oz Glass Single Packed Green,Evo 6oz Glass Single Packed Green,Default Ridgefield,1662,1662,0,0,0,0
,Evo 6oz Glass Single Packed Green,Evo 6oz Glass Single Packed Green,FBALYB Amazon,127,127,0,0,0,0
,Evo 6oz Glass Single Packed Green,Evo 6oz Glass Single Packed Green,FBALYB Canada,12,12,0,0,0,0
,Evo 6oz Glass Single Packed Purple,Evo 6oz Glass Single Packed Purple,Default CT,204,204,0,0,0,0
,Evo 6oz Glass Single Packed Purple,Evo 6oz Glass Single Packed Purple,Default Ridgefield,204,204,0,0,0,0
,Evo 6oz Glass Single Packed Purple,Evo 6oz Glass Single Packed Purple,FBALYB Amazon,33,29,4,1,4,0
,Evo 6oz Glass Single Packed Red,Evo 6oz Glass Single Packed Red,Default CT,1226,1226,0,0,0,0
,Evo 6oz Glass Single Packed Red,Evo 6oz Glass Single Packed Red,Default Ridgefield,1776,1776,0,0,0,0
,Evo 6oz Glass Single Packed Red,Evo 6oz Glass Single Packed Red,FBALYB Amazon,229,224,5,0,5,0
,Evo 6oz Glass Single Packed Yellow,Evo 6oz Glass Single Packed Yellow,Default,0,-99,99,0,0,0
,Evo 6oz Glass Single Packed Yellow,Evo 6oz Glass Single Packed Yellow,Default Ridgefield,1131,1131,0,0,0,0
,Evo 6oz Glass Single Packed Yellow,Evo 6oz Glass Single Packed Yellow,FBALYB Amazon,252,235,17,29,17,0
,Evo 8oz Ellipsoid Internet Blue/Blue,Evo 8oz Ellipsoid Internet Blue/Blue,Default CT,100,100,0,0,0,0
,Evo 8oz Ellipsoid Internet Blue/Blue,Evo 8oz Ellipsoid Internet Blue/Blue,Default Ridgefield,20,20,0,0,0,0
,Evo 8oz Ellipsoid Internet Blue/Blue,Evo 8oz Ellipsoid Internet Blue/Blue,FBALYB Amazon,2,2,0,0,0,0
,Evo 8oz Ellipsoid Internet Green/Green,Evo 8oz Ellipsoid Internet Green/Green,Default CT,50,50,0,0,0,0
,Evo 8oz Ellipsoid Internet Green/Green,Evo 8oz Ellipsoid Internet Green/Green,FBALYB Amazon,46,41,5,0,5,0
,Evo 8oz Ellipsoid Internet Purple/Purple,Evo 8oz Ellipsoid Internet Purple/Purple,FBALYB Amazon,-1,-1,0,0,0,0
,Evo 8oz Ellipsoid Internet Red/Red,Evo 8oz Ellipsoid Internet Red/Red,FBALYB Amazon,12,12,0,0,0,0
,Evo 8oz Ellipsoid Internet Yellow/Green,Evo 8oz Ellipsoid Internet Yellow/Green,Default Oxford,150,150,0,0,0,0
,Evo 8oz Ellipsoid Internet Yellow/Green,Evo 8oz Ellipsoid Internet Yellow/Green,FBALYB Amazon,10,10,0,1,0,0
,Evo 8oz Ellipsoid Internet Yellow/Yellow,Evo 8oz Ellipsoid Internet Yellow/Yellow,Default CT,102,102,0,0,0,0
,Evo 8oz Ellipsoid Internet Yellow/Yellow,Evo 8oz Ellipsoid Internet Yellow/Yellow,Default Ridgefield,1,1,0,0,0,0
,Evo 8oz Ellipsoid Internet Yellow/Yellow,Evo 8oz Ellipsoid Internet Yellow/Yellow,FBALYB Amazon,1,1,0,0,0,0
,Evo Accessory Pack,Evo Accessory Pack,Default CT,315,315,0,0,0,0
,Evo Accessory Pack,Evo Accessory Pack,Default Oxford,1,1,0,0,0,0
,Evo Accessory Pack,Evo Accessory Pack,Default Ridgefield,239,239,0,0,0,0
,Evo Accessory Pack,Evo Accessory Pack,FBALYB Amazon,76,74,2,0,2,0
,Evo Grill 16oz Single Packed,Evo Grill 16oz Single Packed,Avrami - Ebay,1320,1320,0,0,0,0
,Evo Grill 16oz Single Packed,Evo Grill 16oz Single Packed,Default,0,-1100,1100,0,0,0
,Evo Grill 16oz Single Packed,Evo Grill 16oz Single Packed,Default CT,1704,1704,0,0,0,0
,Evo Grill 16oz Single Packed,Evo Grill 16oz Single Packed,Default Ridgefield,2683,2683,0,0,0,0
,Evo Grill 16oz Single Packed,Evo Grill 16oz Single Packed,FBALYB Amazon,2463,2438,25,3,25,0
,Evo Grill 16oz Single Packed,Evo Grill 16oz Single Packed,FBALYB Canada,0,0,0,65,0,0
,Evo Grill 16oz Single Packed Black,Evo Grill 16oz Single Packed Black,Default Ridgefield,716,716,0,0,0,0
,Evo Grill 16oz Single Packed Black,Evo Grill 16oz Single Packed Black,FBALYB Amazon,610,610,0,9,0,0
,Evo Grill 16oz Single Packed Black,Evo Grill 16oz Single Packed Black,FBALYB Canada,6,6,0,0,0,0
,Evo Grill 16oz Single Packed Blue,Evo Grill 16oz Single Packed Blue,Default Ridgefield,232,232,0,0,0,0
,Evo Grill 16oz Single Packed Blue,Evo Grill 16oz Single Packed Blue,FBALYB Amazon,113,105,8,0,8,0
,Evo Grill 16oz Single Packed Purple,Evo Grill 16oz Single Packed Purple,Default CT,901,901,0,0,0,0
,Evo Grill 16oz Single Packed Purple,Evo Grill 16oz Single Packed Purple,Default Ridgefield,900,900,0,0,0,0
,Evo Grill 16oz Single Packed Purple,Evo Grill 16oz Single Packed Purple,FBALYB Amazon,248,248,0,1,0,0
,Evo Grill 16oz Single Packed Red,Evo Grill 16oz Single Packed Red,Default CT,400,400,0,0,0,0
,Evo Grill 16oz Single Packed Red,Evo Grill 16oz Single Packed Red,Default Ridgefield,150,150,0,0,0,0
,Evo Grill 16oz Single Packed Red,Evo Grill 16oz Single Packed Red,FBALYB Amazon,93,80,13,8,13,0
,Exergen Thermometer,Exergen Comfort Scanner Temporal Thermometer,FBALYB Amazon,-1,-1,0,0,0,0
,EXTREME CABERNET PAY 3 GET 4.,EXTREME CABERNET PAY 3 GET 4.,Default Ridgefield,317,314,3,0,0,0
,EXTREME CABERNET PAY 3 GET 4.,EXTREME CABERNET PAY 3 GET 4.,FBALYB Amazon,1182,1177,5,0,5,0
,EXTREME PINOT NOIR 8 pack (2x 3 get 4),EXTREME PINOT NOIR 8 pack (2x 3 get 4),FBALYB Amazon,13,9,4,0,4,0
,EXTREME PINOT NOIR PAY 3 GET 4.,EXTREME PINOT NOIR PAY 3 GET 4.,Default Ridgefield,1221,1221,0,0,0,0
,EXTREME PINOT NOIR PAY 3 GET 4.,EXTREME PINOT NOIR PAY 3 GET 4.,FBALYB Amazon,148,139,9,0,9,0
,Exuviance CoverBlend Multi-Function Concealer - Beige -  0.5oz,Exuviance CoverBlend Multi-Function Concealer - Beige -  0.5oz,FBALYB Amazon,-2,-2,0,0,0,0
,Exuviance CoverBlend Skin Caring Foundation SPF25 - Warm Beige - 1 oz,Exuviance CoverBlend Skin Caring Foundation SPF25 - Warm Beige - 1 oz,FBALYB Amazon,-1,-1,0,0,0,0
,Exuviance HA100 Micro Filler,Exuviance HA100 Micro Filler,FBALYB Amazon,2,2,0,0,0,0
,Exuviance Intensive Eye Treatment Pads - 12 Applications,Exuviance Intensive Eye Treatment Pads - 12 Applications ,FBALYB Amazon,151,151,0,0,0,0
,Exuviance Intensive Eye Treatment Pads - 12 Applications,Exuviance Intensive Eye Treatment Pads - 12 Applications ,WFS,-12,-12,0,0,0,0
,Exuviance Sand 0.5oz,Exuviance Sand 0.5oz,FBALYB Amazon,-3,-3,0,0,0,0
,Exuviance Sensitive/Dry Soothing Toning  Lotion 7.2oz,Exuviance Sensitive/Dry Soothing Toning  Lotion 7.2oz,FBALYB Amazon,2,2,0,0,0,0
,Exuviance Sheer Daily Protector SPF 50,Exuviance Sheer Daily Protector SPF 50,FBALYB Amazon,1,1,0,0,0,0
,Exuviance Targeted Treatments DePuffing  Eye Serum 0.2 fl oz,Exuviance Targeted Treatments DePuffing  Eye Serum 0.2 fl oz,FBALYB Amazon,32,32,0,0,0,0
,Exuviance Targeted Treatments DePuffing  Eye Serum 0.2 fl oz,Exuviance Targeted Treatments DePuffing  Eye Serum 0.2 fl oz,WFS,-11,-11,0,0,0,0
,Exuviance Targeted Treatments Super Retinol Concentrate,Exuviance Targeted Treatments Super Retinol Concentrate,FBALYB Amazon,1,1,0,0,0,0
,Exuviance Vespera Bionic Serum 1oz,Exuviance Vespera Bionic Serum 1oz,FBALYB Amazon,-3,-3,0,0,0,0
,Faber Castell 110038 Polychromos 36 Pencil Studio Set,Faber Castell 110038 Polychromos 36 Pencil Studio Set,Default Ridgefield,198,198,0,0,0,0
,Faber Castell 110038 Polychromos 36 Pencil Studio Set,Faber Castell 110038 Polychromos 36 Pencil Studio Set,FBALYB Amazon,-2,-2,0,0,0,0
,Faber Castell 114736 Creative Studio Goldfaber Color Pencils- Tin of 36,Faber Castell 114736 Creative Studio Goldfaber Color Pencils- Tin of 36,FBALYB Amazon,111,111,0,0,0,0
,"Faber Castell 117536 Albrecht Durer Artist Watercolor Pencils in A Metal Tin (36 Pack), Assorted","Faber Castell 117536 Albrecht Durer Artist Watercolor Pencils in A Metal Tin (36 Pack), Assorted",FBALYB Amazon,-5,-5,0,0,0,0
,"Faber Castell 117538 Albrecht Durer Watercolor Pencil Studio Gift Set, Box of 36 Colors","Faber Castell 117538 Albrecht Durer Watercolor Pencil Studio Gift Set, Box of 36 Colors",FBALYB Amazon,-3,-3,0,0,0,0
,Faber Castell 119064 9000 Design Pencil Pack of 12,Faber Castell 119064 9000 Design Pencil Pack of 12,FBALYB Amazon,-4,-4,0,0,0,0
,Faber Castell 119065 9000 Graphite Sketch Pencil Sets Art set of 12,Faber Castell 119065 9000 Graphite Sketch Pencil Sets Art set of 12,FBALYB Amazon,77,77,0,0,0,0
,"Faber Castell 120124 World Colors Ecopencils, 27 Count","Faber Castell 120124 World Colors Ecopencils, 27 Count",Default Ridgefield,139,139,0,0,0,0
,Faber Castell 125029 Connector Paint Box Watercolor Set- 24 Watercolor Paints with Brush & Accessories,Faber Castell 125029 Connector Paint Box Watercolor Set- 24 Watercolor Paints with Brush & Accessories,Default Ridgefield,233,233,0,0,0,0
,Faber Castell 125029 Connector Paint Box Watercolor Set- 24 Watercolor Paints with Brush & Accessories,Faber Castell 125029 Connector Paint Box Watercolor Set- 24 Watercolor Paints with Brush & Accessories,FBALYB Amazon,57,57,0,0,0,0
,Faber Castell 155560 Felt-Tip Pen Connector in Case 60 Pieces,Faber Castell 155560 Felt-Tip Pen Connector in Case 60 Pieces,FBALYB Amazon,-3,-3,0,0,0,0
,Faber Castell 160330 Albrecht Durer Artist Watercolor Markers- 30 Assorted Colors,Faber Castell 160330 Albrecht Durer Artist Watercolor Markers- 30 Assorted Colors,FBALYB Amazon,9,9,0,0,0,0
,Faber Castell 167100 Pitt Artist Pen Wallet Black (4 Sizes),Faber Castell 167100 Pitt Artist Pen Wallet Black (4 Sizes),FBALYB Amazon,104,103,1,0,1,0
,Faber Castell 167102 Pitt Artist Pen Wallet Sanguine,Faber Castell 167102 Pitt Artist Pen Wallet Sanguine,FBALYB Amazon,48,48,0,0,0,0
,"Faber Castell 167103 Pitt Artist Brush Pens, Basic, 6- pack","Faber Castell 167103 Pitt Artist Brush Pens, Basic, 6- pack",FBALYB Amazon,81,79,2,0,2,0
,"Faber Castell 167137 Wallet Pitt Pen Nibs Art Set, Assorted","Faber Castell 167137 Wallet Pitt Pen Nibs Art Set, Assorted",Default Ridgefield,200,200,0,0,0,0
,"Faber Castell 167137 Wallet Pitt Pen Nibs Art Set, Assorted","Faber Castell 167137 Wallet Pitt Pen Nibs Art Set, Assorted",FBALYB Amazon,42,42,0,0,0,0
,Faber Castell 167139 Pitt Artist Pen Wallet Black (4 Sizes),Faber Castell 167139 Pitt Artist Pen Wallet Black (4 Sizes),FBALYB Amazon,47,46,1,1,1,0
,"Faber Castell 167146 Pitt Artist Brush Pens (12 Pack), Multicolor","Faber Castell 167146 Pitt Artist Brush Pens (12 Pack), Multicolor",FBALYB Amazon,-2,-2,0,0,0,0
,"Faber Castell 167147 Pitt Artist Brush Pens (24 Pack), Multicolor","Faber Castell 167147 Pitt Artist Brush Pens (24 Pack), Multicolor",FBALYB Amazon,-1,-1,0,0,0,0
,Faber Castell 167164 Pitt Artists Pen Set 6 Shades of Blue,Faber Castell 167164 Pitt Artists Pen Set 6 Shades of Blue,FBALYB Amazon,69,69,0,0,0,0
,Faber Castell 167804 4 x Pitt Artist Pens (Soft Brush) Shades of Grey,Faber Castell 167804 4 x Pitt Artist Pens (Soft Brush) Shades of Grey,FBALYB Amazon,74,74,0,0,0,0
,"FACT, AXIS, SKEL THUMB","Benchmade - Fact 417 Minimalist Manual Open Folding,Spear-Point Blade Satin Finish",Default Ridgefield,2,2,0,0,0,0
,"FACT, AXIS, SKEL THUMB","Benchmade - Fact 417 Minimalist Manual Open Folding,Spear-Point Blade Satin Finish",FBALYB Amazon,44,33,11,0,11,0
,Fairy Liquid Original 433ML,Fairy Liquid Original 433ML,Default Ridgefield,1,1,0,0,0,0
,Fairy Liquid Original 433ML,Fairy Liquid Original 433ML,FBALYB Amazon,-1,-1,0,0,0,0
,Fairy Liquid Original 433ML 2 pk,Fairy Liquid Original 433ML 2 pk,FBALYB Amazon,18,8,10,2,10,0
,Fairy Original Washing Up Liquid 6pk,Fairy Original Washing Up Liquid 6pk,FBALYB Amazon,13,13,0,2,0,0
,Fanola Botugen RESTRUCTURING MASK 1000 ml,Fanola Botugen RESTRUCTURING MASK 1000 ml,Default Ridgefield,72,72,0,0,0,0
,Fanola Botugen RESTRUCTURING MASK 300 ml,Fanola Botugen RESTRUCTURING MASK 300 ml,Default Ridgefield,144,144,0,0,0,0
,Fanola Botugen RESTRUCTURING SHAMPOO 1000 ml,Fanola Botugen RESTRUCTURING SHAMPOO 1000 ml,Default Ridgefield,72,72,0,0,0,0
,Fanola Botugen RESTRUCTURING SHAMPOO 300 ml,Fanola Botugen RESTRUCTURING SHAMPOO 300 ml,Default Ridgefield,144,144,0,0,0,0
,Fanola KERATERM MASK 1000 ml,Fanola KERATERM MASK 1000 ml,Default Ridgefield,72,72,0,0,0,0
,Fanola KERATERM MASK 300 ml,Fanola KERATERM MASK 300 ml,Default Ridgefield,144,144,0,0,0,0
,Fanola KERATERM SHAMPOO 1000 ml,Fanola KERATERM SHAMPOO 1000 ml,Default Ridgefield,72,72,0,0,0,0
,Fanola KERATERM SHAMPOO 300 ml,Fanola KERATERM SHAMPOO 300 ml,Default Ridgefield,144,144,0,0,0,0
,Fanola KERATERM SPRAY 200 ml,Fanola KERATERM SPRAY 200 ml,Default Ridgefield,72,72,0,0,0,0
,FANOLA MASK 1000ML NO YELLOW,FANOLA MASK 1000ML NO YELLOW,Default Ridgefield,7229,7229,0,0,0,0
,FANOLA MASK 1000ML NO YELLOW,FANOLA MASK 1000ML NO YELLOW,FBALYB Amazon,271,263,8,0,8,0
,Fanola No More THE PREP CLEANSER 1000ml,Fanola No More THE PREP CLEANSER 1000ml,Default Ridgefield,96,96,0,0,0,0
,Fanola No More THE PREP CLEANSER 250 ml,Fanola No More THE PREP CLEANSER 250 ml,Default Ridgefield,120,120,0,0,0,0
,Fanola No More THE STYLING MASK 350 ml,Fanola No More THE STYLING MASK 350 ml,Default Ridgefield,120,120,0,0,0,0
,Fanola No More THE STYLING MASK 750 ml,Fanola No More THE STYLING MASK 750 ml,Default Ridgefield,96,96,0,0,0,0
,Fanola NO ORANGE MASK 1000 ml,Fanola NO ORANGE MASK 1000 ml,Default Ridgefield,443,443,0,0,0,0
,Fanola NO ORANGE MASK 200 ml,Fanola NO ORANGE MASK 200 ml,Default Ridgefield,1080,1080,0,0,0,0
,Fanola No Orange Shampoo 1000ml,Fanola No Orange Shampoo 1000ml,Default Ridgefield,1746,1746,0,0,0,0
,Fanola No Orange Shampoo 1000ml,Fanola No Orange Shampoo 1000ml,FBALYB Amazon,-4,-5,1,500,1,0
,Fanola No Orange Shampoo 1000ml,Fanola No Orange Shampoo 1000ml,FBALYB Canada,176,174,2,0,2,0
,Fanola No Orange Shampoo 350ml,Fanola No Orange Shampoo 350ml,Default Ridgefield,1473,1473,0,0,0,0
,Fanola No Orange Shampoo 350ml,Fanola No Orange Shampoo 350ml,FBALYB Canada,241,234,7,0,7,0
,Fanola No Orange Shampoo 350ml,Fanola No Orange Shampoo 350ml,FBALYB Saudi,12,12,0,0,0,0
,Fanola No Orange Shampoo 350ml 2PK,Fanola No Orange Shampoo 350ml 2PK,FBALYB Amazon,11,10,1,0,1,0
,Fanola No Orange Shampoo 350ml 2PK,Fanola No Orange Shampoo 350ml 2PK,FBALYB Canada,0,0,0,40,0,0
,Fanola No Orange Shampoo 350ml + Fanola No Orange Mask 350ml Set,Fanola No Orange Shampoo 350ml + Fanola No Orange Mask 350ml Set,FBALYB Amazon,10,10,0,2,0,0
,Fanola No Orange Shampoo 350ml + Fanola Nutri Care Restructuring Conditioner 350ml SET,Fanola No Orange Shampoo 350ml + Fanola Nutri Care Restructuring Conditioner 350ml SET,FBALYB Amazon,1193,1188,5,0,5,0
,Fanola No Orange Shampoo & NO ORANGE MASK 1000 ml DUO,Fanola No Orange Shampoo & NO ORANGE MASK 1000 ml DUO,FBALYB Amazon,211,210,1,6,1,0
,Fanola- No Yellow Care 2-PHASE POTION 150 ml,Fanola- No Yellow Care 2-PHASE POTION 150 ml,Default Ridgefield,96,96,0,0,0,0
,Fanola- No Yellow Care THERMO-PROTECTIVE CREAM 150 ml,Fanola- No Yellow Care THERMO-PROTECTIVE CREAM 150 ml,Default Ridgefield,120,120,0,0,0,0
,Fanola - No Yellow Mask 100 ML,Fanola - No Yellow Mask 100 ML,Default Ridgefield,696,696,0,0,0,0
,Fanola No Yellow Mask 1L,Fanola No Yellow Mask 1L,Default Ridgefield,2280,2280,0,0,0,0
,Fanola No Yellow Mask 350ml,Fanola No Yellow Mask 350ml,Default Ridgefield,7312,7312,0,0,0,0
,Fanola No Yellow Mask 350ml,Fanola No Yellow Mask 350ml,FBALYB Amazon,367,362,5,0,5,0
,Fanola No Yellow Shampoo 1000ml,Fanola No Yellow Shampoo 1000ml,Default Ridgefield,9298,9298,0,0,0,0
,Fanola No Yellow Shampoo 1000ml,Fanola No Yellow Shampoo 1000ml,FBALYB Amazon,2655,2637,18,1,18,0
,Fanola No Yellow Shampoo 1000ml,Fanola No Yellow Shampoo 1000ml,FBALYB Canada,0,0,0,50,0,0
,Fanola No Yellow Shampoo 1000ml,Fanola No Yellow Shampoo 1000ml,FBALYB Saudi,18,18,0,0,0,0
,Fanola No Yellow Shampoo 1000ml 2PK,Fanola No Yellow Shampoo 1000ml 2PK,FBALYB Amazon,597,597,0,0,0,0
,Fanola No Yellow Shampoo 1000ml 3PK,Fanola No Yellow Shampoo 1000ml 3PK,FBALYB Amazon,87,87,0,0,0,0
,Fanola- No Yellow Shampoo 100 ML,Fanola- No Yellow Shampoo 100 ML,Default Ridgefield,984,984,0,0,0,0
,Fanola No Yellow Shampoo 350ml,Fanola No Yellow Shampoo 350ml,Default Ridgefield,293,293,0,0,0,0
,Fanola No Yellow Shampoo 350ml,Fanola No Yellow Shampoo 350ml,FBALYB Amazon,932,930,2,34,2,0
,Fanola No Yellow Shampoo 350ml,Fanola No Yellow Shampoo 350ml,FBALYB Canada,863,852,11,1001,11,0
,Fanola No Yellow Shampoo 350ml + Fanola No Orange Shampoo 350ml SET,Fanola No Yellow Shampoo 350ml + Fanola No Orange Shampoo 350ml SET,FBALYB Canada,61,59,2,0,2,0
,Fanola No Yellow Shampoo 350ml + Fanola No Yellow Mask 350ml set,Fanola No Yellow Shampoo 350ml + Fanola No Yellow Mask 350ml set,Default Ridgefield,816,816,0,0,0,0
,Fanola No Yellow Shampoo 350ml + Fanola No Yellow Mask 350ml set,Fanola No Yellow Shampoo 350ml + Fanola No Yellow Mask 350ml set,FBALYB Amazon,515,514,1,0,1,0
,Fanola No Yellow Shampoo 350ml + Fanola No Yellow Mask 350ml set,Fanola No Yellow Shampoo 350ml + Fanola No Yellow Mask 350ml set,FBALYB Canada,50,48,2,0,2,0
,Fanola No Yellow Shampoo 350 ml & Fanola Nutri Care Restructuring Mask 500 ml,Fanola No Yellow Shampoo 350 ml & Fanola Nutri Care Restructuring Mask 500 ml,FBALYB Saudi,24,24,0,0,0,0
,Fanola No Yellow Shampoo &  Fanola No Orange Shampoo 1000ml Duo,Fanola No Yellow Shampoo &  Fanola No Orange Shampoo 1000ml Duo,FBALYB Amazon,4,4,0,0,0,0
,Fanola No Yellow Shampoo & Fanola Nutri Care Restructuring Conditioner 1000ml Duo,Fanola No Yellow Shampoo & Fanola Nutri Care Restructuring Conditioner 1000ml Duo,Default Ridgefield,0,-200,200,0,0,0
,Fanola No Yellow Shampoo & Fanola Nutri Care Restructuring Conditioner 1000ml Duo,Fanola No Yellow Shampoo & Fanola Nutri Care Restructuring Conditioner 1000ml Duo,FBALYB Amazon,399,389,10,141,10,0
,Fanola No Yellow Shampoo & Nutri Care Restructuring Conditioner 350ml Duo,Fanola No Yellow Shampoo & Nutri Care Restructuring Conditioner 350ml Duo,Default Ridgefield,0,-740,740,0,0,0
,Fanola Nutri Care Nutri-One 10 Actions Restructuring Spray Mask 200ml,Fanola Nutri Care Nutri-One 10 Actions Restructuring Spray Mask 200ml,Default Ridgefield,513,513,0,0,0,0
,Fanola Nutri Care Nutri-One 10 Actions Restructuring Spray Mask 200ml,Fanola Nutri Care Nutri-One 10 Actions Restructuring Spray Mask 200ml,FBALYB Amazon,376,373,3,0,3,0
,Fanola Nutri Care Restructuring Conditioner 1000ml,Fanola Nutri Care Restructuring Conditioner 1000ml,Default Ridgefield,1188,1188,0,0,0,0
,Fanola Nutri Care Restructuring Conditioner 1000ml,Fanola Nutri Care Restructuring Conditioner 1000ml,FBALYB Amazon,2,2,0,0,0,0
,Fanola Nutri Care Restructuring Conditioner 350ml,Fanola Nutri Care Restructuring Conditioner 350ml,Default Ridgefield,708,708,0,0,0,0
,Fanola Nutri care RESTRUCTURING FLUID CRYSTALS 100 ml,Fanola Nutri care RESTRUCTURING FLUID CRYSTALS 100 ml,Default Ridgefield,144,144,0,0,0,0
,Fanola Nutri Care Restructuring Mask 1500ml,Fanola Nutri Care Restructuring Mask 1500ml,Default Ridgefield,782,782,0,0,0,0
,Fanola Nutri Care Restructuring Mask 1500ml,Fanola Nutri Care Restructuring Mask 1500ml,FBALYB Amazon,445,438,7,7,7,0
,Fanola Nutri Care Restructuring Mask 500ml,Fanola Nutri Care Restructuring Mask 500ml,Default Ridgefield,1423,1423,0,0,0,0
,Fanola Nutri Care Restructuring Mask 500ml,Fanola Nutri Care Restructuring Mask 500ml,FBALYB Amazon,498,498,0,0,0,0
,Fanola Nutri Care Restructuring Mask 500ml,Fanola Nutri Care Restructuring Mask 500ml,FBALYB Canada,16,16,0,0,0,0
,Fanola Nutri Care Restructuring Shampoo 1000ml,Fanola Nutri Care Restructuring Shampoo 1000ml,Default Ridgefield,1595,1595,0,0,0,0
,Fanola Nutri Care RESTRUCTURING SHAMPOO 350 ml,Fanola Nutri Care RESTRUCTURING SHAMPOO 350 ml,Default Ridgefield,288,288,0,0,0,0
,Fanola - RESTRUCTURING LEAVE-IN CONDITIONER 300 ML,Fanola - RESTRUCTURING LEAVE-IN CONDITIONER 300 ML,Default Ridgefield,1440,1440,0,0,0,0
,FANOLA SHAMPOO 350ML ANTIORANGE,FANOLA SHAMPOO 350ML ANTIORANGE,Default Ridgefield,1929,1929,0,0,0,0
,FANOLA SHAMPOO 350ML NO YELLOW CARE,FANOLA SHAMPOO 350ML NO YELLOW CARE,Default Ridgefield,-2,-2,0,0,0,0
,FANOLA SHAMPOO 350ML NO YELLOW CARE,FANOLA SHAMPOO 350ML NO YELLOW CARE,FBALYB Amazon,61,55,6,2,6,0
,Febreeze Car Linen and Sky 5 count,Febreze Car Linen and Sky 5 count,Default,0,0,0,0,0,29
,Febreeze Car Linen and Sky 5 count,Febreze Car Linen and Sky 5 count,Default Ridgefield,243,243,0,0,0,0
,Febreeze Car Linen and Sky 5 count,Febreze Car Linen and Sky 5 count,FBALYB Amazon,401,341,60,292,60,0
,Febreze 27oz Variety 2pk,Febreze 27oz Variety 2pk,Default,-72,-72,0,0,0,0
,Febreze 27oz Variety 2pk,Febreze 27oz Variety 2pk,FBALYB Amazon,7,7,0,0,0,0
,Febreze Antibacterial 27oz,Febreze Antibacterial 27oz,Default,0,0,0,0,0,218
,Febreze Antibacterial 27oz,Febreze Antibacterial 27oz,Default Ridgefield,7,7,0,0,0,0
,Febreze Antibacterial 27oz 2pk,Febreze Antibacterial 27oz 2pk,FBALYB Amazon,282,282,0,18,0,0
,Febreze Anti Tobbaco Car Clips 8 Pack,Febreze Anti Tobbaco Car Clips 8 Pack,FBALYB Amazon,-2,-2,0,0,0,0
,Febreze Car Anti Tobacco Clip Air Freshener,Febreze Car Anti Tobacco Clip Air Freshener,Default,0,-240,240,0,0,0
,Febreze Car Vent Clip 4pk Linen & Sky,Febreze Car Vent Clip 4pk Linen & Sky,Default,0,-120,120,0,0,0
,Febreze Car Vent Clip 4pk Linen & Sky,Febreze Car Vent Clip 4pk Linen & Sky,Default Ridgefield,28,28,0,0,0,0
,Febreze Car Vent Clip 4pk Linen & Sky,Febreze Car Vent Clip 4pk Linen & Sky,FBALYB Amazon,-121,-146,25,120,25,0
,Febreze Car Vent Clip 4pk Linen & Sky 2pk,Febreze Car Vent Clip 4pk Linen & Sky 2pk,FBALYB Amazon,-47,-48,1,42,1,0
,Febreze Car Vents Total 12ct (3pk x 4),Febreze Car Vents Total 12ct (3pk x 4),FBALYB Amazon,38,38,0,2,0,0
,Febreze Original Extra Strength 27oz,Febreze Original Extra Strength 27oz,Default,0,-72,72,0,0,0
,Febreze Original Extra Strength 27oz,Febreze Original Extra Strength 27oz,Default Ridgefield,3,3,0,0,0,0
,Febreze Original Extra Strength 27oz,Febreze Original Extra Strength 27oz,FBALYB Amazon,81,81,0,24,0,0
,Febreze Original Extra Strength 27oz 2pk,Febreze Original Extra Strength 27oz 2pk,FBALYB Amazon,-11,-13,2,24,2,0
,Febreze Small Spaces 2 Linen&Sky + 2 Unstopables Fresh,Febreze Small Spaces 2 Linen&Sky + 2 Unstopables Fresh,FBALYB Amazon,1,1,0,0,0,0
,Felina Women's Bralette 2pk Large Black/Grey,Felina Women's Bralette 2pk Large Black/Grey ,Default,0,0,0,0,0,151
,Felina Women's Bralette 2pk Large Black/Grey,Felina Women's Bralette 2pk Large Black/Grey ,FBALYB Amazon,-35,-35,0,0,0,0
,Felina Women's Bralette 2pk Large White/Purple,Felina Women's Bralette 2pk Large White/Purple,Default,1,1,0,0,0,1
,Felina Women's Bralette 2pk Large White/Purple,Felina Women's Bralette 2pk Large White/Purple,FBALYB Amazon,-5,-5,0,0,0,0
,Felina Women's Bralette 2pk Medium Black/Grey,Felina Women's Bralette 2pk Medium Black/Grey ,FBALYB Amazon,-29,-31,2,0,2,0
,Felina Women's Bralette 2pk Medium White/Pink,Felina Women's Bralette 2pk Medium White/Pink,Default,0,0,0,0,0,1
,Felina Women's Bralette 2pk Medium White/Purple,Felina Women's Bralette 2pk Medium White/Purple,Default,0,0,0,0,0,13
,Felina Women's Bralette 2pk Medium White/Purple,Felina Women's Bralette 2pk Medium White/Purple,FBALYB Amazon,-2,-2,0,0,0,0
,Felina Women's Bralette 2pk Small Black/Grey,Felina Women's Bralette 2pk Small Black/Grey ,FBALYB Amazon,-3,-3,0,0,0,0
,Felina Women's Bralette 2pk Small White/Purple,Felina Women's Bralette 2pk Small White/Purple,FBALYB Amazon,-1,-1,0,0,0,0
,Felina Women's Bralette 2pk XLarge Black/Grey,Felina Women's Bralette 2pk XLarge Black/Grey,Default,-1,-1,0,0,0,0
,Felina Women's Bralette 2pk XLarge White/Purple,Felina Women's Bralette 2pk XLarge White/Purple,Default,0,0,0,0,0,4
,Feline Greenies Dental Treat 2.5oz Beef 6 pk,Feline Greenies Dental Treat 2.5oz Beef 6 pk,FBALYB Amazon,-1,-1,0,1,0,0
,Feline Greenies Dental Treat 2.5oz Chicken 6PK,Feline Greenies Dental Treat 2.5oz Chicken 6PK,FBALYB Amazon,5,5,0,0,0,0
,Feline Greenies Dental Treat 2.5oz Salmon 6PK,Feline Greenies Dental Treat 2.5oz Salmon 6PK,FBALYB Amazon,7,7,0,0,0,0
,Feline Greenies Dental Treat Fusion 2.5oz Chicken/Salmon 2pk,Feline Greenies Dental Treat Fusion 2.5oz Chicken/Salmon 2pk,FBALYB Amazon,-4,-4,0,0,0,0
,Feliway Refill for Diffuser Multiple Cats 3pk,Feliway Refill for Diffuser Multiple Cats 3pk,Default,0,0,0,0,0,26
,Feliway Refill for Diffuser Multiple Cats 3pk,Feliway Refill for Diffuser Multiple Cats 3pk,FBALYB Amazon,-1,-1,0,1,0,0
,Femfresh Ultimate Care Active Fresh Wash 250ml,Femfresh Ultimate Care Active Fresh Wash 250ml,Default Ridgefield,606,606,0,0,0,0
,Femfresh Ultimate Care Active Fresh Wash 250ml 3PK,Femfresh Ultimate Care Active Fresh Wash 250ml 3PK,FBALYB Amazon,48,48,0,0,0,0
,Femfresh Ultimate Care Pure & Fresh Wash 250ml,Femfresh Ultimate Care Pure & Fresh Wash 250ml,Default Ridgefield,786,786,0,0,0,0
,Femfresh Wash 250ML Daily Intimate,Femfresh Wash 250ML Daily Intimate,FBALYB Amazon,-2,-2,0,0,0,0
,Femfresh Wash 250ML Daily Intimate 6pk,Femfresh Wash 250ML Daily Intimate 6pk,FBALYB Amazon,5,5,0,0,0,0
,Femfresh Wash 250ML Ultimate Care Soothing,Femfresh Wash 250ML Ultimate Care Soothing,FBALYB Amazon,7,6,1,0,1,0
,"Fermosa Anti-Aging Skin Serum Set 3pk (Vitamin C, Retinol, Hyaluronic Acid)","Fermosa Anti-Aging Skin Serum Set 3pk (Vitamin C, Retinol, Hyaluronic Acid)",FBALYB Amazon,250,250,0,0,0,0
,Fermosa Apple Cider Vinegar Conditioner 500ml,Fermosa Apple Cider Vinegar Conditioner 500ml,Default,0,0,0,0,0,52
,Fermosa Apple Cider Vinegar Conditioner 500ml,Fermosa Apple Cider Vinegar Conditioner 500ml,Default Ridgefield,270,270,0,0,0,0
,Fermosa Apple Cider Vinegar Shampoo 500ml,Fermosa Apple Cider Vinegar Shampoo 500ml,Default,0,0,0,0,0,35
,Fermosa Apple Cider Vinegar Shampoo 500ml,Fermosa Apple Cider Vinegar Shampoo 500ml,Default Ridgefield,160,160,0,0,0,0
,Fermosa Apple Cider Vinegar Shampoo 500ml,Fermosa Apple Cider Vinegar Shampoo 500ml,FBALYB Amazon,137,137,0,0,0,0
,Fermosa Apple Cider Vinegar Shampoo 500 ml & Conditioner 500 ml Bundle,Fermosa Apple Cider Vinegar Shampoo 500 ml & Conditioner 500 ml Bundle,FBALYB Amazon,158,158,0,0,0,0
,Fermosa Argan Conditioner 500ml,Fermosa Argan Conditioner 500ml,Default,0,0,0,0,0,87
,Fermosa Argan Conditioner 500ml,Fermosa Argan Conditioner 500ml,Default Ridgefield,215,215,0,0,0,0
,Fermosa Argan Conditioner 500ml,Fermosa Argan Conditioner 500ml,FBALYB Amazon,144,144,0,0,0,0
,Fermosa Argan Shampoo 500ml,Fermosa Argan Shampoo 500ml,Default Ridgefield,333,333,0,0,0,0
,Fermosa Argan Shampoo 500ml,Fermosa Argan Shampoo 500ml,FBALYB Amazon,66,66,0,0,0,0
,Fermosa Argan Shampoo 500 ml & Argan Conditioner 500 ml Bundle,Fermosa Argan Shampoo 500 ml & Argan Conditioner 500 ml Bundle,FBALYB Amazon,82,82,0,0,0,0
,Fermosa Charcoal Conditioner 500ml,Fermosa Charcoal Conditioner 500ml,FBALYB Amazon,145,145,0,1,0,0
,Fermosa Charcoal Shampoo 500ml,Fermosa Charcoal Shampoo 500ml,Default,0,0,0,0,0,21
,Fermosa Charcoal Shampoo 500ml,Fermosa Charcoal Shampoo 500ml,Default Ridgefield,160,160,0,0,0,0
,Fermosa Charcoal Shampoo 500ml,Fermosa Charcoal Shampoo 500ml,FBALYB Amazon,136,136,0,0,0,0
,Fermosa Charcoal Shampoo 500 ml & Charcoal Conditioner 500 ml Bundle,Fermosa Charcoal Shampoo 500 ml & Charcoal Conditioner 500 ml Bundle,FBALYB Amazon,111,111,0,0,0,0
,"FERMOSA FACE SCRUBS BUNDLE 3PK (Grape, Papaya, Charcoal)","FERMOSA FACE SCRUBS BUNDLE 3PK (Grape, Papaya, Charcoal)",FBALYB Amazon,250,250,0,0,0,0
,Ferrero Rocher 48 pieces,Ferrero Rocher Fine Hazelnut Chocolate ‑ 48 pieces,Default,52,-4,56,0,0,0
,Ferrero Rocher 48 pieces,Ferrero Rocher Fine Hazelnut Chocolate ‑ 48 pieces,FBALYB Amazon,-15,-15,0,2,0,0
,Ferrero Rocher 48 pieces,Ferrero Rocher Fine Hazelnut Chocolate ‑ 48 pieces,WFS,-47,-47,0,0,0,0
,Ferrero Rocher 48 pieces 2pk,Ferrero Rocher 48 pieces 2pk,Default,0,-26,26,0,0,0
,Ferrero Rocher 48 pieces 2pk,Ferrero Rocher 48 pieces 2pk,FBALYB Amazon,4,4,0,0,0,0
,Ferrero Rocher 48 pieces 3pk,Ferrero Rocher 48 pieces 3pk,FBALYB Amazon,1,1,0,0,0,0
,Fig Bar Variety 24,Fig Bar Variety 24,FBALYB Amazon,13,13,0,6,0,0
,Fila Disruptor II Premium Repeat Sneakers Black/White 5FM00079-021 Size 11,,Default Ridgefield,14,14,0,0,0,0
,Fila Disruptor II Premium Repeat Sneakers Black/White 5FM00079-021 Size 6,,FBALYB Amazon,-1,-2,1,0,1,0
,Fila Disruptor II Premium Repeat Sneakers Black/White 5FM00079-021 Size 7,,FBALYB Amazon,-1,-1,0,0,0,0
,Fila Disruptor II Premium Repeat Sneakers Black/White 5FM00079-021 Size 7.5,,FBALYB Amazon,-4,-4,0,0,0,0
,Fila Disruptor II Premium Repeat Sneakers Black/White 5FM00079-021 Size 8,,Default Ridgefield,0,-49,49,0,0,0
,Fila Disruptor II Premium Repeat Sneakers Black/White 5FM00079-021 Size 8,,FBALYB Amazon,-1,-1,0,0,0,0
,Fila Disruptor II Premium Repeat Sneakers Black/White 5FM00079-021 Size 8.5,,FBALYB Amazon,-3,-3,0,0,0,0
,Fila Disruptor II Premium Repeat Sneakers Black/White 5FM00079-021 Size 9.5,,FBALYB Amazon,-1,-1,0,0,0,0
,Fila Disruptor II Tie Dye Sneakers 5XM00819-775 Size 10,,FBALYB Amazon,-2,-2,0,0,0,0
,Fila Disruptor II Tie Dye Sneakers 5XM00819-775 Size 11,,Default Ridgefield,12,12,0,0,0,0
,Fila Disruptor II Tie Dye Sneakers 5XM00819-775 Size 5.5,,Default Ridgefield,12,12,0,0,0,0
,Fila Disruptor II Tie Dye Sneakers 5XM00819-775 Size 6,,FBALYB Amazon,3,3,0,0,0,0
,Fila Disruptor II Tie Dye Sneakers 5XM00819-775 Size 7,,FBALYB Amazon,-1,-1,0,0,0,0
,Fila Disruptor II Tie Dye Sneakers 5XM00819-775 Size 7.5,,FBALYB Amazon,-4,-4,0,0,0,0
,Fila Disruptor II Tie Dye Sneakers 5XM00819-775 Size 8,,FBALYB Amazon,-3,-3,0,0,0,0
,Fila Disruptor II Tie Dye Sneakers 5XM00819-775 Size 8.5,,FBALYB Amazon,19,19,0,0,0,0
,Fila Disruptor II Tie Dye Sneakers 5XM00819-775 Size 9,,FBALYB Amazon,-1,-1,0,0,0,0
,Fila Disruptor II Tie Dye Sneakers 5XM00819-775 Size 9.5,,FBALYB Amazon,-1,-1,0,0,0,0
,Fila Men's Drifter Red/Navy/White 1SM00010-616 Size 11,Fila Men's Drifter Red/Navy/White 1SM00010-616 Size 11,FBALYB Amazon,6,6,0,0,0,0
,Fila Men's Drifter Red/Navy/White 1SM00010-616 Size 12,Fila Men's Drifter Red/Navy/White 1SM00010-616 Size 12,FBALYB Amazon,1,1,0,0,0,0
,Fila Men's Drifter Red/Navy/White 1SM00010-616 Size 13,Fila Men's Drifter Red/Navy/White 1SM00010-616 Size 13,FBALYB Amazon,1,1,0,0,0,0
,Fila Men's Drifter Red/Navy/White 1SM00010-616 Size 8,Fila Men's Drifter Red/Navy/White 1SM00010-616 Size 8,FBALYB Amazon,8,8,0,0,0,0
,Fila Men's Drifter Red/Navy/White 1SM00010-616 Size 9,Fila Men's Drifter Red/Navy/White 1SM00010-616 Size 9,FBALYB Amazon,3,3,0,0,0,0
,Fila Men's Workshift Shoe Black/Black/Black 1SG30002-001 Size 10,Fila Men's Workshift Shoe Black/Black/Black 1SG30002-001 Size 10,FBALYB Amazon,60,60,0,0,0,0
,Fila Men's Workshift Shoe Black/Black/Black 1SG30002-001 Size 10.5,Fila Men's Workshift Shoe Black/Black/Black 1SG30002-001 Size 10.5,FBALYB Amazon,-7,-7,0,0,0,0
,Fila Men's Workshift Shoe Black/Black/Black 1SG30002-001 Size 11,Fila Men's Workshift Shoe Black/Black/Black 1SG30002-001 Size 11,Default,0,0,0,0,0,2
,Fila Men's Workshift Shoe Black/Black/Black 1SG30002-001 Size 11,Fila Men's Workshift Shoe Black/Black/Black 1SG30002-001 Size 11,Default Ridgefield,31,31,0,0,0,0
,Fila Men's Workshift Shoe Black/Black/Black 1SG30002-001 Size 11,Fila Men's Workshift Shoe Black/Black/Black 1SG30002-001 Size 11,FBALYB Amazon,-14,-14,0,0,0,0
,Fila Men's Workshift Shoe Black/Black/Black 1SG30002-001 Size 11.5,Fila Men's Workshift Shoe Black/Black/Black 1SG30002-001 Size 11.5,FBALYB Amazon,-1,-1,0,0,0,0
,Fila Men's Workshift Shoe Black/Black/Black 1SG30002-001 Size 12,Fila Men's Workshift Shoe Black/Black/Black 1SG30002-001 Size 12,FBALYB Amazon,-7,-7,0,0,0,0
,Fila Men's Workshift Shoe Black/Black/Black 1SG30002-001 Size 13,Fila Men's Workshift Shoe Black/Black/Black 1SG30002-001 Size 13,Default,0,0,0,0,0,2
,Fila Men's Workshift Shoe Black/Black/Black 1SG30002-001 Size 13,Fila Men's Workshift Shoe Black/Black/Black 1SG30002-001 Size 13,FBALYB Amazon,-3,-3,0,0,0,0
,Fila Men's Workshift Shoe Black/Black/Black 1SG30002-001 Size 7,Fila Men's Workshift Shoe Black/Black/Black 1SG30002-001 Size 7,FBALYB Amazon,7,7,0,0,0,0
,Fila Men's Workshift Shoe Black/Black/Black 1SG30002-001 Size 8,Fila Men's Workshift Shoe Black/Black/Black 1SG30002-001 Size 8,Default Ridgefield,9,9,0,0,0,0
,Fila Men's Workshift Shoe Black/Black/Black 1SG30002-001 Size 8,Fila Men's Workshift Shoe Black/Black/Black 1SG30002-001 Size 8,FBALYB Amazon,-3,-3,0,0,0,0
,Fila Men's Workshift Shoe Black/Black/Black 1SG30002-001 Size 8.5,Fila Men's Workshift Shoe Black/Black/Black 1SG30002-001 Size 8.5,FBALYB Amazon,30,30,0,0,0,0
,Fila Men's Workshift Shoe Black/Black/Black 1SG30002-001 Size 9,Fila Men's Workshift Shoe Black/Black/Black 1SG30002-001 Size 9,Default,0,0,0,0,0,2
,Fila Men's Workshift Shoe Black/Black/Black 1SG30002-001 Size 9,Fila Men's Workshift Shoe Black/Black/Black 1SG30002-001 Size 9,FBALYB Amazon,-1,-1,0,0,0,0
,Fila Men's Workshift Shoe Black/Black/Black 1SG30002-001 Size 9.5,Fila Men's Workshift Shoe Black/Black/Black 1SG30002-001 Size 9.5,Default,0,0,0,0,0,1
,Fila Men's Workshift Shoe Black/Black/Black 1SG30002-001 Size 9.5,Fila Men's Workshift Shoe Black/Black/Black 1SG30002-001 Size 9.5,FBALYB Amazon,-11,-11,0,0,0,0
,Fila Woman Disruptor Sandal 5SM00034-125 Size 10,,Default Ridgefield,0,-1,1,0,0,0
,Fila Woman Disruptor Sandal 5SM00034-125 Size 10,,FBALYB Amazon,-7,-7,0,0,0,0
,Fila Woman Disruptor Sandal 5SM00034-125 Size 11,,Default Ridgefield,0,-2,2,0,0,0
,Fila Woman Disruptor Sandal 5SM00034-125 Size 11,,FBALYB Amazon,11,11,0,0,0,0
,Fila Woman Disruptor Sandal  5SM00034-125 Size 6,,FBALYB Amazon,152,152,0,0,0,0
,Fila Woman Disruptor Sandal 5SM00034-125 Size 7,,FBALYB Amazon,71,70,1,0,1,0
,Fila Woman Disruptor Sandal 5SM00034-125 Size 8,,FBALYB Amazon,-5,-5,0,0,0,0
,Fila Woman Disruptor Sandal 5SM00034-125 Size 9,,FBALYB Amazon,-11,-11,0,0,0,0
,Fila Women's Disruptor II Metallic Accent Sneakers 5FM00702-141 Size 11,,Default Ridgefield,6,6,0,0,0,0
,Fila Women's Disruptor II Metallic Accent Sneakers 5FM00702-141 Size 5,Fila Women's Disruptor II Metallic Accent Sneakers 5FM00702-141 Size 5,Default Ridgefield,13,13,0,0,0,0
,Fila Women's Disruptor II Metallic Accent Sneakers 5FM00702-141 Size 5.5,,Default Ridgefield,5,5,0,0,0,0
,Fila Women's Disruptor II Metallic Accent Sneakers 5FM00702-141 Size 7,,FBALYB Amazon,-1,-1,0,0,0,0
,Fila Women's Disruptor II Metallic Accent Sneakers 5FM00702-141 Size 8.5,,Default Ridgefield,12,12,0,0,0,0
,Fila Women's Disruptor II Metallic Accent Sneakers 5FM00702-141 Size 9,,FBALYB Amazon,-1,-1,0,0,0,0
,Fila Women's Disruptor II Premium Metallic Silver/White 5FM00040-662 Size 11,Fila Women's Disruptor II Premium Metallic Silver/White 5FM00040-662 Size 11,Default Ridgefield,10,10,0,0,0,0
,Fila Women's Disruptor II Premium Metallic  Silver/White 5FM00040-662 Size 5.5,,FBALYB Amazon,-1,-1,0,0,0,0
,Fila Women's Disruptor II Premium Metallic  Silver/White 5FM00040-662 Size 6,,FBALYB Amazon,-1,-1,0,0,0,0
,Fila Women's Disruptor II Premium Metallic Silver/White 5FM00040-662 Size 7.5,,Default,36,36,0,0,0,0
,Fila Women's Disruptor II Premium Metallic Silver/White 5FM00040-662 Size 7.5,,FBALYB Amazon,-43,-43,0,0,0,0
,Fila Women's Disruptor II Premium Metallic Silver/White 5FM00040-662 Size 8,,FBALYB Amazon,-4,-4,0,0,0,0
,Fila Women's Disruptor II Premium Metallic Silver/White 5FM00040-662 Size 8.5,,FBALYB Amazon,-1,-1,0,0,0,0
,Fila Women's Disruptor II Premium Metallic Silver/White 5FM00040-662 Size 9,Fila Women's Disruptor II Premium Metallic Silver/White 5FM00040-662 Size 9,FBALYB Amazon,-9,-10,1,0,1,0
,Fila Women's Disruptor II Premium Repeat Sneakers White/Navy/Red 5FM00079-125 Size 10,,FBALYB Amazon,3,3,0,0,0,0
,Fila Women's Disruptor II Premium Repeat Sneakers White/Navy/Red 5FM00079-125 Size 11,,FBALYB Amazon,4,4,0,0,0,0
,Fila Women's Disruptor II Premium Repeat Sneakers White/Navy/Red 5FM00079-125 Size 5.5,,FBALYB Amazon,-1,-1,0,0,0,0
,Fila Women's Disruptor II Premium Repeat Sneakers White/Navy/Red 5FM00079-125 Size 6,,FBALYB Amazon,-1,-1,0,0,0,0
,Fila Women's Disruptor II Premium Repeat Sneakers White/Navy/Red 5FM00079-125 Size 6.5,,FBALYB Amazon,15,15,0,0,0,0
,Fila Women's Disruptor II Premium Repeat Sneakers White/Navy/Red 5FM00079-125 Size 7,,FBALYB Amazon,-3,-3,0,0,0,0
,Fila Women's Disruptor II Premium Repeat Sneakers White/Navy/Red 5FM00079-125 Size 7.5,,Default,14,14,0,0,0,0
,Fila Women's Disruptor II Premium Repeat Sneakers White/Navy/Red 5FM00079-125 Size 7.5,,FBALYB Amazon,-16,-16,0,0,0,0
,Fila Women's Disruptor II Premium Repeat Sneakers White/Navy/Red 5FM00079-125 Size 8.5,,FBALYB Amazon,-6,-6,0,0,0,0
,Fila Women's Disruptor II Premium Repeat Sneakers White/Navy/Red 5FM00079-125 Size 9,,FBALYB Amazon,-1,-1,0,0,0,0
,Fila Women's Disruptor II Premium Repeat Sneakers White/Navy/Red 5FM00079-125 Size 9.5,,FBALYB Amazon,-6,-6,0,0,0,0
,Fila Women's Disruptor II Premium White Trainers 5FM00104-161 Size 7,Fila Women's Disruptor II Premium White Trainers 5FM00104-161 Size 7,FBALYB Amazon,-2,-2,0,0,0,0
,Fila Women's Disruptor II Premium White Trainers 5FM00104-161 Size 7.5,Fila Women's Disruptor II Premium White Trainers 5FM00104-161 Size 7.5,FBALYB Amazon,-2,-2,0,0,0,0
,Fila Women's Disruptor II Premium White Trainers 5FM00104-161 Size 8,Fila Women's Disruptor II Premium White Trainers 5FM00104-161 Size 8,Default,0,0,0,0,0,18
,Fila Women's Disruptor II Premium White Trainers 5FM00104-161 Size 8,Fila Women's Disruptor II Premium White Trainers 5FM00104-161 Size 8,FBALYB Amazon,-2,-2,0,0,0,0
,Fila Women's Disruptor II Premium White Trainers 5FM00104-161 Size 8.5,Fila Women's Disruptor II Premium White Trainers 5FM00104-161 Size 8.5,Default Ridgefield,1,1,0,0,0,0
,Fila Women's Disruptor II Premium White Trainers 5FM00104-161 Size 8.5,Fila Women's Disruptor II Premium White Trainers 5FM00104-161 Size 8.5,FBALYB Amazon,-3,-3,0,0,0,0
,Fila Women's Disruptor II Premium White Trainers 5FM00104-161 Size 9,Fila Women's Disruptor II Premium White Trainers 5FM00104-161 Size 9,Default Ridgefield,3,3,0,0,0,0
,Fila Women's Disruptor II Premium White Trainers 5FM00104-161 Size 9,Fila Women's Disruptor II Premium White Trainers 5FM00104-161 Size 9,FBALYB Amazon,-1,-1,0,0,0,0
,Fila Women's Disruptor II Premium White Trainers 5FM00104-161 Size 9.5,Fila Women's Disruptor II Premium White Trainers 5FM00104-161 Size 9.5,FBALYB Amazon,-1,-1,0,0,0,0
,Fila Women's Disruptor II Wedge White/Fila Navy/Fila Red 5FM00704-125 Size 7,Fila Women's Disruptor II Wedge White/Fila Navy/Fila Red 5FM00704-125 Size 7,Default,0,0,0,0,0,4
,Fila Women's Disruptor II Wedge White/Fila Navy/Fila Red 5FM00704-125 Size 8,Fila Women's Disruptor II Wedge White/Fila Navy/Fila Red 5FM00704-125 Size 8,FBALYB Amazon,-5,-5,0,0,0,0
,Fila Women's Disruptor II Wedge White/Fila Navy/Fila Red 5FM00704-125 Size 9,Fila Women's Disruptor II Wedge White/Fila Navy/Fila Red 5FM00704-125 Size 9,Default,0,0,0,0,0,7
,Fila Womens Sneaker White Navy Red Sz 10,Fila Womens Sneaker White Navy Red Sz 10,Default Ridgefield,36,36,0,0,0,0
,Fila Womens Sneaker White Navy Red Sz 10,Fila Womens Sneaker White Navy Red Sz 10,FBALYB Amazon,43,43,0,0,0,0
,Fila Womens Sneaker White Navy Red Sz 11,Fila Womens Sneaker White Navy Red Sz 11,Default,0,-1,1,0,0,0
,Fila Womens Sneaker White Navy Red Sz 11,Fila Womens Sneaker White Navy Red Sz 11,FBALYB Amazon,-8,-8,0,0,0,0
,Fila Womens Sneaker White Navy Red Sz 5,Fila Womens Sneaker White Navy Red Sz 5,Default Ridgefield,0,-1,1,0,0,0
,Fila Womens Sneaker White Navy Red Sz 5,Fila Womens Sneaker White Navy Red Sz 5,FBALYB Amazon,-25,-25,0,0,0,0
,Fila Womens Sneaker White Navy Red Sz 6,Fila Womens Sneaker White Navy Red Sz 6,FBALYB Amazon,-34,-34,0,0,0,0
,Fila Womens Sneaker White Navy Red Sz 6.5,"Fila Womens Sneaker White Navy Red Sz 6.5	",FBALYB Amazon,-49,-49,0,0,0,0
,Fila Womens Sneaker White Navy Red Sz 7,Fila Womens Sneaker White Navy Red Sz 7,FBALYB Amazon,-49,-49,0,0,0,0
,Fila Womens Sneaker White Navy Red Sz 7.5,Fila Womens Sneaker White Navy Red Sz 7.5,FBALYB Amazon,-57,-57,0,0,0,0
,Fila Womens Sneaker White Navy Red Sz 8,Fila Womens Sneaker White Navy Red Sz 8,Default,12,-68,80,0,0,0
,Fila Womens Sneaker White Navy Red Sz 8,Fila Womens Sneaker White Navy Red Sz 8,Default Ridgefield,8,8,0,0,0,0
,Fila Womens Sneaker White Navy Red Sz 8,Fila Womens Sneaker White Navy Red Sz 8,FBALYB Amazon,-80,-80,0,0,0,0
,Fila Womens Sneaker White Navy Red Sz 8.5,Fila Womens Sneaker White Navy Red Sz 8.5,Default,0,0,0,0,0,12
,Fila Womens Sneaker White Navy Red Sz 8.5,Fila Womens Sneaker White Navy Red Sz 8.5,FBALYB Amazon,-131,-131,0,4,0,0
,Fila Womens Sneaker White Navy Red Sz 9,Fila Womens Sneaker White Navy Red Sz 9,Default,3,-7,10,0,0,0
,Fila Womens Sneaker White Navy Red Sz 9,Fila Womens Sneaker White Navy Red Sz 9,FBALYB Amazon,-123,-123,0,58,0,0
,Fila Womens Sneaker White Navy Red Sz 9.5,Fila Womens Sneaker White Navy Red Sz 9.5,FBALYB Amazon,-4,-4,0,0,0,0
,Finish 250ml lemon,Finish 250ml lemon,Default,0,-2728,2728,0,0,0
,Finish 250ml lemon,Finish 250ml lemon,Default Oxford,192,192,0,0,0,0
,Finish 250ml lemon,Finish 250ml lemon,Default Ridgefield,18,18,0,0,0,0
,Finish 250ml lemon 4 PK,Finish 250ml lemon 4 PK,FBALYB Amazon,-49,-51,2,312,2,0
,Finish 2kg,Finish 2kg,Default,0,-36,36,0,0,0
,Finish 2kg,Finish 2kg,FBALYB Amazon,22,22,0,0,0,0
,Finish 2kg Two Pack,Finish 2kg Two Pack,FBALYB Amazon,-96,-96,0,232,0,0
,Finish Dishwasher Citrus 8.75oz,Finish Dishwasher Citrus 8.75oz,Default,0,-528,528,0,0,0
,Finish Dishwasher Citrus 8.75oz 4pk,Finish Dishwasher Citrus 8.75oz 4pk,FBALYB Amazon,145,145,0,0,0,0
,Finish Dishwasher Cleaner 8.45oz,Finish Dishwasher Cleaner 8.45oz,Default,0,-14204,14204,0,0,0
,Finish Dishwasher Cleaner 8.45oz,Finish Dishwasher Cleaner 8.45oz,Default Ridgefield,4,4,0,0,0,0
,Finish Dishwasher Cleaner 8.45oz,Finish Dishwasher Cleaner 8.45oz,FBALYB Amazon,13,13,0,0,0,0
,Finish Dishwasher Cleaner 8.45oz 4pk,Finish Dishwasher Cleaner 8.45oz 4pk,FBALYB Amazon,133,132,1,14,1,0
,Finish Dishwasher Freshener Od 3 PK,Finish Dishwasher Freshener Od 3 PK,FBALYB Amazon,-5,-5,0,4,0,0
,Finish Jet Dry 946 ml,Finish Jet Dry 946 ml,FBALYB Amazon,2,2,0,0,0,0
,Finish performance salt 1kg,Finish performance salt 1kg ,Default,0,-3400,3400,0,0,0
,Finish performance salt 1kg,Finish performance salt 1kg ,Default Ridgefield,7,7,0,0,0,0
,Finish performance salt 1kg 2 PK,Finish performance salt 1kg 2 PK,FBALYB Amazon,79,56,23,159,23,0
,Finish performance salt 1kg 3PK,Finish performance salt 1kg 3PK,FBALYB Amazon,9,7,2,0,2,0
,Finish performance salt 1kg 4Pk,Finish performance salt 1kg 4Pk,FBALYB Amazon,475,472,3,561,3,0
,Finish Powerball Classic 110s,Finish Powerball Classic 110s ,FBALYB Amazon,28,27,1,0,1,0
,Finish Quantum,Finish Quantum,Avrami - Ebay,203,203,0,0,0,0
,Finish Quantum,Finish Quantum,Default,0,-156,156,0,0,0
,Finish Quantum,Finish Quantum,Default Ridgefield,1315,1315,0,0,0,0
,Finish Quantum,Finish Quantum,FBALYB Amazon,632,620,12,105,12,0
,Finish Quantum,Finish Quantum,FBALYB Canada,118,118,0,0,0,0
,Finish Quantum,Finish Quantum,WFS,-47,-47,0,0,0,0
,Finish Quantum 60 ct EU,Finish Quantum 60 ct EU,Default Ridgefield,16,16,0,0,0,0
,Finish Quantum EU 60 ct 2pk,Finish Quantum EU 60 ct 2pk,FBALYB Amazon,108,106,2,0,2,0
,Finish Salt 5kg,Finish Salt 5kg,Default Ridgefield,242,242,0,0,0,0
,Finish Salt 5kg,Finish Salt 5kg,FBALYB Amazon,727,649,78,350,78,0
,Finish salt box 3kg,Finish salt box 3kg,Default Ridgefield,212,212,0,0,0,0
,Finish salt box 3kg,Finish salt box 3kg,FBALYB Amazon,72,62,10,16,10,0
,Finish salt box 3kg 2 PK,Finish salt box 3kg 2 PK,FBALYB Amazon,52,52,0,0,0,0
,Finish Ultra Powerball 140 ct,Finish Ultra Powerball 140 ct,Default Ridgefield,399,399,0,0,0,0
,First Alert Smoke & Fire Alarm 2ct,First Alert Smoke & Fire Alarm 2ct,FBALYB Amazon,-3,-3,0,0,0,0
,Fisher Price Imaginext Batcave,Fisher-Price Imaginext DC Super Friends Batcave(Discontinued by manufacturer),FBALYB Amazon,-1,-1,0,0,0,0
,"Fisher‑Price Little People Helping Others Fire Truck, Red","Fisher‑Price Little People Helping Others Fire Truck, Red",Default,0,0,0,0,0,43
,Fisher Price Little People Sit with Me School Bus,Fisher Price Little People Sit with Me School Bus,Default,0,0,0,0,0,34
,Fisher Price Little People Travel Together Airplane,Fisher Price Little People Travel Together Airplane,Default,0,0,0,0,0,71
,Fisher Price Mini Train Asst,Fisher Price Thomas Mini Train Assorted,Default Ridgefield,23,23,0,0,0,0
,Fisher Price Pirate Ship,Fisher Price Imaginext Pirate Ship with 2 Figures,Default,0,0,0,0,0,17
,Fisher Price Pirate Ship,Fisher Price Imaginext Pirate Ship with 2 Figures,FBALYB Amazon,-2,-2,0,0,0,0
,Fisher-Price Stand-Up Ballcano,Fisher-Price Stand-Up Ballcano ,FBALYB Amazon,-1,-1,0,0,0,0
,FIXA tool kit 17 piece,FIXA tool kit 17 piece,FBALYB Amazon,1,1,0,0,0,0
,Fixodent Denture Cream 1ct,Fixodent Denture Cream 1ct,Default,0,-100,100,0,0,0
,Fixodent Denture Cream 1ct 3pk,Fixodent Denture Cream 1ct 3pk,FBALYB Amazon,-30,-30,0,0,0,0
,Fixodent Denture Cream 1ct 4pk,Fixodent Denture Cream 1ct 4pk,FBALYB Amazon,-62,-73,11,7,11,0
,Flax for Nutrition,Flax for Nutrition,FBALYB Amazon,9,9,0,1,0,0
,Fleischmann's 1lb bag,Fleischmann's Instant Dry Yeast 1lb bag,FBALYB Amazon,682,682,0,2,0,0
,Fleischmann's 1lb bag 2pk,Fleischmann's 1lb bag 2pk,FBALYB Amazon,0,0,0,53,0,0
,Flents Wipe n Clear 225 Count,Flents Wipe n Clear Lens Wipes (225 Count),FBALYB Amazon,-3,-3,0,0,0,0
,Flintstones Gummies 250 ct.,Flintstones Gummies Vitamin Supplement ‑ 250 ct.,FBALYB Amazon,-32,-32,0,30,0,0
,Flonase Allergy Relief 3ct,Flonase Allergy Relief 3ct,FBALYB Amazon,-1,-1,0,0,0,0
,Floss action refill 4pc,Floss action refill 4pc,FBALYB Amazon,785,735,50,20,50,0
,Floss action refill 4pc,Floss action refill 4pc,WFS,-358,-358,0,0,0,0
,Fluker's Basking Spotlight Bulb 150 W,Fluker's Basking Spotlight Bulb 150 W ,Default Ridgefield,3,3,0,0,0,0
,Flukers Blue Daylight 60 Watt 3pk,Flukers Blue Daylight 60 Watt 3pk,FBALYB Amazon,-1,-1,0,0,0,0
,Fluker's Cricket Quench Calcium 16oz,Fluker's Cricket Quench Calcium 16oz,Default,0,0,0,0,0,42
,Fluker's Cricket Quench Calcium 16oz,Fluker's Cricket Quench Calcium 16oz,FBALYB Amazon,0,0,0,12,0,0
,Flukers Cricket Quencher Orig. 7.5lb,Flukers Cricket Quencher Orig. 7.5lb,FBALYB Amazon,5,5,0,6,0,0
,Flukers Driftwood Reptile,Flukers Driftwood Reptile,Default,0,-8,8,0,0,0
,Flukers Driftwood Reptile,Flukers Driftwood Reptile,FBALYB Amazon,-6,-6,0,0,0,0
,"Fluker's High Calcium Cricket Diet, 11.5oz","Fluker's High Calcium Cricket Diet, 11.5oz",Default,0,0,0,0,0,3
,"Fluker's High Calcium Cricket Diet, 11.5oz","Fluker's High Calcium Cricket Diet, 11.5oz",FBALYB Amazon,-1,-1,0,1,0,0
,"Fluker's High Calcium Cricket Diet, 11.5oz 3pk","Fluker's High Calcium Cricket Diet, 11.5oz 3pk",FBALYB Amazon,-10,-10,0,11,0,0
,Fluker's Orange Cube 12oz 2pk,Fluker's Orange Cube 12oz 2pk,FBALYB Amazon,1,0,1,0,1,0
,"Fluker's Orange Cube Complete Cricket Diet, 12oz","Fluker's Orange Cube Complete Cricket Diet, 12oz",Default,0,-100,100,0,0,16
,"Fluker's Orange Cube Complete Cricket Diet, 12oz","Fluker's Orange Cube Complete Cricket Diet, 12oz",FBALYB Amazon,296,296,0,0,0,0
,"Flukers Original Cricket Quencher, 16 Oz","Flukers Original Cricket Quencher, 16 Oz",FBALYB Amazon,85,85,0,0,0,0
,Flukers Repta-Sun Red 60 Watt 3pk,Flukers Repta-Sun Red 60 Watt 3pk,FBALYB Amazon,1,0,1,0,1,0
,Flying Saucer Exercise Wheel Small,Ware Critter Flying Saucer Exercise Wheel Small,FBALYB Amazon,-2,-2,0,1,0,0
,Focus UT 3oz 12pk Bundle,Focus UT 3oz 12pk Bundle,FBALYB Amazon,599,599,0,4,0,0
,"Folgers Black Silk, K-Cups 96ct","Folgers Black Silk, K-Cups 96ct",FBALYB Amazon,-6,-7,1,7,1,0
,"Folgers Classic Roast Coffee, 51oz","Folgers Classic Roast Coffee, 51oz",FBALYB Amazon,1,1,0,0,0,0
,"Folgers Classic Roast Coffee, 51oz 2pk","Folgers Classic Roast Coffee, 51oz 2pk",FBALYB Amazon,99,99,0,0,0,0
,Folgers DeCaf Coffee 33.9oz,Folgers DeCaf Coffee 33.9oz,FBALYB Amazon,2,2,0,0,0,0
,Folgers Instant Coffee 16oz 2PK,Folgers Instant Coffee 16oz 2PK,FBALYB Amazon,-7,-7,0,6,0,0
,Folgers Vanilla Biscotti 96ct K cups,Folgers Vanilla Biscotti 96ct K cups,FBALYB Amazon,5,5,0,3,0,0
,FoodSaver FM2110 Vacuum Sealing System,FoodSaver FM2110 Vacuum Sealing System,FBALYB Amazon,-3,-3,0,0,0,0
,FoodSaver System M5480,FoodSaver System M5480,FBALYB Amazon,2,2,0,0,0,0
,Ford Gum 12 ct,Ford Gum 12 ct Big League Chew,FBALYB Amazon,18,18,0,0,0,0
,Fortuna Refined Salmon Oil,,Default,0,0,0,0,0,2280
,Four Paws Cable Trolley Exerciser 100' 2pk,Four Paws Cable Trolley Exerciser 100' 2pk,FBALYB Amazon,-1,-1,0,0,0,0
,Four Paws Cable Trolley Exerciser 50',Four Paws Tie Out Cable Trolley Exerciser 50' ,Default Ridgefield,1,1,0,0,0,0
,Four Paws Cable Trolley Exerciser 50',Four Paws Tie Out Cable Trolley Exerciser 50' ,FBALYB Amazon,-3,-3,0,0,0,0
,Four Paws Cotton Web Lead Black - 30 ft,Four Paws Cotton Web Lead Black - 30 ft,Default,0,0,0,0,0,4
,Four Paws Cotton Web Lead Black - 30 ft,Four Paws Cotton Web Lead Black - 30 ft,Default Ridgefield,46,46,0,0,0,0
,Four Paws Large Dog Rake Set,Four Paws Large Dog Rake Set,Default Ridgefield,85,85,0,0,0,0
,Four Paws Large Dog Rake Set,Four Paws Large Dog Rake Set,FBALYB Amazon,88,88,0,0,0,0
,"Four Square Dish Dog Blue 5""","Four Square Dish Dog Blue 5""",Default,0,0,0,0,0,1
,"Frank's Buffalo Sauce, 2 ct./25 oz.","Frank's Buffalo Sauce, 2 ct./25 oz.",FBALYB Amazon,4,4,0,0,0,0
,"Frank's RedHot 25oz, 2pk","Frank's RedHot Original 25 oz, 2 pk",FBALYB Amazon,28,28,0,0,0,0
,"FREEK, DR PT, AXS, G10, M4","FREEK, DR PT, AXS, G10, M4 ",FBALYB Amazon,41,32,9,1,9,0
,"FREEK, DR PT, AXS, G10, M4","FREEK, DR PT, AXS, G10, M4 ",WFS,-4,-4,0,0,0,0
,Freeman - Facial Mask 6oz 2pk,Freeman - Facial Mask 6oz 2pk,Default Ridgefield,0,-50,50,0,0,0
,Freeman - Facial Mask 6oz 2pk,Freeman - Facial Mask 6oz 2pk,FBALYB Amazon,0,-4,4,0,4,0
,Freeze Dried Chicken Liver 3 oz,Freeze Dried Chicken Liver 3 oz,FBALYB Amazon,13,13,0,0,0,0
,French's Original Fried Onions 26.5 oz,French's Original Crispy French Fried Onions 26.5 oz,FBALYB Amazon,1,1,0,0,0,0
,Fresh Black Tea Firming Overnight Mask 100 Ml,Fresh Black Tea Firming Overnight Mask 100 Ml,FBALYB Amazon,46,45,1,0,1,0
,Fresh Kisses Coconut Large 16ct,Fresh Kisses Coconut Large 16ct,FBALYB Amazon,-1,-1,0,0,0,0
,Fresh-n-Clean Creme Rinse 18oz,Fresh-n-Clean Creme Rinse 18oz,Default,0,0,0,0,0,52
,Fresh-n-Clean Creme Rinse 18oz,Fresh-n-Clean Creme Rinse 18oz,Default Ridgefield,12,12,0,0,0,0
,Fresh-n-Clean Creme Rinse 18oz,Fresh-n-Clean Creme Rinse 18oz,FBALYB Amazon,3,3,0,0,0,0
,Fresh-n-Clean Creme Rinse 18oz,Fresh-n-Clean Creme Rinse 18oz,FBALYB Canada,12,12,0,0,0,0
,FreshNClean Rinse/Shampoo Bundle,FreshNClean Rinse/Shampoo Bundle,FBALYB Amazon,-8,-8,0,14,0,0
,Fresh 'n Clean Scented Shampoo 18oz,Fresh 'n Clean Scented Shampoo 18oz,Default,0,0,0,0,0,6
,Fresh Plum Neutrogena Rainbath,Fresh Plum Neutrogena Rainbath,FBALYB Amazon,99,99,0,0,0,0
,Friedrich D70BPA Dehumidifier,"Friedrich D70BPA 15"" Dehumidifier",FBALYB Amazon,1,1,0,0,0,0
,Frozen kids refill 4pc,Frozen kids refill 4pc,Avrami - Ebay,310,310,0,0,0,0
,Frozen kids refill 4pc,Frozen kids refill 4pc,Default Ridgefield,191,191,0,0,0,0
,Frozen kids refill 4pc,Frozen kids refill 4pc,FBALYB Amazon,-20,-20,0,10,0,0
,Frozen kids refill 4pc,Frozen kids refill 4pc,WFS,-180,-180,0,0,0,0
,Frozen Toddler Backpack Bag,Disney Frozen Toddler Backpack Bag,FBALYB Amazon,-1,-1,0,0,0,0
,Fruitables Skinny Minis Pumpkin & Berry 5oz,Fruitables Skinny Minis Pumpkin & Berry 5oz,FBALYB Amazon,3,3,0,0,0,0
,"Fruit Gushers, 36 ct.","Betty Crocker Fruit Gushers, 36 ct.",FBALYB Amazon,7,7,0,0,0,0
,Fruit Gushers 42ct,Fruit Gushers 42ct,FBALYB Amazon,25,25,0,3,0,0
,Fruit Roll-Ups Strawberry 72ct,Fruit Roll-Ups Strawberry & Tropical Tie Dye 72ct,FBALYB Amazon,78,48,30,0,30,0
,"FSKR 5"" POINT SCISSR","FSKR 5"" POINT SCISSR          ",Default Ridgefield,219,219,0,0,0,0
,"FSKR 5"" POINT SCISSR 3pk","FSKR 5"" POINT SCISSR 3pk",Default,144,-144,288,0,0,0
,"FSKR 5"" POINT SCISSR 3pk","FSKR 5"" POINT SCISSR 3pk",Default Ridgefield,0,-200,200,0,0,0
,"FSKR 5"" POINT SCISSR 3pk","FSKR 5"" POINT SCISSR 3pk",FBALYB Amazon,-3,-3,0,0,0,0
,Fuji QS 400 Flash 10 Pack,Fuji QS 400 Flash 10 Pack,FBALYB Amazon,-4,-4,0,0,0,0
,Fuji QS 400 Flash 20 Pack,Fuji QS 400 Flash 20 Pack,FBALYB Amazon,19,19,0,5,0,0
,Fuji QS 400 Flash 2 pack,Fuji QS 400 Flash 2 pack,FBALYB Amazon,-185,-185,0,118,0,0
,Fuji QS 400 Flash 40 Pack,Fuji QS 400 Flash 40 Pack,FBALYB Amazon,-3,-3,0,11,0,0
,Fuji QS 400 Flash 4 pack,Fuji QS 400 Flash 4 pack,FBALYB Amazon,2,2,0,0,0,0
,Fuji QS 400 Flash 5 Pack,Fuji QS 400 Flash 5 Pack,FBALYB Amazon,-35,-35,0,10,0,0
,Fuji QS Flash 400 Single-Use,Fuji QS Flash 400 Single-Use,FBALYB Amazon,2,2,0,0,0,0
,Funhouse Candy Mix Bag,Funhouse Candy Mix Bag,FBALYB Amazon,-1,-1,0,1,0,0
,FURminator Nail Clippers,FURminator Nail Clippers,FBALYB Amazon,-2,-2,0,0,0,0
,"Furo-Vite Paste for Ferrets, 3.5oz","Furo-Vite Paste for Ferrets, 3.5oz",Default,0,0,0,0,0,4
,G7 3 in 1 Instant Coffee Sachets - 100 Pack,G7 3 in 1 Instant Coffee Sachets - 100 Pack,Default Ridgefield,8,8,0,0,0,0
,G7 3 in 1 Instant Coffee Sachets - 100 Pack,G7 3 in 1 Instant Coffee Sachets - 100 Pack,FBALYB Amazon,4509,4447,62,678,62,0
,G7 3 in 1 Instant Coffee Sachets - 100 Pack,G7 3 in 1 Instant Coffee Sachets - 100 Pack,WFS,-307,-307,0,0,0,0
,G9-83YY-Y7RT,FoodSaver FM2110 Vacuum Sealing System,FBAAP Amazon,14,14,0,0,0,0
,Gain 1.56 GAL 146 loads,Gain 1.56 GAL 146 loads,Default,0,0,0,0,0,158
,Gain 1.56 GAL 146 loads,Gain 1.56 GAL 146 loads,FBALYB Amazon,-65,-65,0,91,0,0
,Gain Original 1.75 GAL,Gain Original 1.75 GAL Detergent,FBALYB Amazon,-1,-1,0,109,0,0
,Garcia 3 Seed Lentil Crackers 850g,Garcia 3 Seed Lentil Crackers 850g,FBALYB Amazon,3,3,0,0,0,0
,Garcia 3 Seed S.Potato Crackers 850g,Garcia 3 Seed S.Potato Crackers 850g,FBALYB Amazon,7,7,0,0,0,0
,Garden Veggie Snack 30 Count,"Sensible Portions Garden Veggie Snack Straws Shape Chips Variety Pack, 30 Count ",Default,0,0,0,0,0,48
,"Garmin Approach X40, Black","Garmin Approach X40, Black",FBALYB Amazon,-4,-4,0,0,0,0
,Garmin Drive 50LMT GPS,Garmin Drive 50LMT GPS,FBALYB Amazon,-2,-2,0,0,0,0
,"Garmin Fenix 5, Slate Gray","Garmin Fenix 5, Slate Gray with Black Band MPN 010-01688-00",FBALYB Amazon,1,1,0,0,0,0
,Garmin nuvi 2699LMT GPS,Garmin nuvi 2699LMT GPS,FBALYB Amazon,-2,-2,0,0,0,0
,Garmin Smartwatch Black,Garmin - vivoactive HR Smartwatch - Black,FBALYB Amazon,-19,-19,0,0,0,0
,Garmont Men's T8 Extreme GTX Insulated Tactical Military Coyote Boot Wide 481235/218 US Size 7,Garmont Men's T8 Extreme GTX Insulated Tactical Military Coyote Boot Wide 481235/218 US Size 7,Default Ridgefield,3,3,0,0,0,0
,Garmont Men's T8 Extreme GTX Insulated Tactical Military Coyote Boot Wide 481235/218 US Size 7,Garmont Men's T8 Extreme GTX Insulated Tactical Military Coyote Boot Wide 481235/218 US Size 7,FBALYB Amazon,5,5,0,0,0,0
,Garmont Men's T8 Extreme GTX Insulated Tactical Military Coyote Boot Wide 481235/218 US Size 7.5,"Garmont Men's T8 Extreme GTX Insulated Tactical Military Coyote Boot Wide 481235/218 US Size 7.5	",Default Ridgefield,2,2,0,0,0,0
,Garmont Men's T8 Extreme GTX Insulated Tactical Military Coyote Boot Wide 481235/218 US Size 7.5,"Garmont Men's T8 Extreme GTX Insulated Tactical Military Coyote Boot Wide 481235/218 US Size 7.5	",FBALYB Amazon,4,4,0,0,0,0
,GAS-X SOFTGELS  EXTRA STRENGTH,GAS-X SOFTGELS  EXTRA STRENGTH,FBALYB Amazon,8,8,0,0,0,0
,Gazillion Bubbles 67.6 oz,Gazillion Bubbles 67.6 oz,Default Ridgefield,-1,-1,0,0,0,0
,Gazillion Bubbles 67.6 oz 2 pack,Gazillion Bubbles 67.6 oz 2 pack,FBALYB Amazon,2,2,0,0,0,0
,"GD ACE 7"" ALL PURPOSE COMB BLACK 2pk","GD ACE 7"" ALL PURPOSE COMB BLACK 2pk",FBALYB Amazon,8,8,0,3,0,0
,GE ICE Crystal XMAS LIGHTS,GE ICE Crystal XMAS LIGHTS,FBALYB Amazon,-42,-49,7,40,7,0
,Ge led sphere,GE LED Spheres - 3 pack,FBALYB Amazon,18,18,0,0,0,0
,General Cure Powder Packet,General Cure Powder Packet,FBALYB Amazon,-1,-1,0,18,0,0
,General Cure Powder Packet 2pk,General Cure Powder Packet 2pk,FBALYB Amazon,-1,-1,0,0,0,0
,Gerber 12ct Yogurt,Gerber 12ct Yogurt,FBALYB Amazon,-2,-2,0,0,0,0
,Get led 4 pack,GE LED Light Bulbs 10 Watt (60 Watt Equivalent) Soft White Dimmable 4-Pack,FBALYB Amazon,-3,-3,0,0,0,0
,GF Performance Satin Quart 2 lbs,GF Performance Satin Quart 2 lbs,Default Ridgefield,963,963,0,0,0,0
,GF Performance Satin Quart 2 lbs,GF Performance Satin Quart 2 lbs,FBALYB Amazon,1248,1201,47,0,47,0
,Ghirardelli Brownie Mix 3pk,Ghirardelli Triple Chocolate Brownie Mix 3pk,Default,0,0,0,0,0,2
,Ghirardelli Brownie Mix 3pk,Ghirardelli Triple Chocolate Brownie Mix 3pk,FBALYB Amazon,10,10,0,0,0,0
,Ghirardelli Gold Assorted 22.82oz,Ghirardelli Gold Assorted 4 Flavors 22.82 Ounce,FBALYB Amazon,14,14,0,0,0,0
,"Ghirardelli Triple Chocolate Cookie Mix, 3 pk","Ghirardelli Triple Chocolate Cookie Mix, 3 pk",FBALYB Amazon,69,69,0,7,0,0
,Gilette Sensor Excel 5 Blades (One Box),Gillette Sensor Excel 5 Blades (One Box),Default Ridgefield,0,-1156,1156,0,0,0
,Gilette Sensor Excel 5 Blades (One Box),Gillette Sensor Excel 5 Blades (One Box),FBALYB Amazon,149,149,0,0,0,0
,Gilette Sensor Excel 5 Blades (One Box)    10BOXES 50ct total,Gilette Sensor Excel 5 Blades (One Box)    10BOXES 50ct total,FBALYB Amazon,15,11,4,0,4,0
,Gilette Sensor Excel 5 Blades (One Box) 4pk,Gillette Sensor Excel 5 Blades (One Box) 4pk,FBALYB Amazon,2,2,0,0,0,0
,GILLETTE BLADES MACH3 4 CT,GILLETTE BLADES MACH3 4 CT,Avrami - Ebay,135,135,0,0,0,0
,GILLETTE BLADES MACH3 4 CT,GILLETTE BLADES MACH3 4 CT,WFS,-3,-3,0,0,0,0
,Gillette Cool wave 5pk,Gillette Cool wave 5pk,FBALYB Amazon,-75,-159,84,118,84,0
,Gillette Cool wave 5pk,Gillette Cool wave 5pk,WFS,-25,-25,0,0,0,0
,Gillette Cool Wave Deodorant,Gillette Cool Wave Deodorant ,Avrami - Ebay,5185,5185,0,0,0,0
,Gillette Cool Wave Deodorant 2PK,Gillette Cool Wave Deodorant 2PK,FBALYB Amazon,59,26,33,1,33,0
,Gillette Cool Wave Deodorant 3PK,Gillette Cool Wave Deodorant 3PK,FBALYB Amazon,-10,-52,42,5,42,0
,Gillette Cool Wave Deodorant 4PK,Gillette Cool Wave Deodorant 4PK,FBALYB Amazon,176,170,6,1,6,0
,Gillette Cool Wave Deodorant 5ct,Gillette Cool Wave Deodorant 5ct,FBALYB Amazon,-62,-62,0,135,0,0
,Gillette Cool Wave Deodorant 5PK,Gillette Cool Wave Deodorant 5PK,Default Ridgefield,-2,-2,0,0,0,0
,Gillette Cool Wave Deodorant 5PK,Gillette Cool Wave Deodorant 5PK,FBALYB Amazon,1,1,0,0,0,0
,Gillette Cool Wave Deodorant 6pack,Gillette Cool Wave Deodorant 6pack,FBALYB Amazon,127,123,4,0,4,0
,Gillette Cool Wave Deodorant Men 3ct,Gillette Cool Wave Deodorant Men 3ct,FBALYB Amazon,-63,-63,0,24,0,0
,"Gillette Foamy Shaving Cream, Regular - 11 oz 3pk","Gillette Foamy Shaving Cream, Regular - 11 oz 3pk",FBALYB Amazon,-1,-1,0,0,0,0
,Gillette Fusion 5 Men's Razor Handle + 4 Blade,Gillette Fusion 5 Men's Razor Handle + 4 Blade,Avrami - Ebay,3,3,0,0,0,0
,Gillette Fusion 5 Men's Razor Handle + 4 Blade,Gillette Fusion 5 Men's Razor Handle + 4 Blade,FBALYB Amazon,-15,-15,0,1,0,0
,Gillette Fusion 5 Men's Razor Handle + 4 Blade,Gillette Fusion 5 Men's Razor Handle + 4 Blade,WFS,-1,-1,0,0,0,0
,Gillette Fusion Hydra Gel 6pk,Gillette Fusion Hydra Gel 6pk,FBALYB Amazon,1,1,0,33,0,0
,Gillette Fusion ProGlide Sensitive Shave Gel,Gillette Fusion ProGlide Sensitive Shave Gel,Default,0,-300,300,0,0,0
,Gillette Match 3 Turbo 1 Razor + 20 Cartridges,Gillette Match 3 Turbo 1 Razor + 20 Cartridges,Avrami - Ebay,397,397,0,0,0,0
,Gillette Match 3 Turbo 1 Razor + 20 Cartridges,Gillette Match 3 Turbo 1 Razor + 20 Cartridges,Default,0,0,0,0,0,2
,Gillette Match 3 Turbo 1 Razor + 20 Cartridges,Gillette Match 3 Turbo 1 Razor + 20 Cartridges,Default Ridgefield,198,198,0,0,0,0
,Gillette Men's Razors 52ct 2pk,Gillette Men's Razors 52ct 2pk,FBALYB Amazon,-81,-86,5,102,5,0
,Gillette Razors 52ct,Gillette Razors 52ct,Avrami - Ebay,99,99,0,0,0,0
,Gillette Razors 52ct,Gillette Razors 52ct,Default Ridgefield,51,51,0,0,0,0
,Gillette Razors 52ct,Gillette Razors 52ct,FBALYB Amazon,810,634,176,1578,176,0
,Gillette Razors 52ct,Gillette Razors 52ct,FBALYB Canada,16,16,0,0,0,0
,Gillette Razors 52ct,Gillette Razors 52ct,WFS,231,231,0,0,0,0
,Gillette Sensor 10 ct,Gillette Sensor 10 ct,FBALYB Amazon,2,2,0,0,0,0
,Gillette Sensor Excel 10pk,Gillette Sensor Excel 5 Refills 10pk,FBALYB Amazon,-1,-1,0,22,0,0
,Gillette Sensor Excel 2pk,Gillette Sensor Excel 5 Refills 2pk,Default Ridgefield,1,0,1,0,0,0
,Gillette Sensor Excel 2pk,Gillette Sensor Excel 5 Refills 2pk,FBALYB Amazon,11,9,2,6,2,0
,Gillette Sensor Excel 6pk,Gillette Sensor Excel 5 Refills 6pk,FBALYB Amazon,1,-45,46,1,46,0
,Gíllette Sensor Excel Razor Refill 4pk,Gíllette Sensor Excel Razor Refill 4pk,FBALYB Amazon,6148,6076,72,3,72,0
,Gillette TGS Series Shave Gel 7oz 6pk,Gillette TGS Series Shave Gel 7oz 6pk,FBALYB Amazon,-10,-10,0,0,0,0
,Gillette Venus Extra Smooth Platinum,Gillette Venus Extra Smooth Platinum ,Avrami - Ebay,29,29,0,0,0,0
,Gillette Venus Extra Smooth Platinum,Gillette Venus Extra Smooth Platinum ,Default Oxford,5,5,0,0,0,0
,Gillette Venus Extra Smooth Platinum,Gillette Venus Extra Smooth Platinum ,Default Ridgefield,-2,-2,0,0,0,0
,Gillette Venus Extra Smooth Platinum,Gillette Venus Extra Smooth Platinum ,FBALYB Amazon,-3,-3,0,0,0,0
,Gillette Venus Extra Smooth Platinum,Gillette Venus Extra Smooth Platinum ,WFS,-27,-27,0,0,0,0
,"Giovanni L.A. Natural Styling Gel, 6.8 Fl Oz","Giovanni L.A. Natural Styling Gel, 6.8 Fl Oz",Default Ridgefield,22,22,0,0,0,0
,GK-3MC7-DKV9,Pac-Man Heat Change Mug,FBALYB Amazon,-1,-1,0,0,0,0
,Glad 4 gal Trash Bags,"Glad OdorShield Small Trash Bags, Fresh Clean, 4 gal, 26 CT",FBALYB Amazon,-1,-1,0,1,0,0
,Glade 8 hawaiian 7 linen variety 2pk,Glade 8 hawaiian 7 linen variety 2pk,FBALYB Amazon,-10,-11,1,4,1,0
,Glade plugIns Cashmere Woods 8pk,Glade plugIns Cashmere Woods 8pk,Default Ridgefield,1204,1204,0,0,0,0
,Glade plugIns Cashmere Woods 8pk,Glade plugIns Cashmere Woods 8pk,FBALYB Amazon,1091,1083,8,0,8,0
,Glade Plugins Clean Linen 7ct,Glade Plugins Clean Linen 7ct,FBALYB Amazon,-392,-396,4,700,4,0
,Glade PlugIns Hawaiian Breeze 8 pk.,Glade PlugIns Hawaiian Breeze 8 pk.,Chicago,-399,-399,0,0,0,0
,Glade PlugIns Hawaiian Breeze 8 pk.,Glade PlugIns Hawaiian Breeze 8 pk.,Default Ridgefield,919,919,0,0,0,0
,Glade PlugIns Hawaiian Breeze 8 pk.,Glade PlugIns Hawaiian Breeze 8 pk.,FBALYB Amazon,-947,-1004,57,2626,57,0
,GLAMGLOW EYE CREAM 15G BRIGHTEYES,GLAMGLOW EYE CREAM 15G BRIGHTEYES,Default Ridgefield,2,2,0,0,0,0
,GLAMGLOW EYE CREAM 15G BRIGHTEYES,GLAMGLOW EYE CREAM 15G BRIGHTEYES,FBALYB Amazon,-4,-4,0,0,0,0
,GLAMGLOW GENTLEBUBBLE 150ML,GLAMGLOW GENTLEBUBBLE 150ML,FBALYB Amazon,3,3,0,0,0,0
,GLAMGLOW GLOWSTARTER MOISTURIZER 50GR NUDE GLOW,GLAMGLOW GLOWSTARTER MOISTURIZER 50GR NUDE GLOW,Default Ridgefield,1,1,0,0,0,0
,GLAMGLOW GLOWSTARTER MOISTURIZER 50GR NUDE GLOW,GLAMGLOW GLOWSTARTER MOISTURIZER 50GR NUDE GLOW,FBALYB Amazon,0,-2,2,0,2,0
,GLAMGLOW GLOWSTARTER MOISTURIZER 50GR SUN GLOW,GLAMGLOW GLOWSTARTER MOISTURIZER 50GR SUN GLOW,FBALYB Amazon,-2,-2,0,0,0,0
,GLAMGLOW TONER SUPER 200ML,GLAMGLOW TONER SUPER 200ML,FBALYB Amazon,-4,-4,0,0,0,0
,GLAMGLOW TREATMENT 100G SUPERMUD CLEARING,GLAMGLOW TREATMENT 100G SUPERMUD CLEARING,Default,0,0,0,0,0,10
,GLAMGLOW TREATMENT 100G SUPERMUD CLEARING,GLAMGLOW TREATMENT 100G SUPERMUD CLEARING,FBALYB Amazon,-1,-1,0,0,0,0
,GLAMGLOW WATERBURST MOISTURIZER 50GR HYDRATED GLOW,GLAMGLOW WATERBURST MOISTURIZER 50GR HYDRATED GLOW,FBALYB Amazon,-2,-2,0,0,0,0
,"Glass Canopy ‑ 48"" x 13","Glass Canopy ‑ 48"" x 13",Default,0,0,0,0,0,100
,"Glass Canopy ‑ 48"" x 13","Glass Canopy ‑ 48"" x 13",FBALYB Amazon,6,6,0,0,0,0
,Glasslock Tempered Glass Food Storage 26 ct,Glasslock Tempered Glass Food Storage 26 ct,Default,0,0,0,0,0,8
,Glasslock Tempered Glass Food Storage 26 ct,Glasslock Tempered Glass Food Storage 26 ct,Default Ridgefield,2,2,0,0,0,0
,Glasslock Tempered Glass Food Storage 26 ct,Glasslock Tempered Glass Food Storage 26 ct,FBALYB Amazon,184,184,0,0,0,0
,Glaxal Moisturizing cream 450 + 50g combo,Glaxal Moisturizing cream 450 + 50g combo,FBALYB Amazon,-29,-29,0,44,0,0
,Glide Mint Dental Floss 12ct 2pk,Glide Mint Dental Floss 12ct 2pk,FBALYB Amazon,-1,-1,0,2,0,0
,GloFish 19667 Color Booster 4oz,GloFish 19667 Color Booster 4oz,FBALYB Amazon,1,1,0,0,0,0
,Glofish Special Flake Food 1.59 Ounce,Glofish Special Flake Food 1.59 Ounce,Default Oxford,19,19,0,0,0,0
,Glofish Special Flake Food 1.59 Ounce,Glofish Special Flake Food 1.59 Ounce,Default Ridgefield,3179,3179,0,0,0,0
,Glofish Special Flake Food 1.59 Ounce,Glofish Special Flake Food 1.59 Ounce,FBALYB Amazon,145,145,0,0,0,0
,"Gloria Vanderbilt Amanda Classic High-Waist Tapered Jeans Scottsdale wash, Size: 10"" AVERAGE","Gloria Vanderbilt Amanda Classic High-Waist Tapered Jeans Scottsdale wash, Size: 10"" AVERAGE",Default Ridgefield,2,2,0,0,0,0
,"Gloria Vanderbilt Amanda Classic High-Waist Tapered Jeans Scottsdale wash, Size: 16"" SHORT","Gloria Vanderbilt Amanda Classic High-Waist Tapered Jeans Scottsdale wash, Size: 16"" SHORT",Default Ridgefield,7,7,0,0,0,0
,"Gloria Vanderbilt Amanda Classic High-Waist Tapered Jeans Scottsdale Wash, Size: 8 AVERAGE","Gloria Vanderbilt Amanda Classic High-Waist Tapered Jeans Scottsdale Wash, Size: 8 AVERAGE",Default Ridgefield,23,23,0,0,0,0
,"Gloria Vanderbilt Amanda Classic High-Waist Tapered Jeans Scottsdale wash, Size: 8"" Short","Gloria Vanderbilt Amanda Classic High-Waist Tapered Jeans Scottsdale wash, Size: 8"" Short",Default Ridgefield,34,34,0,0,0,0
,"Gloria Vanderbilt Amanda Stretch Jeans Size 8"" - Portland - AVERAGE","Gloria Vanderbilt Amanda Stretch Jeans Size 8"" - Portland - AVERAGE",Default Ridgefield,7,7,0,0,0,0
,"Gloria Vanderbilt Women's Amanda Classic Tapered Jean, Scottsdale Wash, 10"" Short","Gloria Vanderbilt Women's Amanda Classic Tapered Jean, Scottsdale Wash, 10"" Short",Default Ridgefield,16,16,0,0,0,0
,"Gloria Vanderbilt Women's Amanda Classic Tapered, Scottsdale Wash, Size 14"" SHORT","Gloria Vanderbilt Women's Amanda Classic Tapered, Scottsdale Wash, Size 14"" SHORT",Default Ridgefield,1,1,0,0,0,0
,"Gloria Vanderbilt Women's Amanda Slimming Stretch Denim Jeans Portland, 10"" SHORT","Gloria Vanderbilt Women's Amanda Slimming Stretch Denim Jeans Portland, 10"" SHORT",Default Ridgefield,1,1,0,0,0,0
,"Gloria Vanderbilt Women's Amanda Slimming Stretch Denim Jeans Portland, 16"" SHORT","Gloria Vanderbilt Women's Amanda Slimming Stretch Denim Jeans Portland, 16"" SHORT",Default Ridgefield,10,10,0,0,0,0
,"Gloria Vanderbilt Women's Amanda Slim Stretch Heritage Fit Tapered Leg Jeans 8"" SHORT","Gloria Vanderbilt Women's Amanda Slim Stretch Heritage Fit Tapered Leg Jeans Portland 8"" SHORT",Default Ridgefield,12,12,0,0,0,0
,"Gloria Vanderbilt Women's Jean Lilac Burst 12"" Short","Gloria Vanderbilt Women's Jean Lilac Burst 12"" Short",Default Ridgefield,5,5,0,0,0,0
,"Gloria Vanderbilt Women's Jean Lilac Burst 16"" Short","Gloria Vanderbilt Women's Jean Lilac Burst 16"" Short",Default Ridgefield,1,1,0,0,0,0
,Glysomed Large Hand Cream,Glysomed Large Hand Cream 2 X 250ml/8.5 oz,Default Ridgefield,1175,1175,0,0,0,0
,Glysomed Large Hand Cream,Glysomed Large Hand Cream 2 X 250ml/8.5 oz,FBALYB Amazon,316,308,8,1,8,0
,Glysomed Large Hand Cream,Glysomed Large Hand Cream 2 X 250ml/8.5 oz,FBALYB Canada,2,2,0,5,0,0
,GM Caramel Vanilla Cream 24ct 3pk,GM Caramel Vanilla Cream 24ct 3pk,FBALYB Amazon,1,1,0,0,0,0
,GM Caramel Vanilla Cream 24ct 4pk,GM Caramel Vanilla Cream 24ct 4pk,FBALYB Amazon,11,11,0,0,0,0
,GMCR Donut House™ Coffee,GMCR Donut House™ Coffee,Default,0,0,0,0,0,24
,GMCR Folgers Gourmet Black Silk,GMCR Folgers Gourmet Black Silk,Default,0,-68,68,0,0,0
,GMCR Folgers Gourmet Black Silk 2pk,GMCR Folgers Gourmet Black Silk 2pk,FBALYB Amazon,13,13,0,28,0,0
,GMCR Folgers Gourmet Caramel Drizzle,GMCR Folgers Gourmet Caramel Drizzle,FBALYB Amazon,0,0,0,2,0,0
,GMCR Folgers Gourmet Caramel Drizzle 2pk,GMCR Folgers Gourmet Caramel Drizzle 2pk,FBALYB Amazon,2,0,2,4,2,0
,"GMCR Folgers Gourmet Classic Roast, 24 CT","GMCR Folgers Gourmet Classic Roast, 24 CT",Default,0,0,0,0,0,80
,"GMCR Folgers Gourmet Classic Roast, 24 CT 2pk","GMCR Folgers Gourmet Classic Roast, 24 CT 2pk",Default,-40,-40,0,0,0,0
,"GMCR Folgers Gourmet Classic Roast, 24 CT 2pk","GMCR Folgers Gourmet Classic Roast, 24 CT 2pk",FBALYB Amazon,-35,-35,0,0,0,0
,GMCR Folgers Gourmet Vanilla Biscotti 2pk,GMCR Folgers Gourmet Vanilla Biscotti 2pk,FBALYB Amazon,-106,-106,0,86,0,0
,GMCR Van Houtte Vanilla Hazelnut Decaf 24ct,GMCR Van Houtte Vanilla Hazelnut Decaf 24ct,Default,0,-300,300,0,0,0
,GMCR Van Houtte Vanilla Hazelnut Decaf 24ct,GMCR Van Houtte Vanilla Hazelnut Decaf 24ct,FBALYB Amazon,46,44,2,0,2,0
,"GMCR VH Butterscotch, 24 CT","GMCR VH Butterscotch, 24 CT",Default,0,0,0,0,0,208
,"GMCR VH Butterscotch, 24 CT","GMCR VH Butterscotch, 24 CT",FBALYB Amazon,24,22,2,0,2,0
,GMCR VH Crème Brulee,GMCR VH Crème Brulee,Default,0,0,0,0,0,20
,GMCR VH Crème Brulee,GMCR VH Crème Brulee,FBALYB Amazon,18,18,0,0,0,0
,GMCR VH Eclipse Extra Bold,GMCR VH Eclipse Extra Bold,Default,0,0,0,0,0,60
,GMCR VH French Vanilla,GMCR VH French Vanilla,Default,0,-39,39,0,0,256
,GMCR VH French Vanilla,GMCR VH French Vanilla,FBALYB Amazon,107,107,0,0,0,0
,GMCR VH French Vanilla 2pk,GMCR VH French Vanilla 2pk,FBALYB Amazon,12,12,0,0,0,0
,"GMCR VH Hazelnut Decaf, 24 CT","GMCR VH Hazelnut Decaf, 24 CT",Default,50,-250,300,0,0,100
,"GMCR VH Hazelnut Decaf, 24 CT","GMCR VH Hazelnut Decaf, 24 CT",FBALYB Amazon,-85,-85,0,9,0,0
,"GMCR VH Hazelnut Decaf, 24 CT 2pk","GMCR VH Hazelnut Decaf, 24 CT 2pk",FBALYB Amazon,90,90,0,1,0,0
,GMCR VH Honduras Extra Bold,GMCR VH Honduras Extra Bold,FBALYB Amazon,-8,-8,0,8,0,0
,GMCR VH House Blend,GMCR VH House Blend,Default,0,-2400,2400,0,0,0
,GMCR VH Mexico Fair Trade Organic,GMCR VH Mexico Fair Trade Organic,FBALYB Amazon,7,7,0,0,0,0
,GMCR VH Pecan Praline,GMCR VH Pecan Praline,FBALYB Amazon,30,30,0,0,0,0
,GMCR VH Pecan Praline 2PK,GMCR VH Pecan Praline 2PK,FBALYB Amazon,3,3,0,17,0,0
,"GMCR VH Vanilla Hazelnut, 24 CT","GMCR VH Vanilla Hazelnut, 24 CT",Default,0,-40,40,0,0,0
,"GMCR VH Vanilla Hazelnut, 24 CT 2pk","GMCR VH Vanilla Hazelnut, 24 CT 2pk",FBALYB Amazon,4,4,0,0,0,0
,GNC Fish Oil 90ct,GNC Fish Oil 90ct,FBALYB Amazon,-1,-1,0,0,0,0
,GNC Hip+Joint Large Breed Bacon 120ct,GNC Hip+Joint Large Breed Bacon 120ct,FBALYB Amazon,6,6,0,0,0,0
,GNC Probiotic Beef 90ct,GNC Probiotic Beef 90ct,FBALYB Amazon,-1,-1,0,0,0,0
,Goetze's Carmel Cream 4lb,Goetze's Vanilla Carmel Cream 4lbs,FBALYB Amazon,74,73,1,0,1,0
,GoGo Squeez Applesauce 20ct,GoGo Squeez Organic Applesauce Variety 20 Count,FBALYB Amazon,1,1,0,0,0,0
,Gold Bond Lotion with Aloe 2pk,Gold Bond Lotion with Aloe 2pk,Avrami - Ebay,16,16,0,0,0,0
,Gold Bond Lotion with Aloe 2pk,Gold Bond Lotion with Aloe 2pk,Default,8,8,0,0,0,0
,Gold Bond Lotion with Aloe 2pk,Gold Bond Lotion with Aloe 2pk,Default Ridgefield,24,24,0,0,0,0
,Gold Bond Lotion with Aloe 2pk,Gold Bond Lotion with Aloe 2pk,FBALYB Amazon,386,372,14,2,14,0
,Gold Bond Lotion with Aloe 2pk,Gold Bond Lotion with Aloe 2pk,WFS,-11,-11,0,0,0,0
,Gold Bond Medicated Body Powder 4 oz 4pk,Gold Bond Medicated Body Powder 4 oz 4pk,FBALYB Amazon,-1,-1,0,0,0,0
,Golden Barrel Butter Flavored Coconut Oil (32 oz.),Golden Barrel Butter Flavored Coconut Oil (32 oz.),FBALYB Amazon,-1,-1,0,0,0,0
,Golden Barrel Butter Flavored Coconut Oil (32 oz.) 2pk,Golden Barrel Butter Flavored Coconut Oil (32 oz.) 2pk,FBALYB Amazon,2,1,1,0,1,0
,Goldfish 24 Snack Packs,Goldfish 24 Snack Packs  ,FBALYB Amazon,5,5,0,0,0,0
,"Goldfish Variety Pack, 45 ct","Pepperidge Farm Goldfish Baked Snack Crackers, Variety Pack, 45 ct",FBALYB Amazon,4,4,0,0,0,0
,"Good Cook Wood Rolling Pin 10"" 3pk","Good Cook Wood Rolling Pin 10"" 3pk",FBALYB Amazon,-18,-18,0,14,0,0
,Good Earth Tea Mango Me Crazy 18ct 3pk,Good Earth Tea Mango Me Crazy 18ct 3pk,FBALYB Amazon,5,5,0,0,0,0
,Good Earth Tea Mango Me Crazy 18ct 6pk,Good Earth Tea Mango Me Crazy 18ct 6pk,FBALYB Amazon,84,84,0,0,0,0
,Good Earth Tea Matcha Maker 18ct,Good Earth Tea Matcha Maker 18ct,Default CT,3,3,0,0,0,0
,Good Earth Tea Matcha Maker 18ct,Good Earth Tea Matcha Maker 18ct,FBALYB Amazon,49,47,2,0,2,0
,Good Earth Tea Matcha Maker 18ct 3pk,Good Earth Tea Matcha Maker 18ct 3pk,FBALYB Amazon,1,1,0,0,0,0
,Good Earth Tea Matcha Maker 18ct 6pk,Good Earth Tea Matcha Maker 18ct 6pk,FBALYB Amazon,122,122,0,0,0,0
,Good Earth Tea Organic Sweet & Spicy Caffree 18ct,Good Earth Tea Organic Sweet & Spicy Caffree 18ct,Default CT,11416,11416,0,0,0,0
,Good Earth Tea Organic Sweet & Spicy Caffree 18ct,Good Earth Tea Organic Sweet & Spicy Caffree 18ct,Default Ridgefield,0,-588,588,0,0,0
,Good Earth Tea Organic Sweet & Spicy Caffree 18ct,Good Earth Tea Organic Sweet & Spicy Caffree 18ct,FBALYB Amazon,114,61,53,0,53,0
,Good Earth Tea Organic Sweet & Spicy Caffree 18ct 3pk,Good Earth Tea Organic Sweet & Spicy Caffree 18ct 3pk,FBALYB Amazon,70,65,5,0,5,0
,Good Earth Tea Organic Sweet & Spicy Caffree 18ct 4pk,Good Earth Tea Organic Sweet & Spicy Caffree 18ct 4pk,FBALYB Amazon,570,570,0,49,0,0
,Good Earth Tea Organic Sweet & Spicy Caffree 18ct 6pk,Good Earth Tea Organic Sweet & Spicy Caffree 18ct 6pk,FBALYB Amazon,26,24,2,0,2,0
,Good Earth Tea Pomegranate Burst 18ct 6pk,Good Earth Tea Pomegranate Burst 18ct 6pk,FBALYB Amazon,1,0,1,0,1,0
,Good Earth Tea Sweet & Spicy 18ct 6pk,Good Earth Tea Sweet & Spicy 18ct 6pk,FBALYB Amazon,-1,-1,0,0,0,0
,Good Earth Tea Sweet & Spicy Caffree 18ct,Good Earth Tea Sweet & Spicy Caffree 18ct,Default CT,588,588,0,0,0,0
,Good Earth Tea Sweet & Spicy Chai 18ct 6pk,Good Earth Tea Sweet & Spicy Chai 18ct 6pk,FBALYB Amazon,63,63,0,0,0,0
,Good Earth Tea Sweet & Spicy Green 18ct 6pk,Good Earth Tea Sweet & Spicy Green 18ct 6pk,Default CT,1,1,0,0,0,0
,Good Earth Tea Sweet & Spicy Green 18ct 6pk,Good Earth Tea Sweet & Spicy Green 18ct 6pk,FBALYB Amazon,141,141,0,0,0,0
,Good Earth Tea Sweet & Spicy Green Decaf 18ct 6pk,Good Earth Tea Sweet & Spicy Green Decaf 18ct 6pk,FBALYB Amazon,59,59,0,0,0,0
,Good Earth Tea Sweet & Spicy Peppermint 18ct 6pk,Good Earth Tea Sweet & Spicy Peppermint 18ct 6pk,FBALYB Amazon,10,10,0,0,0,0
,Goody Ouchless Flex Small Updo Hair Barrettes 2 Count 3pk,Goody Ouchless Flex Small Updo Hair Barrettes 2 Count 3pk,FBALYB Amazon,-1,-1,0,0,0,0
,Google - Home - White/Slate fabric,Google - Home - White/Slate fabric,Default,0,0,0,0,0,1
,GoPro HERO5 4K Camera Bundle,GoPro HERO5 Session 4K Camera Bundle - CHDRB-501,Default,0,0,0,0,0,5
,GoPro HERO5 Black Bundle,GoPro HERO5 Black Bundle,FBALYB Amazon,-7,-7,0,0,0,0
,GoPro Hero5 Session Bundle,GoPro Hero5 Session Bundle,FBALYB Amazon,-9,-9,0,0,0,0
,Grab A Rag 75 ct,Grab A Rag 75 ct,FBALYB Amazon,171,149,22,0,22,0
,Grannick's Bitter Apple 16oz Refill for Dogs,Grannick's Bitter Apple 16-Ounce Refill for Dogs,FBALYB Amazon,-5,-5,0,0,0,0
,Greenies 60ct Capsules Variety 2pk,Greenies 60ct Capsules Variety 2pk,Default,0,-201,201,0,0,0
,Greenies 60ct Capsules Variety 2pk,Greenies 60ct Capsules Variety 2pk,FBALYB Amazon,-14,-14,0,13,0,0
,Greenies 60ct Hickory Capsules 2pk,Greenies 60ct Hickory Capsules 2pk,FBALYB Amazon,0,0,0,1,0,0
,Greenies Allergy Formula Duck & Pea Pill Pockets 6 PK,Greenies Allergy Formula Duck & Pea Pill Pockets 6 PK,FBALYB Amazon,0,0,0,2,0,0
,GREENIES BREATH BUSTER Fresh Dog Treat 2.5oz,GREENIES BREATH BUSTER Fresh Dog Treat 2.5oz,FBALYB Amazon,-13,-14,1,12,1,0
,Greenies Breath Busters 3pk Variety Bundle,Greenies Breath Busters 3pk Variety Bundle,FBALYB Amazon,-1,-1,0,0,0,0
,Greenies Cat Skin Salmon 2.1oz 2pk,Greenies Cat Skin Salmon 2.1oz 2pk,FBALYB Amazon,1,1,0,0,0,0
,Greenies Cat Skin Salmon 2.1oz 6pk,Greenies Cat Skin Salmon 2.1oz 6pk,FBALYB Amazon,54,54,0,0,0,0
,Greenies Cats Skin Chicken 2.1oz,Greenies Cats Skin Chicken 2.1oz,FBALYB Amazon,1,1,0,0,0,0
,Greenies Chicken 30ct Tablets,Greenies Chicken 30ct Tablets,Default,0,0,0,0,0,11
,Greenies Chicken 30ct Tablets,Greenies Chicken 30ct Tablets,FBALYB Amazon,1,1,0,0,0,0
,Greenies Chicken 30ct Tablets 6pk,Greenies Chicken 30ct Tablets 6pk,FBALYB Amazon,-4,-4,0,4,0,0
,Greenies Chicken 60ct Capsules 2pk,Greenies Chicken 60ct Capsules 2pk,FBALYB Amazon,-3,-3,0,0,0,0
,Greenies Dental 2.1oz 6 Pouch Variety PK,Greenies Dental 2.1oz 6 Pouch Variety PK,FBALYB Amazon,0,0,0,8,0,0
,Greenies Feline Catnip 2.5oz 3pk,Greenies Feline Catnip 2.5oz 3pk,FBALYB Amazon,-1,-1,0,0,0,0
,Greenies Feline Chicken 2.1oz 10pk,Greenies Feline Chicken 2.1oz 10pk,FBALYB Amazon,25,25,0,18,0,0
,Greenies Feline Chicken 2.1oz 12pk,Greenies Feline Chicken 2.1oz 12pk,FBALYB Amazon,-9,-9,0,0,0,0
,Greenies Feline Chicken 2.1oz 2pk,Greenies Feline Chicken 2.1oz 2pk,FBALYB Amazon,1,1,0,0,0,0
,Greenies Feline Chicken 45 Capsules 6PK,Greenies Feline Chicken 45 Capsules 6PK,FBALYB Amazon,-2,-2,0,5,0,0
,Greenies Feline Chicken 4.6oz,Greenies Feline Chicken 4.6oz,Default,0,-549,549,0,0,0
,Greenies Feline Chicken 4.6oz,Greenies Feline Chicken 4.6oz,FBALYB Amazon,59,59,0,0,0,0
,Greenies Feline Chicken 4.6oz 2 pk,Greenies Feline Chicken 4.6oz 2 pk,FBALYB Amazon,-4,-4,0,7,0,0
,Greenies Feline Chicken 4.6oz 3pk,Greenies Feline Chicken 4.6oz 3pk,FBALYB Amazon,-2,-2,0,0,0,0
,Greenies Feline Chicken Hairball 2.1oz 6pk,Greenies Feline Chicken Hairball 2.1oz 6pk,FBALYB Amazon,76,76,0,0,0,0
,Greenies Feline Pill Pocket Chicken & Salmon 2PK,Greenies Feline Pill Pocket Chicken & Salmon 2PK,FBALYB Amazon,55,55,0,1,0,0
,GREENIES Feline Variety Bundle for Cats,GREENIES Feline Variety Bundle for Cats,FBALYB Amazon,-1,-3,2,2,2,0
,Greenies Grain Free Petite 12 Oz,Greenies Grain Free Petite 12 Oz,FBALYB Amazon,0,0,0,1,0,0
,Greenies Grain Free Petite 45 Count 27 Oz,Greenies Grain Free Petite 45 Count 27 Oz,FBALYB Amazon,16,16,0,0,0,0
,Greenies Hairball Tuna 4.6oz 2 PK,Greenies Hairball Tuna 4.6oz 2 PK,FBALYB Amazon,-3,-3,0,3,0,0
,Greenies Hickory 30ct Tablets,Greenies Hickory 30ct Tablets,Default,0,0,0,0,0,16
,Greenies Hickory 30ct Tablets 6pk,Greenies Hickory 30ct Tablets 6pk,FBALYB Amazon,-20,-20,0,17,0,0
,Greenies Peanut 7.9oz 30ct Capsules,Greenies Peanut 7.9oz 30ct Capsules,Default,0,-120,120,0,0,0
,Greenies Peanut 7.9oz 30ct Capsules 2pk,Greenies Peanut 7.9oz 30ct Capsules 2pk,FBALYB Amazon,-17,-17,0,8,0,0
,Greenies Peanut 7.9oz 30ct Capsules 6pk,Greenies Peanut 7.9oz 30ct Capsules 6pk,FBALYB Amazon,1,1,0,0,0,0
,Greenies Peanut Butter 30ct Tablets 6pk,Greenies Peanut Butter 30ct Tablets 6pk,FBALYB Amazon,-2,-2,0,1,0,0
,"Greenies- Peanut Butter x2, Chicken x2, Hickory x2 Tablets 6 pk","Greenies- Peanut Butter 30 ct x2, Chicken 30 ct x2, Hickory 30 ct x2 Tablets 6 pk",FBALYB Amazon,-22,-22,0,18,0,0
,Greenies Pill Pocket Capsules 60ct 6pk,Greenies Pill Pocket Capsules 60ct 6pk,FBALYB Amazon,4,4,0,2,0,0
,"Greenies Pill Pocket Variety, Chkn, PB, HKRY 3PK","Greenies Pill Pocket Variety, Chkn, PB, HKRY 3PK",FBALYB Amazon,-3,-3,0,0,0,0
,Greenies Pumpkin Spice Large 12oz,Greenies Pumpkin Spice Large 12oz,FBALYB Amazon,2,2,0,0,0,0
,Greenies Pumpkin Spice Regular 12oz,Greenies Pumpkin Spice Regular 12oz,FBALYB Amazon,1,1,0,0,0,0
,Greenies Pumpkin Spice Teenie 12oz,Greenies Pumpkin Spice Teenie 12oz,FBALYB Amazon,-2,-2,0,0,0,0
,Greenies Salmon Skin & Fur 2.1oz 12pk,Greenies Salmon Skin & Fur 2.1oz 12pk,FBALYB Amazon,-6,-6,0,0,0,0
,Greenies Skin And Fur Chicken 2.1oz 6pk,Greenies Skin And Fur Chicken 2.1oz 6pk,FBALYB Amazon,2,2,0,1,0,0
,Greenies Tablets Variety Bundle,"Greenies Chk, Hkry, PB 30 ct Tablets Variety Bundle 3pk",FBALYB Amazon,1,1,0,4,0,0
,Greenies Tablet Variety 6pk,Greenies Tablet Variety 6pk,FBALYB Amazon,13,13,0,0,0,0
,Greenies Teenie 43ct 12oz,Greenies Teenie 43ct 12oz,FBALYB Amazon,1,1,0,0,0,0
,Greenies Teenie Dental Dog Treats 96ct,Greenies Teenie Dental Dog Treats 96ct,Default,0,-115,115,0,0,0
,Greenies Teenie Dental Dog Treats 96ct,Greenies Teenie Dental Dog Treats 96ct,FBALYB Amazon,-1,-1,0,0,0,0
,Greenies Tuna Hairball Control - 2.1oz 12 pk,Greenies Tuna Hairball Control - 2.1oz 12 pk,FBALYB Amazon,-1,-1,0,1,0,0
,Greenies Tuna Hairball Control - 2.1oz 24 pk,Greenies Tuna Hairball Control - 2.1oz 24pk,FBALYB Amazon,36,36,0,1,0,0
,Greenies weight management 45 petite, Greenies weight management 45 petite,FBALYB Amazon,1,1,0,0,0,0
,Greenies Weight Management Teenie 12 Oz,Greenies Weight Management Teenie 12 Oz,FBALYB Amazon,-2,-2,0,0,0,0
,Greenies Weight Management Teenie 12 Oz,Greenies Weight Management Teenie 12 Oz,Joes Playground (Testing),10,-1,11,0,0,0
,Green Mountain Coffee Half-Caff 48 K-Cup,Green Mountain Coffee Half-Caff 48 K-Cup,FBALYB Amazon,120,120,0,0,0,0
,Green mountain coffee Kenya 48ct,Green mountain coffee Kenya 48ct,FBALYB Amazon,3,3,0,2,0,0
,Green Mountain Decaf French Vanilla,Green Mountain Decaf French Vanilla,FBALYB Amazon,-1,-1,0,0,0,0
,Green Mountain French Vanilla Decaf 48c,Green Mountain French Vanilla Decaf 48c,FBALYB Amazon,1,1,0,0,0,0
,Green Mountain Half Caff Medium 24ct K Cups,Green Mountain Half Caff Medium 24ct K Cups,FBALYB Amazon,-15,-16,1,21,1,0
,Green Mountain Island Coconut 24ct,Green Mountain Island Coconut 24ct,FBALYB Amazon,30,22,8,10,8,0
,Green Mountain Island Coconut 24ct 3pk,Green Mountain Island Coconut 24ct 3pk,FBALYB Amazon,3,3,0,0,0,0
,Green Mountain Island Coconut 24ct 4pk,Green Mountain Island Coconut 24ct 4pk,FBALYB Amazon,2,-2,4,18,4,0
,Green Mountain Kenyan AA Coffee K-Cup 24ct,Green Mountain Kenyan AA Coffee K-Cup 24ct,FBALYB Amazon,-25,-25,0,35,0,0
,Green Mountain Lake and Lodge 24ct K Cups,Green Mountain Lake and Lodge 24ct K Cups,Default,0,-20,20,0,0,0
,Green Mountain Lake and Lodge 48ct K Cups,Green Mountain Lake and Lodge 48ct K Cups,FBALYB Amazon,-1,-1,0,2,0,0
,Green Mountain Nantucket 96 k cups,Green Mountain Nantucket 96 k cups,FBALYB Amazon,-120,-120,0,0,0,0
,Green Mountain OUR BLEND 48ct K Cups,Green Mountain OUR BLEND 48ct K Cups,FBALYB Amazon,1,0,1,0,1,0
,Green Mountain Vermont Country Blend 24ct,Green Mountain Vermont Country Blend 24ct,FBALYB Amazon,8,8,0,0,0,0
,Green Mountain Vermont Country Blend 24ct 2pk,Green Mountain Vermont Country Blend 24ct 2pk,FBALYB Amazon,1,1,0,0,0,0
,Green Mountain Wild Blueberry 24ct,Green Mountain Wild Blueberry 24ct,FBALYB Amazon,4,4,0,0,0,0
,Green Mountain Wild Blueberry 24ct 4pk,Green Mountain Wild Blueberry 24ct 4pk,FBALYB Amazon,13,13,0,0,0,0
,Greenpan Ceramic Non‑stick 2‑piece,Greenpan Ceramic Non‑stick 2‑piece Frypan Set,Default,1,1,0,0,0,0
,Greenpan Ceramic Non‑stick 2‑piece,Greenpan Ceramic Non‑stick 2‑piece Frypan Set,FBALYB Amazon,-23,-23,0,0,0,0
,GreenPan Grill & Griddle Pan,GreenPan Hard Anodized Non-Stick Ceramic Square 10 inch Grill Pan 11 inch Griddle Pan,FBALYB Amazon,20,20,0,23,0,0
,Green tea fat burner 200,Green Tea Fat Burner Maximum Strength 200 Liquid Soft-Gels,FBALYB Amazon,1,0,1,0,1,0
,Green tea fat burner 200 2pk,Green tea fat burner 200 2pk,FBALYB Amazon,-1,-1,0,0,0,0
,Green Tea Neutrogena Rainbath,Green Tea Neutrogena Rainbath,FBALYB Amazon,92,92,0,0,0,0
,"Grey Poupon Dijon Mustard ‑ 2 pack, 16 oz jars","Grey Poupon Dijon Mustard ‑ 2 pack, 16 oz jars",Default,0,0,0,0,0,2
,"Grey Poupon Dijon Mustard ‑ 2 pack, 16 oz jars","Grey Poupon Dijon Mustard ‑ 2 pack, 16 oz jars",FBALYB Amazon,329,329,0,5,0,0
,"Griptilian, DROP PT GRIP, AXS,STUD 551BKSN-S30V","Griptilian, DROP PT GRIP, AXS,STUD 551BKSN-S30V",Default Ridgefield,25,25,0,0,0,0
,"Griptilian, DROP PT GRIP, AXS,STUD 551BKSN-S30V","Griptilian, DROP PT GRIP, AXS,STUD 551BKSN-S30V",FBALYB Amazon,-1,-1,0,0,0,0
,"GRIZZLY CREEK, DP, AXIS, WOOD","GRIZZLY CREEK, DP, AXIS, WOOD",Default Ridgefield,25,25,0,0,0,0
,"GRIZZLY CREEK, DP, AXIS, WOOD","GRIZZLY CREEK, DP, AXIS, WOOD",FBALYB Amazon,-3,-4,1,0,1,0
,"GRIZZLY RIDGE, DP, AXIS, FOLDER, DD","GRIZZLY RIDGE, DP, AXIS, FOLDER, DD",FBALYB Amazon,-12,-12,0,0,0,0
,Grooming Wipes Mango Tango 100 ct,Grooming Wipes Mango Tango 100 ct ,Default,1,1,0,0,0,0
,Grooming Wipes Mango Tango 100 ct,Grooming Wipes Mango Tango 100 ct ,FBALYB Amazon,-58,-58,0,0,0,0
,G SEASONS 10PK ITAL DRESS MIX,G SEASONS 10PK ITAL DRESS MIX,FBALYB Amazon,-51,-55,4,45,4,0
,GUM Go-Betweens Proxabrush Wide 8ct 3pk,GUM Go-Betweens Proxabrush Wide 3pk,FBALYB Amazon,-23,-23,0,533,0,0
,GUM Go-Betweens Refills Wide 6pk,GUM Go-Betweens Refills Wide 6pk,FBALYB Amazon,-3,-3,0,3,0,0
,"GUM Go-Betweens Refills Wide, 8ct 10pk","GUM Go-Betweens Refills Wide, 8ct 10pk",FBALYB Amazon,4,0,4,0,4,0
,"GUM Go-Betweens Refills Wide, 8ct 12pk","GUM Go-Betweens Refills Wide, 8ct 12pk",FBALYB Amazon,-1,-1,0,0,0,0
,"GUM Go-Betweens Refills, Wide, 8ct 3pk","GUM Go-Betweens Refills, Wide, 8ct 3pk",FBALYB Amazon,1,1,0,0,0,0
,"GUM Go-Betweens Refills, Wide, 8ct 5pk","GUM Go-Betweens Refills, Wide, 8ct 5pk",FBALYB Amazon,-1,-1,0,0,0,0
,GUM GO BETWEEN WIDE BASE,GUM GO BETWEEN WIDE BASE,Default Ridgefield,9,9,0,0,0,0
,GUM GO BETWEEN WIDE BASE,GUM GO BETWEEN WIDE BASE,FBALYB Amazon,118,93,25,228,25,0
,GUM Soft-Picks Original 540 ct,GUM Soft-Picks Original 540 ct,FBALYB Amazon,-5,-5,0,0,0,0
,GUM Soft-Picks Original 5pk,GUM Soft-Picks Original 5pk,FBALYB Amazon,-2,-2,0,2,0,0
,Gum Soft Tooth Picks 320 Picks,Gum Soft Tooth Picks 320 Picks,FBALYB Amazon,8,8,0,0,0,0
,H2-RREW-CLD5,"HP Envy 7640 Wireless All-in-One Photo Printer with Mobile Printing, Instant ...",Default,0,-1,1,0,0,13
,H2-RREW-CLD5,"HP Envy 7640 Wireless All-in-One Photo Printer with Mobile Printing, Instant ...",FBALYB Amazon,5,5,0,3,0,0
,Halls Cherry Cough Drops 200ct,Halls Cherry Cough Drops 200ct ,FBALYB Amazon,-692,-692,0,700,0,0
,"Halls Citrus, 180 Count","Halls Defense Drops Assorted Citrus, 180 Count",FBALYB Amazon,47,47,0,0,0,0
,"Halls Lemon, 180 Count",Halls Defense Drops Honey Lemon 180 Count,FBALYB Amazon,-1,-1,0,0,0,0
,Halo Liv a Littles Chicken 2.2oz 6pk,Halo Liv a Littles Chicken 2.2oz 6pk,FBALYB Amazon,-1,-1,0,0,0,0
,"Hampton Salted Peanuts, 40 oz.","Hampton Farms Super Extra Large Extra Crunchy Salted Roasted Peanuts, 40 oz.",FBALYB Amazon,12,12,0,0,0,0
,"Happy Howie Beef Burgers Bulk 2"" 125ct","Happy Howie Beef Burgers Bulk 2"" 125ct",FBALYB Amazon,1,1,0,0,0,0
,"Happy Howies Beef Burger Bulk 4"" 60ct","Happy Howies Beef Burger Bulk 4"" 60ct",FBALYB Amazon,1,1,0,0,0,0
,Happy Howies Beef Roll 1lb,Happy Howies Beef Roll 1lb,FBALYB Amazon,96,96,0,0,0,0
,Happy Howies Beef Roll 2lb,Happy Howies Beef Roll 2lb,FBALYB Amazon,88,88,0,0,0,0
,Happy Howies Beef Roll 2lb 2pk,Happy Howies Beef Roll 2lb 2pk,FBALYB Amazon,-1,-1,0,0,0,0
,Happy Howies Beef Roll 2lb 6pk,Happy Howies Beef Roll 2lb 6pk,FBALYB Amazon,16,16,0,0,0,0
,"Happy Howie's Beef Sausage 12"" 36ct","Happy Howie's Beef Sausage 12"" 36ct",FBALYB Amazon,3,3,0,0,0,0
,Happy Howies beef/turkey/lamb,Happy Howies beef/turkey/lamb,Default,-28,-28,0,0,0,0
,Happy Howies beef/turkey/lamb,Happy Howies beef/turkey/lamb,FBALYB Amazon,6,6,0,0,0,0
,"Happy Howie's Beef Woof Stix 6"" 4ct 2pk","Happy Howie's Beef Woof Stix 6"" 4ct 2pk",FBALYB Amazon,-3,-3,0,1,0,0
,Happy Howies Lamb Roll 1lb,Happy Howies Lamb Roll 1lb,FBALYB Amazon,19,19,0,3,0,0
,Happy Howies Turkey Roll 2lb,Happy Howies Turkey Roll 2lb,Default,0,0,0,0,0,29
,Happy Howies Turkey Roll 2lb 2pk,Happy Howies Turkey Roll 2lb 2pk,FBALYB Amazon,78,78,0,1,0,0
,Happy Howies Turkey Roll 2lb 6pk,Happy Howies Turkey Roll 2lb 6pk,FBALYB Amazon,-2,-2,0,3,0,0
,"Happy Howies Turkey Sausage Bulk 4"" 80ct","Happy Howies Turkey Sausage Bulk 4"" 80ct",FBALYB Amazon,-1,-1,0,0,0,0
,"Happy Howies Turkey Sausage Dog 4"" 8oz","Happy Howies LAMB Sausage Dog 4"" 8oz",FBALYB Amazon,-1,-1,0,1,0,0
,"Happy Howies Woof Stix Bulk 11"" 46ct","Happy Howies Woof Stix Bulk 11"" 46ct",FBALYB Amazon,-77,-77,0,79,0,0
,"Happy Howies Woof Stix Bulk 6"" 80ct","Happy Howies Woof Stix Bulk 6"" 80ct",FBALYB Amazon,-2,-2,0,1,0,0
,Harman Kardon (Graphite),Harman Kardon Invoke with Cortana by Microsoft (Graphite),FBALYB Amazon,-1,-1,0,0,0,0
,Harmony Touch Remote Control,Harmony Touch Remote Control,FBALYB Amazon,-3,-3,0,0,0,0
,Harney and Sons Black Cask Bourbon Tea 4oz,Harney and Sons Black Cask Bourbon Tea 4oz,Default Ridgefield,60,60,0,0,0,0
,Harney and Sons Black Cask Bourbon Tea 4oz,Harney and Sons Black Cask Bourbon Tea 4oz,FBALYB Amazon,84,84,0,0,0,0
,Harney and Sons Blueberry Green Tea 20 Sachets,Harney and Sons Blueberry Green Tea 20 Sachets,FBALYB Amazon,2,1,1,0,1,0
,Harney and Sons Chamomile Tea 50 Sachets,Harney and Sons Chamomile Tea 50 Sachets,FBALYB Amazon,1,1,0,0,0,0
,Harney and Sons Darjeeling Tea 20 Sachets,Harney and Sons Darjeeling Tea 20 Sachets,FBALYB Amazon,44,42,2,0,2,0
,Harney and Sons Decaf Earl Grey Tea 50 Sachets,Harney and Sons Decaf Earl Grey Tea 50 Sachets,FBALYB Amazon,18,18,0,3,0,0
,Harney and Sons Decaffeinated Ceylon Tea 50 Sachets,Harney and Sons Decaffeinated Ceylon Tea 50 Sachets,Default Ridgefield,12,10,2,0,0,0
,Harney and Sons Decaffeinated Ceylon Tea 50 Sachets,Harney and Sons Decaffeinated Ceylon Tea 50 Sachets,FBALYB Amazon,1,1,0,0,0,0
,Harney and Sons Decaf Fruit Flavored Black Tea 30 Count,Harney and Sons Decaf Fruit Flavored Black Tea 30 Count,FBALYB Amazon,149,149,0,0,0,0
,Harney and Sons Earl Grey Imperial Black Tea 30 Sachets,Harney and Sons Earl Grey Imperial Black Tea 30 Sachets,FBALYB Amazon,166,124,42,0,42,0
,Harney and Sons Earl Grey Imperial Black Tea 30 Sachets 2 pack,Harney and Sons Earl Grey Imperial Black Tea 30 Sachets 2 pack,FBALYB Amazon,3,0,3,0,3,0
,Harney and Sons Ginger Tea with Lemon  30 Sachets,Harney and Sons Ginger Tea with Lemon  30 Sachets,Default Ridgefield,40,40,0,0,0,0
,"Harney and Sons Green Tea with Coconut, Ginger and Vanilla  30 Sachets","Harney and Sons Green Tea with Coconut, Ginger and Vanilla  30 Sachets",FBALYB Amazon,345,330,15,0,15,0
,"Harney and Sons Green Tea with Coconut, Ginger and Vanilla 30 Sachets 4PK","Harney and Sons Green Tea with Coconut, Ginger and Vanilla 30 Sachets 4PK",FBALYB Amazon,3,3,0,2,0,0
,Harney and Sons Green Tea with Coconut Tea 20 Sachets,Harney and Sons Green Tea with Coconut Tea 20 Sachets,Default Ridgefield,549,549,0,0,0,0
,Harney and Sons Green Tea with Coconut Tea 20 Sachets,Harney and Sons Green Tea with Coconut Tea 20 Sachets,FBALYB Amazon,57,57,0,40,0,0
,Harney and Sons Hot Cinnamon Spice Tea 30 Sachets,Harney and Sons Hot Cinnamon Spice Tea 30 Sachets,Default Ridgefield,4,4,0,0,0,0
,Harney and Sons Hot Cinnamon Spice Tea 30 Sachets,Harney and Sons Hot Cinnamon Spice Tea 30 Sachets,FBALYB Amazon,574,548,26,0,26,0
,Harney and Sons Hot Cinnamon Spice Tea 30 Sachets 2pk,Harney and Sons Hot Cinnamon Spice Tea 30 Sachets 2pk,FBALYB Amazon,392,382,10,1,10,0
,Harney and Sons Hot Cinnamon Spice Tea 30 Sachets 3 pack,Harney and Sons Hot Cinnamon Spice Tea 30 Sachets 3 pack,FBALYB Amazon,250,242,8,0,8,0
,Harney and Sons Hot Cinnamon Spice Tea 30 Sachets 4pk,Harney and Sons Hot Cinnamon Spice Tea 30 Sachets 4pk,FBALYB Amazon,363,354,9,20,9,0
,Harney and Sons Hot Cinnamon Sunset Tea 20 Count 2pk,Harney and Sons Hot Cinnamon Sunset Tea 20 Count 2pk,FBALYB Amazon,-75,-76,1,0,1,0
,Harney and Sons Hot Cinnamon Sunset Tea 20 Count 3pk,Harney and Sons Hot Cinnamon Sunset Tea 20 Count 3pk,FBALYB Amazon,2,1,1,0,1,0
,Harney and Sons Lemon Herbal Tea 50 Sachets,Harney and Sons Lemon Herbal Tea 50 Sachets,FBALYB Amazon,1,1,0,0,0,0
,Harney and Sons Organic Citron Green Tea 50 Sachets,Harney and Sons Organic Citron Green Tea 50 Sachets,FBALYB Amazon,37,36,1,0,1,0
,Harney and Sons Organic Peppermint Tea 50 Sachets,Harney and Sons Organic Peppermint Tea 50 Sachets,Default Ridgefield,2,2,0,0,0,0
,Harney and Sons Organic Peppermint Tea 50 Sachets,Harney and Sons Organic Peppermint Tea 50 Sachets,FBALYB Amazon,-1,-1,0,0,0,0
,Harney and Sons Paris Black Tea 16oz,Harney and Sons Paris Black Tea 16oz,Default,0,0,0,0,0,400
,Harney and Sons Paris Black Tea 16oz,Harney and Sons Paris Black Tea 16oz,Default Ridgefield,400,400,0,0,0,0
,Harney and Sons Paris Black Tea 16oz,Harney and Sons Paris Black Tea 16oz,FBALYB Amazon,279,279,0,0,0,0
,Harney and Sons Paris Black Tea 20 Sachets,Harney and Sons Paris Black Tea 20 Sachets,Default Ridgefield,1647,1647,0,0,0,0
,Harney and Sons Paris Black Tea 20 Sachets,Harney and Sons Paris Black Tea 20 Sachets,FBALYB Amazon,1528,1514,14,4,14,0
,Harney and Sons Paris Black Tea 20 Sachets,Harney and Sons Paris Black Tea 20 Sachets,FBALYB Canada,0,0,0,50,0,0
,Harney and Sons Paris Black Tea 20 Sachets 3 pack,Harney and Sons Paris Black Tea 20 Sachets 3 pack,FBALYB Amazon,187,182,5,0,5,0
,Harney and Sons Paris Black Tea 50 Sachets,Harney and Sons Paris Black Tea 50 Sachets,Default,0,0,0,0,0,10
,Harney and Sons Paris Black Tea 50 Sachets,Harney and Sons Paris Black Tea 50 Sachets,FBALYB Amazon,4,0,4,0,4,0
,Harney and Sons Paris Fruity Black Tea With Bergamot 50 Sachets,Harney and Sons Paris Fruity Black Tea With Bergamot 50 Sachets,Default Ridgefield,10,10,0,0,0,0
,Harney and Sons Paris Fruity Black Tea With Bergamot 50 Sachets 2PK,Harney and Sons Paris Fruity Black Tea With Bergamot 50 Sachets 2PK,FBALYB Amazon,145,143,2,0,2,0
,Harney and Sons Royal English Breakfast Tea 30 Sachets,Harney and Sons Royal English Breakfast Tea 30 Sachets,FBALYB Amazon,926,924,2,0,2,0
,Harney and Sons Royal English Breakfast Tea 30 Sachets 2pk,Harney and Sons Royal English Breakfast Tea 30 Sachets 2pk,FBALYB Amazon,4,1,3,0,3,0
,Harney and Sons SoHo Chocolate Coconut Black Tea 20 Sachets,Harney and Sons SoHo Chocolate Coconut Black Tea 20 Sachets,Default Ridgefield,1,1,0,0,0,0
,Harney and Sons SoHo Chocolate Coconut Black Tea 20 Sachets,Harney and Sons SoHo Chocolate Coconut Black Tea 20 Sachets,FBALYB Amazon,8,3,5,0,5,0
,Harney and Sons Victorian London Fog Tea 30 Sachets,Harney and Sons Victorian London Fog Tea 30 Sachets,Default Ridgefield,404,404,0,0,0,0
,Harney and Sons Victorian London Fog Tea 30 Sachets,Harney and Sons Victorian London Fog Tea 30 Sachets,FBALYB Amazon,578,556,22,0,22,0
,"Harvest Snaps Snapea Crisps, 20 oz.","Harvest Snaps Snapea Crisps, 20 oz.",Default,0,0,0,0,0,16
,Hasbro Family Fun Pack Conquest Edition for Xbox One,Hasbro Family Fun Pack Conquest Edition for Xbox One,FBALYB Amazon,-1,-1,0,0,0,0
,Hatchimals Colleggtibles Collector's Case,Hatchimals Colleggtibles Collector's Case ,FBALYB Amazon,2,2,0,2,0,0
,Hatchimals Colleggtibles Coral Castle Display Set,,FBALYB Amazon,-10,-10,0,0,0,0
,Hatchimals Game GML,,FBALYB Amazon,209,209,0,0,0,0
,Hatchimals Wow,,FBALYB Amazon,-2,-2,0,0,0,0
,Havaianas Slim Animal Sandals 4103352 Leapord Gray/Silver EU Size 35/36,Havaianas Slim Animal Sandals 4103352 Leapord Gray/Silver EU Size 35/36,Default,0,0,0,0,0,252
,Havaianas Slim Animal Sandals 4103352 Leapord Gray/Silver EU Size 35/36,Havaianas Slim Animal Sandals 4103352 Leapord Gray/Silver EU Size 35/36,Default Ridgefield,180,180,0,0,0,0
,Havaianas Slim Animal Sandals 4103352 Leapord Gray/Silver EU Size 37/38,Havaianas Slim Animal Sandals 4103352 Leapord Gray/Silver EU Size 37/38,Default,0,0,0,0,0,552
,Havaianas Slim Animal Sandals 4103352 Leapord Gray/Silver EU Size 37/38,Havaianas Slim Animal Sandals 4103352 Leapord Gray/Silver EU Size 37/38,Default Ridgefield,408,408,0,0,0,0
,Havaianas Slim Animal Sandals 4103352 Leapord Gray/Silver EU Size 39/40,Havaianas Slim Animal Sandals 4103352 Leapord Gray/Silver EU Size 39/40,Default,0,0,0,0,0,276
,Havaianas Slim Animal Sandals 4103352 Leapord Gray/Silver EU Size 39/40,Havaianas Slim Animal Sandals 4103352 Leapord Gray/Silver EU Size 39/40,Default Ridgefield,204,204,0,0,0,0
,Havaianas Slim Animal Sandals 4103352 Leapord Rose Gold EU Size 35/36,Havaianas Slim Animal Sandals 4103352 Leapord Rose Gold EU Size 35/36,Default,0,0,0,0,0,324
,Havaianas Slim Animal Sandals 4103352 Leapord Rose Gold EU Size 35/36,Havaianas Slim Animal Sandals 4103352 Leapord Rose Gold EU Size 35/36,Default Ridgefield,144,144,0,0,0,0
,Havaianas Slim Animal Sandals 4103352 Leapord Rose Gold EU Size 37/38,Havaianas Slim Animal Sandals 4103352 Leapord Rose Gold EU Size 37/38,Default,0,0,0,0,0,576
,Havaianas Slim Animal Sandals 4103352 Leapord Rose Gold EU Size 37/38,Havaianas Slim Animal Sandals 4103352 Leapord Rose Gold EU Size 37/38,Default Ridgefield,407,407,0,0,0,0
,Havaianas Slim Animal Sandals 4103352 Leapord Rose Gold EU Size 39/40,Havaianas Slim Animal Sandals 4103352 Leapord Rose Gold EU Size 39/40,Default,0,0,0,0,0,432
,Havaianas Slim Animal Sandals 4103352 Leapord Rose Gold EU Size 39/40,Havaianas Slim Animal Sandals 4103352 Leapord Rose Gold EU Size 39/40,Default Ridgefield,287,287,0,0,0,0
,Havaianas Slim Metalic Sandals 4135102 Black EU Size 35/36,Havaianas Slim Metalic Sandals 4135102 Black EU Size 35/36,Default,0,0,0,0,0,360
,Havaianas Slim Metalic Sandals 4135102 Black EU Size 35/36,Havaianas Slim Metalic Sandals 4135102 Black EU Size 35/36,Default Ridgefield,168,168,0,0,0,0
,Havaianas Slim Metalic Sandals 4135102 Black EU Size 37/38,Havaianas Slim Metalic Sandals 4135102 Black EU Size 37/38,Default,0,0,0,0,0,720
,Havaianas Slim Metalic Sandals 4135102 Black EU Size 37/38,Havaianas Slim Metalic Sandals 4135102 Black EU Size 37/38,Default Ridgefield,420,420,0,0,0,0
,Havaianas Slim Metalic Sandals 4135102 Black EU Size 39/40,Havaianas Slim Metalic Sandals 4135102 Black EU Size 39/40,Default,0,0,0,0,0,372
,Havaianas Slim Metalic Sandals 4135102 Black EU Size 39/40,Havaianas Slim Metalic Sandals 4135102 Black EU Size 39/40,Default Ridgefield,204,204,0,0,0,0
,Havaianas Slim Metalic Sandals 4135102 Sand Grey EU Size 35/36,Havaianas Slim Metalic Sandals 4135102 Sand Grey EU Size 35/36,Default,0,0,0,0,0,360
,Havaianas Slim Metalic Sandals 4135102 Sand Grey EU Size 35/36,Havaianas Slim Metalic Sandals 4135102 Sand Grey EU Size 35/36,Default Ridgefield,120,120,0,0,0,0
,Havaianas Slim Metalic Sandals 4135102 Sand Grey EU Size 37/38,Havaianas Slim Metalic Sandals 4135102 Sand Grey EU Size 37/38,Default,0,0,0,0,0,1056
,Havaianas Slim Metalic Sandals 4135102 Sand Grey EU Size 37/38,Havaianas Slim Metalic Sandals 4135102 Sand Grey EU Size 37/38,Default Ridgefield,504,504,0,0,0,0
,Havaianas Slim Metalic Sandals 4135102 Sand Grey EU Size 39/40,Havaianas Slim Metalic Sandals 4135102 Sand Grey EU Size 39/40,Default,0,0,0,0,0,372
,Havaianas Slim Metalic Sandals 4135102 Sand Grey EU Size 39/40,Havaianas Slim Metalic Sandals 4135102 Sand Grey EU Size 39/40,Default Ridgefield,204,204,0,0,0,0
,Havaianas Slim Metalic Sandals 4135102 Steel Grey EU Size 35/36,Havaianas Slim Metalic Sandals 4135102 Steel Grey EU Size 35/36,Default,0,0,0,0,0,300
,Havaianas Slim Metalic Sandals 4135102 Steel Grey EU Size 35/36,Havaianas Slim Metalic Sandals 4135102 Steel Grey EU Size 35/36,Default Ridgefield,180,180,0,0,0,0
,Havaianas Slim Metalic Sandals 4135102 Steel Grey EU Size 37/38,Havaianas Slim Metalic Sandals 4135102 Steel Grey EU Size 37/38,Default,0,0,0,0,0,816
,Havaianas Slim Metalic Sandals 4135102 Steel Grey EU Size 37/38,Havaianas Slim Metalic Sandals 4135102 Steel Grey EU Size 37/38,Default Ridgefield,408,408,0,0,0,0
,Havaianas Slim Metalic Sandals 4135102 Steel Grey EU Size 39/40,Havaianas Slim Metalic Sandals 4135102 Steel Grey EU Size 39/40,Default,0,0,0,0,0,276
,Havaianas Slim Metalic Sandals 4135102 Steel Grey EU Size 39/40,Havaianas Slim Metalic Sandals 4135102 Steel Grey EU Size 39/40,Default Ridgefield,204,204,0,0,0,0
,Havaianas Slim Sandals 4000030 Ballet Rose EU Size 35/36,Havaianas Slim Sandals 4000030 Ballet Rose EU Size 35/36,Default,0,0,0,0,0,1392
,Havaianas Slim Sandals 4000030 Ballet Rose EU Size 35/36,Havaianas Slim Sandals 4000030 Ballet Rose EU Size 35/36,Default Ridgefield,736,736,0,0,0,0
,Havaianas Slim Sandals 4000030 Ballet Rose EU Size 35/36,Havaianas Slim Sandals 4000030 Ballet Rose EU Size 35/36,FBALYB Amazon,226,225,1,0,1,0
,Havaianas Slim Sandals 4000030 Ballet Rose EU Size 37/38,Havaianas Slim Sandals 4000030 Ballet Rose EU Size 37/38,Default,0,0,0,0,0,4116
,Havaianas Slim Sandals 4000030 Ballet Rose EU Size 37/38,Havaianas Slim Sandals 4000030 Ballet Rose EU Size 37/38,Default Ridgefield,1799,1799,0,0,0,0
,Havaianas Slim Sandals 4000030 Ballet Rose EU Size 37/38,Havaianas Slim Sandals 4000030 Ballet Rose EU Size 37/38,FBALYB Amazon,387,384,3,0,3,0
,Havaianas Slim Sandals 4000030 Ballet Rose EU Size 39/40,Havaianas Slim Sandals 4000030 Ballet Rose EU Size 39/40,Default,0,0,0,0,0,2316
,Havaianas Slim Sandals 4000030 Ballet Rose EU Size 39/40,Havaianas Slim Sandals 4000030 Ballet Rose EU Size 39/40,Default Ridgefield,204,204,0,0,0,0
,Havaianas Slim Sandals 4000030 Ballet Rose EU Size 39/40,Havaianas Slim Sandals 4000030 Ballet Rose EU Size 39/40,FBALYB Amazon,204,203,1,25,1,0
,Havaianas Slim Sandals 4000030 Ballet Rose EU Size 41/42,Havaianas Slim Sandals 4000030 Ballet Rose EU Size 41/42,Default,0,0,0,0,0,228
,Havaianas Slim Sandals 4000030 Ballet Rose EU Size 41/42,Havaianas Slim Sandals 4000030 Ballet Rose EU Size 41/42,Default Ridgefield,36,36,0,0,0,0
,Havaianas Slim Sandals 4000030 Ballet Rose EU Size 41/42,Havaianas Slim Sandals 4000030 Ballet Rose EU Size 41/42,FBALYB Amazon,161,156,5,0,5,0
,Havaianas Slim Sandals 4000030 Black EU Size 35/36,Havaianas Slim Sandals 4000030 Black EU Size 35/36,Default,0,0,0,0,0,1848
,Havaianas Slim Sandals 4000030 Black EU Size 35/36,Havaianas Slim Sandals 4000030 Black EU Size 35/36,Default Ridgefield,667,667,0,0,0,0
,Havaianas Slim Sandals 4000030 Black EU Size 35/36,Havaianas Slim Sandals 4000030 Black EU Size 35/36,FBALYB Amazon,196,196,0,0,0,0
,Havaianas Slim Sandals 4000030 Black EU Size 37/38,Havaianas Slim Sandals 4000030 Black EU Size 37/38,Default,0,0,0,0,0,10008
,Havaianas Slim Sandals 4000030 Black EU Size 37/38,Havaianas Slim Sandals 4000030 Black EU Size 37/38,Default Ridgefield,4068,4068,0,0,0,0
,Havaianas Slim Sandals 4000030 Black EU Size 37/38,Havaianas Slim Sandals 4000030 Black EU Size 37/38,FBALYB Amazon,696,695,1,0,1,0
,Havaianas Slim Sandals 4000030 Black EU Size 39/40,Havaianas Slim Sandals 4000030 Black EU Size 39/40,Default,0,0,0,0,0,2976
,Havaianas Slim Sandals 4000030 Black EU Size 39/40,Havaianas Slim Sandals 4000030 Black EU Size 39/40,Default Ridgefield,1183,1183,0,0,0,0
,Havaianas Slim Sandals 4000030 Black EU Size 39/40,Havaianas Slim Sandals 4000030 Black EU Size 39/40,FBALYB Amazon,460,445,15,28,15,0
,Havaianas Slim Sandals 4000030 Navy EU Size 35/36,Havaianas Slim Sandals 4000030 Navy EU Size 35/36,Default,0,0,0,0,0,1224
,Havaianas Slim Sandals 4000030 Navy EU Size 35/36,Havaianas Slim Sandals 4000030 Navy EU Size 35/36,Default Ridgefield,864,864,0,0,0,0
,Havaianas Slim Sandals 4000030 Navy EU Size 37/38,Havaianas Slim Sandals 4000030 Navy EU Size 37/38,Default,0,0,0,0,0,2016
,Havaianas Slim Sandals 4000030 Navy EU Size 37/38,Havaianas Slim Sandals 4000030 Navy EU Size 37/38,Default Ridgefield,1368,1368,0,0,0,0
,Havaianas Slim Sandals 4000030 Navy EU Size 39/40,Havaianas Slim Sandals 4000030 Navy EU Size 39/40,Default,0,0,0,0,0,1536
,Havaianas Slim Sandals 4000030 Navy EU Size 39/40,Havaianas Slim Sandals 4000030 Navy EU Size 39/40,Default Ridgefield,1068,1068,0,0,0,0
,Havaianas Slim Sandals 4000030 Navy EU Size 41/42,Havaianas Slim Sandals 4000030 Navy EU Size 41/42,Default,0,0,0,0,0,312
,Havaianas Slim Sandals 4000030 Navy EU Size 41/42,Havaianas Slim Sandals 4000030 Navy EU Size 41/42,Default Ridgefield,288,288,0,0,0,0
,Havaianas Slim Sandals 4000030 Pink Flux EU Size 35/36,Havaianas Slim Sandals 4000030 Pink Flux EU Size 35/36,Default,0,0,0,0,0,1016
,Havaianas Slim Sandals 4000030 Pink Flux EU Size 35/36,Havaianas Slim Sandals 4000030 Pink Flux EU Size 35/36,Default Ridgefield,660,660,0,0,0,0
,Havaianas Slim Sandals 4000030 Pink Flux EU Size 37/38,Havaianas Slim Sandals 4000030 Pink Flux EU Size 37/38,Default,0,0,0,0,0,1308
,Havaianas Slim Sandals 4000030 Pink Flux EU Size 37/38,Havaianas Slim Sandals 4000030 Pink Flux EU Size 37/38,Default Ridgefield,1308,1308,0,0,0,0
,Havaianas Slim Sandals 4000030 Pink Flux EU Size 39/40,Havaianas Slim Sandals 4000030 Pink Flux EU Size 39/40,Default,0,0,0,0,0,1104
,Havaianas Slim Sandals 4000030 Pink Flux EU Size 39/40,Havaianas Slim Sandals 4000030 Pink Flux EU Size 39/40,Default Ridgefield,240,240,0,0,0,0
,Havaianas Slim Sandals 4000030 Rose Gold EU Size 35/36,Havaianas Slim Sandals 4000030 Rose Gold EU Size 35/36,Default,0,0,0,0,0,960
,Havaianas Slim Sandals 4000030 Rose Gold EU Size 35/36,Havaianas Slim Sandals 4000030 Rose Gold EU Size 35/36,Default Ridgefield,648,648,0,0,0,0
,Havaianas Slim Sandals 4000030 Rose Gold EU Size 37/38,Havaianas Slim Sandals 4000030 Rose Gold EU Size 37/38,Default,0,0,0,0,0,1644
,Havaianas Slim Sandals 4000030 Rose Gold EU Size 37/38,Havaianas Slim Sandals 4000030 Rose Gold EU Size 37/38,Default Ridgefield,1092,1092,0,0,0,0
,Havaianas Slim Sandals 4000030 Rose Gold EU Size 39/40,Havaianas Slim Sandals 4000030 Rose Gold EU Size 39/40,Default,0,0,0,0,0,1116
,Havaianas Slim Sandals 4000030 Rose Gold EU Size 39/40,Havaianas Slim Sandals 4000030 Rose Gold EU Size 39/40,Default Ridgefield,648,648,0,0,0,0
,Havaianas Slim Sandals 4000030 Sand Grey EU Size 35/36,Havaianas Slim Sandals 4000030 Sand Grey EU Size 35/36,Default,0,0,0,0,0,1056
,Havaianas Slim Sandals 4000030 Sand Grey EU Size 35/36,Havaianas Slim Sandals 4000030 Sand Grey EU Size 35/36,Default Ridgefield,460,460,0,0,0,0
,Havaianas Slim Sandals 4000030 Sand Grey EU Size 35/36,Havaianas Slim Sandals 4000030 Sand Grey EU Size 35/36,FBALYB Amazon,240,239,1,0,1,0
,Havaianas Slim Sandals 4000030 Sand Grey EU Size 37/38,Havaianas Slim Sandals 4000030 Sand Grey EU Size 37/38,Default,0,0,0,0,0,2618
,Havaianas Slim Sandals 4000030 Sand Grey EU Size 37/38,Havaianas Slim Sandals 4000030 Sand Grey EU Size 37/38,Default Ridgefield,2,2,0,0,0,0
,Havaianas Slim Sandals 4000030 Sand Grey EU Size 37/38,Havaianas Slim Sandals 4000030 Sand Grey EU Size 37/38,FBALYB Amazon,375,371,4,0,4,0
,Havaianas Slim Sandals 4000030 Sand Grey EU Size 39/40,Havaianas Slim Sandals 4000030 Sand Grey EU Size 39/40,Default,0,0,0,0,0,1500
,Havaianas Slim Sandals 4000030 Sand Grey EU Size 39/40,Havaianas Slim Sandals 4000030 Sand Grey EU Size 39/40,Default Ridgefield,936,936,0,0,0,0
,Havaianas Slim Sandals 4000030 Sand Grey EU Size 41/42,Havaianas Slim Sandals 4000030 Sand Grey EU Size 41/42,Default,0,0,0,0,0,48
,Havaianas Slim Sandals 4000030 White EU Size 35/36,Havaianas Slim Sandals 4000030 White EU Size 35/36,Default,0,0,0,0,0,1052
,Havaianas Slim Sandals 4000030 White EU Size 35/36,Havaianas Slim Sandals 4000030 White EU Size 35/36,Default Ridgefield,664,664,0,0,0,0
,Havaianas Slim Sandals 4000030 White EU Size 37/38,Havaianas Slim Sandals 4000030 White EU Size 37/38,Default,0,0,0,0,0,2400
,Havaianas Slim Sandals 4000030 White EU Size 37/38,Havaianas Slim Sandals 4000030 White EU Size 37/38,Default Ridgefield,864,864,0,0,0,0
,Havaianas Slim Sandals 4000030 White EU Size 39/40,Havaianas Slim Sandals 4000030 White EU Size 39/40,Default,0,0,0,0,0,1152
,Havaianas Slim Sandals 4000030 White EU Size 39/40,Havaianas Slim Sandals 4000030 White EU Size 39/40,Default Ridgefield,732,732,0,0,0,0
,Havaiana top sandals 4000029 Ballet Rose EU Size 35/36,Havaiana top sandals 4000029 Ballet Rose EU Size 35/36,Default,0,0,0,0,0,408
,Havaiana top sandals 4000029 Ballet Rose EU Size 35/36,Havaiana top sandals 4000029 Ballet Rose EU Size 35/36,Default Ridgefield,96,96,0,0,0,0
,Havaiana top sandals 4000029 Ballet Rose EU Size 37/38,Havaiana top sandals 4000029 Ballet Rose EU Size 37/38,Default,0,0,0,0,0,816
,Havaiana top sandals 4000029 Ballet Rose EU Size 37/38,Havaiana top sandals 4000029 Ballet Rose EU Size 37/38,Default Ridgefield,168,168,0,0,0,0
,Havaiana top sandals 4000029 Ballet Rose EU Size 39/40,Havaiana top sandals 4000029 Ballet Rose EU Size 39/40,Default,0,0,0,0,0,600
,Havaiana top sandals 4000029 Ballet Rose EU Size 39/40,Havaiana top sandals 4000029 Ballet Rose EU Size 39/40,Default Ridgefield,155,155,0,0,0,0
,Havaiana top sandals 4000029 Black EU Size 35/36,Havaiana top sandals 4000029 Black EU Size 35/36,Default,0,0,0,0,0,1104
,Havaiana top sandals 4000029 Black EU Size 35/36,Havaiana top sandals 4000029 Black EU Size 35/36,Default Ridgefield,552,552,0,0,0,0
,Havaiana top sandals 4000029 Black EU Size 37/38,Havaiana top sandals 4000029 Black EU Size 37/38,Default,0,0,0,0,0,3588
,Havaiana top sandals 4000029 Black EU Size 37/38,Havaiana top sandals 4000029 Black EU Size 37/38,Default Ridgefield,2588,2588,0,0,0,0
,Havaiana top sandals 4000029 Black EU Size 37/38,Havaiana top sandals 4000029 Black EU Size 37/38,FBALYB Amazon,874,861,13,1,13,0
,Havaiana top sandals 4000029 Black EU Size 39/40,Havaiana top sandals 4000029 Black EU Size 39/40,Default,0,0,0,0,0,1692
,Havaiana top sandals 4000029 Black EU Size 39/40,Havaiana top sandals 4000029 Black EU Size 39/40,Default Ridgefield,1464,1464,0,0,0,0
,Havaiana top sandals 4000029 Black EU Size 41/42,Havaiana top sandals 4000029 Black EU Size 41/42,Default,0,0,0,0,0,1116
,Havaiana top sandals 4000029 Black EU Size 41/42,Havaiana top sandals 4000029 Black EU Size 41/42,Default Ridgefield,564,564,0,0,0,0
,Havaiana top sandals 4000029 Black EU Size 43/44,Havaiana top sandals 4000029 Black EU Size 43/44,Default,0,0,0,0,0,384
,Havaiana top sandals 4000029 Black EU Size 43/44,Havaiana top sandals 4000029 Black EU Size 43/44,Default Ridgefield,239,239,0,0,0,0
,Havaiana top sandals 4000029 Black EU Size 45/46,Havaiana top sandals 4000029 Black EU Size 45/46,Default,0,0,0,0,0,60
,Havaiana top sandals 4000029 Black EU Size 45/46,Havaiana top sandals 4000029 Black EU Size 45/46,Default Ridgefield,48,48,0,0,0,0
,Havaiana top sandals 4000029 Marine Blue EU Size 35/36,Havaiana top sandals 4000029 Marine Blue EU Size 35/36,Default,0,0,0,0,0,300
,Havaiana top sandals 4000029 Marine Blue EU Size 35/36,Havaiana top sandals 4000029 Marine Blue EU Size 35/36,Default Ridgefield,204,204,0,0,0,0
,Havaiana top sandals 4000029 Marine Blue EU Size 37/38,Havaiana top sandals 4000029 Marine Blue EU Size 37/38,Default,0,0,0,0,0,504
,Havaiana top sandals 4000029 Marine Blue EU Size 37/38,Havaiana top sandals 4000029 Marine Blue EU Size 37/38,Default Ridgefield,96,96,0,0,0,0
,Havaiana top sandals 4000029 Marine Blue EU Size 39/40,Havaiana top sandals 4000029 Marine Blue EU Size 39/40,Default,0,0,0,0,0,696
,Havaiana top sandals 4000029 Marine Blue EU Size 41/42,Havaiana top sandals 4000029 Marine Blue EU Size 41/42,Default,0,0,0,0,0,792
,Havaiana top sandals 4000029 Marine Blue EU Size 41/42,Havaiana top sandals 4000029 Marine Blue EU Size 41/42,Default Ridgefield,384,384,0,0,0,0
,Havaiana top sandals 4000029 Marine Blue EU Size 43/44,Havaiana top sandals 4000029 Marine Blue EU Size 43/44,Default,0,0,0,0,0,732
,Havaiana top sandals 4000029 Marine Blue EU Size 43/44,Havaiana top sandals 4000029 Marine Blue EU Size 43/44,Default Ridgefield,408,408,0,0,0,0
,Havaiana top sandals 4000029 Marine Blue EU Size 45/46,Havaiana top sandals 4000029 Marine Blue EU Size 45/46,Default,0,0,0,0,0,156
,Havaiana top sandals 4000029 Marine Blue EU Size 45/46,Havaiana top sandals 4000029 Marine Blue EU Size 45/46,Default Ridgefield,84,84,0,0,0,0
,Havaiana top sandals 4000029 Navy EU Size 35/36,Havaiana top sandals 4000029 Navy EU Size 35/36,Default,0,0,0,0,0,1128
,Havaiana top sandals 4000029 Navy EU Size 35/36,Havaiana top sandals 4000029 Navy EU Size 35/36,Default Ridgefield,324,324,0,0,0,0
,Havaiana top sandals 4000029 Navy EU Size 37/38,Havaiana top sandals 4000029 Navy EU Size 37/38,Default,0,0,0,0,0,5916
,Havaiana top sandals 4000029 Navy EU Size 37/38,Havaiana top sandals 4000029 Navy EU Size 37/38,Default Ridgefield,1176,1176,0,0,0,0
,Havaiana top sandals 4000029 Navy EU Size 39/40,Havaiana top sandals 4000029 Navy EU Size 39/40,Default,0,0,0,0,0,2904
,Havaiana top sandals 4000029 Navy EU Size 39/40,Havaiana top sandals 4000029 Navy EU Size 39/40,Default Ridgefield,24,24,0,0,0,0
,Havaiana top sandals 4000029 Navy EU Size 41/42,Havaiana top sandals 4000029 Navy EU Size 41/42,Default,0,0,0,0,0,1128
,Havaiana top sandals 4000029 Navy EU Size 43/34,Havaiana top sandals 4000029 Navy EU Size 43/34,Default,0,0,0,0,0,576
,Havaiana top sandals 4000029 Navy EU Size 45/46,Havaiana top sandals 4000029 Navy EU Size 45/46,Default,0,0,0,0,0,120
,Havaiana top sandals 4000029 Pink EU Size 35/36,Havaiana top sandals 4000029 Pink EU Size 35/36,Default,0,0,0,0,0,396
,Havaiana top sandals 4000029 Pink EU Size 35/36,Havaiana top sandals 4000029 Pink EU Size 35/36,Default Ridgefield,108,108,0,0,0,0
,Havaiana top sandals 4000029 Pink EU Size 37/38,Havaiana top sandals 4000029 Pink EU Size 37/38,Default,0,0,0,0,0,768
,Havaiana top sandals 4000029 Pink EU Size 37/38,Havaiana top sandals 4000029 Pink EU Size 37/38,Default Ridgefield,408,408,0,0,0,0
,Havaiana top sandals 4000029 Pink EU Size 39/40,Havaiana top sandals 4000029 Pink EU Size 39/40,Default,0,0,0,0,0,600
,Havaiana top sandals 4000029 Pink EU Size 39/40,Havaiana top sandals 4000029 Pink EU Size 39/40,Default Ridgefield,300,300,0,0,0,0
,Havaiana top sandals 4000029 Rose Gold EU Size 35/36,Havaiana top sandals 4000029 Rose Gold EU Size 35/36,Default,0,0,0,0,0,408
,Havaiana top sandals 4000029 Rose Gold EU Size 35/36,Havaiana top sandals 4000029 Rose Gold EU Size 35/36,Default Ridgefield,108,108,0,0,0,0
,Havaiana top sandals 4000029 Rose Gold EU Size 37/38,Havaiana top sandals 4000029 Rose Gold EU Size 37/38,Default,0,0,0,0,0,816
,Havaiana top sandals 4000029 Rose Gold EU Size 37/38,Havaiana top sandals 4000029 Rose Gold EU Size 37/38,Default Ridgefield,12,12,0,0,0,0
,Havaiana top sandals 4000029 Rose Gold EU Size 39/40,Havaiana top sandals 4000029 Rose Gold EU Size 39/40,Default,0,0,0,0,0,408
,Havaiana top sandals 4000029 Rose Gold EU Size 39/40,Havaiana top sandals 4000029 Rose Gold EU Size 39/40,Default Ridgefield,132,132,0,0,0,0
,Havaiana top sandals 4000029 White EU Size 35/36,Havaiana top sandals 4000029 White EU Size 35/36,Default,0,0,0,0,0,540
,Havaiana top sandals 4000029 White EU Size 35/36,Havaiana top sandals 4000029 White EU Size 35/36,Default Ridgefield,180,180,0,0,0,0
,Havaiana top sandals 4000029 White EU Size 37/38,Havaiana top sandals 4000029 White EU Size 37/38,Default,0,0,0,0,0,1872
,Havaiana top sandals 4000029 White EU Size 37/38,Havaiana top sandals 4000029 White EU Size 37/38,Default Ridgefield,563,563,0,0,0,0
,Havaiana top sandals 4000029 White EU Size 39/40,Havaiana top sandals 4000029 White EU Size 39/40,Default,0,0,0,0,0,1284
,Havaiana top sandals 4000029 White EU Size 39/40,Havaiana top sandals 4000029 White EU Size 39/40,Default Ridgefield,648,648,0,0,0,0
,Havaiana top sandals 4000029 White EU Size 41/42,Havaiana top sandals 4000029 White EU Size 41/42,Default,0,0,0,0,0,72
,Havaiana top sandals 4000029 White EU Size 41/42,Havaiana top sandals 4000029 White EU Size 41/42,Default Ridgefield,48,48,0,0,0,0
,Havaiana top sandals 4000029 White EU Size 43/44,Havaiana top sandals 4000029 White EU Size 43/44,Default,0,0,0,0,0,852
,Havaiana top sandals 4000029 White EU Size 43/44,Havaiana top sandals 4000029 White EU Size 43/44,Default Ridgefield,396,396,0,0,0,0
,Havaiana top sandals 4000029 White EU Size 45/46,Havaiana top sandals 4000029 White EU Size 45/46,Default,0,0,0,0,0,204
,Havaiana top sandals 4000029 White EU Size 45/46,Havaiana top sandals 4000029 White EU Size 45/46,Default Ridgefield,60,60,0,0,0,0
,HBO flip 2 black,JBL Flip 2 Portable Wireless Speaker (Black),FBALYB Amazon,-1,-1,0,0,0,0
,HD-9LFD-E3M9,"Tootsie Roll Pops, Assorted (100-Count Pops), 60-Ounce Box",FBALYB Amazon,-1,-1,0,0,0,0
,"Head Junior Ski Glove (L, Black)","Head Junior Ski Glove (L, Black)",FBALYB Amazon,-3,-3,0,24,0,0
,"Head Junior Ski Glove (L, Purple)","Head Junior Ski Glove (L, Purple)",FBALYB Amazon,-1,-1,0,0,0,0
,"Head Junior Ski Glove (M, Black)","Head Junior Ski Glove (M, Black)",FBALYB Amazon,-4,-4,0,0,0,0
,"Head Junior Ski Glove (M, Purple)","Head Junior Ski Glove (M, Purple)",FBALYB Amazon,-2,-2,0,0,0,0
,"Head Junior Ski Glove (XL, Black)","Head Junior Ski Glove (XL, Black)",FBALYB Amazon,-2,-2,0,0,0,0
,"Head Junior Ski Glove (XL, Purple)","Head Junior Ski Glove (XL, Purple)",FBALYB Amazon,-1,-1,0,0,0,0
,"Head Junior Ski Mitten (S, Purple)","Head Junior Ski Mitten (S, Purple)",FBALYB Amazon,-3,-3,0,0,0,0
,"Head Junior Ski Mitten (XS, Black/Grey)","Head Junior Ski Mitten (XS, Black/Grey)",FBALYB Amazon,-1,-1,0,0,0,0
,"Head Junior Ski Mitten (XS, Purple)","Head Junior Ski Mitten (XS, Purple)",Default,0,0,0,0,0,24
,"Head Junior Ski Mitten (XXS, Black/Grey)","Head Junior Ski Mitten (XXS, Black/Grey)",FBALYB Amazon,-2,-2,0,0,0,0
,"Head Junior Ski Mitten (XXS, Purple)","Head Junior Ski Mitten (XXS, Purple)",FBALYB Amazon,28,28,0,0,0,0
,Head MENS UltraFit Touchscreen SENSATEC TOUCH SCREEN Running Gloves BLACK XL,Head MENS UltraFit Touchscreen SENSATEC TOUCH SCREEN Running Gloves BLACK XL,FBALYB Amazon,-3,-3,0,0,0,0
,Head Sensatec Black Extra Small Gloves,Head Sensatec Black Extra Small Gloves,FBALYB Amazon,-4,-4,0,0,0,0
,Head Sensatec Black Small Gloves,Head Sensatec Black Small Gloves,Default,1,1,0,0,0,0
,Head Sensatec Black Small Gloves,Head Sensatec Black Small Gloves,FBALYB Amazon,-3,-3,0,2,0,0
,Head Shoulders 2 in 1 40 oz,Head Shoulders 2 in 1 40 oz,FBALYB Amazon,2,1,1,0,1,0
,Head & Shoulders Classic Clean Shampoo 2 x 950ml,Head & Shoulders Classic Clean Shampoo 2 x 950ml,Avrami - Ebay,469,469,0,0,0,0
,Head & Shoulders Classic Clean Shampoo 2 x 950ml,Head & Shoulders Classic Clean Shampoo 2 x 950ml,Default Oxford,15,15,0,0,0,0
,Head & Shoulders Classic Clean Shampoo 2 x 950ml,Head & Shoulders Classic Clean Shampoo 2 x 950ml,Default Ridgefield,2,2,0,0,0,0
,Head & Shoulders Classic Clean Shampoo 2 x 950ml,Head & Shoulders Classic Clean Shampoo 2 x 950ml,FBALYB Amazon,-308,-313,5,408,5,0
,Head & Shoulders Classic Clean Shampoo 2 x 950ml,Head & Shoulders Classic Clean Shampoo 2 x 950ml,WFS,-461,-461,0,0,0,0
,Head & Shoulders Classic Clean Shampoo 4 x 950ml,Head & Shoulders Classic Clean Shampoo 4 x 950ml,FBALYB Amazon,89,89,0,0,0,0
,Head Touchscreen Gloves L Black,Head Touchscreen Gloves L Black,FBALYB Amazon,-6,-6,0,0,0,0
,Head Touchscreen Gloves L Pink,Head Touchscreen Gloves L Pink,FBALYB Amazon,-1,-1,0,0,0,0
,Head Touchscreen Gloves M Black,Head Touchscreen Gloves M Black,Default,0,0,0,0,0,1
,Head Touchscreen Gloves M Black,Head Touchscreen Gloves M Black,FBALYB Amazon,-7,-7,0,0,0,0
,Head Touchscreen Gloves M Pink,Head Touchscreen Gloves M Pink,FBALYB Amazon,-4,-4,0,0,0,0
,Head Touchscreen Gloves S Black,Head Touchscreen Gloves S Black,FBALYB Amazon,-8,-8,0,0,0,0
,Head Touchscreen Gloves S Pink,Head Touchscreen Gloves S Pink,FBALYB Amazon,-5,-5,0,0,0,0
,Head Touchscreen Gloves XS Silver,Head Touchscreen Gloves XS Silver,Default Ridgefield,91,91,0,0,0,0
,Head Touchscreen Gloves XS Silver,Head Touchscreen Gloves XS Silver,FBALYB Amazon,95,95,0,0,0,0
,Health Extension Allergix Dog Food 4lb,Health Extension Allergix Dog Food 4lb,FBALYB Amazon,16,16,0,1,0,0
,Health Extension Buffalo/whitefish 10lb,Health Extension Buffalo/whitefish 10lb,Default,0,0,0,0,0,1
,Health Extension Buffalo/whitefish 10lb,Health Extension Buffalo/whitefish 10lb,FBALYB Amazon,-1,-1,0,0,0,0
,Health Extension Chicken/Turkey 10lb,Health Extension Chicken/Turkey 10lb,FBALYB Amazon,169,168,1,0,1,0
,Health Extension Lamb/BRice 30lb,Health Extension Lamb/BRice 30lb,Default,0,0,0,0,0,1
,Health Extension Lil Bites 10lb,Health Extension Lil Bites 10lb,FBALYB Amazon,-12,-13,1,99,1,0
,Health Extension Lil Bites 18lb,Health Extension Lil Bites 18lb,FBALYB Amazon,6,6,0,0,0,0
,Health Extension Lil Bites 4lb,Health Extension Lil Bites 4lb,FBALYB Amazon,1,1,0,0,0,0
,Health Extension Lite 15lb,Health Extension Lite 15lb,FBALYB Amazon,23,23,0,0,0,0
,"Health Extension Lite Little Bites, 4lb","Health Extension Lite Little Bites, 4lb",Default,1,1,0,0,0,0
,"Health Extension Lite Little Bites, 4lb","Health Extension Lite Little Bites, 4lb",FBALYB Amazon,-2,-2,0,1,0,0
,Health Extension little bite Buffalo/Whitefish 10lb,Health Extension little bite Buffalo/Whitefish 10lb,FBALYB Amazon,26,26,0,57,0,0
,Health Extension Original Chicken 4lb,Health Extension Original Chicken 4lb,FBALYB Amazon,1,1,0,0,0,0
,Healthy DeodorantVanillaCoconut 2oz 2pk,Healthy DeodorantVanillaCoconut 2oz 2pk,FBALYB Amazon,1,1,0,0,0,0
,Healthy Deodorant Vanilla Lavender 2pk,Healthy Deodorant Vanilla Lavender 2pk,FBALYB Amazon,-1,-1,0,0,0,0
,Hear Doggy Toy,Hear Doggy Toy,Default Ridgefield,234,234,0,0,0,0
,Hear Doggy Toy,Hear Doggy Toy,FBAFBA LYB AUSTRALIA,0,0,0,28,0,0
,Hear Doggy Toy,Hear Doggy Toy,FBALYB Amazon,569,568,1,0,1,0
,Hear Doggy Toy,Hear Doggy Toy,FBALYB Canada,16,16,0,0,0,0
,Hear Doggy Toy 3PK,Hear Doggy Toy 3PK,FBALYB Amazon,16,16,0,0,0,0
,HEART TO HEART CHAMPAGNE PAY 3 GET 4,HEART TO HEART CHAMPAGNE PAY 3 GET 4,Default Ridgefield,44,44,0,0,0,0
,HEART TO HEART RIESLING,HEART TO HEART RIESLING,Default Ridgefield,107,107,0,0,0,0
,HEART TO HEART RIESLING,HEART TO HEART RIESLING,FBALYB Amazon,44,44,0,0,0,0
,Heated Blanket Red,Heated Blanket Red,FBALYB Amazon,-1,-1,0,0,0,0
,Heat Kids Thermal Set Large Black,Heat Kids Thermal Set Large Black,FBALYB Amazon,-26,-26,0,0,0,0
,Heat Kids Thermal Set Large Fig,Heat Kids Thermal Set Large Fig,FBALYB Amazon,-1,-1,0,0,0,0
,Heat Kids Thermal Set Large Snowflake,Heat Kids Thermal Set Large Snowflake,FBALYB Amazon,1,1,0,0,0,0
,Heat Kids Thermal Set Medium Black,Heat Kids Thermal Set Medium Black,FBALYB Amazon,-18,-18,0,0,0,0
,Heat Kids Thermal Set Medium Charcoal,Heat Kids Thermal Set Medium Charcoal,FBALYB Amazon,-3,-3,0,0,0,0
,Heat Kids Thermal Set Medium Navy,Heat Kids Thermal Set Medium Navy,FBALYB Amazon,-2,-2,0,0,0,0
,Heat Kids Thermal Set Medium Purple,Heat Kids Thermal Set Medium Fig,FBALYB Amazon,-9,-9,0,0,0,0
,Heat Kids Thermal Set Small Black,Heat Kids Thermal Set Small Black,Default,0,0,0,0,0,2
,Heat Kids Thermal Set Small Black,Heat Kids Thermal Set Small Black,FBALYB Amazon,-7,-7,0,1,0,0
,Heat Kids Thermal Set Small Charcoal,Heat Kids Thermal Set Small Charcoal,FBALYB Amazon,-4,-4,0,0,0,0
,Heat Kids Thermal Set Small Fig,Heat Kids Thermal Set Small Fig ,FBALYB Amazon,-1,-1,0,0,0,0
,Heat Kids Thermal Set Small Navy,Heat Kids Thermal Set Small Navy ,FBALYB Amazon,-1,-1,0,0,0,0
,Heat Kids Thermal Set X-Large Black,Heat Kids Thermal Set X-Large Black,Default,0,0,0,0,0,1
,Heat Kids Thermal Set X-Large Black,Heat Kids Thermal Set X-Large Black,Default Ridgefield,241,241,0,0,0,0
,Heat Kids Thermal Set X-Large Black,Heat Kids Thermal Set X-Large Black,FBALYB Amazon,382,382,0,0,0,0
,Heat Kids Thermal Set X-Large Fig,Heat Kids Thermal Set X-Large Fig,FBALYB Amazon,-2,-2,0,0,0,0
,Heat Kids Thermal Set X-Large Vanilla Snowflake,Heat Kids Thermal Set X-Large Vanilla Snowflake,FBALYB Amazon,13,13,0,0,0,0
,Heat Kids Thermal Set X-Small Navy,Heat Kids Thermal Set X-Small Navy ,Default,0,-1,1,0,0,0
,Heat Mens Thermal Pant Medium Black,Heat Mens Thermal Pant Medium Black,FBALYB Amazon,-5,-5,0,0,0,0
,Heat Mens Thermal Pant Small Black,Heat Mens Thermal Pant Small Black,FBALYB Amazon,35,35,0,0,0,0
,Heat Women's Base Shirt Frozen Snowflake Small,Heat Women's Base Shirt Frozen Snowflake Small,FBALYB Amazon,-5,-5,0,0,0,0
,Heat Women's Small Heather Stone,Heat Women's Small Heather Stone,FBALYB Amazon,-1,-1,0,0,0,0
,Heavenly Hunks Organic Dark Chocolate Oatmeal 22 Oz,Heavenly Hunks Organic Dark Chocolate Oatmeal 22 Oz,FBALYB Amazon,7,7,0,0,0,0
,Heinz Baked Beans 4pk,Heinz Baked Beans 4pk,FBALYB Amazon,1,1,0,0,0,0
,Heinz Baked Beans 6pk,Heinz Baked Beans 6pk,FBALYB Amazon,96,94,2,8,2,0
,Heinz Baked With Tomato Sauce 12pk,Heinz Baked With Tomato Sauce 12pk,FBALYB Amazon,270,270,0,88,0,0
,Helicocare Color Gelcr (L) 50ml,Helicocare Color Gelcr (L) 50ml,Default Ridgefield,250,250,0,0,0,0
,Helicocare Color Gelcr (L) 50ml,Helicocare Color Gelcr (L) 50ml,FBALYB Amazon,-1,-1,0,0,0,0
,Heliocare 360 Fluidcream Spf50+ 50ml,Heliocare 360 Fluidcream Spf50+ 50ml,Default Ridgefield,61,61,0,0,0,0
,Heliocare 360 Fluidcream Spf50+ 50ml,Heliocare 360 Fluidcream Spf50+ 50ml,FBALYB Amazon,-5,-5,0,2,0,0
,Heliocare 360 Gel Oil-Free Spf50 50ml,Heliocare 360 Gel Oil-Free Spf50 50ml,FBALYB Amazon,620,602,18,0,18,0
,Heliocare 360 Mineral Spf50+ 50ml,Heliocare 360 Mineral Spf50+ 50ml,Default Ridgefield,250,250,0,0,0,0
,Heliocare 360 Mineral Spf50+ 50ml,Heliocare 360 Mineral Spf50+ 50ml,FBALYB Amazon,-245,-245,0,0,0,0
,Heliocare - Comp Spf 50L 10G,Heliocare - Comp Spf 50L 10G,Default Ridgefield,414,414,0,0,0,0
,Heliocare - Comp Spf 50L 10G,Heliocare - Comp Spf 50L 10G,FBALYB Amazon,-14,-14,0,9,0,0
,Heliocare Ultra Crema Spf90 50ml,Heliocare Ultra Crema Spf90 50ml,Default Ridgefield,100,100,0,0,0,0
,Heliocare Ultra Crema Spf90 50ml,Heliocare Ultra Crema Spf90 50ml,FBALYB Amazon,-1,-1,0,0,0,0
,Heliocare Ultra Gel Spf90 50ml,Heliocare Ultra Gel Spf90 50ml,FBALYB Amazon,244,244,0,0,0,0
,Hello Kitty 5 Figure Set,Hello Kitty 5 Figure Set,FBALYB Amazon,-1,-1,0,1,0,0
,Hello Kitty Stationery Set,Hello Kitty Super Cute Mini Stationery Set,FBALYB Amazon,-6,-6,0,0,0,0
,Hello Panda Cookies Jumbo Box,Hello Panda Chocolate Filled Cookies Jumbo Box,Default,0,0,0,0,0,28
,Hello Panda Cookies Jumbo Box,Hello Panda Chocolate Filled Cookies Jumbo Box,Default Ridgefield,8,8,0,0,0,0
,Hello Panda Cookies Jumbo Box,Hello Panda Chocolate Filled Cookies Jumbo Box,FBALYB Amazon,2,1,1,0,1,0
,Hello Panda Cookies Jumbo Box,Hello Panda Chocolate Filled Cookies Jumbo Box,FBALYB Canada,11,11,0,0,0,0
,Helly Hansen Men's Alpha 3.0 Jacket Black Size L 65551-990,Helly Hansen Men's Alpha 3.0 Jacket Black Size L 65551-990,FBALYB Amazon,16,15,1,0,1,0
,Helly Hansen Men's Alpha 3.0 Jacket Black Size XL 65551-990,Helly Hansen Men's Alpha 3.0 Jacket Black Size XL 65551-990,FBALYB Amazon,66,66,0,0,0,0
,Helly Hansen Men's Crew Hooded Jacket Black Size XL 33875-990,Helly Hansen Men's Crew Hooded Jacket Black Size XL 33875-990,FBALYB Amazon,5,4,1,0,1,0
,Helly Hansen Men's Crew Hooded Jacket Black Size XXL 33875-990,Helly Hansen Men's Crew Hooded Jacket Black Size XXL 33875-990,FBALYB Amazon,5,5,0,0,0,0
,Helly Hansen Men's Crew Jacket Black Size L 30263-990,Helly Hansen Men's Crew Jacket Black Size L 30263-990,Default Ridgefield,4,4,0,0,0,0
,Helly Hansen Men's Crew Jacket Black Size L 30263-990,Helly Hansen Men's Crew Jacket Black Size L 30263-990,FBALYB Amazon,50,50,0,0,0,0
,Helly Hansen Men's Crew Jacket Navy Size L 30263-597,Helly Hansen Men's Crew Jacket Navy Size L 30263-597,FBALYB Amazon,74,74,0,0,0,0
,Helly Hansen Men's Crew Jacket Navy Size XL 30263-597,Helly Hansen Men's Crew Jacket Navy Size XL 30263-597,FBALYB Amazon,60,59,1,0,1,0
,Helly Hansen Men's Crew Midlayer Jacket Black Size L 30253-990,Helly Hansen Men's Crew Midlayer Jacket Black Size L 30253-990,FBALYB Amazon,-9,-9,0,0,0,0
,Helly Hansen Men's Crew Midlayer Jacket Black Size XL 30253-990,Helly Hansen Men's Crew Midlayer Jacket Black Size XL 30253-990,Default Ridgefield,4,4,0,0,0,0
,Helly Hansen Men's Crew Midlayer Jacket Black Size XL 30253-990,Helly Hansen Men's Crew Midlayer Jacket Black Size XL 30253-990,FBALYB Amazon,-5,-5,0,0,0,0
,Helly Hansen Men's Crew Midlayer Jacket Navy Size L 30253-597,Helly Hansen Men's Crew Midlayer Jacket Navy Size L 30253-597,FBALYB Amazon,-9,-9,0,0,0,0
,Helly Hansen Men's Daybreaker Fleece Jacket Black Size XL 51598-990,Helly Hansen Men's Daybreaker Fleece Jacket Black Size XL 51598-990,Default Ridgefield,2,2,0,0,0,0
,Helly Hansen Men's Daybreaker Fleece Jacket Black Size XL 51598-990,Helly Hansen Men's Daybreaker Fleece Jacket Black Size XL 51598-990,FBALYB Amazon,-5,-6,1,0,1,0
,Helly Hansen Men's Daybreaker Fleece Jacket Black Size XXL 51598-990,Helly Hansen Men's Daybreaker Fleece Jacket Black Size XXL 51598-990,FBALYB Amazon,11,11,0,0,0,0
,Helly Hansen Men's Dubliner Jacket Black Size L 62643-990,Helly Hansen Men's Dubliner Jacket Black Size L 62643-990,FBALYB Amazon,-13,-13,0,0,0,0
,Helly Hansen Men's Dubliner Jacket Black Size M 62643-990,Helly Hansen Men's Dubliner Jacket Black Size M 62643-990,FBALYB Amazon,-7,-7,0,0,0,0
,Helly Hansen Men's Dubliner Jacket Black Size XL 62643-990,Helly Hansen Men's Dubliner Jacket Black Size XL 62643-990,FBALYB Amazon,-14,-14,0,0,0,0
,Helly Hansen Men's Dubliner Jacket Black Size XXL 62643-990,Helly Hansen Men's Dubliner Jacket Black Size XXL 62643-990,FBALYB Amazon,-5,-5,0,0,0,0
,Helly Hansen Men's Team Crew Midlayer Jacket Navy Size L 34144-597,Helly Hansen Men's Team Crew Midlayer Jacket Navy Size L 34144-597,FBALYB Amazon,50,49,1,0,1,0
,Helly Hansen Men's Team Crew Midlayer Jacket Navy Size M 34144-597,Helly Hansen Men's Team Crew Midlayer Jacket Navy Size M 34144-597,FBALYB Amazon,17,17,0,0,0,0
,Helly Hansen Men's Team Crew Midlayer Jacket Navy Size XL 34144-597,Helly Hansen Men's Team Crew Midlayer Jacket Navy Size XL 34144-597,FBALYB Amazon,-12,-13,1,0,1,0
,Helly Hansen Men's Team Crew Midlayer Jacket Navy Size XXL 34144-597,Helly Hansen Men's Team Crew Midlayer Jacket Navy Size XXL 34144-597,FBALYB Amazon,5,5,0,0,0,0
,Hemp Dawg Hemp seed oil 2-Pack, Hemp Dawg Hemp seed oil 2-Pack,FBALYB Amazon,98,98,0,0,0,0
,Henna Cream Black 2pk,Henna Cream Black 2pk,FBALYB Amazon,5,5,0,1,0,0
,Henna Dark Brown Cream 2pk,Henna Dark Brown Cream 2pk,FBALYB Amazon,-36,-37,1,36,1,0
,Hershey Kisses 56oz,Hershey Kisses 56oz,Default,0,0,0,0,0,1
,Hershey Kisses 56oz 3pack,Hershey Kisses 56oz 3pack,FBALYB Amazon,2,2,0,0,0,0
,"Hershey's Bars, Variety 30 ct","Hershey's Full Size Bars, Variety Pack ‑ 30 count, 45 oz box",FBALYB Amazon,1,1,0,1,0,0
,"Hershey's Cookies 'N' Cream Crunchers, 22oz","Hershey's Cookies 'N' Cream Crunchers, 22oz",FBALYB Amazon,38,38,0,0,0,0
,"Hershey's Dark Chocolate Bars, 36 ct","Hershey's Dark Chocolate Bars, 36 ct",FBALYB Amazon,8,8,0,26,0,0
,"Hershey's Kit Kat Bars, 36 ct","Hershey's Kit Kat Bars, 36 ct",FBALYB Amazon,50,50,0,0,0,0
,"Hershey's Kit Kat Mini Bars, 22 oz","Hershey's Kit Kat Mini Bars, 22 oz",FBALYB Amazon,61,61,0,2,0,0
,Hershey's Miniatures Bars,Hershey's Miniatures Special Dark Chocolate Bars,FBALYB Amazon,2,2,0,9,0,0
,"Hershey's Snack Size Assortment, 20.3 oz","Hershey's Snack Size Assortment, 20.3 oz",FBALYB Amazon,1,1,0,1,0,0
,HEY DUDE 110350500 WALLY SOX BEIGE SIZE 40,HEY DUDE 110350500 WALLY SOX BEIGE SIZE 40,Default Ridgefield,12,12,0,0,0,0
,HEY DUDE 110350500 WALLY SOX BEIGE SIZE 41,HEY DUDE 110350500 WALLY SOX BEIGE SIZE 41,Default Ridgefield,1,1,0,0,0,0
,HEY DUDE 110350500 WALLY SOX BEIGE SIZE 42,HEY DUDE 110350500 WALLY SOX BEIGE SIZE 42,FBALYB Amazon,-1,-1,0,0,0,0
,HEY DUDE 110350703 WALLY SOX STONE WHITE SIZE 40,HEY DUDE 110350703 WALLY SOX STONE WHITE SIZE 40,FBALYB Amazon,30,30,0,0,0,0
,HEY DUDE 110350703 WALLY SOX STONE WHITE SIZE 41,HEY DUDE 110350703 WALLY SOX STONE WHITE SIZE 41,Default Ridgefield,3,3,0,0,0,0
,HEY DUDE 110350703 WALLY SOX STONE WHITE SIZE 42,HEY DUDE 110350703 WALLY SOX STONE WHITE SIZE 42,Default Ridgefield,1,1,0,0,0,0
,HEY DUDE 110350703 WALLY SOX STONE WHITE SIZE 43,HEY DUDE 110350703 WALLY SOX STONE WHITE SIZE 43,Default Ridgefield,1,1,0,0,0,0
,HEY DUDE 110350703 WALLY SOX STONE WHITE SIZE 44,HEY DUDE 110350703 WALLY SOX STONE WHITE SIZE 44,Default Ridgefield,1,1,0,0,0,0
,HEY DUDE 110351500 WALLY SOX BROWN SIZE 40,HEY DUDE 110351500 WALLY SOX BROWN SIZE 40,Default Ridgefield,1,1,0,0,0,0
,HEY DUDE 110351500 WALLY SOX BROWN SIZE 40,HEY DUDE 110351500 WALLY SOX BROWN SIZE 40,FBALYB Amazon,15,15,0,0,0,0
,HEY DUDE 110351500 WALLY SOX BROWN SIZE 41,HEY DUDE 110351500 WALLY SOX BROWN SIZE 41,Default Ridgefield,1,1,0,0,0,0
,HEY DUDE 110351500 WALLY SOX BROWN SIZE 41,HEY DUDE 110351500 WALLY SOX BROWN SIZE 41,FBALYB Amazon,41,40,1,0,1,0
,HEY DUDE 110351500 WALLY SOX BROWN SIZE 42,HEY DUDE 110351500 WALLY SOX BROWN SIZE 42,Default Ridgefield,4,4,0,0,0,0
,HEY DUDE 110351500 WALLY SOX BROWN SIZE 42,HEY DUDE 110351500 WALLY SOX BROWN SIZE 42,FBALYB Amazon,17,13,4,0,4,0
,HEY DUDE 110351500 WALLY SOX BROWN SIZE 43,HEY DUDE 110351500 WALLY SOX BROWN SIZE 43,Default Ridgefield,1,1,0,0,0,0
,HEY DUDE 110791010 WALLY LINEN NATURAL KHAKI SIZE 40,HEY DUDE 110791010 WALLY LINEN NATURAL KHAKI SIZE 40,FBALYB Amazon,27,27,0,0,0,0
,HEY DUDE 110791010 WALLY LINEN NATURAL KHAKI SIZE 41,HEY DUDE 110791010 WALLY LINEN NATURAL KHAKI SIZE 41,Default Ridgefield,1,1,0,0,0,0
,HEY DUDE 110791010 WALLY LINEN NATURAL KHAKI SIZE 41,HEY DUDE 110791010 WALLY LINEN NATURAL KHAKI SIZE 41,FBALYB Amazon,50,50,0,0,0,0
,HEY DUDE 110791010 WALLY LINEN NATURAL KHAKI SIZE 42,HEY DUDE 110791010 WALLY LINEN NATURAL KHAKI SIZE 42,Default Ridgefield,1,1,0,0,0,0
,HEY DUDE 110791010 WALLY LINEN NATURAL KHAKI SIZE 42,HEY DUDE 110791010 WALLY LINEN NATURAL KHAKI SIZE 42,FBALYB Amazon,86,86,0,0,0,0
,HEY DUDE 110791010 WALLY LINEN NATURAL KHAKI SIZE 43,HEY DUDE 110791010 WALLY LINEN NATURAL KHAKI SIZE 43,FBALYB Amazon,49,49,0,0,0,0
,HEY DUDE 110791010 WALLY LINEN NATURAL KHAKI SIZE 44,HEY DUDE 110791010 WALLY LINEN NATURAL KHAKI SIZE 44,Default Ridgefield,1,1,0,0,0,0
,HEY DUDE 110791010 WALLY LINEN NATURAL KHAKI SIZE 44,HEY DUDE 110791010 WALLY LINEN NATURAL KHAKI SIZE 44,FBALYB Amazon,21,20,1,0,1,0
,HEY DUDE 110791010 WALLY LINEN NATURAL KHAKI SIZE 45,HEY DUDE 110791010 WALLY LINEN NATURAL KHAKI SIZE 45,FBALYB Amazon,2,2,0,0,0,0
,HEY DUDE 121410121 WENDY CHAMBRAY WHITE NUT SIZE 37,HEY DUDE 121410121 WENDY CHAMBRAY WHITE NUT SIZE 37,Default Ridgefield,42,42,0,0,0,0
,HEY DUDE 121410121 WENDY CHAMBRAY WHITE NUT SIZE 38,HEY DUDE 121410121 WENDY CHAMBRAY WHITE NUT SIZE 38,FBALYB Amazon,63,62,1,0,1,0
,HEY DUDE 121410121 WENDY CHAMBRAY WHITE NUT SIZE 39,HEY DUDE 121410121 WENDY CHAMBRAY WHITE NUT SIZE 39,FBALYB Amazon,51,50,1,0,1,0
,HEY DUDE 121410121 WENDY CHAMBRAY WHITE NUT SIZE 40,HEY DUDE 121410121 WENDY CHAMBRAY WHITE NUT SIZE 40,FBALYB Amazon,28,28,0,0,0,0
,HEY DUDE 121410121 WENDY CHAMBRAY WHITE NUT SIZE 41,HEY DUDE 121410121 WENDY CHAMBRAY WHITE NUT SIZE 41,FBALYB Amazon,13,13,0,0,0,0
,HEY DUDE 121410522 WENDY CHAMBRAY BEIGE SIZE 36,HEY DUDE 121410522 WENDY CHAMBRAY BEIGE SIZE 36,Default Ridgefield,1,1,0,0,0,0
,HEY DUDE 121410522 WENDY CHAMBRAY BEIGE SIZE 36,HEY DUDE 121410522 WENDY CHAMBRAY BEIGE SIZE 36,FBALYB Amazon,9,4,5,4,5,0
,HEY DUDE 121410522 WENDY CHAMBRAY BEIGE SIZE 37,HEY DUDE 121410522 WENDY CHAMBRAY BEIGE SIZE 37,Default Ridgefield,6,6,0,0,0,0
,HEY DUDE 121410522 WENDY CHAMBRAY BEIGE SIZE 38,HEY DUDE 121410522 WENDY CHAMBRAY BEIGE SIZE 38,Default Ridgefield,3,3,0,0,0,0
,HEY DUDE 121410522 WENDY CHAMBRAY BEIGE SIZE 38,HEY DUDE 121410522 WENDY CHAMBRAY BEIGE SIZE 38,FBALYB Amazon,-1,-1,0,0,0,0
,HEY DUDE 121410522 WENDY CHAMBRAY BEIGE SIZE 39,HEY DUDE 121410522 WENDY CHAMBRAY BEIGE SIZE 39,Default Ridgefield,5,5,0,0,0,0
,HEY DUDE 121410522 WENDY CHAMBRAY BEIGE SIZE 40,HEY DUDE 121410522 WENDY CHAMBRAY BEIGE SIZE 40,Default Ridgefield,2,2,0,0,0,0
,HEY DUDE 121410522 WENDY CHAMBRAY BEIGE SIZE 40,HEY DUDE 121410522 WENDY CHAMBRAY BEIGE SIZE 40,FBALYB Amazon,-1,-1,0,0,0,0
,HEY DUDE 121410522 WENDY CHAMBRAY BEIGE SIZE 41,HEY DUDE 121410522 WENDY CHAMBRAY BEIGE SIZE 41,FBALYB Amazon,0,0,0,1,0,0
,Hey Dude Flinn Free Beige 113350500 Size UK 41/ US 8,Hey Dude Flinn Free Beige 113350500 Size UK 41/ US 8,FBALYB Amazon,20,20,0,0,0,0
,Hey Dude Flinn Free Beige 113350500 Size UK 42/ US 9,Hey Dude Flinn Free Beige 113350500 Size UK 42/ US 9,Default Ridgefield,2,2,0,0,0,0
,Hey Dude Flinn Free Beige 113350500 Size UK 42/ US 9,Hey Dude Flinn Free Beige 113350500 Size UK 42/ US 9,FBALYB Amazon,51,51,0,0,0,0
,Hey Dude Flinn Free Beige 113350500 Size UK 43/ US 10,Hey Dude Flinn Free Beige 113350500 Size UK 43/ US 10,Default Ridgefield,3,3,0,0,0,0
,Hey Dude Flinn Free Beige 113350500 Size UK 43/ US 10,Hey Dude Flinn Free Beige 113350500 Size UK 43/ US 10,FBALYB Amazon,96,96,0,0,0,0
,Hey Dude Flinn Free Beige 113350500 Size UK 44/ US 11,Hey Dude Flinn Free Beige 113350500 Size UK 44/ US 11,FBALYB Amazon,99,99,0,0,0,0
,Hey Dude Flinn Free Beige 113350500 Size UK 45/ US 12,Hey Dude Flinn Free Beige 113350500 Size UK 45/ US 12,Default Ridgefield,100,100,0,0,0,0
,Hey Dude Flinn Free Beige 113350500 Size UK 46/ US 13,Hey Dude Flinn Free Beige 113350500 Size UK 46/ US 13,FBALYB Amazon,40,40,0,0,0,0
,Hey Dude Flinn Free Black 113354900  Size UK 43/ US 10,Hey Dude Flinn Free Black 113354900  Size UK 43/ US 10,FBALYB Amazon,64,64,0,0,0,0
,Hey Dude Flinn Free Black 113354900  Size UK 44/ US 11,Hey Dude Flinn Free Black 113354900  Size UK 44/ US 11,FBALYB Amazon,101,101,0,0,0,0
,Hey Dude Flinn Free Black 113354900  Size UK 45/ US 12,Hey Dude Flinn Free Black 113354900  Size UK 45/ US 12,Default Ridgefield,4,4,0,0,0,0
,Hey Dude Flinn Free Black 113354900  Size UK 45/ US 12,Hey Dude Flinn Free Black 113354900  Size UK 45/ US 12,FBALYB Amazon,12,12,0,0,0,0
,Hey Dude Flinn Free Grey 113353000 Size UK 41/ US 8,Hey Dude Flinn Free Grey 113353000 Size UK 41/ US 8,FBALYB Amazon,9,9,0,0,0,0
,Hey Dude Flinn Free Grey 113353000 Size UK 42/ US 9,Hey Dude Flinn Free Grey 113353000 Size UK 42/ US 9,Default Ridgefield,1,1,0,0,0,0
,Hey Dude Flinn Free Grey 113353000 Size UK 42/ US 9,Hey Dude Flinn Free Grey 113353000 Size UK 42/ US 9,FBALYB Amazon,50,50,0,1,0,0
,Hey Dude Flinn Free Grey 113353000 Size UK 43/ US 10,Hey Dude Flinn Free Grey 113353000 Size UK 43/ US 10,FBALYB Amazon,100,100,0,0,0,0
,Hey Dude Flinn Free Grey 113353000 Size UK 44/ US 11,Hey Dude Flinn Free Grey 113353000 Size UK 44/ US 11,FBALYB Amazon,97,97,0,0,0,0
,Hey Dude Flinn Free Grey 113353000 Size UK 46/ US 13,Hey Dude Flinn Free Grey 113353000 Size UK 46/ US 13,FBALYB Amazon,55,55,0,0,0,0
,Hey Dude Flinn Sox Beige Polybag 112200528-PB Size UK 42/ US 9,Hey Dude Flinn Sox Beige Polybag 112200528-PB Size UK 42/ US 9,Default Ridgefield,108,108,0,0,0,0
,Hey Dude Flinn Sox Beige Polybag 112200528-PB Size UK 43/ US 10,Hey Dude Flinn Sox Beige Polybag 112200528-PB Size UK 43/ US 10,Default Ridgefield,7,7,0,0,0,0
,Hey Dude Flinn Sox Beige Polybag 112200528-PB Size UK 43/ US 10,Hey Dude Flinn Sox Beige Polybag 112200528-PB Size UK 43/ US 10,FBALYB Amazon,161,161,0,0,0,0
,Hey Dude Flinn Sox Brown Polybag 112201515-PB Size UK 41/ US 8,Hey Dude Flinn Sox Brown Polybag 112201515-PB Size UK 41/ US 8,FBALYB Amazon,16,16,0,0,0,0
,Hey Dude Flinn Sox Brown Polybag 112201515-PB Size UK 43/ US 10,Hey Dude Flinn Sox Brown Polybag 112201515-PB Size UK 43/ US 10,FBALYB Amazon,13,13,0,7,0,0
,Hey Dude Flinn Sox Brown Polybag 112201515-PB Size UK 44/ US 11,Hey Dude Flinn Sox Brown Polybag 112201515-PB Size UK 44/ US 11,FBALYB Amazon,104,104,0,0,0,0
,Hey Dude Flinn Sox Brown Polybag 112201515-PB Size UK 45/ US 12,Hey Dude Flinn Sox Brown Polybag 112201515-PB Size UK 45/ US 12,Default Ridgefield,1,1,0,0,0,0
,Hey Dude Flinn Sox Brown Polybag 112201515-PB Size UK 45/ US 12,Hey Dude Flinn Sox Brown Polybag 112201515-PB Size UK 45/ US 12,FBALYB Amazon,84,84,0,0,0,0
,Hey Dude Flinn Sox Grey Polybag 112203082-PB Size UK 43/ US 10,Hey Dude Flinn Sox Grey Polybag 112203082-PB Size UK 43/ US 10,Default Ridgefield,1,1,0,0,0,0
,Hey Dude Flinn Sox Grey Polybag 112203082-PB Size UK 43/ US 10,Hey Dude Flinn Sox Grey Polybag 112203082-PB Size UK 43/ US 10,FBALYB Amazon,104,104,0,0,0,0
,Hey Dude Flinn Sox Grey Polybag 112203082-PB Size UK 44/ US 11,Hey Dude Flinn Sox Grey Polybag 112203082-PB Size UK 44/ US 11,Default Ridgefield,3,3,0,0,0,0
,Hey Dude Flinn Sox Grey Polybag 112203082-PB Size UK 44/ US 11,Hey Dude Flinn Sox Grey Polybag 112203082-PB Size UK 44/ US 11,FBALYB Amazon,89,89,0,0,0,0
,Hey Dude Flinn Sox Navy 112202529 Size UK 41/ US 8,Hey Dude Flinn Sox Navy 112202529 Size UK 41/ US 8,FBALYB Amazon,38,38,0,0,0,0
,Hey Dude Flinn Sox Navy 112202529 Size UK 43/ US 10,Hey Dude Flinn Sox Navy 112202529 Size UK 43/ US 10,Default Ridgefield,2,2,0,0,0,0
,Hey Dude Flinn Sox Navy 112202529 Size UK 43/ US 10,Hey Dude Flinn Sox Navy 112202529 Size UK 43/ US 10,FBALYB Amazon,99,99,0,0,0,0
,Hey Dude Flinn Sox Navy 112202529 Size UK 44/ US 11,Hey Dude Flinn Sox Navy 112202529 Size UK 44/ US 11,Default Ridgefield,1,1,0,0,0,0
,Hey Dude Flinn Sox Navy 112202529 Size UK 44/ US 11,Hey Dude Flinn Sox Navy 112202529 Size UK 44/ US 11,FBALYB Amazon,131,131,0,0,0,0
,Hey Dude Flinn Sox Navy 112202529 Size UK 45/ US 12,Hey Dude Flinn Sox Navy 112202529 Size UK 45/ US 12,Default Ridgefield,1,1,0,0,0,0
,Hey Dude Flinn Sox Navy 112202529 Size UK 45/ US 12,Hey Dude Flinn Sox Navy 112202529 Size UK 45/ US 12,FBALYB Amazon,24,24,0,0,0,0
,Hey Dude Thad Chambray Walnut 111911621 Size UK 44/ US 11,Hey Dude Thad Chambray Walnut 111911621 Size UK 44/ US 11,FBALYB Amazon,59,51,8,0,8,0
,Hey Dude WALLY  110061613 CHAMBRAY NUT Size: 40,Hey Dude WALLY  110061613 CHAMBRAY NUT Size: 40,FBALYB Amazon,-1,-1,0,0,0,0
,Hey Dude WALLY  110061613 CHAMBRAY NUT Size: 41,Hey Dude WALLY  110061613 CHAMBRAY NUT Size: 41,Default Ridgefield,0,0,0,0,0,102
,Hey Dude WALLY  110061613 CHAMBRAY NUT Size: 41,Hey Dude WALLY  110061613 CHAMBRAY NUT Size: 41,FBALYB Amazon,-1,-1,0,0,0,0
,Hey Dude WALLY  110061613 CHAMBRAY NUT Size: 42,Hey Dude WALLY  110061613 CHAMBRAY NUT Size: 42,Default Ridgefield,1,1,0,0,0,342
,Hey Dude WALLY  110061613 CHAMBRAY NUT Size: 42,Hey Dude WALLY  110061613 CHAMBRAY NUT Size: 42,FBALYB Amazon,-4,-4,0,0,0,0
,Hey Dude WALLY  110061613 CHAMBRAY NUT Size: 43,Hey Dude WALLY  110061613 CHAMBRAY NUT Size: 43,Default Ridgefield,0,0,0,0,0,684
,Hey Dude WALLY  110061613 CHAMBRAY NUT Size: 43,Hey Dude WALLY  110061613 CHAMBRAY NUT Size: 43,FBALYB Amazon,-7,-7,0,0,0,0
,Hey Dude WALLY  110061613 CHAMBRAY NUT Size: 44,Hey Dude WALLY  110061613 CHAMBRAY NUT Size: 44,Default Ridgefield,0,0,0,0,0,942
,Hey Dude WALLY  110061613 CHAMBRAY NUT Size: 44,Hey Dude WALLY  110061613 CHAMBRAY NUT Size: 44,FBALYB Amazon,29,29,0,0,0,0
,Hey Dude WALLY  110061613 CHAMBRAY NUT Size: 45,Hey Dude WALLY  110061613 CHAMBRAY NUT Size: 45,Default Ridgefield,0,0,0,0,0,444
,Hey Dude WALLY  110061613 CHAMBRAY NUT Size: 45,Hey Dude WALLY  110061613 CHAMBRAY NUT Size: 45,FBALYB Amazon,-11,-11,0,0,0,0
,Hey Dude WALLY  110061613 CHAMBRAY NUT Size: 46,Hey Dude WALLY  110061613 CHAMBRAY NUT Size: 46,Default Ridgefield,0,0,0,0,0,366
,Hey Dude WALLY  110061613 CHAMBRAY NUT Size: 46,Hey Dude WALLY  110061613 CHAMBRAY NUT Size: 46,FBALYB Amazon,0,0,0,48,0,0
,Hey Dude WALLY  110061613 CHAMBRAY NUT Size: 47,Hey Dude WALLY  110061613 CHAMBRAY NUT Size: 47,Default Ridgefield,0,0,0,0,0,102
,Hey Dude WALLY  110062645 CHAMBRAY BLUE Size: 40,Hey Dude WALLY  110062645 CHAMBRAY BLUE Size: 40,FBALYB Amazon,-2,-2,0,0,0,0
,Hey Dude WALLY  110062645 CHAMBRAY BLUE Size: 42,Hey Dude WALLY  110062645 CHAMBRAY BLUE Size: 42,FBALYB Amazon,-2,-2,0,0,0,0
,Hey Dude WALLY  110062645 CHAMBRAY BLUE Size: 44,Hey Dude WALLY  110062645 CHAMBRAY BLUE Size: 44,FBALYB Amazon,-1,-1,0,0,0,0
,Hey Dude WALLY  110063059 CHAMBRAY GREY Size: 42,Hey Dude WALLY  110063059 CHAMBRAY GREY Size: 42,Default Ridgefield,16,16,0,0,0,0
,Hey Dude WALLY  110063059 CHAMBRAY GREY Size: 43,Hey Dude WALLY  110063059 CHAMBRAY GREY Size: 43,FBALYB Amazon,-32,-33,1,30,1,0
,Hey Dude WALLY  110063059 CHAMBRAY GREY Size: 44,Hey Dude WALLY  110063059 CHAMBRAY GREY Size: 44,FBALYB Amazon,-38,-38,0,36,0,0
,Hey Dude WALLY  110063059 CHAMBRAY GREY Size: 45,Hey Dude WALLY  110063059 CHAMBRAY GREY Size: 45,FBALYB Amazon,-17,-17,0,18,0,0
,Hey Dude WALLY  110063059 CHAMBRAY GREY Size: 46,Hey Dude WALLY  110063059 CHAMBRAY GREY Size: 46,FBALYB Amazon,-18,-18,0,18,0,0
,Hey Dude WALLY FUNK 110410535 AZTEC BEIGE Size: 41,Hey Dude WALLY FUNK 110410535 AZTEC BEIGE Size: 41,Default Ridgefield,0,0,0,0,0,6
,Hey Dude WALLY FUNK 110410535 AZTEC BEIGE Size: 42,Hey Dude WALLY FUNK 110410535 AZTEC BEIGE Size: 42,Default Ridgefield,0,0,0,0,0,12
,Hey Dude WALLY FUNK 110410535 AZTEC BEIGE Size: 43,Hey Dude WALLY FUNK 110410535 AZTEC BEIGE Size: 43,Default Ridgefield,0,0,0,0,0,24
,Hey Dude WALLY FUNK 110410535 AZTEC BEIGE Size: 44,Hey Dude WALLY FUNK 110410535 AZTEC BEIGE Size: 44,Default,0,0,0,0,0,6
,Hey Dude WALLY FUNK 110410535 AZTEC BEIGE Size: 44,Hey Dude WALLY FUNK 110410535 AZTEC BEIGE Size: 44,Default Ridgefield,0,0,0,0,0,36
,Hey Dude WALLY FUNK 110410535 AZTEC BEIGE Size: 45,Hey Dude WALLY FUNK 110410535 AZTEC BEIGE Size: 45,Default Ridgefield,0,0,0,0,0,18
,Hey Dude WALLY FUNK 110410535 AZTEC BEIGE Size: 45,Hey Dude WALLY FUNK 110410535 AZTEC BEIGE Size: 45,FBALYB Amazon,3,3,0,0,0,0
,Hey Dude WALLY FUNK 110410535 AZTEC BEIGE Size: 46,Hey Dude WALLY FUNK 110410535 AZTEC BEIGE Size: 46,Default Ridgefield,0,0,0,0,0,12
,Hey Dude WALLY FUNK 110410535 AZTEC BEIGE Size: 46,Hey Dude WALLY FUNK 110410535 AZTEC BEIGE Size: 46,FBALYB Amazon,7,7,0,0,0,0
,Hey Dude WALLY FUNK 110410535 AZTEC BEIGE Size: 47,Hey Dude WALLY FUNK 110410535 AZTEC BEIGE Size: 47,Default Ridgefield,0,0,0,0,0,6
,Hey Dude Wally Funk Anchor 110413225 Size UK 44/ US 11,Hey Dude Wally Funk Anchor 110413225 Size UK 44/ US 11,Default Ridgefield,6,6,0,0,0,0
,Hey Dude Wally Funk Anchor 110413225 Size UK 44/ US 11,Hey Dude Wally Funk Anchor 110413225 Size UK 44/ US 11,FBALYB Amazon,125,125,0,0,0,0
,Hey Dude Wally Funk Anchor 110413225 Size UK 45/ US 12,Hey Dude Wally Funk Anchor 110413225 Size UK 45/ US 12,FBALYB Amazon,41,41,0,0,0,0
,Hey Dude Wally Funk Rhyolite 110413228 Size UK 44/ US 11,Hey Dude Wally Funk Rhyolite 110413228 Size UK 44/ US 11,FBALYB Amazon,1,1,0,1,0,0
,Hey Dude WALLY LINEN 110793901 IRON Size: 40,Hey Dude WALLY LINEN 110793901 IRON Size: 40,Default Ridgefield,3,3,0,0,0,0
,Hey Dude WALLY LINEN 110793901 IRON Size: 40,Hey Dude WALLY LINEN 110793901 IRON Size: 40,FBALYB Amazon,-3,-3,0,0,0,0
,Hey Dude WALLY LINEN 110793901 IRON Size: 41,Hey Dude WALLY LINEN 110793901 IRON Size: 41,Default Ridgefield,5,5,0,0,0,30
,Hey Dude WALLY LINEN 110793901 IRON Size: 41,Hey Dude WALLY LINEN 110793901 IRON Size: 41,FBALYB Amazon,-4,-6,2,4,2,0
,Hey Dude WALLY LINEN 110793901 IRON Size: 42,Hey Dude WALLY LINEN 110793901 IRON Size: 42,Default Ridgefield,4,4,0,0,0,102
,Hey Dude WALLY LINEN 110793901 IRON Size: 42,Hey Dude WALLY LINEN 110793901 IRON Size: 42,FBALYB Amazon,-7,-7,0,0,0,0
,Hey Dude WALLY LINEN 110793901 IRON Size: 43,Hey Dude WALLY LINEN 110793901 IRON Size: 43,Default Ridgefield,0,0,0,0,0,210
,Hey Dude WALLY LINEN 110793901 IRON Size: 43,Hey Dude WALLY LINEN 110793901 IRON Size: 43,FBALYB Amazon,-4,-7,3,3,3,0
,Hey Dude WALLY LINEN 110793901 IRON Size: 44,Hey Dude WALLY LINEN 110793901 IRON Size: 44,Default Ridgefield,1,1,0,0,0,288
,Hey Dude WALLY LINEN 110793901 IRON Size: 44,Hey Dude WALLY LINEN 110793901 IRON Size: 44,FBALYB Amazon,-6,-9,3,3,3,0
,Hey Dude WALLY LINEN 110793901 IRON Size: 45,Hey Dude WALLY LINEN 110793901 IRON Size: 45,Default Ridgefield,0,0,0,0,0,138
,Hey Dude WALLY L STRETCH 111161004 STEPPA Size: 41,Hey Dude WALLY L STRETCH 111161004 STEPPA Size: 41,FBALYB Amazon,0,0,0,6,0,0
,Hey Dude WALLY L STRETCH 111161004 STEPPA Size: 42,Hey Dude WALLY L STRETCH 111161004 STEPPA Size: 42,Default Ridgefield,4,4,0,0,0,0
,Hey Dude WALLY L STRETCH 111161004 STEPPA Size: 44,Hey Dude WALLY L STRETCH 111161004 STEPPA Size: 44,Default Ridgefield,12,12,0,0,0,0
,Hey Dude WALLY L STRETCH 111161004 STEPPA Size: 45,Hey Dude WALLY L STRETCH 111161004 STEPPA Size: 45,FBALYB Amazon,8,8,0,0,0,0
,Hey Dude WALLY L STRETCH 111161004 STEPPA Size: 46,Hey Dude WALLY L STRETCH 111161004 STEPPA Size: 46,FBALYB Amazon,0,-1,1,0,1,0
,Hey Dude WALLY L STRETCH 111161004 STEPPA Size: 47,Hey Dude WALLY L STRETCH 111161004 STEPPA Size: 47,FBALYB Amazon,5,5,0,0,0,0
,Hey Dude WALLY L STRETCH 111163200 STEEL Size: 40,Hey Dude WALLY L STRETCH 111163200 STEEL Size: 40,FBALYB Amazon,-1,-1,0,0,0,0
,Hey Dude WALLY L STRETCH 111163200 STEEL Size: 41,Hey Dude WALLY L STRETCH 111163200 STEEL Size: 41,Default Ridgefield,0,0,0,0,0,24
,Hey Dude WALLY L STRETCH 111163200 STEEL Size: 41,Hey Dude WALLY L STRETCH 111163200 STEEL Size: 41,FBALYB Amazon,-1,-1,0,0,0,0
,Hey Dude WALLY L STRETCH 111163200 STEEL Size: 42,Hey Dude WALLY L STRETCH 111163200 STEEL Size: 42,Default Ridgefield,1,1,0,0,0,90
,Hey Dude WALLY L STRETCH 111163200 STEEL Size: 42,Hey Dude WALLY L STRETCH 111163200 STEEL Size: 42,FBALYB Amazon,-10,-10,0,0,0,0
,Hey Dude WALLY L STRETCH 111163200 STEEL Size: 43,Hey Dude WALLY L STRETCH 111163200 STEEL Size: 43,Default Ridgefield,0,0,0,0,0,174
,Hey Dude WALLY L STRETCH 111163200 STEEL Size: 43,Hey Dude WALLY L STRETCH 111163200 STEEL Size: 43,FBALYB Amazon,-6,-6,0,0,0,0
,Hey Dude WALLY L STRETCH 111163200 STEEL Size: 44.,Hey Dude WALLY L STRETCH 111163200 STEEL Size: 44.,Default Ridgefield,0,0,0,0,0,234
,Hey Dude WALLY L STRETCH 111163200 STEEL Size: 44.,Hey Dude WALLY L STRETCH 111163200 STEEL Size: 44.,FBALYB Amazon,-3,-3,0,0,0,0
,Hey Dude WALLY L STRETCH 111163200 STEEL Size: 45,Hey Dude WALLY L STRETCH 111163200 STEEL Size: 45,Default Ridgefield,0,0,0,0,0,114
,Hey Dude WALLY L STRETCH 111163200 STEEL Size: 45,Hey Dude WALLY L STRETCH 111163200 STEEL Size: 45,FBALYB Amazon,-13,-13,0,0,0,0
,Hey Dude WALLY L STRETCH 111163200 STEEL Size: 46,Hey Dude WALLY L STRETCH 111163200 STEEL Size: 46,Default Ridgefield,0,0,0,0,0,96
,Hey Dude WALLY L STRETCH 111163200 STEEL Size: 46,Hey Dude WALLY L STRETCH 111163200 STEEL Size: 46,FBALYB Amazon,-4,-4,0,0,0,0
,Hey Dude Wally Recycled Leather Navy 150202550 Size UK 44/ US M11,Hey Dude Wally Recycled Leather Navy 150202550 Size UK 44/ US M11,FBALYB Amazon,3,3,0,0,0,0
,Hey Dude Wally Shawdow 110060166 Size UK 41/ US 8,Hey Dude Wally Shawdow 110060166 Size UK 41/ US 8,FBALYB Amazon,13,13,0,0,0,0
,Hey Dude Wally Shawdow 110060166 Size UK 42/ US 9,Hey Dude Wally Shawdow 110060166 Size UK 42/ US 9,Default Ridgefield,2,2,0,0,0,0
,Hey Dude Wally Shawdow 110060166 Size UK 42/ US 9,Hey Dude Wally Shawdow 110060166 Size UK 42/ US 9,FBALYB Amazon,194,194,0,0,0,0
,Hey Dude Wally Shawdow 110060166 Size UK 45/ US 12,Hey Dude Wally Shawdow 110060166 Size UK 45/ US 12,Default Ridgefield,1,1,0,0,0,0
,Hey Dude Wally Shawdow 110060166 Size UK 45/ US 12,Hey Dude Wally Shawdow 110060166 Size UK 45/ US 12,FBALYB Amazon,79,79,0,0,0,0
,Hey Dude Wally Shawdow 110060166 Size UK 46/ US 13,Hey Dude Wally Shawdow 110060166 Size UK 46/ US 13,FBALYB Amazon,2,2,0,0,0,0
,Hey Dude WALLY SOX 110350127 ICE GREY Size: 40,Hey Dude WALLY SOX 110350127 ICE GREY Size: 40,Default Ridgefield,0,0,0,0,0,1
,Hey Dude WALLY SOX 110350127 ICE GREY Size: 40,Hey Dude WALLY SOX 110350127 ICE GREY Size: 40,FBALYB Amazon,-1,-2,1,0,1,0
,Hey Dude WALLY SOX 110350127 ICE GREY Size: 41,Hey Dude WALLY SOX 110350127 ICE GREY Size: 41,Default Ridgefield,2,2,0,0,0,15
,Hey Dude WALLY SOX 110350127 ICE GREY Size: 41,Hey Dude WALLY SOX 110350127 ICE GREY Size: 41,FBALYB Amazon,-2,-2,0,0,0,0
,Hey Dude WALLY SOX 110350127 ICE GREY Size: 42,Hey Dude WALLY SOX 110350127 ICE GREY Size: 42,Default Ridgefield,0,0,0,0,0,17
,Hey Dude WALLY SOX 110350127 ICE GREY Size: 42,Hey Dude WALLY SOX 110350127 ICE GREY Size: 42,FBALYB Amazon,-3,-3,0,0,0,0
,Hey Dude WALLY SOX 110350127 ICE GREY Size: 43,Hey Dude WALLY SOX 110350127 ICE GREY Size: 43,Default Ridgefield,1,1,0,0,0,96
,Hey Dude WALLY SOX 110350127 ICE GREY Size: 43,Hey Dude WALLY SOX 110350127 ICE GREY Size: 43,FBALYB Amazon,-2,-2,0,0,0,0
,Hey Dude WALLY SOX 110350127 ICE GREY Size: 44,Hey Dude WALLY SOX 110350127 ICE GREY Size: 44,Default Ridgefield,0,0,0,0,0,123
,Hey Dude WALLY SOX 110350127 ICE GREY Size: 44,Hey Dude WALLY SOX 110350127 ICE GREY Size: 44,FBALYB Amazon,-1,-1,0,0,0,0
,Hey Dude WALLY SOX 110350127 ICE GREY Size: 45,Hey Dude WALLY SOX 110350127 ICE GREY Size: 45,Default Ridgefield,0,0,0,0,0,63
,Hey Dude WALLY SOX 110350127 ICE GREY Size: 45,Hey Dude WALLY SOX 110350127 ICE GREY Size: 45,FBALYB Amazon,-3,-3,0,0,0,0
,Hey Dude WALLY SOX 110350127 ICE GREY Size: 46,Hey Dude WALLY SOX 110350127 ICE GREY Size: 46,Default Ridgefield,19,19,0,0,0,43
,Hey Dude WALLY SOX 110352632 BLUE ORANGE Size: 40,Hey Dude WALLY SOX 110352632 BLUE ORANGE Size: 40,Default Ridgefield,2,2,0,0,0,73
,Hey Dude WALLY SOX 110352632 BLUE ORANGE Size: 40,Hey Dude WALLY SOX 110352632 BLUE ORANGE Size: 40,FBALYB Amazon,-4,-6,2,0,2,0
,Hey Dude WALLY SOX 110352632 BLUE ORANGE Size: 41,Hey Dude WALLY SOX 110352632 BLUE ORANGE Size: 41,Default Ridgefield,20,20,0,0,0,147
,Hey Dude WALLY SOX 110352632 BLUE ORANGE Size: 41,Hey Dude WALLY SOX 110352632 BLUE ORANGE Size: 41,FBALYB Amazon,44,42,2,0,2,0
,Hey Dude WALLY SOX 110352632 BLUE ORANGE Size: 42,Hey Dude WALLY SOX 110352632 BLUE ORANGE Size: 42,Default Ridgefield,25,25,0,0,0,221
,Hey Dude WALLY SOX 110352632 BLUE ORANGE Size: 42,Hey Dude WALLY SOX 110352632 BLUE ORANGE Size: 42,FBALYB Amazon,74,72,2,0,2,0
,Hey Dude WALLY SOX 110352632 BLUE ORANGE Size: 43,Hey Dude WALLY SOX 110352632 BLUE ORANGE Size: 43,Default Ridgefield,0,0,0,0,0,222
,Hey Dude WALLY SOX 110352632 BLUE ORANGE Size: 43,Hey Dude WALLY SOX 110352632 BLUE ORANGE Size: 43,FBALYB Amazon,3,-13,16,0,16,0
,Hey Dude WALLY SOX 110352632 BLUE ORANGE Size: 44,Hey Dude WALLY SOX 110352632 BLUE ORANGE Size: 44,Default Ridgefield,0,0,0,0,0,149
,Hey Dude WALLY SOX 110352632 BLUE ORANGE Size: 44,Hey Dude WALLY SOX 110352632 BLUE ORANGE Size: 44,FBALYB Amazon,-9,-10,1,0,1,0
,Hey Dude WALLY SOX 110352632 BLUE ORANGE Size: 45,Hey Dude WALLY SOX 110352632 BLUE ORANGE Size: 45,Default Ridgefield,2,2,0,0,0,75
,Hey Dude WALLY SOX 110352632 BLUE ORANGE Size: 45,Hey Dude WALLY SOX 110352632 BLUE ORANGE Size: 45,FBALYB Amazon,-3,-3,0,0,0,0
,Hey Dude WALLY SOX 110352632 BLUE ORANGE Size: 46,Hey Dude WALLY SOX 110352632 BLUE ORANGE Size: 46,Default Ridgefield,0,0,0,0,0,1
,Hey Dude WALLY SOX 110354000 CHARCOAL Size: 40,Hey Dude WALLY SOX 110354000 CHARCOAL Size: 40,Default Ridgefield,0,0,0,0,0,31
,Hey Dude WALLY SOX 110354000 CHARCOAL Size: 41,Hey Dude WALLY SOX 110354000 CHARCOAL Size: 41,Default Ridgefield,2,2,0,0,0,63
,Hey Dude WALLY SOX 110354000 CHARCOAL Size: 42,Hey Dude WALLY SOX 110354000 CHARCOAL Size: 42,Default Ridgefield,0,0,0,0,0,95
,Hey Dude WALLY SOX 110354000 CHARCOAL Size: 43,Hey Dude WALLY SOX 110354000 CHARCOAL Size: 43,Default Ridgefield,2,2,0,0,0,96
,Hey Dude WALLY SOX 110354000 CHARCOAL Size: 44,Hey Dude WALLY SOX 110354000 CHARCOAL Size: 44,Default Ridgefield,0,0,0,0,0,65
,Hey Dude WALLY SOX 110354000 CHARCOAL Size: 45,Hey Dude WALLY SOX 110354000 CHARCOAL Size: 45,Default Ridgefield,0,0,0,0,0,33
,Hey Dude WALLY SOX 110354000 CHARCOAL Size: 46,Hey Dude WALLY SOX 110354000 CHARCOAL Size: 46,Default Ridgefield,0,0,0,0,0,1
,Hey Dude Wally Storm Dark Grey 112233008 SIze UK 42/ US 9,Hey Dude Wally Storm Dark Grey 112233008 SIze UK 42/ US 9,FBALYB Amazon,9,8,1,0,1,0
,Hey Dude Wally Storm Dark Grey 112233008 SIze UK 43/ US 10,Hey Dude Wally Storm Dark Grey 112233008 SIze UK 43/ US 10,Default Ridgefield,2,2,0,0,0,0
,Hey Dude Wally Storm Dark Grey 112233008 SIze UK 43/ US 10,Hey Dude Wally Storm Dark Grey 112233008 SIze UK 43/ US 10,FBALYB Amazon,49,48,1,0,1,0
,Hey Dude Wally Storm Dark Grey 112233008 SIze UK 44/ US 11,Hey Dude Wally Storm Dark Grey 112233008 SIze UK 44/ US 11,Default Ridgefield,1,1,0,0,0,0
,Hey Dude Wally Storm Dark Grey 112233008 SIze UK 44/ US 11,Hey Dude Wally Storm Dark Grey 112233008 SIze UK 44/ US 11,FBALYB Amazon,68,68,0,0,0,0
,Hey Dude Wally Storm Dark Grey 112233008 SIze UK 45/ US 12,Hey Dude Wally Storm Dark Grey 112233008 SIze UK 45/ US 12,FBALYB Amazon,39,39,0,0,0,0
,Hey Dude Wally Storm Dark Grey 112233008 SIze UK 47/ US 14,Hey Dude Wally Storm Dark Grey 112233008 SIze UK 47/ US 14,FBALYB Amazon,2,2,0,0,0,0
,Hey Dude WALLY STRETCH 110380500 BEIGE Size: 40,Hey Dude WALLY STRETCH 110380500 BEIGE Size: 40,Default Ridgefield,1,1,0,0,0,0
,Hey Dude WALLY STRETCH 110380500 BEIGE Size: 40,Hey Dude WALLY STRETCH 110380500 BEIGE Size: 40,FBALYB Amazon,-4,-4,0,0,0,0
,Hey Dude WALLY STRETCH 110380500 BEIGE Size: 41,Hey Dude WALLY STRETCH 110380500 BEIGE Size: 41,Default Ridgefield,1,1,0,0,0,18
,Hey Dude WALLY STRETCH 110380500 BEIGE Size: 41,Hey Dude WALLY STRETCH 110380500 BEIGE Size: 41,FBALYB Amazon,21,20,1,0,1,0
,Hey Dude WALLY STRETCH 110380500 BEIGE Size: 42,Hey Dude WALLY STRETCH 110380500 BEIGE Size: 42,Default Ridgefield,0,0,0,0,0,48
,Hey Dude WALLY STRETCH 110380500 BEIGE Size: 42,Hey Dude WALLY STRETCH 110380500 BEIGE Size: 42,FBALYB Amazon,54,53,1,0,1,0
,Hey Dude WALLY STRETCH 110380500 BEIGE Size: 43,Hey Dude WALLY STRETCH 110380500 BEIGE Size: 43,Default Ridgefield,7,7,0,0,0,90
,Hey Dude WALLY STRETCH 110380500 BEIGE Size: 43,Hey Dude WALLY STRETCH 110380500 BEIGE Size: 43,FBALYB Amazon,-16,-16,0,0,0,0
,Hey Dude WALLY STRETCH 110380500 BEIGE Size: 44,Hey Dude WALLY STRETCH 110380500 BEIGE Size: 44,Default Ridgefield,2,2,0,0,0,126
,Hey Dude WALLY STRETCH 110380500 BEIGE Size: 44,Hey Dude WALLY STRETCH 110380500 BEIGE Size: 44,FBALYB Amazon,-9,-9,0,0,0,0
,Hey Dude WALLY STRETCH 110380500 BEIGE Size: 45,Hey Dude WALLY STRETCH 110380500 BEIGE Size: 45,Default Ridgefield,0,0,0,0,0,60
,Hey Dude WALLY STRETCH 110380500 BEIGE Size: 45,Hey Dude WALLY STRETCH 110380500 BEIGE Size: 45,FBALYB Amazon,-7,-8,1,0,1,0
,Hey Dude WALLY STRETCH 110380500 BEIGE Size: 46,Hey Dude WALLY STRETCH 110380500 BEIGE Size: 46,Default Ridgefield,0,0,0,0,0,48
,Hey Dude WALLY STRETCH 110380500 BEIGE Size: 46,Hey Dude WALLY STRETCH 110380500 BEIGE Size: 46,FBALYB Amazon,-2,-2,0,0,0,0
,Hey Dude WALLY STRETCH 110380500 BEIGE Size: 47,Hey Dude WALLY STRETCH 110380500 BEIGE Size: 47,Default Ridgefield,0,0,0,0,0,18
,Hey Dude WALLY STRETCH 110380500 BEIGE Size: 47,Hey Dude WALLY STRETCH 110380500 BEIGE Size: 47,FBALYB Amazon,-2,-2,0,0,0,0
,Hey Dude WALLY STRETCH 110382600 BLUE Size: 40,Hey Dude WALLY STRETCH 110382600 BLUE Size: 40,Default,0,0,0,0,0,12
,Hey Dude WALLY STRETCH 110382600 BLUE Size: 41,Hey Dude WALLY STRETCH 110382600 BLUE Size: 41,Default Ridgefield,1,1,0,0,0,30
,Hey Dude WALLY STRETCH 110382600 BLUE Size: 41,Hey Dude WALLY STRETCH 110382600 BLUE Size: 41,FBALYB Amazon,1,1,0,0,0,0
,Hey Dude WALLY STRETCH 110382600 BLUE Size: 42,Hey Dude WALLY STRETCH 110382600 BLUE Size: 42,Default Ridgefield,2,2,0,0,0,96
,Hey Dude WALLY STRETCH 110382600BLUE Size: 43,Hey Dude WALLY STRETCH 110382600BLUE Size: 43,Default Ridgefield,1,1,0,0,0,186
,Hey Dude WALLY STRETCH 110382600 BLUE Size: 44,Hey Dude WALLY STRETCH 110382600 BLUE Size: 44,Default Ridgefield,2,2,0,0,0,252
,Hey Dude WALLY STRETCH 110382600 BLUE Size: 45,Hey Dude WALLY STRETCH 110382600 BLUE Size: 45,Default Ridgefield,1,1,0,0,0,120
,Hey Dude WALLY STRETCH 110382600 BLUE Size: 45,Hey Dude WALLY STRETCH 110382600 BLUE Size: 45,FBALYB Amazon,0,0,0,1,0,0
,Hey Dude WALLY STRETCH 110382600 BLUE Size: 46,Hey Dude WALLY STRETCH 110382600 BLUE Size: 46,Default Ridgefield,1,1,0,0,0,102
,Hey Dude WALLY STRETCH 110382600 BLUE Size: 46,Hey Dude WALLY STRETCH 110382600 BLUE Size: 46,FBALYB Amazon,42,34,8,0,8,0
,Hey Dude WALLY STRETCH 110382600 BLUE Size: 47,Hey Dude WALLY STRETCH 110382600 BLUE Size: 47,Default Ridgefield,2,2,0,0,0,30
,Hey Dude WALLY STRETCH 110384900 BLACK Size: 40,Hey Dude WALLY STRETCH 110384900 BLACK Size: 40,Default Ridgefield,12,12,0,0,0,0
,Hey Dude WALLY STRETCH 110384900 BLACK Size: 41,Hey Dude WALLY STRETCH 110384900 BLACK Size: 41,Default Ridgefield,0,0,0,0,0,12
,Hey Dude WALLY STRETCH 110384900 BLACK Size: 42,Hey Dude WALLY STRETCH 110384900 BLACK Size: 42,Default Ridgefield,0,0,0,0,0,30
,Hey Dude WALLY STRETCH 110384900 BLACK Size: 42,Hey Dude WALLY STRETCH 110384900 BLACK Size: 42,FBALYB Amazon,0,0,0,4,0,0
,Hey Dude WALLY STRETCH 110384900 BLACK Size: 43,Hey Dude WALLY STRETCH 110384900 BLACK Size: 43,Default Ridgefield,2,2,0,0,0,60
,Hey Dude WALLY STRETCH 110384900 BLACK Size: 43,Hey Dude WALLY STRETCH 110384900 BLACK Size: 43,FBALYB Amazon,1,1,0,0,0,0
,Hey Dude WALLY STRETCH 110384900 BLACK Size: 44,Hey Dude WALLY STRETCH 110384900 BLACK Size: 44,Default Ridgefield,1,1,0,0,0,84
,Hey Dude WALLY STRETCH 110384900 BLACK Size: 45,Hey Dude WALLY STRETCH 110384900 BLACK Size: 45,Default Ridgefield,0,0,0,0,0,42
,Hey Dude WALLY STRETCH 110384900 BLACK Size: 46,Hey Dude WALLY STRETCH 110384900 BLACK Size: 46,Default Ridgefield,3,3,0,0,0,36
,Hey Dude WALLY STRETCH 110384900 BLACK Size: 47,Hey Dude WALLY STRETCH 110384900 BLACK Size: 47,Default Ridgefield,0,0,0,0,0,12
,Hey Dude Wally Stretch Iron 150203910 Size UK 42/ US 9,Hey Dude Wally Stretch Iron 150203910 Size UK 42/ US 9,FBALYB Amazon,125,125,0,0,0,0
,Hey Dude WALLY WOVEN 110394300 CARBONE Size: 41,Hey Dude WALLY WOVEN 110394300 CARBONE Size: 41,Default,0,0,0,0,0,6
,Hey Dude WALLY WOVEN 110394300 CARBONE Size: 41,Hey Dude WALLY WOVEN 110394300 CARBONE Size: 41,Default Ridgefield,3,3,0,0,0,24
,Hey Dude WALLY WOVEN 110394300 CARBONE Size: 42,Hey Dude WALLY WOVEN 110394300 CARBONE Size: 42,Default Ridgefield,1,1,0,0,0,72
,Hey Dude WALLY WOVEN 110394300 CARBONE Size: 42,Hey Dude WALLY WOVEN 110394300 CARBONE Size: 42,FBALYB Amazon,33,26,7,0,7,0
,Hey Dude WALLY WOVEN 110394300 CARBONE Size: 43,Hey Dude WALLY WOVEN 110394300 CARBONE Size: 43,Default Ridgefield,1,1,0,0,0,138
,Hey Dude WALLY WOVEN 110394300 CARBONE Size: 44,Hey Dude WALLY WOVEN 110394300 CARBONE Size: 44,Default Ridgefield,0,0,0,0,0,186
,Hey Dude WALLY WOVEN 110394300 CARBONE Size: 44,Hey Dude WALLY WOVEN 110394300 CARBONE Size: 44,FBALYB Amazon,-1,-1,0,0,0,0
,Hey Dude WENDY  121410123 CHAMBRAY  WHITE Size: 36,Hey Dude WENDY  121410123 CHAMBRAY  WHITE Size: 36,Default Ridgefield,12,12,0,0,0,0
,Hey Dude WENDY  121410123 CHAMBRAY  WHITE Size: 37,Hey Dude WENDY  121410123 CHAMBRAY  WHITE Size: 37,Default Ridgefield,28,28,0,0,0,18
,Hey Dude WENDY  121410123 CHAMBRAY  WHITE Size: 38,Hey Dude WENDY  121410123 CHAMBRAY  WHITE Size: 38,Default Ridgefield,16,16,0,0,0,48
,Hey Dude WENDY  121410123 CHAMBRAY  WHITE Size: 38,Hey Dude WENDY  121410123 CHAMBRAY  WHITE Size: 38,FBALYB Amazon,0,-1,1,0,1,0
,Hey Dude WENDY  121410123 CHAMBRAY  WHITE Size: 39,Hey Dude WENDY  121410123 CHAMBRAY  WHITE Size: 39,Default Ridgefield,0,0,0,0,0,66
,Hey Dude WENDY  121410123 CHAMBRAY  WHITE Size: 39,Hey Dude WENDY  121410123 CHAMBRAY  WHITE Size: 39,FBALYB Amazon,-1,-3,2,0,2,0
,Hey Dude WENDY  121410123 CHAMBRAY  WHITE Size: 40,Hey Dude WENDY  121410123 CHAMBRAY  WHITE Size: 40,Default,0,0,0,0,0,9
,Hey Dude WENDY  121410123 CHAMBRAY  WHITE Size: 40,Hey Dude WENDY  121410123 CHAMBRAY  WHITE Size: 40,Default Ridgefield,0,0,0,0,0,54
,Hey Dude WENDY  121410123 CHAMBRAY  WHITE Size: 40,Hey Dude WENDY  121410123 CHAMBRAY  WHITE Size: 40,FBALYB Amazon,1,1,0,0,0,0
,Hey Dude WENDY  121410123 CHAMBRAY  WHITE Size: 41,Hey Dude WENDY  121410123 CHAMBRAY  WHITE Size: 41,Default Ridgefield,0,0,0,0,0,42
,Hey Dude WENDY 121412526 CHAMBRAY NAVY WHITE Size: 37,Hey Dude WENDY 121412526 CHAMBRAY NAVY WHITE Size: 37,Default Ridgefield,6,6,0,0,0,6
,Hey Dude WENDY 121412526 CHAMBRAY NAVY WHITE Size: 38,Hey Dude WENDY 121412526 CHAMBRAY NAVY WHITE Size: 38,Default Ridgefield,11,11,0,0,0,24
,Hey Dude WENDY 121412526 CHAMBRAY NAVY WHITE Size: 39,Hey Dude WENDY 121412526 CHAMBRAY NAVY WHITE Size: 39,Default Ridgefield,7,7,0,0,0,36
,Hey Dude WENDY 121413058 CHAMBRAY LIGHT GREY Size: 36,Hey Dude WENDY 121413058 CHAMBRAY LIGHT GREY Size: 36,Default Ridgefield,2,2,0,0,0,0
,Hey Dude WENDY 121413058 CHAMBRAY LIGHT GREY Size: 36,Hey Dude WENDY 121413058 CHAMBRAY LIGHT GREY Size: 36,FBALYB Amazon,1,1,0,0,0,0
,Hey Dude WENDY  121413058 CHAMBRAY LIGHT GREY Size: 37,Hey Dude WENDY  121413058 CHAMBRAY LIGHT GREY Size: 37,Default Ridgefield,1,1,0,0,0,6
,Hey Dude WENDY  121413058 CHAMBRAY LIGHT GREY Size: 37,Hey Dude WENDY  121413058 CHAMBRAY LIGHT GREY Size: 37,FBALYB Amazon,25,25,0,0,0,0
,Hey Dude WENDY  121413058 CHAMBRAY LIGHT GREY Size: 38,Hey Dude WENDY  121413058 CHAMBRAY LIGHT GREY Size: 38,Default Ridgefield,2,2,0,0,0,120
,Hey Dude WENDY  121413058 CHAMBRAY LIGHT GREY Size: 38,Hey Dude WENDY  121413058 CHAMBRAY LIGHT GREY Size: 38,FBALYB Amazon,148,147,1,12,1,0
,Hey Dude WENDY  121413058 CHAMBRAY LIGHT GREY Size: 39,Hey Dude WENDY  121413058 CHAMBRAY LIGHT GREY Size: 39,Default Ridgefield,0,0,0,0,0,168
,Hey Dude WENDY  121413058 CHAMBRAY LIGHT GREY Size: 39,Hey Dude WENDY  121413058 CHAMBRAY LIGHT GREY Size: 39,FBALYB Amazon,75,73,2,0,2,0
,Hey Dude WENDY  121413058 CHAMBRAY LIGHT GREY Size: 40,Hey Dude WENDY  121413058 CHAMBRAY LIGHT GREY Size: 40,Default Ridgefield,1,1,0,0,0,132
,Hey Dude WENDY  121413058 CHAMBRAY LIGHT GREY Size: 41,Hey Dude WENDY  121413058 CHAMBRAY LIGHT GREY Size: 41,Default Ridgefield,0,0,0,0,0,102
,Hey Dude WENDY  121414949 CHAMBRAY OFF BLACK Size: 37,Hey Dude WENDY  121414949 CHAMBRAY OFF BLACK Size: 37,Default Ridgefield,0,0,0,0,0,30
,Hey Dude WENDY  121414949 CHAMBRAY OFF BLACK Size: 37,Hey Dude WENDY  121414949 CHAMBRAY OFF BLACK Size: 37,FBALYB Amazon,-1,-1,0,0,0,0
,Hey Dude WENDY  121414949CHAMBRAY OFF BLACK Size: 38,Hey Dude WENDY  121414949CHAMBRAY OFF BLACK Size: 38,Default Ridgefield,0,0,0,0,0,72
,Hey Dude WENDY  121414949CHAMBRAY OFF BLACK Size: 38,Hey Dude WENDY  121414949CHAMBRAY OFF BLACK Size: 38,FBALYB Amazon,-2,-2,0,0,0,0
,Hey Dude WENDY  121414949 CHAMBRAY OFF BLACK Size: 39,Hey Dude WENDY  121414949 CHAMBRAY OFF BLACK Size: 39,Default Ridgefield,0,0,0,0,0,108
,Hey Dude WENDY  121414949 CHAMBRAY OFF BLACK Size: 39,Hey Dude WENDY  121414949 CHAMBRAY OFF BLACK Size: 39,FBALYB Amazon,-6,-7,1,0,1,0
,Hey Dude WENDY  121414949 CHAMBRAY OFF BLACK Size: 40,Hey Dude WENDY  121414949 CHAMBRAY OFF BLACK Size: 40,Default Ridgefield,0,0,0,0,0,84
,Hey Dude WENDY  121414949 CHAMBRAY OFF BLACK Size: 40,Hey Dude WENDY  121414949 CHAMBRAY OFF BLACK Size: 40,FBALYB Amazon,-4,-4,0,0,0,0
,Hey Dude WENDY  121414949 CHAMBRAY OFF BLACK Size: 41,Hey Dude WENDY  121414949 CHAMBRAY OFF BLACK Size: 41,Default Ridgefield,0,0,0,0,0,66
,Hey Dude WENDY  121414949 CHAMBRAY OFF BLACK Size: 41,Hey Dude WENDY  121414949 CHAMBRAY OFF BLACK Size: 41,FBALYB Amazon,-3,-3,0,0,0,0
,Hey Dude WENDY  121414949 CHAMBRAY OFF BLACK Size: 42,Hey Dude WENDY  121414949 CHAMBRAY OFF BLACK Size: 42,Default Ridgefield,0,0,0,0,0,6
,Hey Dude WENDY 121415016 SPARKLING ROSE GOLD Size: 37,Hey Dude WENDY 121415016 SPARKLING ROSE GOLD Size: 37,Default Ridgefield,0,0,0,0,0,22
,Hey Dude WENDY 121415016 SPARKLING ROSE GOLD Size: 37,Hey Dude WENDY 121415016 SPARKLING ROSE GOLD Size: 37,FBALYB Amazon,16,15,1,0,1,0
,Hey Dude WENDY 121415016 SPARKLING ROSE GOLD Size: 38,Hey Dude WENDY 121415016 SPARKLING ROSE GOLD Size: 38,Default,0,0,0,0,0,4
,Hey Dude WENDY 121415016 SPARKLING ROSE GOLD Size: 38,Hey Dude WENDY 121415016 SPARKLING ROSE GOLD Size: 38,Default Ridgefield,0,0,0,0,0,55
,Hey Dude WENDY 121415016 SPARKLING ROSE GOLD Size: 38,Hey Dude WENDY 121415016 SPARKLING ROSE GOLD Size: 38,FBALYB Amazon,33,33,0,0,0,0
,Hey Dude WENDY 121415016 SPARKLING ROSE GOLD Size: 39,Hey Dude WENDY 121415016 SPARKLING ROSE GOLD Size: 39,Default,0,0,0,0,0,3
,Hey Dude WENDY 121415016 SPARKLING ROSE GOLD Size: 39,Hey Dude WENDY 121415016 SPARKLING ROSE GOLD Size: 39,Default Ridgefield,0,0,0,0,0,72
,Hey Dude WENDY 121415016 SPARKLING ROSE GOLD Size: 39,Hey Dude WENDY 121415016 SPARKLING ROSE GOLD Size: 39,FBALYB Amazon,-1,-1,0,0,0,0
,Hey Dude WENDY 121415016 SPARKLING ROSE GOLD Size: 40,Hey Dude WENDY 121415016 SPARKLING ROSE GOLD Size: 40,Default,0,0,0,0,0,4
,Hey Dude WENDY 121415016 SPARKLING ROSE GOLD Size: 40,Hey Dude WENDY 121415016 SPARKLING ROSE GOLD Size: 40,Default Ridgefield,6,6,0,0,0,59
,Hey Dude WENDY 121415016 SPARKLING ROSE GOLD Size: 40,Hey Dude WENDY 121415016 SPARKLING ROSE GOLD Size: 40,FBALYB Amazon,27,27,0,0,0,0
,Hey Dude WENDY 121415016 SPARKLING ROSE GOLD Size: 41,Hey Dude WENDY 121415016 SPARKLING ROSE GOLD Size: 41,Default Ridgefield,0,0,0,0,0,44
,Hey Dude WENDY 121419102 SPARKLING GOLD Size: 36,Hey Dude WENDY 121419102 SPARKLING GOLD Size: 36,FBALYB Amazon,0,-1,1,0,1,0
,Hey Dude WENDY 121419102 SPARKLING GOLD Size: 37,Hey Dude WENDY 121419102 SPARKLING GOLD Size: 37,Default Ridgefield,0,0,0,0,0,18
,Hey Dude WENDY 121419102 SPARKLING GOLD Size: 37,Hey Dude WENDY 121419102 SPARKLING GOLD Size: 37,FBALYB Amazon,17,13,4,0,4,0
,Hey Dude WENDY 121419102 SPARKLING GOLD Size: 38,Hey Dude WENDY 121419102 SPARKLING GOLD Size: 38,Default Ridgefield,1,1,0,0,0,48
,Hey Dude WENDY 121419102 SPARKLING GOLD Size: 38,Hey Dude WENDY 121419102 SPARKLING GOLD Size: 38,FBALYB Amazon,1,0,1,0,1,0
,Hey Dude WENDY 121419102 SPARKLING GOLD Size: 39,Hey Dude WENDY 121419102 SPARKLING GOLD Size: 39,Default Ridgefield,0,0,0,0,0,66
,Hey Dude WENDY 121419102 SPARKLING GOLD Size: 40,Hey Dude WENDY 121419102 SPARKLING GOLD Size: 40,Default Ridgefield,0,0,0,0,0,54
,Hey Dude WENDY 121419102 SPARKLING GOLD Size: 41,Hey Dude WENDY 121419102 SPARKLING GOLD Size: 41,Default Ridgefield,0,0,0,0,0,42
,Hey Dude WENDY L 121704900 BLACK Size: 36,Hey Dude WENDY L 121704900 BLACK Size: 36,Default Ridgefield,2,2,0,0,0,0
,Hey Dude WENDY L 121704900 BLACK Size: 37,Hey Dude WENDY L 121704900 BLACK Size: 37,Default Ridgefield,0,0,0,0,0,30
,Hey Dude WENDY L 121704900 BLACK Size: 37,Hey Dude WENDY L 121704900 BLACK Size: 37,FBALYB Amazon,23,18,5,0,5,0
,Hey Dude WENDY L 121704900 BLACK Size: 38,Hey Dude WENDY L 121704900 BLACK Size: 38,Default,0,0,0,0,0,7
,Hey Dude WENDY L 121704900 BLACK Size: 38,Hey Dude WENDY L 121704900 BLACK Size: 38,Default Ridgefield,0,0,0,0,0,66
,Hey Dude WENDY L 121704900 BLACK Size: 38,Hey Dude WENDY L 121704900 BLACK Size: 38,FBALYB Amazon,33,-3,36,0,36,0
,Hey Dude WENDY L 121704900 BLACK Size: 39,Hey Dude WENDY L 121704900 BLACK Size: 39,Default Ridgefield,1,1,0,0,0,96
,Hey Dude WENDY L 121704900 BLACK Size: 39,Hey Dude WENDY L 121704900 BLACK Size: 39,FBALYB Amazon,0,-1,1,0,1,0
,Hey Dude WENDY L 121704900 BLACK Size: 40,Hey Dude WENDY L 121704900 BLACK Size: 40,Default Ridgefield,1,1,0,0,0,78
,Hey Dude WENDY L 121704900 BLACK Size: 41,Hey Dude WENDY L 121704900 BLACK Size: 41,Default Ridgefield,1,1,0,0,0,60
,Hey Dude WENDY L LINEN 121533901 IRON Size: 36,Hey Dude WENDY L LINEN 121533901 IRON Size: 36,Default Ridgefield,1,1,0,0,0,0
,Hey Dude WENDY L LINEN 121533901 IRON Size: 37,Hey Dude WENDY L LINEN 121533901 IRON Size: 37,Default Ridgefield,3,3,0,0,0,48
,Hey Dude WENDY L LINEN 121533901 IRON Size: 38,Hey Dude WENDY L LINEN 121533901 IRON Size: 38,Default Ridgefield,0,0,0,0,0,108
,Hey Dude WENDY L LINEN 121533901 IRON Size: 39,Hey Dude WENDY L LINEN 121533901 IRON Size: 39,Default Ridgefield,0,0,0,0,0,156
,Hey Dude WENDY L LINEN 121533901 IRON Size: 40,Hey Dude WENDY L LINEN 121533901 IRON Size: 40,Default Ridgefield,0,0,0,0,0,120
,Hey Dude WENDY L LINEN 121533901 IRON Size: 41,Hey Dude WENDY L LINEN 121533901 IRON Size: 41,Default Ridgefield,0,0,0,0,0,96
,Hey Dude WENDY L LINEN 121533901 IRON Size: 41,Hey Dude WENDY L LINEN 121533901 IRON Size: 41,FBALYB Amazon,-1,-1,0,0,0,0
,Hey Dude WENDY WASHED 121415602 LILAC ORCHID Size: 37,Hey Dude WENDY WASHED 121415602 LILAC ORCHID Size: 37,Default Ridgefield,6,6,0,0,0,0
,Hey Dude WENDY WASHED 121415602 LILAC ORCHID Size: 38,Hey Dude WENDY WASHED 121415602 LILAC ORCHID Size: 38,FBALYB Amazon,7,7,0,0,0,0
,Hey Dude WENDY WASHED 121415602 LILAC ORCHID Size: 39,Hey Dude WENDY WASHED 121415602 LILAC ORCHID Size: 39,FBALYB Amazon,8,7,1,0,1,0
,Hey Dude WENDY WASHED 121415602 LILAC ORCHID Size: 40,Hey Dude WENDY WASHED 121415602 LILAC ORCHID Size: 40,FBALYB Amazon,11,11,0,0,0,0
,Hi Chew 30oz 2pk,Hi Chew 30oz 2pk,FBALYB Amazon,-169,-170,1,173,1,0
,Hi-Chew Fruit Chews Variety 30oz,Hi-Chew Fruit Chews Variety 30oz,Default,0,-1,1,0,0,0
,Hi-Chew Fruit Chews Variety 30oz,Hi-Chew Fruit Chews Variety 30oz,FBALYB Amazon,-305,-320,15,366,15,0
,Hidden Valley Dressing 2pk/40oz,"Hidden Valley Ranch Dressing, Home Style ‑ 2 bottles, 40 fl oz each",FBALYB Amazon,9,9,0,0,0,0
,Hidden Valley Dressing Mix 16oz,"Hidden Valley Original Ranch Seasoning and Salad Dressing Mix, 16 Ounce",Default Oxford,240,240,0,0,0,0
,Hidden Valley Dressing Mix 16oz,"Hidden Valley Original Ranch Seasoning and Salad Dressing Mix, 16 Ounce",FBALYB Amazon,4,4,0,0,0,0
,Hidden Valley Dressing Mix 16oz 2pk,Hidden Valley Dressing Mix 16oz 2pk,FBALYB Amazon,15,14,1,0,1,0
,Hidden Valley Ranch Dressing 2x40 oz,Hidden Valley Ranch Dressing 2x40 oz,FBALYB Amazon,-38,-38,0,51,0,0
,Higgins Conure/Cockatiel 3lb 2pk,Higgins Conure/Cockatiel 3lb 2pk,FBALYB Amazon,4,4,0,1,0,0
,"Higgins Hamster & Gerbil Food, 2.5lb","Higgins Sunburst Gourmet Blend Hamster & Gerbil Food, 2.5lb",FBALYB Amazon,1,1,0,0,0,0
,Higgins InTune Food for Parrots 3lb,Higgins InTune Food for Parrots 3lb,FBALYB Amazon,1,1,0,0,0,0
,Higgins Large Safflower Gold 3lb 2pk,Higgins Large Safflower Gold 3lb 2pk,FBALYB Amazon,-1,-1,0,1,0,0
,Higgins Pet Food Large Safflower Gold ‑ 3 lb,Higgins Pet Food HS30121 Large Safflower Gold ‑ 3 lb,FBALYB Amazon,67,67,0,0,0,0
,Higgins Premium Sunburst Conure 3Lb,Higgins Premium Sunburst Conure 3Lb,FBALYB Amazon,1,1,0,0,0,0
,Higgins Premium Sunburst Conure 3Lb 2pk,Higgins Premium Sunburst Conure 3Lb 2pk,Default,-4,-4,0,0,0,0
,Higgins Premium Sunburst Conure 3Lb 2pk,Higgins Premium Sunburst Conure 3Lb 2pk,FBALYB Amazon,1,1,0,0,0,0
,"Higgins Safflower Gold, Conure/Cockatiel, 3 lb","Higgins Safflower Gold - Conure/Cockatiel, 3 lb",FBALYB Amazon,2,2,0,0,0,0
,"Higgins Safflower Gold Conure/Tiel, 25LB","Higgins Safflower Gold Conure/Tiel, 25LB",Default,0,0,0,0,0,12
,"Higgins Safflower Gold Conure/Tiel, 25LB","Higgins Safflower Gold Conure/Tiel, 25LB",FBALYB Amazon,2,2,0,2,0,0
,Higgins Safflower Gold Nut Fruit Mix,Higgins Safflower Gold Large Parrot Diet Bird Food Nut Fruit Mix,Default,0,0,0,0,0,30
,Higgins Safflower Gold Nut Fruit Mix,Higgins Safflower Gold Large Parrot Diet Bird Food Nut Fruit Mix,FBALYB Amazon,2,2,0,3,0,0
,"Higgins Sunburst Chinchilla Food Mix, 3 lbs.","Higgins Sunburst Gourmet Chinchilla Food Mix, 3 lbs.",FBALYB Amazon,1,1,0,0,0,0
,Higgins Sunburst Fruit to Nuts Lg Bird 20lb,Higgins Sunburst Fruit to Nuts Lg Bird 20lb,FBALYB Amazon,-3,-3,0,4,0,0
,Higgins Sunburst Rabbit Food 6lb,Higgins Sunburst Rabbit Food 6lb,FBALYB Amazon,3,3,0,0,0,0
,Higgins Sunburst Veggie Stix 4oz 2pk,Higgins Sunburst Veggie Stix 4oz 2pk,FBALYB Amazon,2,2,0,0,0,0
,Higgins Sunburst Veggie Stix Treats 4 OZ,"Higgins Sunburst Veggie Stix Gourmet Treats for Guinea Pigs, Rabbits & Chinchillas, 4 OZ",FBALYB Amazon,-1,-1,0,0,0,0
,Higgins Vita Seed Parakeet Bird Food 2.5 lbs,Higgins Vita Seed Parakeet Bird Food 2.5 lbs,FBALYB Amazon,2,2,0,0,0,0
,Higgins Vita Seed Parakeet Bird Food 2pk,Higgins Vita Seed Parakeet Bird Food 2pk,FBALYB Amazon,2,2,0,0,0,0
,Higgins Vita Seed Parrot Food 25lb,"Higgins Vita Seed Parrot Food for Lrg Hookbills, 25‑Pound",FBALYB Amazon,2,2,0,45,0,0
,Higgins Yucatan Blend Bird Food 3lb 2pk,Higgins Yucatan Blend Bird Food 3lb 2pk,FBALYB Amazon,1,1,0,0,0,0
,Hikari 12.3-Oz Sinking Pellets,"Hikari 12.3-Ounce Lionhead Sinking Pellets for Pets, Mini",FBALYB Amazon,1,1,0,0,0,0
,Hikari Gold Fish Food,Hikari Gold Fish Food 10.5 Oz - Baby Pellet,FBALYB Amazon,0,0,0,1,0,0
,Hilary Radley Ladies Black Pull On Pants #148 Size 10,Hilary Radley Ladies Black Pull On Pants #148 Size 10,Default Ridgefield,10,10,0,0,0,0
,Hilary Radley Ladies Black Pull On Pants #148 Size 8,Hilary Radley Ladies Black Pull On Pants #148 Size 8,Default Ridgefield,7,7,0,0,0,0
,Hilary Radley Ladies Black Texture Pull On Pants #34153 Size 12,Hilary Radley Ladies Black Texture Pull On Pants #34153 Size 12,Default Ridgefield,5,5,0,0,0,0
,Hilary Radley Ladies Black Texture Pull On Pants #34153 Size 6,Hilary Radley Ladies Black Texture Pull On Pants #34153 Size 6,Default Ridgefield,10,10,0,0,0,0
,Hilary Radley Ladies Pull On Pant Black #148 Size 16,Hilary Radley Ladies Pull On Pant Black #148 Size 16,Default Ridgefield,6,6,0,0,0,0
,Hilary Radley Women Black Slim Leg Pull on Pants #148 Size 6 29 inch Inseam,Hilary Radley Women Black Slim Leg Pull on Pants #148 Size 6 29 inch Inseam,Default Ridgefield,8,8,0,0,0,0
,Hilary Radley Women Black Slim Leg Pull on Pants #34143 Size 10 29 Inch Inseam,Hilary Radley Women Black Slim Leg Pull on Pants #34143 Size 10 29 Inch Inseam,Default Ridgefield,5,5,0,0,0,0
,Hilary Radley Women Black Slim Leg Pull On Pants #34153 Size 4 29 Inch Inseam,Hilary Radley Women Black Slim Leg Pull On Pants #34153 Size 4 29 Inch Inseam,Default Ridgefield,5,5,0,0,0,0
,Hilary Radley Women Black Stretch Pull On Dress Pants 1112142 #148 Size 4,Hilary Radley Women Black Stretch Pull On Dress Pants 1112142 #148 Size 4,Default Ridgefield,4,4,0,0,0,0
,Hilary Radley Womens Black Pull On Pants #148 Size 12,Hilary Radley Womens Black Pull On Pants #148 Size 12,Default Ridgefield,12,12,0,0,0,0
,Him & Hers Bundle of Nature Made,Him & Hers Bundle of Nature Made,FBALYB Amazon,190,190,0,0,0,0
,Him & Hers Bundle of Nature Made,Him & Hers Bundle of Nature Made,WFS,-41,-41,0,0,0,0
,Hippeas Organic Vegan White Cheddar 18 Ounce,Hippeas Organic Vegan White Cheddar 18 Ounce,FBALYB Amazon,0,0,0,1,0,0
,Hi-Tor Neo Cat Food 5.5oz,Hi-Tor Neo Cat Food 5.5oz,Default,0,0,0,0,0,68
,Hi-Tor Neo Cat Food 5.5oz 24pk,Hi-Tor Neo Cat Food 5.5oz 24pk,FBALYB Amazon,1,1,0,0,0,0
,Hockey Tape 3-Pack (1 Clear/1 Black/1 White),Hockey Tape 3-Pack (1 Clear/1 Black/1 White),FBALYB Amazon,-1,-1,0,4,0,0
,Hockey Tape 6-Pack (3 Clear/2 Black/1 White),Hockey Tape 6-Pack (3 Clear/2 Black/1 White),Default Ridgefield,20,20,0,0,0,0
,Hockey Tape 6-Pack (3 Clear/2 Black/1 White),Hockey Tape 6-Pack (3 Clear/2 Black/1 White),FBALYB Amazon,121,110,11,7,11,0
,Hockey tape Assorted Kit Ontario 12/29,Hockey tape Assorted Kit Ontario 12/29,Default Oxford,1139,1139,0,0,0,0
,Hockey Tape Black 6pk 24mm x 25 m Ontario,Hockey Tape Black 6pk 24mm x 25 m Ontario,Default Ridgefield,31,31,0,0,0,0
,Hockey Tape Black 6pk 24mm x 25 m Ontario,Hockey Tape Black 6pk 24mm x 25 m Ontario,FBALYB Amazon,4,4,0,0,0,0
,Hockey Tape Black 6pk 24mm x 25 m Ontario,Hockey Tape Black 6pk 24mm x 25 m Ontario,WFS,-2,-2,0,0,0,0
,Hockey Tape Clear 10ct,Hockey Tape Clear 10ct,FBALYB Amazon,-13,-13,0,3,0,0
,Hockey Tape Clear 12 ct Ontario,Hockey Tape Clear 12 ct Ontario,Default Ridgefield,88,88,0,0,0,0
,Hockey Tape Clear 12 ct Ontario,Hockey Tape Clear 12 ct Ontario,FBALYB Amazon,280,280,0,44,0,0
,Hockey Tape Clear 12 ct Ontario,Hockey Tape Clear 12 ct Ontario,WFS,-5,-5,0,0,0,0
,Hoka Bondi 7 Black / Black Men 1110518-BBLC Size 10,Hoka Bondi 7 Black / Black Men 1110518-BBLC Size 10,Default Ridgefield,13,9,4,0,4,0
,Hoka Bondi 7 Black / Black Men 1110518-BBLC Size 10,Hoka Bondi 7 Black / Black Men 1110518-BBLC Size 10,FBALYB Amazon,40,40,0,0,0,0
,Hoka Bondi 7 Black / Black Men 1110518-BBLC Size 10.5,Hoka Bondi 7 Black / Black Men 1110518-BBLC Size 10.5,Default Ridgefield,24,23,1,0,1,0
,Hoka Bondi 7 Black / Black Men 1110518-BBLC Size 10.5,Hoka Bondi 7 Black / Black Men 1110518-BBLC Size 10.5,FBALYB Amazon,-2,-2,0,0,0,0
,Hoka Bondi 7 Black / Black Men 1110518-BBLC Size 11,Hoka Bondi 7 Black / Black Men 1110518-BBLC Size 11,Default Ridgefield,52,52,0,0,0,0
,Hoka Bondi 7 Black / Black Men 1110518-BBLC Size 11.5,Hoka Bondi 7 Black / Black Men 1110518-BBLC Size 11.5,Default Ridgefield,36,36,0,0,0,0
,Hoka Bondi 7 Black / Black Men 1110518-BBLC Size 11.5,Hoka Bondi 7 Black / Black Men 1110518-BBLC Size 11.5,FBALYB Amazon,2,2,0,0,0,0
,Hoka Bondi 7 Black / Black Men 1110518-BBLC Size 12,Hoka Bondi 7 Black / Black Men 1110518-BBLC Size 12,Default Ridgefield,17,17,0,0,0,0
,Hoka Bondi 7 Black / Black Men 1110518-BBLC Size 12,Hoka Bondi 7 Black / Black Men 1110518-BBLC Size 12,FBALYB Amazon,19,19,0,0,0,0
,Hoka Bondi 7 Black / Black Men 1110518-BBLC Size 13,Hoka Bondi 7 Black / Black Men 1110518-BBLC Size 13,Default Ridgefield,10,8,2,0,2,0
,Hoka Bondi 7 Black / Black Men 1110518-BBLC Size 13,Hoka Bondi 7 Black / Black Men 1110518-BBLC Size 13,FBALYB Amazon,2,2,0,0,0,0
,Hoka Bondi 7 Black / Black Men 1110518-BBLC Size 15,Hoka Bondi 7 Black / Black Men 1110518-BBLC Size 15,Default Ridgefield,12,12,0,0,0,0
,Hoka Bondi 7 Black / Black Men 1110518-BBLC Size 9,Hoka Bondi 7 Black / Black Men 1110518-BBLC Size 9,FBALYB Amazon,37,37,0,0,0,0
,Hoka Bondi 7 Black / Black Men 1110518-BBLC Size 9.5,Hoka Bondi 7 Black / Black Men 1110518-BBLC Size 9.5,FBALYB Amazon,51,51,0,0,0,0
,Hoka Bondi 7 Black / Black Women 1110519-BBLC Size 10,Hoka Bondi 7 Black / Black Women 1110519-BBLC Size 10,Default Ridgefield,6,6,0,0,0,0
,Hoka Bondi 7 Black / Black Women 1110519-BBLC Size 10,Hoka Bondi 7 Black / Black Women 1110519-BBLC Size 10,FBALYB Amazon,10,10,0,0,0,0
,Hoka Bondi 7 Black / Black Women 1110519-BBLC Size 10.5,Hoka Bondi 7 Black / Black Women 1110519-BBLC Size 10.5,Default Ridgefield,8,7,1,0,1,0
,Hoka Bondi 7 Black / Black Women 1110519-BBLC Size 11,Hoka Bondi 7 Black / Black Women 1110519-BBLC Size 11,Default Ridgefield,50,50,0,0,0,0
,Hoka Bondi 7 Black / Black Women 1110519-BBLC Size 6,Hoka Bondi 7 Black / Black Women 1110519-BBLC Size 6,FBALYB Amazon,-2,-2,0,0,0,0
,Hoka Bondi 7 Black / Black Women 1110519-BBLC Size 7,Hoka Bondi 7 Black / Black Women 1110519-BBLC Size 7,Default Ridgefield,12,9,3,0,3,0
,Hoka Bondi 7 Black / Black Women 1110519-BBLC Size 7,Hoka Bondi 7 Black / Black Women 1110519-BBLC Size 7,FBALYB Amazon,-1,-1,0,0,0,0
,Hoka Bondi 7 Black / Black Women 1110519-BBLC Size 7.5,Hoka Bondi 7 Black / Black Women 1110519-BBLC Size 7.5,Default Ridgefield,36,36,0,0,0,0
,Hoka Bondi 7 Black / Black Women 1110519-BBLC Size 8,Hoka Bondi 7 Black / Black Women 1110519-BBLC Size 8,Default Ridgefield,41,41,0,0,0,0
,Hoka Bondi 7 Black / Black Women 1110519-BBLC Size 8,Hoka Bondi 7 Black / Black Women 1110519-BBLC Size 8,FBALYB Amazon,-1,-1,0,0,0,0
,Hoka Bondi 7 Black / Black Women 1110519-BBLC Size 8.5,Hoka Bondi 7 Black / Black Women 1110519-BBLC Size 8.5,Default Ridgefield,48,47,1,0,1,0
,Hoka Bondi 7 Black / Black Women 1110519-BBLC Size 8.5,Hoka Bondi 7 Black / Black Women 1110519-BBLC Size 8.5,FBALYB Amazon,1,-4,5,0,5,0
,Hoka Bondi 7 Black / Black Women 1110519-BBLC Size 9,Hoka Bondi 7 Black / Black Women 1110519-BBLC Size 9,FBALYB Amazon,-5,-5,0,0,0,0
,Hoka Bondi 7 Black / Black Women 1110519-BBLC Size 9.5,Hoka Bondi 7 Black / Black Women 1110519-BBLC Size 9.5,Default Ridgefield,18,18,0,0,0,0
,Hoka Bondi 7 Black / Black Women 1110519-BBLC Size 9.5,Hoka Bondi 7 Black / Black Women 1110519-BBLC Size 9.5,FBALYB Amazon,-8,-8,0,0,0,0
,Hoka Bondi 7 Black Iris / Ballad Blue Women 1110519-BIBBL Size 10,Hoka Bondi 7 Black Iris / Ballad Blue Women 1110519-BIBBL Size 10,FBALYB Amazon,-2,-2,0,0,0,0
,Hoka Bondi 7 Black Iris / Ballad Blue Women 1110519-BIBBL Size 11,Hoka Bondi 7 Black Iris / Ballad Blue Women 1110519-BIBBL Size 11,Default Ridgefield,24,24,0,0,0,0
,Hoka Bondi 7 Black Iris / Ballad Blue Women 1110519-BIBBL Size 6,Hoka Bondi 7 Black Iris / Ballad Blue Women 1110519-BIBBL Size 6,Default Ridgefield,24,24,0,0,0,0
,Hoka Bondi 7 Black Iris / Ballad Blue Women 1110519-BIBBL Size 6.5,Hoka Bondi 7 Black Iris / Ballad Blue Women 1110519-BIBBL Size 6.5,FBALYB Amazon,12,12,0,0,0,0
,Hoka Bondi 7 Black Iris / Ballad Blue Women 1110519-BIBBL Size 7.5,Hoka Bondi 7 Black Iris / Ballad Blue Women 1110519-BIBBL Size 7.5,FBALYB Amazon,-1,-1,0,0,0,0
,Hoka Bondi 7 Black Iris / Ballad Blue Women 1110519-BIBBL Size 8,Hoka Bondi 7 Black Iris / Ballad Blue Women 1110519-BIBBL Size 8,FBALYB Amazon,-2,-3,1,0,1,0
,Hoka Bondi 7 Black Iris / Ballad Blue Women 1110519-BIBBL Size 8.5,Hoka Bondi 7 Black Iris / Ballad Blue Women 1110519-BIBBL Size 8.5,FBALYB Amazon,24,24,0,0,0,0
,Hoka Bondi 7 Black Iris / Ballad Blue Women 1110519-BIBBL Size 9,Hoka Bondi 7 Black Iris / Ballad Blue Women 1110519-BIBBL Size 9,FBALYB Amazon,-3,-3,0,0,0,0
,Hoka Bondi 7 Black Iris / Ballad Blue Women 1110519-BIBBL Size 9.5,Hoka Bondi 7 Black Iris / Ballad Blue Women 1110519-BIBBL Size 9.5,FBALYB Amazon,-7,-7,0,0,0,0
,Hoka Bondi 7 Black / White Women 1110519-BWHT Size 10,Hoka Bondi 7 Black / White Women 1110519-BWHT Size 10,Default Ridgefield,6,6,0,0,0,0
,Hoka Bondi 7 Black / White Women 1110519-BWHT Size 10.5,Hoka Bondi 7 Black / White Women 1110519-BWHT Size 10.5,Default Ridgefield,8,8,0,0,0,0
,Hoka Bondi 7 Black / White Women 1110519-BWHT Size 11,Hoka Bondi 7 Black / White Women 1110519-BWHT Size 11,Default Ridgefield,45,45,0,0,0,0
,Hoka Bondi 7 Black / White Women 1110519-BWHT Size 6,Hoka Bondi 7 Black / White Women 1110519-BWHT Size 6,Default Ridgefield,6,6,0,0,0,0
,Hoka Bondi 7 Black / White Women 1110519-BWHT Size 6,Hoka Bondi 7 Black / White Women 1110519-BWHT Size 6,FBALYB Amazon,-2,-2,0,0,0,0
,Hoka Bondi 7 Black / White Women 1110519-BWHT Size 6.5,Hoka Bondi 7 Black / White Women 1110519-BWHT Size 6.5,Default Ridgefield,12,12,0,0,0,0
,Hoka Bondi 7 Black / White Women 1110519-BWHT Size 7,Hoka Bondi 7 Black / White Women 1110519-BWHT Size 7,Default Ridgefield,55,53,2,0,2,0
,Hoka Bondi 7 Black / White Women 1110519-BWHT Size 7,Hoka Bondi 7 Black / White Women 1110519-BWHT Size 7,FBALYB Amazon,1,1,0,0,0,0
,Hoka Bondi 7 Black / White Women 1110519-BWHT Size 7.5,Hoka Bondi 7 Black / White Women 1110519-BWHT Size 7.5,Default Ridgefield,130,130,0,0,0,0
,Hoka Bondi 7 Black / White Women 1110519-BWHT Size 8,Hoka Bondi 7 Black / White Women 1110519-BWHT Size 8,Default Ridgefield,103,102,1,0,1,0
,Hoka Bondi 7 Black / White Women 1110519-BWHT Size 8.5,Hoka Bondi 7 Black / White Women 1110519-BWHT Size 8.5,Default Ridgefield,36,35,1,0,1,0
,Hoka Bondi 7 Black / White Women 1110519-BWHT Size 8.5,Hoka Bondi 7 Black / White Women 1110519-BWHT Size 8.5,FBALYB Amazon,-3,-3,0,0,0,0
,Hoka Bondi 7 Black / White Women 1110519-BWHT Size 9,Hoka Bondi 7 Black / White Women 1110519-BWHT Size 9,Default Ridgefield,16,16,0,0,0,0
,Hoka Bondi 7 Black / White Women 1110519-BWHT Size 9,Hoka Bondi 7 Black / White Women 1110519-BWHT Size 9,FBALYB Amazon,-1,-1,0,0,0,0
,Hoka Bondi 7 Black / White Women 1110519-BWHT Size 9.5,Hoka Bondi 7 Black / White Women 1110519-BWHT Size 9.5,Default Ridgefield,54,54,0,0,0,0
,Hoka Bondi 7 Black / White Women 1110519-BWHT Size 9.5,Hoka Bondi 7 Black / White Women 1110519-BWHT Size 9.5,FBALYB Amazon,40,40,0,0,0,0
,Hoka Bondi 7 Blue Fog / Ombre Blue Women 1110519-BFOB Size 11,Hoka Bondi 7 Blue Fog / Ombre Blue Women 1110519-BFOB Size 11,Default Ridgefield,48,48,0,0,0,0
,Hoka Bondi 7 Blue Fog / Ombre Blue Women 1110519-BFOB Size 6,Hoka Bondi 7 Blue Fog / Ombre Blue Women 1110519-BFOB Size 6,Default Ridgefield,36,36,0,0,0,0
,Hoka Bondi 7 Blue Fog / Ombre Blue Women 1110519-BFOB Size 6.5,Hoka Bondi 7 Blue Fog / Ombre Blue Women 1110519-BFOB Size 6.5,FBALYB Amazon,-1,-1,0,0,0,0
,Hoka Bondi 7 Blue Fog / Ombre Blue Women 1110519-BFOB Size 7,Hoka Bondi 7 Blue Fog / Ombre Blue Women 1110519-BFOB Size 7,FBALYB Amazon,-1,-1,0,0,0,0
,Hoka Bondi 7 Blue Fog / Ombre Blue Women 1110519-BFOB Size 7.5,Hoka Bondi 7 Blue Fog / Ombre Blue Women 1110519-BFOB Size 7.5,FBALYB Amazon,1,1,0,0,0,0
,Hoka Bondi 7 Blue Fog / Ombre Blue Women 1110519-BFOB Size 8,Hoka Bondi 7 Blue Fog / Ombre Blue Women 1110519-BFOB Size 8,FBALYB Amazon,-1,-1,0,0,0,0
,Hoka Bondi 7 Blue Fog / Ombre Blue Women 1110519-BFOB Size 9,Hoka Bondi 7 Blue Fog / Ombre Blue Women 1110519-BFOB Size 9,FBALYB Amazon,-1,-1,0,0,0,0
,Hoka Bondi 7 Blue Haze / Black Iris Women 1110519-BHBI Size 10,Hoka Bondi 7 Blue Haze / Black Iris Women 1110519-BHBI Size 10,Default Ridgefield,2,2,0,0,0,0
,Hoka Bondi 7 Blue Haze / Black Iris Women 1110519-BHBI Size 11,Hoka Bondi 7 Blue Haze / Black Iris Women 1110519-BHBI Size 11,Default Ridgefield,77,77,0,0,0,0
,Hoka Bondi 7 Blue Haze / Black Iris Women 1110519-BHBI Size 6.5,Hoka Bondi 7 Blue Haze / Black Iris Women 1110519-BHBI Size 6.5,FBALYB Amazon,7,7,0,0,0,0
,Hoka Bondi 7 Blue Haze / Black Iris Women 1110519-BHBI Size 7,Hoka Bondi 7 Blue Haze / Black Iris Women 1110519-BHBI Size 7,FBALYB Amazon,-1,-1,0,0,0,0
,Hoka Bondi 7 Blue Haze / Black Iris Women 1110519-BHBI Size 7.5,Hoka Bondi 7 Blue Haze / Black Iris Women 1110519-BHBI Size 7.5,FBALYB Amazon,-1,-1,0,0,0,0
,Hoka Bondi 7 Blue Haze / Black Iris Women 1110519-BHBI Size 8,Hoka Bondi 7 Blue Haze / Black Iris Women 1110519-BHBI Size 8,FBALYB Amazon,-1,-1,0,0,0,0
,Hoka Bondi 7 Blue Haze / Black Iris Women 1110519-BHBI Size 8.5,Hoka Bondi 7 Blue Haze / Black Iris Women 1110519-BHBI Size 8.5,Default Ridgefield,6,6,0,0,0,0
,Hoka Bondi 7 Lunar Rock / Black Iris Women 1110519-LRBI Size 10,Hoka Bondi 7 Lunar Rock / Black Iris Women 1110519-LRBI Size 10,Default Ridgefield,110,108,2,0,2,0
,Hoka Bondi 7 Lunar Rock / Black Iris Women 1110519-LRBI Size 11,Hoka Bondi 7 Lunar Rock / Black Iris Women 1110519-LRBI Size 11,Default Ridgefield,34,34,0,0,0,0
,Hoka Bondi 7 Lunar Rock / Black Iris Women 1110519-LRBI Size 6,Hoka Bondi 7 Lunar Rock / Black Iris Women 1110519-LRBI Size 6,Default Ridgefield,6,6,0,0,0,0
,Hoka Bondi 7 Lunar Rock / Black Iris Women 1110519-LRBI Size 6.5,Hoka Bondi 7 Lunar Rock / Black Iris Women 1110519-LRBI Size 6.5,Default Ridgefield,6,6,0,0,0,0
,Hoka Bondi 7 Lunar Rock / Black Iris Women 1110519-LRBI Size 6.5,Hoka Bondi 7 Lunar Rock / Black Iris Women 1110519-LRBI Size 6.5,FBALYB Amazon,3,3,0,0,0,0
,Hoka Bondi 7 Lunar Rock / Black Iris Women 1110519-LRBI Size 7,Hoka Bondi 7 Lunar Rock / Black Iris Women 1110519-LRBI Size 7,Default Ridgefield,18,18,0,0,0,0
,Hoka Bondi 7 Lunar Rock / Black Iris Women 1110519-LRBI Size 7.5,Hoka Bondi 7 Lunar Rock / Black Iris Women 1110519-LRBI Size 7.5,Default Ridgefield,113,112,1,0,1,0
,Hoka Bondi 7 Lunar Rock / Black Iris Women 1110519-LRBI Size 8,Hoka Bondi 7 Lunar Rock / Black Iris Women 1110519-LRBI Size 8,Default Ridgefield,113,113,0,0,0,0
,Hoka Bondi 7 Lunar Rock / Black Iris Women 1110519-LRBI Size 8.5,Hoka Bondi 7 Lunar Rock / Black Iris Women 1110519-LRBI Size 8.5,Default Ridgefield,118,118,0,0,0,0
,Hoka Bondi 7 Lunar Rock / Black Iris Women 1110519-LRBI Size 9,Hoka Bondi 7 Lunar Rock / Black Iris Women 1110519-LRBI Size 9,Default Ridgefield,103,103,0,0,0,0
,Hoka Bondi 7 Lunar Rock / Black Iris Women 1110519-LRBI Size 9.5,Hoka Bondi 7 Lunar Rock / Black Iris Women 1110519-LRBI Size 9.5,Default Ridgefield,6,6,0,0,0,0
,Hoka Bondi 7 Turbulence / Chili Men 1110518-TCHL Size 10,Hoka Bondi 7 Turbulence / Chili Men 1110518-TCHL Size 10,Default Ridgefield,30,30,0,0,0,0
,Hoka Bondi 7 Turbulence / Chili Men 1110518-TCHL Size 10.5,Hoka Bondi 7 Turbulence / Chili Men 1110518-TCHL Size 10.5,Default Ridgefield,30,30,0,0,0,0
,Hoka Bondi 7 Turbulence / Chili Men 1110518-TCHL Size 11,Hoka Bondi 7 Turbulence / Chili Men 1110518-TCHL Size 11,Default Ridgefield,29,29,0,0,0,0
,Hoka Bondi 7 Turbulence / Chili Men 1110518-TCHL Size 11.5,Hoka Bondi 7 Turbulence / Chili Men 1110518-TCHL Size 11.5,Default Ridgefield,10,10,0,0,0,0
,Hoka Bondi 7 Turbulence / Chili Men 1110518-TCHL Size 12,Hoka Bondi 7 Turbulence / Chili Men 1110518-TCHL Size 12,Default Ridgefield,6,6,0,0,0,0
,Hoka Bondi 7 Turbulence / Chili Men 1110518-TCHL Size 12,Hoka Bondi 7 Turbulence / Chili Men 1110518-TCHL Size 12,FBALYB Amazon,5,5,0,0,0,0
,Hoka Bondi 7 Turbulence / Chili Men 1110518-TCHL Size 13,Hoka Bondi 7 Turbulence / Chili Men 1110518-TCHL Size 13,Default Ridgefield,6,6,0,0,0,0
,Hoka Bondi 7 Turbulence / Chili Men 1110518-TCHL Size 7.5,Hoka Bondi 7 Turbulence / Chili Men 1110518-TCHL Size 7.5,Default Ridgefield,6,6,0,0,0,0
,Hoka Bondi 7 Turbulence / Chili Men 1110518-TCHL Size 8,Hoka Bondi 7 Turbulence / Chili Men 1110518-TCHL Size 8,Default Ridgefield,6,6,0,0,0,0
,Hoka Bondi 7 Turbulence / Chili Men 1110518-TCHL Size 8.5,Hoka Bondi 7 Turbulence / Chili Men 1110518-TCHL Size 8.5,Default Ridgefield,6,6,0,0,0,0
,Hoka Bondi 7 Turbulence / Chili Men 1110518-TCHL Size 9,Hoka Bondi 7 Turbulence / Chili Men 1110518-TCHL Size 9,Default Ridgefield,30,30,0,0,0,0
,Hoka Bondi 7 Turbulence / Chili Men 1110518-TCHL Size 9,Hoka Bondi 7 Turbulence / Chili Men 1110518-TCHL Size 9,FBALYB Amazon,1,1,0,0,0,0
,Hoka Bondi 7 Turbulence / Chili Men 1110518-TCHL Size 9.5,Hoka Bondi 7 Turbulence / Chili Men 1110518-TCHL Size 9.5,Default Ridgefield,30,30,0,0,0,0
,Hoka Bondi 7 Turbulence / Chili Men 1110518-TCHL Size 9.5,Hoka Bondi 7 Turbulence / Chili Men 1110518-TCHL Size 9.5,FBALYB Amazon,-1,-1,0,0,0,0
,Hoka Bondi 7 White / White Men 1110518-WWH Size 10,Hoka Bondi 7 White / White Men 1110518-WWH Size 10,FBALYB Amazon,12,12,0,0,0,0
,Hoka Bondi 7 White / White Men 1110518-WWH Size 10.5,Hoka Bondi 7 White / White Men 1110518-WWH Size 10.5,FBALYB Amazon,9,9,0,0,0,0
,Hoka Bondi 7 White / White Men 1110518-WWH Size 11,Hoka Bondi 7 White / White Men 1110518-WWH Size 11,FBALYB Amazon,11,11,0,0,0,0
,Hoka Bondi 7 White / White Men 1110518-WWH Size 11.5,Hoka Bondi 7 White / White Men 1110518-WWH Size 11.5,FBALYB Amazon,12,12,0,0,0,0
,Hoka Bondi 7 White / White Men 1110518-WWH Size 12,Hoka Bondi 7 White / White Men 1110518-WWH Size 12,FBALYB Amazon,10,10,0,0,0,0
,Hoka Bondi 7 White / White Men 1110518-WWH Size 13,Hoka Bondi 7 White / White Men 1110518-WWH Size 13,Default Ridgefield,12,12,0,0,0,0
,Hoka Bondi 7 White / White Men 1110518-WWH Size 9,Hoka Bondi 7 White / White Men 1110518-WWH Size 9,FBALYB Amazon,12,12,0,0,0,0
,Hoka Bondi 7 White / White Men 1110518-WWH Size 9.5,Hoka Bondi 7 White / White Men 1110518-WWH Size 9.5,FBALYB Amazon,11,11,0,0,0,0
,Hoka Bondi 7 Wild Dove / Dark Shadow Men 1110518-WDDS Size 10,Hoka Bondi 7 Wild Dove / Dark Shadow Men 1110518-WDDS Size 10,FBALYB Amazon,-2,-2,0,0,0,0
,Hoka Bondi 7 Wild Dove / Dark Shadow Men 1110518-WDDS Size 10.5,Hoka Bondi 7 Wild Dove / Dark Shadow Men 1110518-WDDS Size 10.5,FBALYB Amazon,1,1,0,0,0,0
,Hoka Bondi 7 Wild Dove / Dark Shadow Men 1110518-WDDS Size 9,Hoka Bondi 7 Wild Dove / Dark Shadow Men 1110518-WDDS Size 9,FBALYB Amazon,0,0,0,1,0,0
,Hoka Bondi 7 Wild Dove / Dark Shadow Men 1110518-WDDS Size 9.5,Hoka Bondi 7 Wild Dove / Dark Shadow Men 1110518-WDDS Size 9.5,FBALYB Amazon,-1,-1,0,0,0,0
,Hoka CARBON X 2 Blue Flower / Luminary Green 1113526-BFLG US Size 10,Hoka CARBON X 2 Blue Flower / Luminary Green 1113526-BFLG US Size 10,Default Ridgefield,18,18,0,0,0,0
,Hoka CARBON X 2 Blue Flower / Luminary Green 1113526-BFLG US Size 10.5,Hoka CARBON X 2 Blue Flower / Luminary Green 1113526-BFLG US Size 10.5,Default Ridgefield,36,36,0,0,0,0
,Hoka CARBON X 2 Blue Flower / Luminary Green 1113526-BFLG US Size 11,Hoka CARBON X 2 Blue Flower / Luminary Green 1113526-BFLG US Size 11,Default Ridgefield,36,36,0,0,0,0
,Hoka CARBON X 2 Blue Flower / Luminary Green 1113526-BFLG US Size 11.5,Hoka CARBON X 2 Blue Flower / Luminary Green 1113526-BFLG US Size 11.5,Default Ridgefield,36,36,0,0,0,0
,Hoka CARBON X 2 Blue Flower / Luminary Green 1113526-BFLG US Size 12,Hoka CARBON X 2 Blue Flower / Luminary Green 1113526-BFLG US Size 12,Default Ridgefield,24,24,0,0,0,0
,Hoka CARBON X 2 Blue Flower / Luminary Green 1113526-BFLG US Size 12.5,Hoka CARBON X 2 Blue Flower / Luminary Green 1113526-BFLG US Size 12.5,Default Ridgefield,18,18,0,0,0,0
,Hoka CARBON X 2 Blue Flower / Luminary Green 1113526-BFLG US Size 13,Hoka CARBON X 2 Blue Flower / Luminary Green 1113526-BFLG US Size 13,Default Ridgefield,18,18,0,0,0,0
,Hoka CARBON X 2 Blue Flower / Luminary Green 1113526-BFLG US Size 9,Hoka CARBON X 2 Blue Flower / Luminary Green 1113526-BFLG US Size 9,Default Ridgefield,18,18,0,0,0,0
,Hoka CARBON X 2 Blue Flower / Luminary Green 1113526-BFLG US Size 9.5,Hoka CARBON X 2 Blue Flower / Luminary Green 1113526-BFLG US Size 9.5,Default Ridgefield,18,18,0,0,0,0
,Hoka Carbon X 2 Dark Shadow / Fiesta 1113526-DSFS US SIze 10,Hoka Carbon X 2 Dark Shadow / Fiesta 1113526-DSFS US SIze 10,Default Ridgefield,18,18,0,0,0,0
,Hoka Carbon X 2 Dark Shadow / Fiesta 1113526-DSFS US SIze 10.5,Hoka Carbon X 2 Dark Shadow / Fiesta 1113526-DSFS US SIze 10.5,Default Ridgefield,36,36,0,0,0,0
,Hoka Carbon X 2 Dark Shadow / Fiesta 1113526-DSFS US SIze 11,Hoka Carbon X 2 Dark Shadow / Fiesta 1113526-DSFS US SIze 11,Default Ridgefield,36,36,0,0,0,0
,Hoka Carbon X 2 Dark Shadow / Fiesta 1113526-DSFS US SIze 11.5,Hoka Carbon X 2 Dark Shadow / Fiesta 1113526-DSFS US SIze 11.5,Default Ridgefield,36,36,0,0,0,0
,Hoka Carbon X 2 Dark Shadow / Fiesta 1113526-DSFS US SIze 12,Hoka Carbon X 2 Dark Shadow / Fiesta 1113526-DSFS US SIze 12,Default Ridgefield,18,18,0,0,0,0
,Hoka Carbon X 2 Dark Shadow / Fiesta 1113526-DSFS US SIze 12.5,Hoka Carbon X 2 Dark Shadow / Fiesta 1113526-DSFS US SIze 12.5,Default Ridgefield,18,18,0,0,0,0
,Hoka Carbon X 2 Dark Shadow / Fiesta 1113526-DSFS US SIze 13,Hoka Carbon X 2 Dark Shadow / Fiesta 1113526-DSFS US SIze 13,Default Ridgefield,18,18,0,0,0,0
,Hoka Carbon X 2 Dark Shadow / Fiesta 1113526-DSFS US SIze 9,Hoka Carbon X 2 Dark Shadow / Fiesta 1113526-DSFS US SIze 9,Default Ridgefield,18,18,0,0,0,0
,Hoka Carbon X 2 Dark Shadow / Fiesta 1113526-DSFS US SIze 9.5,Hoka Carbon X 2 Dark Shadow / Fiesta 1113526-DSFS US SIze 9.5,Default Ridgefield,17,17,0,0,0,0
,Hoka CARBON X 2 Diva Blue / Citrus 1113527-DBCTR US Size 10,Hoka CARBON X 2 Diva Blue / Citrus 1113527-DBCTR US Size 10,Default Ridgefield,18,18,0,0,0,0
,Hoka CARBON X 2 Diva Blue / Citrus 1113527-DBCTR US Size 6,Hoka CARBON X 2 Diva Blue / Citrus 1113527-DBCTR US Size 6,Default Ridgefield,18,18,0,0,0,0
,Hoka CARBON X 2 Diva Blue / Citrus 1113527-DBCTR US Size 6.5,Hoka CARBON X 2 Diva Blue / Citrus 1113527-DBCTR US Size 6.5,Default Ridgefield,18,18,0,0,0,0
,Hoka CARBON X 2 Diva Blue / Citrus 1113527-DBCTR US Size 7,Hoka CARBON X 2 Diva Blue / Citrus 1113527-DBCTR US Size 7,Default Ridgefield,18,18,0,0,0,0
,Hoka CARBON X 2 Diva Blue / Citrus 1113527-DBCTR US Size 7.5,Hoka CARBON X 2 Diva Blue / Citrus 1113527-DBCTR US Size 7.5,Default Ridgefield,36,36,0,0,0,0
,Hoka CARBON X 2 Diva Blue / Citrus 1113527-DBCTR US Size 8,Hoka CARBON X 2 Diva Blue / Citrus 1113527-DBCTR US Size 8,Default Ridgefield,36,36,0,0,0,0
,Hoka CARBON X 2 Diva Blue / Citrus 1113527-DBCTR US Size 8.5,Hoka CARBON X 2 Diva Blue / Citrus 1113527-DBCTR US Size 8.5,Default Ridgefield,36,36,0,0,0,0
,Hoka CARBON X 2 Diva Blue / Citrus 1113527-DBCTR US Size 9,Hoka CARBON X 2 Diva Blue / Citrus 1113527-DBCTR US Size 9,Default Ridgefield,18,18,0,0,0,0
,Hoka CARBON X 2 Diva Blue / Citrus 1113527-DBCTR US Size 9.5,Hoka CARBON X 2 Diva Blue / Citrus 1113527-DBCTR US Size 9.5,Default Ridgefield,18,18,0,0,0,0
,Hoka Carbon X 2 Hot Coral / Black Iris 1113527-HCBI US Size 10,Hoka Carbon X 2 Hot Coral / Black Iris 1113527-HCBI US Size 10,Default Ridgefield,24,24,0,0,0,0
,Hoka Carbon X 2 Hot Coral / Black Iris 1113527-HCBI US Size 6,Hoka Carbon X 2 Hot Coral / Black Iris 1113527-HCBI US Size 6,Default Ridgefield,24,24,0,0,0,0
,Hoka Carbon X 2 Hot Coral / Black Iris 1113527-HCBI US Size 6.5,Hoka Carbon X 2 Hot Coral / Black Iris 1113527-HCBI US Size 6.5,Default Ridgefield,24,24,0,0,0,0
,Hoka Carbon X 2 Hot Coral / Black Iris 1113527-HCBI US Size 7,Hoka Carbon X 2 Hot Coral / Black Iris 1113527-HCBI US Size 7,Default Ridgefield,24,24,0,0,0,0
,Hoka Carbon X 2 Hot Coral / Black Iris 1113527-HCBI US Size 7.5,Hoka Carbon X 2 Hot Coral / Black Iris 1113527-HCBI US Size 7.5,Default Ridgefield,48,48,0,0,0,0
,Hoka Carbon X 2 Hot Coral / Black Iris 1113527-HCBI US Size 8,Hoka Carbon X 2 Hot Coral / Black Iris 1113527-HCBI US Size 8,Default Ridgefield,48,48,0,0,0,0
,Hoka Carbon X 2 Hot Coral / Black Iris 1113527-HCBI US Size 8.5,Hoka Carbon X 2 Hot Coral / Black Iris 1113527-HCBI US Size 8.5,Default Ridgefield,48,48,0,0,0,0
,Hoka Carbon X 2 Hot Coral / Black Iris 1113527-HCBI US Size 9,Hoka Carbon X 2 Hot Coral / Black Iris 1113527-HCBI US Size 9,Default Ridgefield,24,24,0,0,0,0
,Hoka Carbon X 2 Hot Coral / Black Iris 1113527-HCBI US Size 9.5,Hoka Carbon X 2 Hot Coral / Black Iris 1113527-HCBI US Size 9.5,Default Ridgefield,24,24,0,0,0,0
,Hoka Cavu 3 Black / White 1106481-BWHT US Size 10,Hoka Cavu 3 Black / White 1106481-BWHT US Size 10,Default Ridgefield,72,72,0,0,0,0
,Hoka Cavu 3 Black / White 1106481-BWHT US Size 11,Hoka Cavu 3 Black / White 1106481-BWHT US Size 11,Default Ridgefield,60,60,0,0,0,0
,Hoka Cavu 3 Black / White 1106481-BWHT US Size 12,Hoka Cavu 3 Black / White 1106481-BWHT US Size 12,Default Ridgefield,24,24,0,0,0,0
,Hoka Cavu 3 Black / White 1106481-BWHT US Size 13,Hoka Cavu 3 Black / White 1106481-BWHT US Size 13,Default Ridgefield,12,12,0,0,0,0
,Hoka Cavu 3 Black / White 1106481-BWHT US Size 8,Hoka Cavu 3 Black / White 1106481-BWHT US Size 8,Default Ridgefield,48,48,0,0,0,0
,Hoka Cavu 3 Black / White 1106481-BWHT US Size 9,Hoka Cavu 3 Black / White 1106481-BWHT US Size 9,Default Ridgefield,72,72,0,0,0,0
,Hoka Clifton 7 Almond Milk / Bronze Men 1110508-AMBN Size 10,Hoka Clifton 7 Almond Milk / Bronze Men 1110508-AMBN Size 10,Default Ridgefield,41,41,0,0,0,0
,Hoka Clifton 7 Almond Milk / Bronze Men 1110508-AMBN Size 10.5,Hoka Clifton 7 Almond Milk / Bronze Men 1110508-AMBN Size 10.5,Default Ridgefield,42,42,0,0,0,0
,Hoka Clifton 7 Almond Milk / Bronze Men 1110508-AMBN Size 11,Hoka Clifton 7 Almond Milk / Bronze Men 1110508-AMBN Size 11,Default Ridgefield,42,42,0,0,0,0
,Hoka Clifton 7 Almond Milk / Bronze Men 1110508-AMBN Size 11.5,Hoka Clifton 7 Almond Milk / Bronze Men 1110508-AMBN Size 11.5,Default Ridgefield,24,24,0,0,0,0
,Hoka Clifton 7 Almond Milk / Bronze Men 1110508-AMBN Size 12,Hoka Clifton 7 Almond Milk / Bronze Men 1110508-AMBN Size 12,Default Ridgefield,42,42,0,0,0,0
,Hoka Clifton 7 Almond Milk / Bronze Men 1110508-AMBN Size 12.5,Hoka Clifton 7 Almond Milk / Bronze Men 1110508-AMBN Size 12.5,Default Ridgefield,12,12,0,0,0,0
,Hoka Clifton 7 Almond Milk / Bronze Men 1110508-AMBN Size 13,Hoka Clifton 7 Almond Milk / Bronze Men 1110508-AMBN Size 13,Default Ridgefield,24,24,0,0,0,0
,Hoka Clifton 7 Almond Milk / Bronze Men 1110508-AMBN Size 9,Hoka Clifton 7 Almond Milk / Bronze Men 1110508-AMBN Size 9,Default Ridgefield,12,12,0,0,0,0
,Hoka Clifton 7 Almond Milk / Bronze Men 1110508-AMBN Size 9.5,Hoka Clifton 7 Almond Milk / Bronze Men 1110508-AMBN Size 9.5,Default Ridgefield,33,33,0,0,0,0
,Hoka Clifton 7 Black / Black Men 1110508-BBLC Size 10,Hoka Clifton 7 Black / Black Men 1110508-BBLC Size 10,Default Ridgefield,29,29,0,0,0,0
,Hoka Clifton 7 Black / Black Men 1110508-BBLC Size 10,Hoka Clifton 7 Black / Black Men 1110508-BBLC Size 10,FBALYB Amazon,1,1,0,0,0,0
,Hoka Clifton 7 Black / Black Men 1110508-BBLC Size 10.5,Hoka Clifton 7 Black / Black Men 1110508-BBLC Size 10.5,Default Ridgefield,32,31,1,0,1,0
,Hoka Clifton 7 Black / Black Men 1110508-BBLC Size 11,Hoka Clifton 7 Black / Black Men 1110508-BBLC Size 11,Default Ridgefield,34,34,0,0,0,0
,Hoka Clifton 7 Black / Black Men 1110508-BBLC Size 11,Hoka Clifton 7 Black / Black Men 1110508-BBLC Size 11,FBALYB Amazon,-3,-3,0,0,0,0
,Hoka Clifton 7 Black / Black Men 1110508-BBLC Size 11.5,Hoka Clifton 7 Black / Black Men 1110508-BBLC Size 11.5,Default Ridgefield,36,36,0,0,0,0
,Hoka Clifton 7 Black / Black Men 1110508-BBLC Size 11.5,Hoka Clifton 7 Black / Black Men 1110508-BBLC Size 11.5,FBALYB Amazon,1,1,0,0,0,0
,Hoka Clifton 7 Black / Black Men 1110508-BBLC Size 12,Hoka Clifton 7 Black / Black Men 1110508-BBLC Size 12,Default Ridgefield,21,21,0,0,0,0
,Hoka Clifton 7 Black / Black Men 1110508-BBLC Size 13,Hoka Clifton 7 Black / Black Men 1110508-BBLC Size 13,Default Ridgefield,12,12,0,0,0,0
,Hoka Clifton 7 Black / Black Men 1110508-BBLC Size 14,Hoka Clifton 7 Black / Black Men 1110508-BBLC Size 14,Default Ridgefield,12,12,0,0,0,0
,hoka clifton 7 black / black men 1110508-bblc size 7.5,hoka clifton 7 black / black men 1110508-bblc size 7.5,Default Ridgefield,6,6,0,0,0,0
,Hoka Clifton 7 Black / Black Men 1110508-BBLC Size 8,Hoka Clifton 7 Black / Black Men 1110508-BBLC Size 8,Default Ridgefield,6,6,0,0,0,0
,Hoka Clifton 7 Black / Black Men 1110508-BBLC Size 8.5,Hoka Clifton 7 Black / Black Men 1110508-BBLC Size 8.5,Default Ridgefield,6,6,0,0,0,0
,Hoka Clifton 7 Black / Black Men 1110508-BBLC Size 9,Hoka Clifton 7 Black / Black Men 1110508-BBLC Size 9,Default Ridgefield,24,24,0,0,0,0
,Hoka Clifton 7 Black / Black Men 1110508-BBLC Size 9,Hoka Clifton 7 Black / Black Men 1110508-BBLC Size 9,FBALYB Amazon,12,12,0,0,0,0
,Hoka Clifton 7 Black / Black Men 1110508-BBLC Size 9.5,Hoka Clifton 7 Black / Black Men 1110508-BBLC Size 9.5,Default Ridgefield,29,29,0,0,0,0
,Hoka Clifton 7 Black / Bronze Women 1110509-BBRNZ Size 10,Hoka Clifton 7 Black / Bronze Women 1110509-BBRNZ Size 10,Default Ridgefield,49,49,0,0,0,0
,Hoka Clifton 7 Black / Bronze Women 1110509-BBRNZ Size 10.5,Hoka Clifton 7 Black / Bronze Women 1110509-BBRNZ Size 10.5,Default Ridgefield,1,1,0,0,0,0
,Hoka Clifton 7 Black / Bronze Women 1110509-BBRNZ Size 11,Hoka Clifton 7 Black / Bronze Women 1110509-BBRNZ Size 11,Default Ridgefield,31,29,2,0,2,0
,Hoka Clifton 7 Black / Bronze Women 1110509-BBRNZ Size 6,Hoka Clifton 7 Black / Bronze Women 1110509-BBRNZ Size 6,Default Ridgefield,18,17,1,0,1,0
,Hoka Clifton 7 Black / Bronze Women 1110509-BBRNZ Size 6.5,Hoka Clifton 7 Black / Bronze Women 1110509-BBRNZ Size 6.5,Default Ridgefield,17,16,1,0,1,0
,Hoka Clifton 7 Black / Bronze Women 1110509-BBRNZ Size 7,Hoka Clifton 7 Black / Bronze Women 1110509-BBRNZ Size 7,Default Ridgefield,35,35,0,0,0,0
,Hoka Clifton 7 Black / Bronze Women 1110509-BBRNZ Size 7.5,Hoka Clifton 7 Black / Bronze Women 1110509-BBRNZ Size 7.5,Default Ridgefield,83,82,1,0,1,0
,Hoka Clifton 7 Black / Bronze Women 1110509-BBRNZ Size 8,Hoka Clifton 7 Black / Bronze Women 1110509-BBRNZ Size 8,Default Ridgefield,83,83,0,0,0,0
,Hoka Clifton 7 Black / Bronze Women 1110509-BBRNZ Size 8.5,Hoka Clifton 7 Black / Bronze Women 1110509-BBRNZ Size 8.5,Default Ridgefield,81,81,0,0,0,0
,Hoka Clifton 7 Black / Bronze Women 1110509-BBRNZ Size 9,Hoka Clifton 7 Black / Bronze Women 1110509-BBRNZ Size 9,Default Ridgefield,53,51,2,0,2,0
,Hoka Clifton 7 Black / Bronze Women 1110509-BBRNZ Size 9.5,Hoka Clifton 7 Black / Bronze Women 1110509-BBRNZ Size 9.5,Default Ridgefield,54,54,0,0,0,0
,Hoka Clifton 7 Black Iris / Blue Haze Women 1110509-BIBH Size 10,Hoka Clifton 7 Black Iris / Blue Haze Women 1110509-BIBH Size 10,Default Ridgefield,74,74,0,0,0,0
,Hoka Clifton 7 Black Iris / Blue Haze Women 1110509-BIBH Size 11,Hoka Clifton 7 Black Iris / Blue Haze Women 1110509-BIBH Size 11,Default Ridgefield,65,65,0,0,0,0
,Hoka Clifton 7 Black Iris / Blue Haze Women 1110509-BIBH Size 6,Hoka Clifton 7 Black Iris / Blue Haze Women 1110509-BIBH Size 6,Default Ridgefield,12,12,0,0,0,0
,Hoka Clifton 7 Black Iris / Blue Haze Women 1110509-BIBH Size 6.5,Hoka Clifton 7 Black Iris / Blue Haze Women 1110509-BIBH Size 6.5,Default Ridgefield,24,24,0,0,0,0
,Hoka Clifton 7 Black Iris / Blue Haze Women 1110509-BIBH Size 7,Hoka Clifton 7 Black Iris / Blue Haze Women 1110509-BIBH Size 7,Default Ridgefield,22,22,0,0,0,0
,Hoka Clifton 7 Black Iris / Blue Haze Women 1110509-BIBH Size 7.5,Hoka Clifton 7 Black Iris / Blue Haze Women 1110509-BIBH Size 7.5,Default Ridgefield,60,60,0,0,0,0
,Hoka Clifton 7 Black Iris / Blue Haze Women 1110509-BIBH Size 8,Hoka Clifton 7 Black Iris / Blue Haze Women 1110509-BIBH Size 8,Default Ridgefield,45,43,2,0,2,0
,Hoka Clifton 7 Black Iris / Blue Haze Women 1110509-BIBH Size 8.5,Hoka Clifton 7 Black Iris / Blue Haze Women 1110509-BIBH Size 8.5,Default Ridgefield,63,63,0,0,0,0
,Hoka Clifton 7 Black Iris / Blue Haze Women 1110509-BIBH Size 9,Hoka Clifton 7 Black Iris / Blue Haze Women 1110509-BIBH Size 9,Default Ridgefield,74,74,0,0,0,0
,Hoka Clifton 7 Black Iris / Blue Haze Women 1110509-BIBH Size 9.5,Hoka Clifton 7 Black Iris / Blue Haze Women 1110509-BIBH Size 9.5,Default Ridgefield,45,42,3,0,3,0
,Hoka Clifton 7 Black / White Men 1110508-BWHT Size 10,Hoka Clifton 7 Black / White Men 1110508-BWHT Size 10,Default Ridgefield,22,15,7,0,7,0
,Hoka Clifton 7 Black / White Men 1110508-BWHT Size 10,Hoka Clifton 7 Black / White Men 1110508-BWHT Size 10,FBALYB Amazon,-1,-1,0,0,0,0
,Hoka Clifton 7 Black / White Men 1110508-BWHT Size 10.5,Hoka Clifton 7 Black / White Men 1110508-BWHT Size 10.5,Default Ridgefield,131,131,0,0,0,0
,Hoka Clifton 7 Black / White Men 1110508-BWHT Size 11,Hoka Clifton 7 Black / White Men 1110508-BWHT Size 11,Default Ridgefield,120,119,1,0,1,0
,Hoka Clifton 7 Black / White Men 1110508-BWHT Size 11.5,Hoka Clifton 7 Black / White Men 1110508-BWHT Size 11.5,Default Ridgefield,82,82,0,0,0,0
,Hoka Clifton 7 Black / White Men 1110508-BWHT Size 12,Hoka Clifton 7 Black / White Men 1110508-BWHT Size 12,Default Ridgefield,35,32,3,0,3,0
,Hoka Clifton 7 Black / White Men 1110508-BWHT Size 12,Hoka Clifton 7 Black / White Men 1110508-BWHT Size 12,FBALYB Amazon,-4,-4,0,0,0,0
,Hoka Clifton 7 Black / White Men 1110508-BWHT Size 12.5,Hoka Clifton 7 Black / White Men 1110508-BWHT Size 12.5,Default Ridgefield,8,8,0,0,0,0
,Hoka Clifton 7 Black / White Men 1110508-BWHT Size 13,Hoka Clifton 7 Black / White Men 1110508-BWHT Size 13,Default Ridgefield,48,46,2,0,2,0
,Hoka Clifton 7 Black / White Men 1110508-BWHT Size 13,Hoka Clifton 7 Black / White Men 1110508-BWHT Size 13,FBALYB Amazon,1,1,0,0,0,0
,Hoka Clifton 7 Black / White Men 1110508-BWHT Size 14,Hoka Clifton 7 Black / White Men 1110508-BWHT Size 14,Default Ridgefield,10,9,1,0,1,0
,Hoka Clifton 7 Black / White Men 1110508-BWHT Size 14,Hoka Clifton 7 Black / White Men 1110508-BWHT Size 14,FBALYB Amazon,12,12,0,0,0,0
,Hoka Clifton 7 Black / White Men 1110508-BWHT Size 7.5,Hoka Clifton 7 Black / White Men 1110508-BWHT Size 7.5,Default Ridgefield,6,6,0,0,0,0
,Hoka Clifton 7 Black / White Men 1110508-BWHT Size 8,Hoka Clifton 7 Black / White Men 1110508-BWHT Size 8,Default Ridgefield,4,4,0,0,0,0
,Hoka Clifton 7 Black / White Men 1110508-BWHT Size 8.5,Hoka Clifton 7 Black / White Men 1110508-BWHT Size 8.5,Default Ridgefield,8,8,0,0,0,0
,Hoka Clifton 7 Black / White Men 1110508-BWHT Size 9,Hoka Clifton 7 Black / White Men 1110508-BWHT Size 9,FBALYB Amazon,4,4,0,0,0,0
,Hoka Clifton 7 Black / White Men 1110508-BWHT Size 9.5,Hoka Clifton 7 Black / White Men 1110508-BWHT Size 9.5,Default Ridgefield,98,98,0,0,0,0
,Hoka Clifton 7 Black / White Women 1110509-BWHT Size 10,Hoka Clifton 7 Black / White Women 1110509-BWHT Size 10,Default Ridgefield,76,76,0,0,0,0
,Hoka Clifton 7 Black / White Women 1110509-BWHT Size 10.5,Hoka Clifton 7 Black / White Women 1110509-BWHT Size 10.5,Default Ridgefield,2,2,0,0,0,0
,Hoka Clifton 7 Black / White Women 1110509-BWHT Size 11,Hoka Clifton 7 Black / White Women 1110509-BWHT Size 11,Default Ridgefield,22,22,0,0,0,0
,Hoka Clifton 7 Black / White Women 1110509-BWHT Size 6,Hoka Clifton 7 Black / White Women 1110509-BWHT Size 6,Default Ridgefield,24,24,0,0,0,0
,Hoka Clifton 7 Black / White Women 1110509-BWHT Size 6.5,Hoka Clifton 7 Black / White Women 1110509-BWHT Size 6.5,Default Ridgefield,36,36,0,0,0,0
,Hoka Clifton 7 Black / White Women 1110509-BWHT Size 7,Hoka Clifton 7 Black / White Women 1110509-BWHT Size 7,Default Ridgefield,74,74,0,0,0,0
,Hoka Clifton 7 Black / White Women 1110509-BWHT Size 7.5,Hoka Clifton 7 Black / White Women 1110509-BWHT Size 7.5,Default Ridgefield,39,39,0,0,0,0
,Hoka Clifton 7 Black / White Women 1110509-BWHT Size 8,Hoka Clifton 7 Black / White Women 1110509-BWHT Size 8,Default Ridgefield,51,51,0,0,0,0
,Hoka Clifton 7 Black / White Women 1110509-BWHT Size 8.5,Hoka Clifton 7 Black / White Women 1110509-BWHT Size 8.5,Default Ridgefield,98,98,0,0,0,0
,Hoka Clifton 7 Black / White Women 1110509-BWHT Size 9,Hoka Clifton 7 Black / White Women 1110509-BWHT Size 9,Default Ridgefield,120,120,0,0,0,0
,Hoka Clifton 7 Black / White Women 1110509-BWHT Size 9.5,Hoka Clifton 7 Black / White Women 1110509-BWHT Size 9.5,Default Ridgefield,98,98,0,0,0,0
,Hoka Clifton 7 Moonlit Ocean / Anthracite Men 1110508-MOAN  Size 10.5,Hoka Clifton 7 Moonlit Ocean / Anthracite Men 1110508-MOAN  Size 10.5,FBALYB Amazon,-2,-2,0,0,0,0
,Hoka Clifton 7 Moonlit Ocean / Anthracite Men 1110508-MOAN  Size 11,Hoka Clifton 7 Moonlit Ocean / Anthracite Men 1110508-MOAN  Size 11,FBALYB Amazon,-2,-2,0,0,0,0
,Hoka Clifton 7 Moonlit Ocean / Anthracite Men 1110508-MOAN  Size 11.5,Hoka Clifton 7 Moonlit Ocean / Anthracite Men 1110508-MOAN  Size 11.5,FBALYB Amazon,-1,-1,0,0,0,0
,Hoka Clifton 7 Moonlit Ocean / Anthracite Men 1110508-MOAN  Size 12,Hoka Clifton 7 Moonlit Ocean / Anthracite Men 1110508-MOAN  Size 12,Default Ridgefield,2,2,0,0,0,0
,Hoka Clifton 7 Moonlit Ocean / Anthracite Men 1110508-MOAN  Size 12,Hoka Clifton 7 Moonlit Ocean / Anthracite Men 1110508-MOAN  Size 12,FBALYB Amazon,-3,-3,0,0,0,0
,Hoka Clifton 7 Moonlit Ocean / Anthracite Men 1110508-MOAN  Size 13,Hoka Clifton 7 Moonlit Ocean / Anthracite Men 1110508-MOAN  Size 13,FBALYB Amazon,-1,-1,0,0,0,0
,Hoka Clifton 7 Moonlit Ocean / Anthracite Men 1110508-MOAN Size 7.5,Hoka Clifton 7 Moonlit Ocean / Anthracite Men 1110508-MOAN Size 7.5,Default Ridgefield,6,6,0,0,0,0
,Hoka Clifton 7 Moonlit Ocean / Anthracite Men 1110508-MOAN  Size 9.5,Hoka Clifton 7 Moonlit Ocean / Anthracite Men 1110508-MOAN  Size 9.5,FBALYB Amazon,-1,-1,0,0,0,0
,Hoka Clifton 7 White / White Men 1110508-WWH Size 10,Hoka Clifton 7 White / White Men 1110508-WWH Size 10,Default Ridgefield,4,4,0,0,0,0
,Hoka Clifton 7 White / White Men 1110508-WWH Size 10.5,Hoka Clifton 7 White / White Men 1110508-WWH Size 10.5,FBALYB Amazon,-2,-2,0,0,0,0
,Hoka Clifton 7 White / White Men 1110508-WWH Size 11,Hoka Clifton 7 White / White Men 1110508-WWH Size 11,FBALYB Amazon,8,8,0,0,0,0
,Hoka Clifton 7 White / White Men 1110508-WWH Size 11.5,Hoka Clifton 7 White / White Men 1110508-WWH Size 11.5,FBALYB Amazon,1,1,0,0,0,0
,Hoka Clifton 7 White / White Men 1110508-WWH Size 12,Hoka Clifton 7 White / White Men 1110508-WWH Size 12,Default Ridgefield,12,12,0,0,0,0
,Hoka Clifton 7 White / White Men 1110508-WWH Size 12,Hoka Clifton 7 White / White Men 1110508-WWH Size 12,FBALYB Amazon,1,1,0,0,0,0
,Hoka Clifton 7 White / White Men 1110508-WWH Size 13,Hoka Clifton 7 White / White Men 1110508-WWH Size 13,Default Ridgefield,8,8,0,0,0,0
,Hoka Clifton 7 White / White Men 1110508-WWH Size 9,Hoka Clifton 7 White / White Men 1110508-WWH Size 9,Default Ridgefield,12,12,0,0,0,0
,Hoka Clifton 7 Wild Dove / Dark Shadow Men 1110508-WDDS Size 10.5,Hoka Clifton 7 Wild Dove / Dark Shadow Men 1110508-WDDS Size 10.5,FBALYB Amazon,1,1,0,0,0,0
,Hoka Clifton 7 Wild Dove / Dark Shadow Men 1110508-WDDS Size 11,Hoka Clifton 7 Wild Dove / Dark Shadow Men 1110508-WDDS Size 11,FBALYB Amazon,-1,-1,0,0,0,0
,Hoka Clifton 7 Wild Dove / Dark Shadow Men 1110508-WDDS Size 11.5,Hoka Clifton 7 Wild Dove / Dark Shadow Men 1110508-WDDS Size 11.5,FBALYB Amazon,-1,-1,0,0,0,0
,Hoka Clifton 7 Wild Dove / Dark Shadow Men 1110508-WDDS Size 12,Hoka Clifton 7 Wild Dove / Dark Shadow Men 1110508-WDDS Size 12,Default Ridgefield,88,88,0,0,0,0
,hoka clifton 7 wild dove / dark shadow men 1110508-wdds size 7.5,hoka clifton 7 wild dove / dark shadow men 1110508-wdds size 7.5,Default Ridgefield,6,6,0,0,0,0
,Hoka Clifton 7 Wild Dove / Dark Shadow Men 1110508-WDDS Size 9,Hoka Clifton 7 Wild Dove / Dark Shadow Men 1110508-WDDS Size 9,Default Ridgefield,12,12,0,0,0,0
,Hoka Clifton 7 Wild Dove / Dark Shadow Men 1110508-WDDS Size 9.5,Hoka Clifton 7 Wild Dove / Dark Shadow Men 1110508-WDDS Size 9.5,FBALYB Amazon,-1,-1,0,0,0,0
,Hoka Kaha GTX Black / Phantom 1112030-BPHN US SIze 7.5,Hoka Kaha GTX Black / Phantom 1112030-BPHN US SIze 7.5,Default Ridgefield,18,18,0,0,0,0
,Hoka Kaha GTX Black / Phantom 1112030-BPHN US SIze 8,Hoka Kaha GTX Black / Phantom 1112030-BPHN US SIze 8,Default Ridgefield,36,36,0,0,0,0
,Hoka Kaha GTX Black / Phantom 1112030-BPHN US SIze 8.5,Hoka Kaha GTX Black / Phantom 1112030-BPHN US SIze 8.5,Default Ridgefield,36,36,0,0,0,0
,Hoka Kaha GTX Black / Phantom 1112030-BPHN US SIze 9,Hoka Kaha GTX Black / Phantom 1112030-BPHN US SIze 9,Default Ridgefield,18,18,0,0,0,0
,Hoka Kaha GTX Black / Phantom 1112030-BPHN US SIze 9.5,Hoka Kaha GTX Black / Phantom 1112030-BPHN US SIze 9.5,Default Ridgefield,6,6,0,0,0,0
,Hoka Kaha GTX Dune / Oxford Tan 1112030-DOTN US SIze 10.5,Hoka Kaha GTX Dune / Oxford Tan 1112030-DOTN US SIze 10.5,Default Ridgefield,3,3,0,0,0,0
,Hoka Kaha GTX Dune / Oxford Tan 1112030-DOTN US SIze 11,Hoka Kaha GTX Dune / Oxford Tan 1112030-DOTN US SIze 11,Default Ridgefield,4,4,0,0,0,0
,Hoka Kaha GTX Dune / Oxford Tan 1112030-DOTN US SIze 7.5,Hoka Kaha GTX Dune / Oxford Tan 1112030-DOTN US SIze 7.5,Default Ridgefield,3,3,0,0,0,0
,Hoka Kaha GTX Dune / Oxford Tan 1112030-DOTN US SIze 8,Hoka Kaha GTX Dune / Oxford Tan 1112030-DOTN US SIze 8,Default Ridgefield,4,4,0,0,0,0
,Hoka Kaha GTX Dune / Oxford Tan 1112030-DOTN US SIze 8.5,Hoka Kaha GTX Dune / Oxford Tan 1112030-DOTN US SIze 8.5,Default Ridgefield,4,4,0,0,0,0
,HOKA MACH 4 Blue Flower / Citrus 1113529-BFCT US Size 6,HOKA MACH 4 Blue Flower / Citrus 1113529-BFCT US Size 6,Default Ridgefield,12,12,0,0,0,0
,HOKA MACH 4 Blue Flower / Citrus 1113529-BFCT US Size 6.5,HOKA MACH 4 Blue Flower / Citrus 1113529-BFCT US Size 6.5,Default Ridgefield,12,12,0,0,0,0
,HOKA MACH 4 Hot Coral / Saffron 1113529-HCSF US Size 10,HOKA MACH 4 Hot Coral / Saffron 1113529-HCSF US Size 10,Default Ridgefield,3,3,0,0,0,0
,HOKA MACH 4 Hot Coral / Saffron 1113529-HCSF US Size 6,HOKA MACH 4 Hot Coral / Saffron 1113529-HCSF US Size 6,Default Ridgefield,3,3,0,0,0,0
,HOKA MACH 4 Hot Coral / Saffron 1113529-HCSF US Size 7.5,HOKA MACH 4 Hot Coral / Saffron 1113529-HCSF US Size 7.5,Default Ridgefield,3,3,0,0,0,0
,HOKA MACH 4 Hot Coral / Saffron 1113529-HCSF US Size 8,HOKA MACH 4 Hot Coral / Saffron 1113529-HCSF US Size 8,Default Ridgefield,6,6,0,0,0,0
,HOKA MACH 4 Hot Coral / Saffron 1113529-HCSF US Size 8.5,HOKA MACH 4 Hot Coral / Saffron 1113529-HCSF US Size 8.5,Default Ridgefield,9,9,0,0,0,0
,HOKA MACH 4 Hot Coral / Saffron 1113529-HCSF US Size 9,HOKA MACH 4 Hot Coral / Saffron 1113529-HCSF US Size 9,Default Ridgefield,3,3,0,0,0,0
,HOKA MACH 4 Hot Coral / Saffron 1113529-HCSF US Size 9.5,HOKA MACH 4 Hot Coral / Saffron 1113529-HCSF US Size 9.5,Default Ridgefield,3,3,0,0,0,0
,HOKA ONE ONE - Arahi 4 Antigua Sand/Caribbean Sea 1106474-ASCS Size 11,HOKA ONE ONE - Arahi 4 Antigua Sand/Caribbean Sea 1106474-ASCS Size 11,Default Ridgefield,3,3,0,0,0,0
,HOKA ONE ONE - Arahi 4 Black/White 1106474-BWHT Size 11,HOKA ONE ONE - Arahi 4 Black/White 1106474-BWHT Size 11,Default Ridgefield,3,3,0,0,0,0
,HOKA ONE ONE - Arahi 5 Black / White 1115010-BWHT Size 10,HOKA ONE ONE - Arahi 5 Black / White 1115010-BWHT Size 10,Default Ridgefield,46,46,0,0,0,0
,HOKA ONE ONE - Arahi 5 Black / White 1115010-BWHT Size 10.5,HOKA ONE ONE - Arahi 5 Black / White 1115010-BWHT Size 10.5,Default Ridgefield,44,44,0,0,0,0
,HOKA ONE ONE - Arahi 5 Black / White 1115010-BWHT Size 11,HOKA ONE ONE - Arahi 5 Black / White 1115010-BWHT Size 11,Default Ridgefield,45,45,0,0,0,0
,HOKA ONE ONE - Arahi 5 Black / White 1115010-BWHT Size 11.5,HOKA ONE ONE - Arahi 5 Black / White 1115010-BWHT Size 11.5,Default Ridgefield,24,23,1,0,1,0
,HOKA ONE ONE - Arahi 5 Black / White 1115010-BWHT Size 12,HOKA ONE ONE - Arahi 5 Black / White 1115010-BWHT Size 12,Default Ridgefield,45,45,0,0,0,0
,HOKA ONE ONE - Arahi 5 Black / White 1115010-BWHT Size 12.5,HOKA ONE ONE - Arahi 5 Black / White 1115010-BWHT Size 12.5,Default Ridgefield,22,22,0,0,0,0
,HOKA ONE ONE - Arahi 5 Black / White 1115010-BWHT Size 9,HOKA ONE ONE - Arahi 5 Black / White 1115010-BWHT Size 9,Default Ridgefield,21,21,0,0,0,0
,HOKA ONE ONE - Arahi 5 Black / White 1115010-BWHT Size 9.5,HOKA ONE ONE - Arahi 5 Black / White 1115010-BWHT Size 9.5,Default Ridgefield,23,23,0,0,0,0
,HOKA ONE ONE - Arahi 5 Black / White 1115012-BWHT Size 10.5,HOKA ONE ONE - Arahi 5 Black / White 1115012-BWHT Size 10.5,Default Ridgefield,24,24,0,0,0,0
,HOKA ONE ONE - Arahi 5 Blue Fog / Provincial Blue 1115012-BFPB Size 10,HOKA ONE ONE - Arahi 5 Blue Fog / Provincial Blue 1115012-BFPB Size 10,Default Ridgefield,24,23,1,0,1,0
,HOKA ONE ONE - Arahi 5 Blue Fog / Provincial Blue 1115012-BFPB Size 11,HOKA ONE ONE - Arahi 5 Blue Fog / Provincial Blue 1115012-BFPB Size 11,Default Ridgefield,23,22,1,0,1,0
,HOKA ONE ONE - Arahi 5 Blue Fog / Provincial Blue 1115012-BFPB Size 7,HOKA ONE ONE - Arahi 5 Blue Fog / Provincial Blue 1115012-BFPB Size 7,Default Ridgefield,23,22,1,0,1,0
,HOKA ONE ONE - Arahi 5 Blue Fog / Provincial Blue 1115012-BFPB Size 7.5,HOKA ONE ONE - Arahi 5 Blue Fog / Provincial Blue 1115012-BFPB Size 7.5,Default Ridgefield,23,23,0,0,0,0
,HOKA ONE ONE - Arahi 5 Blue Fog / Provincial Blue 1115012-BFPB Size 8,HOKA ONE ONE - Arahi 5 Blue Fog / Provincial Blue 1115012-BFPB Size 8,Default Ridgefield,47,45,2,0,2,0
,HOKA ONE ONE - Arahi 5 Blue Fog / Provincial Blue 1115012-BFPB Size 8.5,HOKA ONE ONE - Arahi 5 Blue Fog / Provincial Blue 1115012-BFPB Size 8.5,Default Ridgefield,48,46,2,0,2,0
,HOKA ONE ONE - Arahi 5 Blue Fog / Provincial Blue 1115012-BFPB Size 9,HOKA ONE ONE - Arahi 5 Blue Fog / Provincial Blue 1115012-BFPB Size 9,Default Ridgefield,47,46,1,0,1,0
,HOKA ONE ONE - Arahi 5 Blue Fog / Provincial Blue 1115012-BFPB Size 9.5,HOKA ONE ONE - Arahi 5 Blue Fog / Provincial Blue 1115012-BFPB Size 9.5,Default Ridgefield,47,47,0,0,0,0
,Hoka One One ARAHI 5 Lunar Rock-Drizzle 1115012-LRDR Size 10,Hoka One One ARAHI 5 Lunar Rock-Drizzle 1115012-LRDR Size 10,Default Ridgefield,12,12,0,0,0,0
,Hoka One One ARAHI 5 Lunar Rock-Drizzle 1115012-LRDR Size 11,Hoka One One ARAHI 5 Lunar Rock-Drizzle 1115012-LRDR Size 11,Default Ridgefield,12,12,0,0,0,0
,Hoka One One ARAHI 5 Lunar Rock-Drizzle 1115012-LRDR Size 7,Hoka One One ARAHI 5 Lunar Rock-Drizzle 1115012-LRDR Size 7,Default Ridgefield,12,12,0,0,0,0
,Hoka One One ARAHI 5 Lunar Rock-Drizzle 1115012-LRDR Size 7.5,Hoka One One ARAHI 5 Lunar Rock-Drizzle 1115012-LRDR Size 7.5,Default Ridgefield,12,12,0,0,0,0
,Hoka One One ARAHI 5 Lunar Rock-Drizzle 1115012-LRDR Size 8,Hoka One One ARAHI 5 Lunar Rock-Drizzle 1115012-LRDR Size 8,Default Ridgefield,24,24,0,0,0,0
,Hoka One One ARAHI 5 Lunar Rock-Drizzle 1115012-LRDR Size 8.5,Hoka One One ARAHI 5 Lunar Rock-Drizzle 1115012-LRDR Size 8.5,Default Ridgefield,24,24,0,0,0,0
,Hoka One One ARAHI 5 Lunar Rock-Drizzle 1115012-LRDR Size 9,Hoka One One ARAHI 5 Lunar Rock-Drizzle 1115012-LRDR Size 9,Default Ridgefield,24,24,0,0,0,0
,Hoka One One ARAHI 5 Lunar Rock-Drizzle 1115012-LRDR Size 9.5,Hoka One One ARAHI 5 Lunar Rock-Drizzle 1115012-LRDR Size 9.5,Default Ridgefield,24,24,0,0,0,0
,HOKA ONE ONE - Bondi 6 Black/Black 1019270-BBLC Size 12,HOKA ONE ONE - Bondi 6 Black/Black 1019270-BBLC Size 12,Default Ridgefield,2,2,0,0,0,0
,HOKA ONE ONE - Bondi 7 Black / Black Wide 1110530-BBLC Size 10,HOKA ONE ONE - Bondi 7 Black / Black Wide 1110530-BBLC Size 10,Default Ridgefield,89,89,0,0,0,0
,HOKA ONE ONE - Bondi 7 Black / Black Wide 1110530-BBLC Size 11.5,HOKA ONE ONE - Bondi 7 Black / Black Wide 1110530-BBLC Size 11.5,Default Ridgefield,75,75,0,0,0,0
,HOKA ONE ONE - Bondi 7 Black / Black Wide 1110530-BBLC Size 14,HOKA ONE ONE - Bondi 7 Black / Black Wide 1110530-BBLC Size 14,Default Ridgefield,36,36,0,0,0,0
,HOKA ONE ONE - Bondi 7 Black / Black Wide 1110530-BBLC Size 15,HOKA ONE ONE - Bondi 7 Black / Black Wide 1110530-BBLC Size 15,Default Ridgefield,12,12,0,0,0,0
,HOKA ONE ONE - Bondi 7 Black / Black Wide 1110530-BBLC Size 9,HOKA ONE ONE - Bondi 7 Black / Black Wide 1110530-BBLC Size 9,Default Ridgefield,42,42,0,0,0,0
,HOKA ONE ONE - Bondi 7 Black / Black Wide 1110531-BBLC Size 11,HOKA ONE ONE - Bondi 7 Black / Black Wide 1110531-BBLC Size 11,Default Ridgefield,36,36,0,0,0,0
,HOKA ONE ONE - Bondi 7 Black / Black Wide 1110531-BBLC Size 6,HOKA ONE ONE - Bondi 7 Black / Black Wide 1110531-BBLC Size 6,Default Ridgefield,42,42,0,0,0,0
,HOKA ONE ONE - Bondi 7 Black / Black Wide 1110531-BBLC Size 6.5,HOKA ONE ONE - Bondi 7 Black / Black Wide 1110531-BBLC Size 6.5,Default Ridgefield,35,35,0,0,0,0
,HOKA ONE ONE - Bondi 7 Black / Black Wide 1110531-BBLC Size 8,HOKA ONE ONE - Bondi 7 Black / Black Wide 1110531-BBLC Size 8,Default Ridgefield,12,12,0,0,0,0
,HOKA ONE ONE - Bondi 7 Black / Black Wide 1110531-BBLC Size 8.5,HOKA ONE ONE - Bondi 7 Black / Black Wide 1110531-BBLC Size 8.5,Default Ridgefield,12,12,0,0,0,0
,HOKA ONE ONE - Bondi 7 Black / Black Wide 1110531-BBLC Size 9,HOKA ONE ONE - Bondi 7 Black / Black Wide 1110531-BBLC Size 9,Default Ridgefield,12,12,0,0,0,0
,HOKA ONE ONE - Bondi 7 Black / White Wide 1110531-BWHT Size 10,HOKA ONE ONE - Bondi 7 Black / White Wide 1110531-BWHT Size 10,Default Ridgefield,114,114,0,0,0,0
,HOKA ONE ONE - Bondi 7 Black / White Wide 1110531-BWHT Size 11,HOKA ONE ONE - Bondi 7 Black / White Wide 1110531-BWHT Size 11,Default Ridgefield,45,45,0,0,0,0
,HOKA ONE ONE - Bondi 7 Black / White Wide 1110531-BWHT Size 6,HOKA ONE ONE - Bondi 7 Black / White Wide 1110531-BWHT Size 6,Default Ridgefield,36,36,0,0,0,0
,HOKA ONE ONE - Bondi 7 Black / White Wide 1110531-BWHT Size 6.5,HOKA ONE ONE - Bondi 7 Black / White Wide 1110531-BWHT Size 6.5,Default Ridgefield,36,36,0,0,0,0
,HOKA ONE ONE - Bondi 7 Black / White Wide 1110531-BWHT Size 7,HOKA ONE ONE - Bondi 7 Black / White Wide 1110531-BWHT Size 7,Default Ridgefield,67,67,0,0,0,0
,HOKA ONE ONE - Bondi 7 Black / White Wide 1110531-BWHT Size 7.5,HOKA ONE ONE - Bondi 7 Black / White Wide 1110531-BWHT Size 7.5,Default Ridgefield,113,113,0,0,0,0
,HOKA ONE ONE - Bondi 7 Black / White Wide 1110531-BWHT Size 8,HOKA ONE ONE - Bondi 7 Black / White Wide 1110531-BWHT Size 8,Default Ridgefield,110,109,1,0,1,0
,HOKA ONE ONE - Bondi 7 Black / White Wide 1110531-BWHT Size 8.5,HOKA ONE ONE - Bondi 7 Black / White Wide 1110531-BWHT Size 8.5,Default Ridgefield,108,107,1,0,1,0
,HOKA ONE ONE - Bondi 7 Black / White Wide 1110531-BWHT Size 9,HOKA ONE ONE - Bondi 7 Black / White Wide 1110531-BWHT Size 9,Default Ridgefield,109,109,0,0,0,0
,HOKA ONE ONE - Bondi 7 Black / White Wide 1110531-BWHT Size 9.5,HOKA ONE ONE - Bondi 7 Black / White Wide 1110531-BWHT Size 9.5,Default Ridgefield,112,112,0,0,0,0
,HOKA ONE ONE - Bondi 7 Misty Rose/Cordovan 1110519-MRCR Size 11,HOKA ONE ONE - Bondi 7 Misty Rose/Cordovan 1110519-MRCR Size 11,Default Ridgefield,32,32,0,0,0,0
,HOKA ONE ONE - Bondi 7 Purple Heather/Clematis Blue 1110519-PHCB Size 10.5,HOKA ONE ONE - Bondi 7 Purple Heather/Clematis Blue 1110519-PHCB Size 10.5,Default Ridgefield,2,2,0,0,0,0
,HOKA ONE ONE - Bondi SR Black/Black 1110521-BBLC Size 11,HOKA ONE ONE - Bondi SR Black/Black 1110521-BBLC Size 11,Default Ridgefield,2,2,0,0,0,0
,HOKA ONE ONE - Cavu 3 Black/White 1106482-BWHT Size 11,HOKA ONE ONE - Cavu 3 Black/White 1106482-BWHT Size 11,Default Ridgefield,2,2,0,0,0,0
,HOKA ONE ONE - Challenger ATR 5 Anthracite/Antigua Sand 1104094-AASN Size 11,HOKA ONE ONE - Challenger ATR 5 Anthracite/Antigua Sand 1104094-AASN Size 11,Default Ridgefield,3,3,0,0,0,0
,HOKA ONE ONE - Challenger ATR 5 Anthracite/Antigua Sand 1104094-DBCB Size 10,HOKA ONE ONE - Challenger ATR 5 Anthracite/Antigua Sand 1104094-DBCB Size 10,Default Ridgefield,12,12,0,0,0,0
,HOKA ONE ONE - Challenger ATR 5 Anthracite/Antigua Sand 1104094-DBCB Size 11,HOKA ONE ONE - Challenger ATR 5 Anthracite/Antigua Sand 1104094-DBCB Size 11,Default Ridgefield,11,11,0,0,0,0
,HOKA ONE ONE - Challenger ATR 5 Black/Antigua Sand 1111991-BASN Size 10,HOKA ONE ONE - Challenger ATR 5 Black/Antigua Sand 1111991-BASN Size 10,Default Ridgefield,5,5,0,0,0,0
,HOKA ONE ONE - Challenger ATR 5 Black/Antigua Sand 1111991-BASN Size 11,HOKA ONE ONE - Challenger ATR 5 Black/Antigua Sand 1111991-BASN Size 11,Default Ridgefield,6,6,0,0,0,0
,HOKA ONE ONE - Challenger ATR 5 Black/Antigua Sand 1111991-BASN Size 7,HOKA ONE ONE - Challenger ATR 5 Black/Antigua Sand 1111991-BASN Size 7,Default Ridgefield,1,1,0,0,0,0
,HOKA ONE ONE - Challenger ATR 5 Black/Antigua Sand 1111991-BASN Size 7.5,HOKA ONE ONE - Challenger ATR 5 Black/Antigua Sand 1111991-BASN Size 7.5,Default Ridgefield,17,17,0,0,0,0
,HOKA ONE ONE - Challenger ATR 5 Black/Antigua Sand 1111991-BASN Size 8.5,HOKA ONE ONE - Challenger ATR 5 Black/Antigua Sand 1111991-BASN Size 8.5,Default Ridgefield,13,13,0,0,0,0
,HOKA ONE ONE - Challenger ATR 5 Black/Antigua Sand 1111991-BASN Size 9,HOKA ONE ONE - Challenger ATR 5 Black/Antigua Sand 1111991-BASN Size 9,Default Ridgefield,8,8,0,0,0,0
,HOKA ONE ONE - Challenger ATR 5 Black/Antigua Sand 1111991-BASN Size 9.5,HOKA ONE ONE - Challenger ATR 5 Black/Antigua Sand 1111991-BASN Size 9.5,Default Ridgefield,2,2,0,0,0,0
,HOKA ONE ONE - Challenger ATR 5 Frost Gray/Bright Marigold 1104093-FGBM Size 10,HOKA ONE ONE - Challenger ATR 5 Frost Gray/Bright Marigold 1104093-FGBM Size 10,Default Ridgefield,20,20,0,0,0,0
,HOKA ONE ONE - Challenger ATR 5 Frost Gray/Bright Marigold 1104093-FGBM Size 10.5,HOKA ONE ONE - Challenger ATR 5 Frost Gray/Bright Marigold 1104093-FGBM Size 10.5,Default Ridgefield,22,22,0,0,0,0
,HOKA ONE ONE - Challenger ATR 5 Frost Gray/Bright Marigold 1104093-FGBM Size 11,HOKA ONE ONE - Challenger ATR 5 Frost Gray/Bright Marigold 1104093-FGBM Size 11,Default Ridgefield,21,21,0,0,0,0
,HOKA ONE ONE - Challenger ATR 5 Frost Gray/Bright Marigold 1104093-FGBM Size 11.5,HOKA ONE ONE - Challenger ATR 5 Frost Gray/Bright Marigold 1104093-FGBM Size 11.5,Default Ridgefield,11,11,0,0,0,0
,HOKA ONE ONE - Challenger ATR 5 Frost Gray/Bright Marigold 1104093-FGBM Size 12,HOKA ONE ONE - Challenger ATR 5 Frost Gray/Bright Marigold 1104093-FGBM Size 12,Default Ridgefield,11,11,0,0,0,0
,HOKA ONE ONE - Challenger ATR 5 Frost Gray/Bright Marigold 1104093-FGBM Size 13,HOKA ONE ONE - Challenger ATR 5 Frost Gray/Bright Marigold 1104093-FGBM Size 13,Default Ridgefield,9,9,0,0,0,0
,HOKA ONE ONE - Challenger ATR 5 Frost Gray/Bright Marigold 1104093-FGBM Size 9,HOKA ONE ONE - Challenger ATR 5 Frost Gray/Bright Marigold 1104093-FGBM Size 9,Default Ridgefield,10,10,0,0,0,0
,HOKA ONE ONE - Challenger ATR 5 Frost Gray/Bright Marigold 1104093-FGBM Size 9.5,HOKA ONE ONE - Challenger ATR 5 Frost Gray/Bright Marigold 1104093-FGBM Size 9.5,Default Ridgefield,22,22,0,0,0,0
,HOKA ONE ONE - Challenger ATR 5 Frost Gray/Evening Primrose 1104094-FGEP Size 11,HOKA ONE ONE - Challenger ATR 5 Frost Gray/Evening Primrose 1104094-FGEP Size 11,Default Ridgefield,9,9,0,0,0,0
,HOKA ONE ONE - Challenger ATR 6 Cascade/Ombre Blue 1106512-COBB Size 10,HOKA ONE ONE - Challenger ATR 6 Cascade/Ombre Blue 1106512-COBB Size 10,Default Ridgefield,1,1,0,0,0,0
,HOKA ONE ONE - Challenger ATR 6 Cascade/Ombre Blue 1106512-COBB Size 7,HOKA ONE ONE - Challenger ATR 6 Cascade/Ombre Blue 1106512-COBB Size 7,Default Ridgefield,2,2,0,0,0,0
,HOKA ONE ONE - Challenger ATR 6 Cascade/Ombre Blue 1106512-COBB Size 7.5,HOKA ONE ONE - Challenger ATR 6 Cascade/Ombre Blue 1106512-COBB Size 7.5,Default Ridgefield,1,1,0,0,0,0
,HOKA ONE ONE - Challenger ATR 6 Cascade/Ombre Blue 1106512-COBB Size 8,HOKA ONE ONE - Challenger ATR 6 Cascade/Ombre Blue 1106512-COBB Size 8,Default Ridgefield,1,1,0,0,0,0
,HOKA ONE ONE - Challenger ATR 6 Cascade/Ombre Blue 1106512-COBB Size 8.5,HOKA ONE ONE - Challenger ATR 6 Cascade/Ombre Blue 1106512-COBB Size 8.5,Default Ridgefield,1,1,0,0,0,0
,HOKA ONE ONE - Challenger ATR 6 Cascade/Ombre Blue 1106512-COBB Size 9,HOKA ONE ONE - Challenger ATR 6 Cascade/Ombre Blue 1106512-COBB Size 9,Default Ridgefield,1,1,0,0,0,0
,HOKA ONE ONE - Challenger ATR 6 Cascade/Ombre Blue 1106512-COBB Size 9.5,HOKA ONE ONE - Challenger ATR 6 Cascade/Ombre Blue 1106512-COBB Size 9.5,Default Ridgefield,1,1,0,0,0,0
,HOKA ONE ONE - Clifton 6 Black/White 1102873-BWHT Size 12,HOKA ONE ONE - Clifton 6 Black/White 1102873-BWHT Size 12,Default Ridgefield,4,4,0,0,0,0
,HOKA ONE ONE - Clifton 6 Lead/Sea Foam 1102873-LSF Size 11,HOKA ONE ONE - Clifton 6 Lead/Sea Foam 1102873-LSF Size 11,Default Ridgefield,12,12,0,0,0,0
,HOKA ONE ONE - Clifton 6 Nimbus Cloud/Lantana 1102873-NCLN Size 11,HOKA ONE ONE - Clifton 6 Nimbus Cloud/Lantana 1102873-NCLN Size 11,Default Ridgefield,13,13,0,0,0,0
,HOKA ONE ONE Clifton 7 Almond Milk / Bronze 1110509-AMBN Size 10,HOKA ONE ONE Clifton 7 Almond Milk / Bronze 1110509-AMBN Size 10,Default Ridgefield,49,49,0,0,0,0
,HOKA ONE ONE Clifton 7 Almond Milk / Bronze 1110509-AMBN Size 11,HOKA ONE ONE Clifton 7 Almond Milk / Bronze 1110509-AMBN Size 11,Default Ridgefield,16,16,0,0,0,0
,HOKA ONE ONE Clifton 7 Almond Milk / Bronze 1110509-AMBN Size 6,HOKA ONE ONE Clifton 7 Almond Milk / Bronze 1110509-AMBN Size 6,Default Ridgefield,18,18,0,0,0,0
,HOKA ONE ONE Clifton 7 Almond Milk / Bronze 1110509-AMBN Size 6.5,HOKA ONE ONE Clifton 7 Almond Milk / Bronze 1110509-AMBN Size 6.5,Default Ridgefield,17,17,0,0,0,0
,HOKA ONE ONE Clifton 7 Almond Milk / Bronze 1110509-AMBN Size 7,HOKA ONE ONE Clifton 7 Almond Milk / Bronze 1110509-AMBN Size 7,Default Ridgefield,40,40,0,0,0,0
,HOKA ONE ONE Clifton 7 Almond Milk / Bronze 1110509-AMBN Size 7.5,HOKA ONE ONE Clifton 7 Almond Milk / Bronze 1110509-AMBN Size 7.5,Default Ridgefield,48,48,0,0,0,0
,HOKA ONE ONE Clifton 7 Almond Milk / Bronze 1110509-AMBN Size 8,HOKA ONE ONE Clifton 7 Almond Milk / Bronze 1110509-AMBN Size 8,Default Ridgefield,51,51,0,0,0,0
,HOKA ONE ONE Clifton 7 Almond Milk / Bronze 1110509-AMBN Size 8.5,HOKA ONE ONE Clifton 7 Almond Milk / Bronze 1110509-AMBN Size 8.5,Default Ridgefield,48,48,0,0,0,0
,HOKA ONE ONE Clifton 7 Almond Milk / Bronze 1110509-AMBN Size 9,HOKA ONE ONE Clifton 7 Almond Milk / Bronze 1110509-AMBN Size 9,Default Ridgefield,40,40,0,0,0,0
,HOKA ONE ONE Clifton 7 Almond Milk / Bronze 1110509-AMBN Size 9.5,HOKA ONE ONE Clifton 7 Almond Milk / Bronze 1110509-AMBN Size 9.5,Default Ridgefield,35,35,0,0,0,0
,HOKA ONE ONE Clifton 7 Almond Milk / Bronze Wide 1110535-AMBN Size 10,HOKA ONE ONE Clifton 7 Almond Milk / Bronze Wide 1110535-AMBN Size 10,Default Ridgefield,12,12,0,0,0,0
,HOKA ONE ONE Clifton 7 Almond Milk / Bronze Wide 1110535-AMBN Size 11,HOKA ONE ONE Clifton 7 Almond Milk / Bronze Wide 1110535-AMBN Size 11,Default Ridgefield,12,12,0,0,0,0
,HOKA ONE ONE Clifton 7 Almond Milk / Bronze Wide 1110535-AMBN Size 7,HOKA ONE ONE Clifton 7 Almond Milk / Bronze Wide 1110535-AMBN Size 7,Default Ridgefield,11,11,0,0,0,0
,HOKA ONE ONE Clifton 7 Almond Milk / Bronze Wide 1110535-AMBN Size 7.5,HOKA ONE ONE Clifton 7 Almond Milk / Bronze Wide 1110535-AMBN Size 7.5,Default Ridgefield,22,22,0,0,0,0
,HOKA ONE ONE Clifton 7 Almond Milk / Bronze Wide 1110535-AMBN Size 8,HOKA ONE ONE Clifton 7 Almond Milk / Bronze Wide 1110535-AMBN Size 8,Default Ridgefield,22,22,0,0,0,0
,HOKA ONE ONE Clifton 7 Almond Milk / Bronze Wide 1110535-AMBN Size 8.5,HOKA ONE ONE Clifton 7 Almond Milk / Bronze Wide 1110535-AMBN Size 8.5,Default Ridgefield,24,24,0,0,0,0
,HOKA ONE ONE Clifton 7 Almond Milk / Bronze Wide 1110535-AMBN Size 9,HOKA ONE ONE Clifton 7 Almond Milk / Bronze Wide 1110535-AMBN Size 9,Default Ridgefield,23,23,0,0,0,0
,HOKA ONE ONE Clifton 7 Almond Milk / Bronze Wide 1110535-AMBN Size 9.5,HOKA ONE ONE Clifton 7 Almond Milk / Bronze Wide 1110535-AMBN Size 9.5,Default Ridgefield,12,12,0,0,0,0
,HOKA ONE ONE - Clifton 7 Black Iris / Blue Haze Wide 1110535-BIBH Size 10,HOKA ONE ONE - Clifton 7 Black Iris / Blue Haze Wide 1110535-BIBH Size 10,Default Ridgefield,59,59,0,0,0,0
,HOKA ONE ONE - Clifton 7 Black Iris / Blue Haze Wide 1110535-BIBH Size 11,HOKA ONE ONE - Clifton 7 Black Iris / Blue Haze Wide 1110535-BIBH Size 11,Default Ridgefield,24,24,0,0,0,0
,HOKA ONE ONE - Clifton 7 Black Iris / Blue Haze Wide 1110535-BIBH Size 7,HOKA ONE ONE - Clifton 7 Black Iris / Blue Haze Wide 1110535-BIBH Size 7,Default Ridgefield,46,46,0,0,0,0
,HOKA ONE ONE - Clifton 7 Black Iris / Blue Haze Wide 1110535-BIBH Size 7.5,HOKA ONE ONE - Clifton 7 Black Iris / Blue Haze Wide 1110535-BIBH Size 7.5,Default Ridgefield,48,48,0,0,0,0
,HOKA ONE ONE - Clifton 7 Black Iris / Blue Haze Wide 1110535-BIBH Size 8,HOKA ONE ONE - Clifton 7 Black Iris / Blue Haze Wide 1110535-BIBH Size 8,Default Ridgefield,47,46,1,0,1,0
,HOKA ONE ONE - Clifton 7 Black Iris / Blue Haze Wide 1110535-BIBH Size 8.5,HOKA ONE ONE - Clifton 7 Black Iris / Blue Haze Wide 1110535-BIBH Size 8.5,Default Ridgefield,48,46,2,0,2,0
,HOKA ONE ONE - Clifton 7 Black Iris / Blue Haze Wide 1110535-BIBH Size 9,HOKA ONE ONE - Clifton 7 Black Iris / Blue Haze Wide 1110535-BIBH Size 9,Default Ridgefield,48,48,0,0,0,0
,HOKA ONE ONE - Clifton 7 Black Iris / Blue Haze Wide 1110535-BIBH Size 9.5,HOKA ONE ONE - Clifton 7 Black Iris / Blue Haze Wide 1110535-BIBH Size 9.5,Default Ridgefield,59,59,0,0,0,0
,HOKA ONE ONE - Clifton 7 Black / White Wide 1110535-BWHT Size 10,HOKA ONE ONE - Clifton 7 Black / White Wide 1110535-BWHT Size 10,Default Ridgefield,84,84,0,0,0,0
,HOKA ONE ONE - Clifton 7 Black / White Wide 1110535-BWHT Size 11,HOKA ONE ONE - Clifton 7 Black / White Wide 1110535-BWHT Size 11,Default Ridgefield,35,35,0,0,0,0
,HOKA ONE ONE - Clifton 7 Black / White Wide 1110535-BWHT Size 7,HOKA ONE ONE - Clifton 7 Black / White Wide 1110535-BWHT Size 7,Default Ridgefield,36,36,0,0,0,0
,HOKA ONE ONE - Clifton 7 Black / White Wide 1110535-BWHT Size 7.5,HOKA ONE ONE - Clifton 7 Black / White Wide 1110535-BWHT Size 7.5,Default Ridgefield,70,70,0,0,0,0
,HOKA ONE ONE - Clifton 7 Black / White Wide 1110535-BWHT Size 8,HOKA ONE ONE - Clifton 7 Black / White Wide 1110535-BWHT Size 8,Default Ridgefield,95,95,0,0,0,0
,HOKA ONE ONE - Clifton 7 Black / White Wide 1110535-BWHT Size 8.5,HOKA ONE ONE - Clifton 7 Black / White Wide 1110535-BWHT Size 8.5,Default Ridgefield,71,71,0,0,0,0
,HOKA ONE ONE - Clifton 7 Black / White Wide 1110535-BWHT Size 9,HOKA ONE ONE - Clifton 7 Black / White Wide 1110535-BWHT Size 9,Default Ridgefield,72,72,0,0,0,0
,HOKA ONE ONE - Clifton 7 Black / White Wide 1110535-BWHT Size 9.5,HOKA ONE ONE - Clifton 7 Black / White Wide 1110535-BWHT Size 9.5,Default Ridgefield,86,86,0,0,0,0
,HOKA ONE ONE - Clifton 7 Lunar Rock/Nimbus Cloud 1110509-LRNC Size 11,HOKA ONE ONE - Clifton 7 Lunar Rock/Nimbus Cloud 1110509-LRNC Size 11,Default Ridgefield,35,35,0,0,0,0
,"Hoka One One Clifton 7 Men's Moonlit Ocean, Anthracite Wide 1110534-MOAN Size 10","Hoka One One Clifton 7 Men's Moonlit Ocean, Anthracite Wide 1110534-MOAN Size 10",Default Ridgefield,25,25,0,0,0,0
,"Hoka One One Clifton 7 Men's Moonlit Ocean, Anthracite Wide 1110534-MOAN Size 11.5","Hoka One One Clifton 7 Men's Moonlit Ocean, Anthracite Wide 1110534-MOAN Size 11.5",Default Ridgefield,12,12,0,0,0,0
,"Hoka One One Clifton 7 Men's Moonlit Ocean, Anthracite Wide 1110534-MOAN Size 12","Hoka One One Clifton 7 Men's Moonlit Ocean, Anthracite Wide 1110534-MOAN Size 12",Default Ridgefield,24,24,0,0,0,0
,HOKA ONE ONE - Clifton 7 Misty Rose/Cameo Brown 1110509-MRCB Size 10.5,HOKA ONE ONE - Clifton 7 Misty Rose/Cameo Brown 1110509-MRCB Size 10.5,Default Ridgefield,2,2,0,0,0,0
,HOKA ONE ONE - Clifton 7 Misty Rose/Cameo Brown 1110509-MRCB Size 11,HOKA ONE ONE - Clifton 7 Misty Rose/Cameo Brown 1110509-MRCB Size 11,Default Ridgefield,35,35,0,0,0,0
,HOKA ONE ONE - Clifton 7 Misty Rose/Cameo Brown 1110509-MRCB Size 9,HOKA ONE ONE - Clifton 7 Misty Rose/Cameo Brown 1110509-MRCB Size 9,Default Ridgefield,1,1,0,0,0,0
,HOKA ONE ONE - Clifton 7 Morning Mist / Hot Coral 1110509-MMHC Size 10,HOKA ONE ONE - Clifton 7 Morning Mist / Hot Coral 1110509-MMHC Size 10,Default Ridgefield,62,62,0,0,0,0
,HOKA ONE ONE - Clifton 7 Morning Mist / Hot Coral 1110509-MMHC Size 11,HOKA ONE ONE - Clifton 7 Morning Mist / Hot Coral 1110509-MMHC Size 11,Default Ridgefield,24,24,0,0,0,0
,HOKA ONE ONE - Clifton 7 Morning Mist / Hot Coral 1110509-MMHC Size 6,HOKA ONE ONE - Clifton 7 Morning Mist / Hot Coral 1110509-MMHC Size 6,Default Ridgefield,22,22,0,0,0,0
,HOKA ONE ONE - Clifton 7 Morning Mist / Hot Coral 1110509-MMHC Size 6.5,HOKA ONE ONE - Clifton 7 Morning Mist / Hot Coral 1110509-MMHC Size 6.5,Default Ridgefield,19,19,0,0,0,0
,HOKA ONE ONE - Clifton 7 Morning Mist / Hot Coral Wide 1110535-MMHC Size 10,HOKA ONE ONE - Clifton 7 Morning Mist / Hot Coral Wide 1110535-MMHC Size 10,Default Ridgefield,24,24,0,0,0,0
,HOKA ONE ONE - Clifton 7 Morning Mist / Hot Coral Wide 1110535-MMHC Size 11,HOKA ONE ONE - Clifton 7 Morning Mist / Hot Coral Wide 1110535-MMHC Size 11,Default Ridgefield,12,12,0,0,0,0
,HOKA ONE ONE - Clifton 7 Morning Mist / Hot Coral Wide 1110535-MMHC Size 7,HOKA ONE ONE - Clifton 7 Morning Mist / Hot Coral Wide 1110535-MMHC Size 7,Default Ridgefield,12,12,0,0,0,0
,HOKA ONE ONE - Clifton 7 Morning Mist / Hot Coral Wide 1110535-MMHC Size 7.5,HOKA ONE ONE - Clifton 7 Morning Mist / Hot Coral Wide 1110535-MMHC Size 7.5,Default Ridgefield,23,23,0,0,0,0
,HOKA ONE ONE - Clifton 7 Morning Mist / Hot Coral Wide 1110535-MMHC Size 8,HOKA ONE ONE - Clifton 7 Morning Mist / Hot Coral Wide 1110535-MMHC Size 8,Default Ridgefield,24,24,0,0,0,0
,HOKA ONE ONE - Clifton 7 Morning Mist / Hot Coral Wide 1110535-MMHC Size 8.5,HOKA ONE ONE - Clifton 7 Morning Mist / Hot Coral Wide 1110535-MMHC Size 8.5,Default Ridgefield,24,24,0,0,0,0
,HOKA ONE ONE - Clifton 7 Morning Mist / Hot Coral Wide 1110535-MMHC Size 9,HOKA ONE ONE - Clifton 7 Morning Mist / Hot Coral Wide 1110535-MMHC Size 9,Default Ridgefield,24,24,0,0,0,0
,HOKA ONE ONE - Clifton 7 Morning Mist / Hot Coral Wide 1110535-MMHC Size 9.5,HOKA ONE ONE - Clifton 7 Morning Mist / Hot Coral Wide 1110535-MMHC Size 9.5,Default Ridgefield,24,24,0,0,0,0
,HOKA ONE ONE - Clifton 7 White / White 1110509-WWH Size 10,HOKA ONE ONE - Clifton 7 White / White 1110509-WWH Size 10,Default Ridgefield,18,17,1,0,1,0
,HOKA ONE ONE - Clifton 7 White / White 1110509-WWH Size 11,HOKA ONE ONE - Clifton 7 White / White 1110509-WWH Size 11,Default Ridgefield,24,24,0,0,0,0
,HOKA ONE ONE - Clifton 7 White / White 1110509-WWH Size 6,HOKA ONE ONE - Clifton 7 White / White 1110509-WWH Size 6,Default Ridgefield,10,10,0,0,0,0
,HOKA ONE ONE - Clifton 7 White / White 1110509-WWH Size 6.5,HOKA ONE ONE - Clifton 7 White / White 1110509-WWH Size 6.5,Default Ridgefield,20,20,0,0,0,0
,HOKA ONE ONE - Clifton 7 White / White 1110509-WWH Size 7,HOKA ONE ONE - Clifton 7 White / White 1110509-WWH Size 7,Default Ridgefield,8,8,0,0,0,0
,HOKA ONE ONE - Clifton 7 White / White 1110509-WWH Size 7.5,HOKA ONE ONE - Clifton 7 White / White 1110509-WWH Size 7.5,Default Ridgefield,24,24,0,0,0,0
,HOKA ONE ONE - Clifton 7 White / White 1110509-WWH Size 8,HOKA ONE ONE - Clifton 7 White / White 1110509-WWH Size 8,Default Ridgefield,12,12,0,0,0,0
,HOKA ONE ONE - Clifton 7 White / White 1110509-WWH Size 8.5,HOKA ONE ONE - Clifton 7 White / White 1110509-WWH Size 8.5,Default Ridgefield,11,10,1,0,1,0
,HOKA ONE ONE - Clifton 7 White / White 1110509-WWH Size 9,HOKA ONE ONE - Clifton 7 White / White 1110509-WWH Size 9,Default Ridgefield,12,11,1,0,1,0
,HOKA ONE ONE - Clifton 7 White / White 1110509-WWH Size 9.5,HOKA ONE ONE - Clifton 7 White / White 1110509-WWH Size 9.5,Default Ridgefield,10,9,1,0,1,0
,HOKA ONE ONE Clifton 7 Women's Shoes Hot Coral/White 1110509-HCWH Size 10,HOKA ONE ONE Clifton 7 Women's Shoes Hot Coral/White 1110509-HCWH Size 10,Default Ridgefield,6,6,0,0,0,0
,HOKA ONE ONE - Elevon 2 Black/Dark Shadow 1106478-BDSD Size 11,HOKA ONE ONE - Elevon 2 Black/Dark Shadow 1106478-BDSD Size 11,Default Ridgefield,12,12,0,0,0,0
,HOKA ONE ONE - Hupana Flow Clematis Blue/Artic Ice 1102891-CBAI Size 11,HOKA ONE ONE - Hupana Flow Clematis Blue/Artic Ice 1102891-CBAI Size 11,Default Ridgefield,10,10,0,0,0,0
,HOKA ONE ONE - Hupana Flow Clematis Blue/Artic Ice 1102891-CBAI Size 9.5,HOKA ONE ONE - Hupana Flow Clematis Blue/Artic Ice 1102891-CBAI Size 9.5,Default Ridgefield,4,4,0,0,0,0
,HOKA ONE ONE - Hupana Flow Wool Dark Shadow / Wild Dove 1105590-DSWD Size 11,HOKA ONE ONE - Hupana Flow Wool Dark Shadow / Wild Dove 1105590-DSWD Size 11,Default Ridgefield,9,9,0,0,0,0
,HOKA ONE ONE - Mach 4 Black / Dark Shadow 1113528-BDSD Size 10,HOKA ONE ONE - Mach 4 Black / Dark Shadow 1113528-BDSD Size 10,Default Ridgefield,24,24,0,0,0,0
,HOKA ONE ONE - Mach 4 Black / Dark Shadow 1113528-BDSD Size 10.5,HOKA ONE ONE - Mach 4 Black / Dark Shadow 1113528-BDSD Size 10.5,Default Ridgefield,38,38,0,0,0,0
,HOKA ONE ONE - Mach 4 Black / Dark Shadow 1113528-BDSD Size 11,HOKA ONE ONE - Mach 4 Black / Dark Shadow 1113528-BDSD Size 11,Default Ridgefield,39,39,0,0,0,0
,HOKA ONE ONE - Mach 4 Black / Dark Shadow 1113528-BDSD Size 11.5,HOKA ONE ONE - Mach 4 Black / Dark Shadow 1113528-BDSD Size 11.5,Default Ridgefield,33,33,0,0,0,0
,HOKA ONE ONE - Mach 4 Black / Dark Shadow 1113528-BDSD Size 12,HOKA ONE ONE - Mach 4 Black / Dark Shadow 1113528-BDSD Size 12,Default Ridgefield,39,39,0,0,0,0
,HOKA ONE ONE - Mach 4 Black / Dark Shadow 1113528-BDSD Size 12.5,HOKA ONE ONE - Mach 4 Black / Dark Shadow 1113528-BDSD Size 12.5,Default Ridgefield,9,9,0,0,0,0
,HOKA ONE ONE - Mach 4 Black / Dark Shadow 1113528-BDSD Size 13,HOKA ONE ONE - Mach 4 Black / Dark Shadow 1113528-BDSD Size 13,Default Ridgefield,15,15,0,0,0,0
,HOKA ONE ONE - Mach 4 Black / Dark Shadow 1113528-BDSD Size 9,HOKA ONE ONE - Mach 4 Black / Dark Shadow 1113528-BDSD Size 9,Default Ridgefield,12,12,0,0,0,0
,HOKA ONE ONE - Mach 4 Black / Dark Shadow 1113528-BDSD Size 9.5,HOKA ONE ONE - Mach 4 Black / Dark Shadow 1113528-BDSD Size 9.5,Default Ridgefield,12,12,0,0,0,0
,HOKA ONE ONE - Mach 4 Black / Dark Shadow 1113529-BDSD Size 10,HOKA ONE ONE - Mach 4 Black / Dark Shadow 1113529-BDSD Size 10,Default Ridgefield,12,12,0,0,0,0
,HOKA ONE ONE - Mach 4 Black / Dark Shadow 1113529-BDSD Size 11,HOKA ONE ONE - Mach 4 Black / Dark Shadow 1113529-BDSD Size 11,Default Ridgefield,12,12,0,0,0,0
,HOKA ONE ONE - Mach 4 Black / Dark Shadow 1113529-BDSD Size 7,HOKA ONE ONE - Mach 4 Black / Dark Shadow 1113529-BDSD Size 7,Default Ridgefield,12,12,0,0,0,0
,HOKA ONE ONE - Mach 4 Black / Dark Shadow 1113529-BDSD Size 7.5,HOKA ONE ONE - Mach 4 Black / Dark Shadow 1113529-BDSD Size 7.5,Default Ridgefield,12,12,0,0,0,0
,HOKA ONE ONE - Mach 4 Black / Dark Shadow 1113529-BDSD Size 8,HOKA ONE ONE - Mach 4 Black / Dark Shadow 1113529-BDSD Size 8,Default Ridgefield,24,24,0,0,0,0
,HOKA ONE ONE - Mach 4 Black / Dark Shadow 1113529-BDSD Size 8.5,HOKA ONE ONE - Mach 4 Black / Dark Shadow 1113529-BDSD Size 8.5,Default Ridgefield,24,24,0,0,0,0
,HOKA ONE ONE - Mach 4 Black / Dark Shadow 1113529-BDSD Size 9,HOKA ONE ONE - Mach 4 Black / Dark Shadow 1113529-BDSD Size 9,Default Ridgefield,24,24,0,0,0,0
,HOKA ONE ONE - Mach 4 Black / Dark Shadow 1113529-BDSD Size 9.5,HOKA ONE ONE - Mach 4 Black / Dark Shadow 1113529-BDSD Size 9.5,Default Ridgefield,24,24,0,0,0,0
,HOKA ONE ONE MEN'S ARAHI 5 - OMBRE BLUE/BLUE FOG 1115010-OBBF Size 10,HOKA ONE ONE MEN'S ARAHI 5 - OMBRE BLUE/BLUE FOG 1115010-OBBF Size 10,Default Ridgefield,24,24,0,0,0,0
,HOKA ONE ONE MEN'S ARAHI 5 - OMBRE BLUE/BLUE FOG 1115010-OBBF Size 10.5,HOKA ONE ONE MEN'S ARAHI 5 - OMBRE BLUE/BLUE FOG 1115010-OBBF Size 10.5,Default Ridgefield,24,24,0,0,0,0
,HOKA ONE ONE MEN'S ARAHI 5 - OMBRE BLUE/BLUE FOG 1115010-OBBF Size 11,HOKA ONE ONE MEN'S ARAHI 5 - OMBRE BLUE/BLUE FOG 1115010-OBBF Size 11,Default Ridgefield,22,22,0,0,0,0
,HOKA ONE ONE MEN'S ARAHI 5 - OMBRE BLUE/BLUE FOG 1115010-OBBF Size 11.5,HOKA ONE ONE MEN'S ARAHI 5 - OMBRE BLUE/BLUE FOG 1115010-OBBF Size 11.5,Default Ridgefield,12,12,0,0,0,0
,HOKA ONE ONE MEN'S ARAHI 5 - OMBRE BLUE/BLUE FOG 1115010-OBBF Size 12,HOKA ONE ONE MEN'S ARAHI 5 - OMBRE BLUE/BLUE FOG 1115010-OBBF Size 12,Default Ridgefield,22,22,0,0,0,0
,HOKA ONE ONE MEN'S ARAHI 5 - OMBRE BLUE/BLUE FOG 1115010-OBBF Size 13,HOKA ONE ONE MEN'S ARAHI 5 - OMBRE BLUE/BLUE FOG 1115010-OBBF Size 13,Default Ridgefield,12,12,0,0,0,0
,HOKA ONE ONE MEN'S ARAHI 5 - OMBRE BLUE/BLUE FOG 1115010-OBBF Size 9,HOKA ONE ONE MEN'S ARAHI 5 - OMBRE BLUE/BLUE FOG 1115010-OBBF Size 9,Default Ridgefield,10,10,0,0,0,0
,HOKA ONE ONE MEN'S ARAHI 5 - OMBRE BLUE/BLUE FOG 1115010-OBBF Size 9.5,HOKA ONE ONE MEN'S ARAHI 5 - OMBRE BLUE/BLUE FOG 1115010-OBBF Size 9.5,Default Ridgefield,12,12,0,0,0,0
,Hoka ORA Recovery Slide Black / Black Men 1099673-BBLC Size 10,Hoka ORA Recovery Slide Black / Black Men 1099673-BBLC Size 10,Default Ridgefield,12,12,0,0,0,0
,Hoka ORA Recovery Slide Black / Black Men 1099673-BBLC Size 10,Hoka ORA Recovery Slide Black / Black Men 1099673-BBLC Size 10,FBALYB Amazon,-5,-6,1,0,1,0
,Hoka ORA Recovery Slide Black / Black Men 1099673-BBLC Size 11,Hoka ORA Recovery Slide Black / Black Men 1099673-BBLC Size 11,Default Ridgefield,11,10,1,0,1,0
,Hoka ORA Recovery Slide Black / Black Men 1099673-BBLC Size 11,Hoka ORA Recovery Slide Black / Black Men 1099673-BBLC Size 11,FBALYB Amazon,-6,-6,0,0,0,0
,Hoka ORA Recovery Slide Black / Black Men 1099673-BBLC Size 12,Hoka ORA Recovery Slide Black / Black Men 1099673-BBLC Size 12,Default Ridgefield,6,6,0,0,0,0
,Hoka ORA Recovery Slide Black / Black Men 1099673-BBLC Size 12,Hoka ORA Recovery Slide Black / Black Men 1099673-BBLC Size 12,FBALYB Amazon,-1,-1,0,0,0,0
,hoka ora recovery slide black / black men 1099673-bblc size 13,hoka ora recovery slide black / black men 1099673-bblc size 13,Default Ridgefield,6,6,0,0,0,0
,Hoka ORA Recovery Slide Black / Black Men 1099673-BBLC Size 9,Hoka ORA Recovery Slide Black / Black Men 1099673-BBLC Size 9,Default Ridgefield,6,6,0,0,0,0
,Hoka ORA Recovery Slide Black / Black Men 1099673-BBLC Size 9,Hoka ORA Recovery Slide Black / Black Men 1099673-BBLC Size 9,FBALYB Amazon,-6,-6,0,0,0,0
,Hoka ORA Recovery Slide Black / Black Women 1099674-BBLC Size 7,Hoka ORA Recovery Slide Black / Black Women 1099674-BBLC Size 7,Default Ridgefield,1,1,0,0,0,0
,Hoka ORA Recovery Slide Black / Black Women 1099674-BBLC Size 7,Hoka ORA Recovery Slide Black / Black Women 1099674-BBLC Size 7,FBALYB Amazon,6,6,0,0,0,0
,Hoka ORA Recovery Slide Black / Black Women 1099674-BBLC Size 8,Hoka ORA Recovery Slide Black / Black Women 1099674-BBLC Size 8,FBALYB Amazon,-6,-6,0,0,0,0
,Hoka ORA Recovery Slide Black / Black Women 1099674-BBLC Size 9,Hoka ORA Recovery Slide Black / Black Women 1099674-BBLC Size 9,FBALYB Amazon,-5,-5,0,0,0,0
,HOKA Ora Recovery Slide Fiesta / Ombre Blue 1099673-FORB US Size 10,HOKA Ora Recovery Slide Fiesta / Ombre Blue 1099673-FORB US Size 10,Default Ridgefield,24,24,0,0,0,0
,HOKA Ora Recovery Slide Fiesta / Ombre Blue 1099673-FORB US Size 11,HOKA Ora Recovery Slide Fiesta / Ombre Blue 1099673-FORB US Size 11,Default Ridgefield,6,6,0,0,0,0
,HOKA Ora Recovery Slide Fiesta / Ombre Blue 1099673-FORB US Size 7,HOKA Ora Recovery Slide Fiesta / Ombre Blue 1099673-FORB US Size 7,Default Ridgefield,6,6,0,0,0,0
,HOKA Ora Recovery Slide Fiesta / Ombre Blue 1099673-FORB US Size 8,HOKA Ora Recovery Slide Fiesta / Ombre Blue 1099673-FORB US Size 8,Default Ridgefield,18,18,0,0,0,0
,HOKA Ora Recovery Slide Fiesta / Ombre Blue 1099673-FORB US Size 9,HOKA Ora Recovery Slide Fiesta / Ombre Blue 1099673-FORB US Size 9,Default Ridgefield,18,18,0,0,0,0
,Hoka ORA Recovery Slide White/ Blue Women 1099674-WBTN Size 10,Hoka ORA Recovery Slide White/ Blue Women 1099674-WBTN Size 10,Default Ridgefield,24,24,0,0,0,0
,Hoka ORA Recovery Slide White/ Blue Women 1099674-WBTN Size 11,Hoka ORA Recovery Slide White/ Blue Women 1099674-WBTN Size 11,Default Ridgefield,12,12,0,0,0,0
,Hoka ORA Recovery Slide White/ Blue Women 1099674-WBTN Size 6,Hoka ORA Recovery Slide White/ Blue Women 1099674-WBTN Size 6,Default Ridgefield,12,12,0,0,0,0
,Hoka ORA Recovery Slide White/ Blue Women 1099674-WBTN Size 7,Hoka ORA Recovery Slide White/ Blue Women 1099674-WBTN Size 7,Default Ridgefield,24,24,0,0,0,0
,Hoka ORA Recovery Slide White/ Blue Women 1099674-WBTN Size 8,Hoka ORA Recovery Slide White/ Blue Women 1099674-WBTN Size 8,Default Ridgefield,36,36,0,0,0,0
,Hoka ORA Recovery Slide White/ Blue Women 1099674-WBTN Size 9,Hoka ORA Recovery Slide White/ Blue Women 1099674-WBTN Size 9,Default Ridgefield,36,36,0,0,0,0
,Hoka Tivra Italian Plum / Evening Sand 1099735-IPES US Size 10,Hoka Tivra Italian Plum / Evening Sand 1099735-IPES US Size 10,Default Ridgefield,12,12,0,0,0,0
,Hoka Tivra Italian Plum / Evening Sand 1099735-IPES US Size 11,Hoka Tivra Italian Plum / Evening Sand 1099735-IPES US Size 11,Default Ridgefield,12,12,0,0,0,0
,Hoka Tivra Italian Plum / Evening Sand 1099735-IPES US Size 6,Hoka Tivra Italian Plum / Evening Sand 1099735-IPES US Size 6,Default Ridgefield,12,12,0,0,0,0
,Hoka Tivra Italian Plum / Evening Sand 1099735-IPES US Size 7,Hoka Tivra Italian Plum / Evening Sand 1099735-IPES US Size 7,Default Ridgefield,35,35,0,0,0,0
,Hoka Tivra Italian Plum / Evening Sand 1099735-IPES US Size 8,Hoka Tivra Italian Plum / Evening Sand 1099735-IPES US Size 8,Default Ridgefield,48,48,0,0,0,0
,Hoka Tivra Italian Plum / Evening Sand 1099735-IPES US Size 9,Hoka Tivra Italian Plum / Evening Sand 1099735-IPES US Size 9,Default Ridgefield,36,36,0,0,0,0
,Holista Bee Propolis 400 Capsules 500 mg,Holista Bee Propolis 400 Capsules 500 mg ,Default,0,0,0,0,0,50
,Holista Bee Propolis 400 Capsules 500 mg,Holista Bee Propolis 400 Capsules 500 mg ,FBALYB Amazon,-2,-2,0,0,0,0
,HOLMO Floor Lamp,HOLMO Floor Lamp,Default,0,-2,2,0,0,0
,HOLMO Floor Lamp,HOLMO Floor Lamp,Default Ridgefield,48,48,0,0,0,0
,HOLMO Floor Lamp,HOLMO Floor Lamp,FBALYB Amazon,-200,-214,14,64,14,0
,HOLMO Floor Lamp 2pk,HOLMO Floor Lamp 2pk,FBALYB Amazon,-52,-61,9,28,9,0
,Holmo Lamp With E26 Bulb 2 Pack,Holmo Lamp With E26 Bulb 2 Pack,FBALYB Amazon,-199,-201,2,45,2,0
,Holmo With Bulb,Holmo With Bulb,FBALYB Amazon,268,266,2,233,2,0
,Honest Earth Creamy Mash 5.6lb,Honest Earth Creamy Mash 5.6lb,FBALYB Amazon,1,1,0,6,0,0
,Honest Kitchen Beef Bone Turmeric 5 oz 2pk,Honest Kitchen Beef Bone Turmeric 5 oz 2pk,Default,-20,-20,0,0,0,0
,Honest Kitchen Beef Bone Turmeric 5 oz 2pk,Honest Kitchen Beef Bone Turmeric 5 oz 2pk,FBALYB Amazon,-1,-1,0,0,0,0
,Honest Kitchen Bone Broth 3pk Variety,Honest Kitchen Bone Broth 3pk Variety,Default,-7,-7,0,0,0,0
,Honest Kitchen Bone Broth 3pk Variety,Honest Kitchen Bone Broth 3pk Variety,FBALYB Amazon,-1,-1,0,0,0,0
,Honest Kitchen Chicken Proper Toppers 14oz,Honest Kitchen Chicken Proper Toppers 14oz,FBALYB Amazon,-48,-48,0,0,0,0
,Honest Kitchen Chicken Proper Toppers 14oz 2pk,Honest Kitchen Chicken Proper Toppers 14oz 2pk,FBALYB Amazon,50,50,0,0,0,0
,Honest Kitchen Fish Skin Chews 6oz,Honest Kitchen Dental Beams Dehydrated Fish Skin Chews 6oz,FBALYB Amazon,2,2,0,0,0,0
,Honest Kitchen Fish Skin Chews 6oz 2pk,Honest Kitchen Fish Skin Chews 6oz 2pk,Default,-1,-1,0,0,0,0
,Honest Kitchen Fruit/Veggie 7lb,Honest Kitchen Fruit/Veggie 7lb,FBALYB Amazon,10,10,0,0,0,0
,Honest Kitchen Mussels Blue/Green 2oz 2pk,Honest Kitchen Mussels Blue/Green 2oz 2pk,FBALYB Amazon,44,44,0,0,0,0
,Honest Kitchen Nuzzles Duck/Cherry 12oz,Honest Kitchen Nuzzles Duck/Cherry 12oz,Default,0,0,0,0,0,53
,Honest Kitchen Nuzzles Duck/Cherry 12oz,Honest Kitchen Nuzzles Duck/Cherry 12oz,FBALYB Amazon,50,50,0,0,0,0
,Honest Kitchen Nuzzles Duck/Cherry 12oz 2pk,Honest Kitchen Nuzzles Duck/Cherry 12oz 2pk,FBALYB Amazon,-49,-49,0,0,0,0
,Honest Kitchen Pecks Beef/Blueberry 12oz 2pk,Honest Kitchen Pecks Beef/Blueberry 12oz 2pk,FBALYB Amazon,-1,-1,0,0,0,0
,Honest Kitchen Proper Toppers Beef 5.5oz,Honest Kitchen Proper Toppers Beef 5.5oz,Default,0,0,0,0,0,12
,Honest Kitchen Proper Toppers Chicken 5.5oz 2pk,Honest Kitchen Proper Toppers Chicken 5.5oz 2pk,Default,-1,-1,0,0,0,0
,Honest Kitchen Proper Toppers Fish 14oz 2pk,Honest Kitchen Proper Toppers Fish 14oz 2pk,FBALYB Amazon,9,9,0,0,0,0
,Honest Kitchen Smooches Chicken/Cranberry 12oz 2pk,Honest Kitchen Smooches Chicken/Cranberry 12oz 2pk,Default,-3,-3,0,0,0,0
,Honest Kitchen Turkey Proper Toppers 14 oz,Honest Kitchen Turkey Proper Toppers 14 oz pouch,Default,0,0,0,0,0,5
,Honest Kitchen Turkey Proper Toppers 14 oz,Honest Kitchen Turkey Proper Toppers 14 oz pouch,FBALYB Amazon,23,23,0,0,0,0
,Honest Kitchen Turkey Proper Toppers 14 oz 2pk,Honest Kitchen Turkey Proper Toppers 14 oz 2pk,FBALYB Amazon,24,24,0,0,0,0
,Honest Kitchen Wishes Fish Filets 3oz,Honest Kitchen Wishes Fish Filets 3oz,Default,0,0,0,0,0,42
,Honey Bunches of Oats 48oz,"Post Honey Bunches of Oats with Almonds, 48 oz.",FBALYB Amazon,-1,-1,0,0,0,0
,Hoover Cruise BH52210,Hoover Cruise BH52210 Stick Vacuum,FBALYB Amazon,-1,-1,0,2,0,0
,Hoover Deluxe FH50150,Hoover Power Scrub Deluxe FH50150 Upright ,Default,0,0,0,0,0,2
,Hoover Deluxe FH50150,Hoover Power Scrub Deluxe FH50150 Upright ,FBALYB Amazon,0,0,0,1,0,0
,Hoover REACT Cordless Advantage BH53210,Hoover REACT Cordless Advantage BH53210,FBALYB Amazon,1,1,0,0,0,0
,Horizon Milk ‑ 18 count,Horizon Organic Lowfat Milk ‑ 18 count,Default,0,0,0,0,0,51
,Horizon Milk ‑ 18 count,Horizon Organic Lowfat Milk ‑ 18 count,FBALYB Amazon,6,6,0,0,0,0
,Horlicks Malted Milk 2pk,Horlicks Malted Milk 2pk,FBALYB Amazon,-1,-1,0,0,0,0
,Horlicks Original Malt Beverage 4pk,Horlicks Original Malt Beverage 4pk,FBALYB Amazon,-1,-1,0,0,0,0
,Horlicks The Original Malted Milk Drink 500g,Horlicks The Original Malted Milk Drink 500g,FBALYB Amazon,0,0,0,2,0,0
,Hotwheels DGC96 Fusion Factory,Hotwheels DGC96 Fusion Factory,Default,4,4,0,0,0,0
,Hot Wheels Splash Rides Sea,Hot Wheels Splash Rides Sea Horsepower ,FBALYB Amazon,3,3,0,0,0,0
,Hot Wheels Splash Twin Mill,Hot Wheels Splash Rides Twin Mill Splash Action Track Set,FBALYB Amazon,1,1,0,0,0,0
,Hot Wheels Tablet - Orange,Hot Wheels 7 inch Kids Learning Tablet - Orange,FBALYB Amazon,-1,-1,0,0,0,0
,HP 3755 Printer,HP 3755 Printer,FBALYB Amazon,129,129,0,101,0,0
,HP 4520,HP 4520,FBALYB Amazon,97,97,0,3,0,0
,HP 4650,HP 4650,Default,1,-4,5,0,0,0
,HP 4650,HP 4650,FBALYB Amazon,-4,-4,0,1,0,0
,HP 5549 Printer,HP 5549 Printer,FBALYB Amazon,0,0,0,2,0,0
,HP 5640 Printer,HP 5640 Printer,FBALYB Amazon,-2,-2,0,9,0,0
,HP 6968,HP 6968,Default,1,1,0,0,0,0
,HP 6968,HP 6968,FBALYB Amazon,-5,-5,0,4,0,0
,HP 6978,HP 6978,FBALYB Amazon,26,26,0,0,0,0
,HP 7155,HP 7155,Default,0,0,0,0,0,11
,HP 7155,HP 7155,FBALYB Amazon,27,27,0,5,0,0
,HP 8720 Printer,HP 8720 Printer 889894126351,FBALYB Amazon,-1,-1,0,1,0,0
,HP Deskjet 3630,HP Deskjet 3630,FBALYB Amazon,-2,-2,0,3,0,0
,HP DeskJet 3752 Printer,"HP DeskJet 3752 Wireless All-in-One Compact Printer with Mobile Printing, Instant Ink Ready",Default,0,0,0,0,0,7
,HP DeskJet 3752 Printer,"HP DeskJet 3752 Wireless All-in-One Compact Printer with Mobile Printing, Instant Ink Ready",FBALYB Amazon,-5,-5,0,0,0,0
,HP Envy 5540 Printer,HP Envy 5540 Printer,FBALYB Amazon,-11,-11,0,5,0,0
,HP OfficeJet 3830 Printer,HP OfficeJet 3830 Printer,FBALYB Amazon,-10,-10,0,58,0,0
,HP Original Sauce 2pk,HP Original Sauce 2pk,FBALYB Amazon,-1,-1,0,0,0,0
,HP Pavilion 580-137c,HP Pavilion 580-137c,Default,0,0,0,0,0,2
,HP Pavilion 580-137c,HP Pavilion 580-137c,FBALYB Amazon,-2,-2,0,0,0,0
,H&S Shampoo 400ML Classic Clean,H&S Shampoo 400ML Classic Clean,Default,0,-640,640,0,0,0
,H&S Shampoo 400ML Classic Clean 2pk,H&S Shampoo 400ML Classic Clean 2pk,FBALYB Amazon,63,62,1,7,1,0
,Huawei - Watch 2 Smartwatch 45mm- Titanium Gray,Huawei - Watch 2 Classic Smartwatch 45mm Stainless steel - Titanium Gray,FBALYB Amazon,-2,-2,0,0,0,0
,HUGGIES LITTLE SWIMMERS 2-3,HUGGIES LITTLE SWIMMERS 2-3,Default,0,-3504,3504,0,0,129
,HUGGIES LITTLE SWIMMERS 2-3,HUGGIES LITTLE SWIMMERS 2-3,FBALYB Amazon,5196,5175,21,1439,21,0
,HUGGIES LITTLE SWIMMERS 2-3 3PK,HUGGIES LITTLE SWIMMERS 2-3 3PK,FBALYB Amazon,16,16,0,0,0,0
,HUGGIES LITTLE SWIMMERS 3-4,HUGGIES LITTLE SWIMMERS 3-4,Default,0,-1240,1240,0,0,0
,HUGGIES LITTLE SWIMMERS 3-4,HUGGIES LITTLE SWIMMERS 3-4,Default Ridgefield,207,130,77,0,0,0
,HUGGIES LITTLE SWIMMERS 3-4,HUGGIES LITTLE SWIMMERS 3-4,FBALYB Amazon,12195,12172,23,54,23,0
,HUGGIES LITTLE SWIMMERS 3-4,HUGGIES LITTLE SWIMMERS 3-4,FBALYB Canada,12,11,1,0,1,0
,HUGGIES LITTLE SWIMMERS 5-6,HUGGIES LITTLE SWIMMERS 5-6,FBALYB Amazon,-113,-123,10,86,10,0
,Huggies Wipes Natural Care 56 count 12PK,Huggies Wipes Natural Care 56 count 12PK,FBALYB Amazon,1,1,0,0,0,0
,Huggies Wipes Natural Care 56 count 4PK,Huggies Wipes Natural Care 56 count 4PK,FBALYB Amazon,24,20,4,0,4,0
,Huggies Wipes Natural Care 56 count 4PK,Huggies Wipes Natural Care 56 count 4PK,FBALYB Canada,28,28,0,0,0,0
,HUNTER BLACK ORIGINAL CHELSEA UK Size 3,HUNTER BLACK ORIGINAL CHELSEA UK Size 3,Default Ridgefield,0,0,0,0,0,66
,HUNTER BLACK ORIGINAL CHELSEA UK Size 3,HUNTER BLACK ORIGINAL CHELSEA UK Size 3,FBALYB Amazon,-9,-9,0,0,0,0
,HUNTER BLACK ORIGINAL CHELSEA UK Size 4,HUNTER BLACK ORIGINAL CHELSEA UK Size 4,Default Ridgefield,119,119,0,0,0,0
,HUNTER BLACK ORIGINAL CHELSEA UK Size 4,HUNTER BLACK ORIGINAL CHELSEA UK Size 4,FBALYB Amazon,61,60,1,0,1,0
,HUNTER BLACK ORIGINAL CHELSEA UK Size 5,HUNTER BLACK ORIGINAL CHELSEA UK Size 5,Default,0,0,0,0,0,4
,HUNTER BLACK ORIGINAL CHELSEA UK Size 5,HUNTER BLACK ORIGINAL CHELSEA UK Size 5,Default Ridgefield,1,1,0,0,0,312
,HUNTER BLACK ORIGINAL CHELSEA UK Size 5,HUNTER BLACK ORIGINAL CHELSEA UK Size 5,FBALYB Amazon,-452,-455,3,294,3,0
,HUNTER BLACK ORIGINAL CHELSEA UK Size 6,HUNTER BLACK ORIGINAL CHELSEA UK Size 6,Default,0,-1,1,0,0,0
,HUNTER BLACK ORIGINAL CHELSEA UK Size 6,HUNTER BLACK ORIGINAL CHELSEA UK Size 6,Default Ridgefield,21,21,0,0,0,0
,HUNTER BLACK ORIGINAL CHELSEA UK Size 6,HUNTER BLACK ORIGINAL CHELSEA UK Size 6,FBALYB Amazon,14,14,0,2,0,0
,HUNTER BLACK ORIGINAL CHELSEA UK Size 7,HUNTER BLACK ORIGINAL CHELSEA UK Size 7,FBALYB Amazon,-144,-146,2,2,2,0
,HUNTER BLACK ORIGINAL CHELSEA UK Size 8,HUNTER BLACK ORIGINAL CHELSEA UK Size 8,Default,2,2,0,0,0,0
,HUNTER BLACK ORIGINAL CHELSEA UK Size 8,HUNTER BLACK ORIGINAL CHELSEA UK Size 8,FBALYB Amazon,-65,-65,0,0,0,0
,HUNTER BLACK ORIGINAL CHELSEA UK Size 9,HUNTER BLACK ORIGINAL CHELSEA UK Size 9,FBALYB Amazon,-4,-4,0,0,0,0
,HUNTER BLACK ORIGINAL PLAY BOOT SHORT UK Size 4,HUNTER BLACK ORIGINAL PLAY BOOT SHORT UK Size 4,FBALYB Amazon,-20,-38,18,1,18,0
,HUNTER BLACK ORIGINAL PLAY BOOT SHORT UK Size 5,HUNTER BLACK ORIGINAL PLAY BOOT SHORT UK Size 5,Default Ridgefield,26,26,0,0,0,0
,HUNTER BLACK ORIGINAL PLAY BOOT SHORT UK Size 5,HUNTER BLACK ORIGINAL PLAY BOOT SHORT UK Size 5,FBALYB Amazon,-116,-125,9,1,9,0
,HUNTER BLACK ORIGINAL PLAY BOOT SHORT UK Size 6,HUNTER BLACK ORIGINAL PLAY BOOT SHORT UK Size 6,FBALYB Amazon,-259,-266,7,0,7,0
,HUNTER BLACK ORIGINAL PLAY BOOT SHORT UK Size 7,HUNTER BLACK ORIGINAL PLAY BOOT SHORT UK Size 7,FBALYB Amazon,-142,-150,8,1,8,0
,HUNTER BLACK ORIGINAL PLAY BOOT SHORT UK Size 8,HUNTER BLACK ORIGINAL PLAY BOOT SHORT UK Size 8,FBALYB Amazon,-70,-73,3,0,3,0
,HUNTER BLACK WOMENS ORIGINAL SHORT UK Size 4,HUNTER BLACK WOMENS ORIGINAL SHORT UK Size 4,Default Ridgefield,10,10,0,0,0,128
,HUNTER BLACK WOMENS ORIGINAL SHORT UK Size 4,HUNTER BLACK WOMENS ORIGINAL SHORT UK Size 4,FBALYB Amazon,-126,-126,0,0,0,0
,HUNTER BLACK WOMENS ORIGINAL SHORT UK Size 5,HUNTER BLACK WOMENS ORIGINAL SHORT UK Size 5,Default,0,0,0,0,0,4
,HUNTER BLACK WOMENS ORIGINAL SHORT UK Size 5,HUNTER BLACK WOMENS ORIGINAL SHORT UK Size 5,Default Ridgefield,22,22,0,0,0,368
,HUNTER BLACK WOMENS ORIGINAL SHORT UK Size 5,HUNTER BLACK WOMENS ORIGINAL SHORT UK Size 5,FBALYB Amazon,-103,-104,1,0,1,0
,HUNTER BLACK WOMENS ORIGINAL SHORT UK Size 6,HUNTER BLACK WOMENS ORIGINAL SHORT UK Size 6,Default,0,0,0,0,0,44
,HUNTER BLACK WOMENS ORIGINAL SHORT UK Size 6,HUNTER BLACK WOMENS ORIGINAL SHORT UK Size 6,Default Ridgefield,44,44,0,0,0,260
,HUNTER BLACK WOMENS ORIGINAL SHORT UK Size 6,HUNTER BLACK WOMENS ORIGINAL SHORT UK Size 6,FBALYB Amazon,-124,-125,1,34,1,0
,HUNTER BLACK WOMENS ORIGINAL SHORT UK Size 7 US 9,HUNTER BLACK WOMENS ORIGINAL SHORT UK Size 7 US 9,Default Ridgefield,0,0,0,0,0,456
,HUNTER BLACK WOMENS ORIGINAL SHORT UK Size 7 US 9,HUNTER BLACK WOMENS ORIGINAL SHORT UK Size 7 US 9,FBALYB Amazon,-84,-84,0,0,0,0
,HUNTER BLACK WOMENS ORIGINAL SHORT UK Size 8,HUNTER BLACK WOMENS ORIGINAL SHORT UK Size 8,Default Ridgefield,0,0,0,0,0,152
,HUNTER BLACK WOMENS ORIGINAL SHORT UK Size 8,HUNTER BLACK WOMENS ORIGINAL SHORT UK Size 8,FBALYB Amazon,-88,-88,0,2,0,0
,Hunter Boots Size 6,Hunter Boots Size 6,FBASKCK Amazon,60,60,0,0,0,0
,Hunter Boots Size 7,Hunter Boots Size 7,FBASKCK Amazon,101,101,0,0,0,0
,Hunter Boots Size 8,Hunter Boots Size 8,FBASKCK Amazon,63,63,0,0,0,0
,Hunter Boots Size 9,Hunter Boots Size 9,FBASKCK Amazon,13,13,0,0,0,0
,"Hunter Boots,Womens Original Chelsea Short,US-6,UK-4","Hunter Boots,Womens Original Chelsea Short,US-6,UK-4",Default,0,0,0,0,0,60
,"Hunter Boots,Womens Original Chelsea Short,US-7,UK-5","Hunter Boots,Womens Original Chelsea Short,US-7,UK-5",Default,0,0,0,0,0,111
,"Hunter Boots,Womens Original Chelsea Short,US-8,UK-6","Hunter Boots,Womens Original Chelsea Short,US-8,UK-6",Default,0,0,0,0,0,74
,"Hunter Boots,Womens Original Chelsea Short,US-9,UK-7","Hunter Boots,Womens Original Chelsea Short,US-9,UK-7",Default,0,0,0,0,0,18
,Hunter Chelsea Boots,Hunter Chelsea Boots WFS2006RMA-BLK,Default,0,0,0,0,0,263
,HUNTER NAVY ORIGINAL CHELSEA UK Size 5 US 7,HUNTER NAVY ORIGINAL CHELSEA UK Size 5 US 7 ,FBALYB Amazon,-8,-8,0,0,0,0
,HUNTER NAVY ORIGINAL CHELSEA UK Size 6 US 8,HUNTER NAVY ORIGINAL CHELSEA UK Size 6 US 8,FBALYB Amazon,-7,-7,0,0,0,0
,HUNTER NAVY ORIGINAL CHELSEA UK Size 7 US  9,HUNTER NAVY ORIGINAL CHELSEA UK Size 7 US  9,FBALYB Amazon,-7,-7,0,0,0,0
,HUNTER NAVY WOMENS ORIGINAL SHORT UK 4 US 6,HUNTER NAVY WOMENS ORIGINAL SHORT UK 4 US 6,Default Ridgefield,0,0,0,0,0,40
,HUNTER NAVY WOMENS ORIGINAL SHORT UK 4 US 6,HUNTER NAVY WOMENS ORIGINAL SHORT UK 4 US 6,FBALYB Amazon,26,26,0,0,0,0
,HUNTER NAVY WOMENS ORIGINAL SHORT UK 5 US 7,HUNTER NAVY WOMENS ORIGINAL SHORT UK 5 US 7,Default,0,0,0,0,0,19
,HUNTER NAVY WOMENS ORIGINAL SHORT UK 5 US 7,HUNTER NAVY WOMENS ORIGINAL SHORT UK 5 US 7,Default Ridgefield,0,0,0,0,0,112
,HUNTER NAVY WOMENS ORIGINAL SHORT UK 5 US 7,HUNTER NAVY WOMENS ORIGINAL SHORT UK 5 US 7,FBALYB Amazon,-25,-25,0,0,0,0
,HUNTER NAVY WOMENS ORIGINAL SHORT UK 6 US 8,HUNTER NAVY WOMENS ORIGINAL SHORT UK 6 US 8,Default,0,0,0,0,0,75
,HUNTER NAVY WOMENS ORIGINAL SHORT UK 6 US 8,HUNTER NAVY WOMENS ORIGINAL SHORT UK 6 US 8,Default Ridgefield,75,75,0,0,0,80
,HUNTER NAVY WOMENS ORIGINAL SHORT UK 6 US 8,HUNTER NAVY WOMENS ORIGINAL SHORT UK 6 US 8,FBALYB Amazon,260,259,1,1,1,0
,HUNTER NAVY WOMENS ORIGINAL SHORT UK 7 US 9,HUNTER NAVY WOMENS ORIGINAL SHORT UK 7 US 9,Default Ridgefield,0,0,0,0,0,140
,HUNTER NAVY WOMENS ORIGINAL SHORT UK 7 US 9,HUNTER NAVY WOMENS ORIGINAL SHORT UK 7 US 9,FBALYB Amazon,-38,-38,0,0,0,0
,HUNTER NAVY WOMENS ORIGINAL SHORT UK 8 US 10,HUNTER NAVY WOMENS ORIGINAL SHORT UK 8 US 10,Default Ridgefield,0,0,0,0,0,44
,HUNTER NAVY WOMENS ORIGINAL SHORT UK 8 US 10,HUNTER NAVY WOMENS ORIGINAL SHORT UK 8 US 10,FBALYB Amazon,-15,-15,0,0,0,0
,Hunter Original Chelsea - Black UK-3 US-5,Hunter Original Chelsea - Black UK-3 US-5,Default,0,-80,80,0,0,0
,Hunter Original Chelsea - Black UK-3 US-5,Hunter Original Chelsea - Black UK-3 US-5,FBALYB Amazon,12,12,0,0,0,0
,HUNTER RED WOMENS ORIGINAL SHORT UK Size 6,HUNTER RED WOMENS ORIGINAL SHORT UK Size 6,Default Ridgefield,0,0,0,0,0,28
,HUNTER RED WOMENS ORIGINAL SHORT UK Size 6,HUNTER RED WOMENS ORIGINAL SHORT UK Size 6,FBALYB Amazon,-8,-10,2,0,2,0
,Hunter UNISEX 6 STITCH CABLE BOOT SOCK - SHORT - BLK L WAS1018AAB,Hunter UNISEX 6 STITCH CABLE BOOT SOCK - SHORT - BLK L WAS1018AAB,Default Ridgefield,72,72,0,0,0,0
,Hunter UNISEX 6 STITCH CABLE BOOT SOCK - SHORT - BLK L WAS1018AAB,Hunter UNISEX 6 STITCH CABLE BOOT SOCK - SHORT - BLK L WAS1018AAB,FBALYB Amazon,-6,-6,0,0,0,0
,Hunter UNISEX 6 STITCH CABLE BOOT SOCK - SHORT - BLK M WAS1018AAB,Hunter UNISEX 6 STITCH CABLE BOOT SOCK - SHORT - BLK M WAS1018AAB,FBALYB Amazon,59,59,0,0,0,0
,Hunter UNISEX 6 STITCH CABLE BOOT SOCK - SHORT - GRG L WAS1018AAB,Hunter UNISEX 6 STITCH CABLE BOOT SOCK - SHORT - GRG L WAS1018AAB,FBALYB Amazon,-17,-17,0,0,0,0
,Hunter UNISEX 6 STITCH CABLE BOOT SOCK - SHORT - GRG M WAS1018AAB,Hunter UNISEX 6 STITCH CABLE BOOT SOCK - SHORT - GRG M WAS1018AAB,Default Ridgefield,33,33,0,0,0,0
,Hunter UNISEX 6 STITCH CABLE BOOT SOCK - SHORT - GRG M WAS1018AAB,Hunter UNISEX 6 STITCH CABLE BOOT SOCK - SHORT - GRG M WAS1018AAB,FBALYB Amazon,-22,-22,0,0,0,0
,Hunter UNISEX BOOT SOCK - BLACK  - L UAS3000AAA,Hunter UNISEX BOOT SOCK - BLACK  - L UAS3000AAA,FBALYB Amazon,161,157,4,26,4,0
,Hunter UNISEX BOOT SOCK - BLACK -  M UAS3000AAA,Hunter UNISEX BOOT SOCK - BLACK -  M UAS3000AAA,Default Ridgefield,265,265,0,0,0,0
,Hunter UNISEX BOOT SOCK - BLACK -  M UAS3000AAA,Hunter UNISEX BOOT SOCK - BLACK -  M UAS3000AAA,FBALYB Amazon,67,62,5,0,5,0
,Hunter UNISEX BOOT SOCK - SHORT -  BLACK - L UAS3011AAA,Hunter UNISEX BOOT SOCK - SHORT -  BLACK - L UAS3011AAA,FBALYB Amazon,167,167,0,1,0,0
,Hunter UNISEX BOOT SOCK - SHORT -  BLACK - M UAS3011AAA,Hunter UNISEX BOOT SOCK - SHORT -  BLACK - M UAS3011AAA,FBALYB Amazon,163,161,2,0,2,0
,Hunter Womens Chelsea Boot Refined Black UK4 US6,Hunter Womens Chelsea Boot Refined Black UK4 US6,Default Ridgefield,42,42,0,0,0,0
,Hunter Womens Chelsea Boot Refined Black UK4 US6,Hunter Womens Chelsea Boot Refined Black UK4 US6,FBALYB Amazon,-10,-10,0,0,0,0
,Hunter Womens Chelsea Boot Refined Black UK5 US7,Hunter Womens Chelsea Boot Refined Black UK5 US7,Default Ridgefield,53,53,0,0,0,0
,Hunter Womens Chelsea Boot Refined Black UK5 US7,Hunter Womens Chelsea Boot Refined Black UK5 US7,FBALYB Amazon,-17,-17,0,0,0,0
,Hunter Womens Chelsea Boot Refined Black UK6 US8,Hunter Womens Chelsea Boot Refined Black UK6 US8,Default Ridgefield,40,40,0,0,0,0
,Hunter Womens Chelsea Boot Refined Black UK6 US8,Hunter Womens Chelsea Boot Refined Black UK6 US8,FBALYB Amazon,-20,-20,0,0,0,0
,Hunter Womens Chelsea Boot Refined Black UK7 US9,Hunter Womens Chelsea Boot Refined Black UK7 US9,FBALYB Amazon,-32,-32,0,0,0,0
,Hunter Womens Chelsea Boot Refined Black UK8 US10,Hunter Womens Chelsea Boot Refined Black UK8 US10,FBALYB Amazon,-4,-4,0,0,0,0
,Hunter Womens Chelsea Original Gloss Boot Black UK5 US7,Hunter Womens Chelsea Original Gloss Boot Black UK5 US7,FBALYB Amazon,-5,-5,0,0,0,0
,Hunter Womens Chelsea Original Gloss Boot Black UK6 US8,Hunter Womens Chelsea Original Gloss Boot Black UK6 US8,FBALYB Amazon,-5,-5,0,0,0,0
,Hunter WOMENS ORIGINAL BACK ADJUSTABLE SHORT BLK - UK 3 US 5 WFS1013RMA,Hunter WOMENS ORIGINAL BACK ADJUSTABLE SHORT BLK - UK 3 US 5 WFS1013RMA,Default Ridgefield,0,0,0,0,0,20
,Hunter WOMENS ORIGINAL BACK ADJUSTABLE SHORT BLK - UK 3 US 5 WFS1013RMA,Hunter WOMENS ORIGINAL BACK ADJUSTABLE SHORT BLK - UK 3 US 5 WFS1013RMA,FBALYB Amazon,32,32,0,1,0,0
,Hunter WOMENS ORIGINAL BACK ADJUSTABLE SHORT BLK - UK 4 US 6 WFS1013RMA,Hunter WOMENS ORIGINAL BACK ADJUSTABLE SHORT BLK - UK 4 US 6 WFS1013RMA,Default Ridgefield,0,0,0,0,0,40
,Hunter WOMENS ORIGINAL BACK ADJUSTABLE SHORT BLK - UK 4 US 6 WFS1013RMA,Hunter WOMENS ORIGINAL BACK ADJUSTABLE SHORT BLK - UK 4 US 6 WFS1013RMA,FBALYB Amazon,-13,-14,1,78,1,0
,Hunter WOMENS ORIGINAL BACK ADJUSTABLE SHORT BLK - UK 5 US 7 WFS1013RMA,Hunter WOMENS ORIGINAL BACK ADJUSTABLE SHORT BLK - UK 5 US 7 WFS1013RMA,Default Ridgefield,0,-160,160,0,0,100
,Hunter WOMENS ORIGINAL BACK ADJUSTABLE SHORT BLK - UK 5 US 7 WFS1013RMA,Hunter WOMENS ORIGINAL BACK ADJUSTABLE SHORT BLK - UK 5 US 7 WFS1013RMA,FBALYB Amazon,124,120,4,0,4,0
,Hunter WOMENS ORIGINAL BACK ADJUSTABLE SHORT BLK - UK 6 US 8 WFS1013RMA,Hunter WOMENS ORIGINAL BACK ADJUSTABLE SHORT BLK - UK 6 US 8 WFS1013RMA,Default Ridgefield,1,1,0,0,0,120
,Hunter WOMENS ORIGINAL BACK ADJUSTABLE SHORT BLK - UK 6 US 8 WFS1013RMA,Hunter WOMENS ORIGINAL BACK ADJUSTABLE SHORT BLK - UK 6 US 8 WFS1013RMA,FBALYB Amazon,25,25,0,96,0,0
,Hunter WOMENS ORIGINAL BACK ADJUSTABLE SHORT BLK - UK 8 US 10 WFS1013RMA,Hunter WOMENS ORIGINAL BACK ADJUSTABLE SHORT BLK - UK 8 US 10 WFS1013RMA,Default Ridgefield,0,0,0,0,0,40
,Hunter WOMENS ORIGINAL BACK ADJUSTABLE SHORT BLK - UK 8 US 10 WFS1013RMA,Hunter WOMENS ORIGINAL BACK ADJUSTABLE SHORT BLK - UK 8 US 10 WFS1013RMA,FBALYB Amazon,-16,-16,0,0,0,0
,Hunter WOMENS ORIGINAL BACK ADJUSTABLE SHORT BLK - UK 9 US 11 WFS1013RMA,Hunter WOMENS ORIGINAL BACK ADJUSTABLE SHORT BLK - UK 9 US 11 WFS1013RMA,Default Ridgefield,197,197,0,0,0,0
,Hunter WOMENS ORIGINAL REFINED CHELSEA - BLACK - UK 3 US 5 WFS1017RMA,Hunter WOMENS ORIGINAL REFINED CHELSEA - BLACK - UK 3 US 5 WFS1017RMA,Default Ridgefield,12,12,0,0,0,0
,Hunter Womens Original Short Adjustable Boot Black UK5 US7,Hunter Womens Original Short Adjustable Boot Black UK5 US7,FBALYB Amazon,-9,-9,0,0,0,0
,Hunter Womens Original Short Adjustable Boot Black UK7 US9,Hunter Womens Original Short Adjustable Boot Black UK7 US9,Default Ridgefield,0,0,0,0,0,100
,Hunter Womens Original Short Adjustable Boot Black UK7 US9,Hunter Womens Original Short Adjustable Boot Black UK7 US9,FBALYB Amazon,-38,-38,0,0,0,0
,Hunter Womens Original Tall Black UK 5 EU 38 US 7 WFT1000RMA-BLK,Hunter Womens Original Tall Black UK 5 EU 38 US 7 WFT1000RMA-BLK,Default Ridgefield,0,0,0,0,0,72
,Hunter Womens Original Tall Black UK 5 EU 38 US 7 WFT1000RMA-BLK,Hunter Womens Original Tall Black UK 5 EU 38 US 7 WFT1000RMA-BLK,FBALYB Amazon,-29,-29,0,0,0,0
,Hunter Womens Original Tall Black UK6 EU39 US8 WFT1000RMA-BLK,Hunter Womens Original Tall Black UK6 EU39 US8 WFT1000RMA-BLK,Default,0,0,0,0,0,5
,Hunter Womens Original Tall Black UK6 EU39 US8 WFT1000RMA-BLK,Hunter Womens Original Tall Black UK6 EU39 US8 WFT1000RMA-BLK,Default Ridgefield,4,4,0,0,0,88
,Hunter Womens Original Tall Black UK6 EU39 US8 WFT1000RMA-BLK,Hunter Womens Original Tall Black UK6 EU39 US8 WFT1000RMA-BLK,FBALYB Amazon,-44,-44,0,0,0,0
,Hunter Womens Original Tall Black UK7 EU40/41 US9 WFT1000RMA-BLK,Hunter Womens Original Tall Black UK7 EU40/41 US9 WFT1000RMA-BLK,Default Ridgefield,0,0,0,0,0,56
,Hunter Womens Original Tall Black UK7 EU40/41 US9 WFT1000RMA-BLK,Hunter Womens Original Tall Black UK7 EU40/41 US9 WFT1000RMA-BLK,FBALYB Amazon,-28,-28,0,1,0,0
,Hunter Womens Original Tall Black UK8 EU42 US10 WFT1000RMA-BLK,Hunter Womens Original Tall Black UK8 EU42 US10 WFT1000RMA-BLK,Default,0,0,0,0,0,5
,Hunter Womens Original Tall Black UK8 EU42 US10 WFT1000RMA-BLK,Hunter Womens Original Tall Black UK8 EU42 US10 WFT1000RMA-BLK,Default Ridgefield,0,0,0,0,0,48
,Hunter Womens Original Tall Black UK8 EU42 US10 WFT1000RMA-BLK,Hunter Womens Original Tall Black UK8 EU42 US10 WFT1000RMA-BLK,FBALYB Amazon,24,23,1,0,1,0
,Hunter Womens Original Tall Hunter Green UK3 US5,Hunter Womens Original Tall Hunter Green UK3 US5,Default,0,0,0,0,0,4
,Hunter Womens Original Tall Hunter Green UK3 US5,Hunter Womens Original Tall Hunter Green UK3 US5,Default Ridgefield,0,0,0,0,0,24
,Hunter Womens Original Tall Hunter Green UK3 US5,Hunter Womens Original Tall Hunter Green UK3 US5,FBALYB Amazon,14,14,0,0,0,0
,Hunter Womens Original Tall Hunter Green UK4 US6,Hunter Womens Original Tall Hunter Green UK4 US6,Default Ridgefield,0,0,0,0,0,56
,Hunter Womens Original Tall Hunter Green UK4 US6,Hunter Womens Original Tall Hunter Green UK4 US6,FBALYB Amazon,95,95,0,0,0,0
,Hunter Womens Original Tall Hunter Green UK5 US7,Hunter Womens Original Tall Hunter Green UK5 US7,Default Ridgefield,0,0,0,0,0,88
,Hunter Womens Original Tall Hunter Green UK5 US7,Hunter Womens Original Tall Hunter Green UK5 US7,FBALYB Amazon,171,170,1,0,1,0
,Hunter Womens Original Tall Hunter Green UK6 US8,Hunter Womens Original Tall Hunter Green UK6 US8,Default Ridgefield,0,-2,2,0,0,108
,Hunter Womens Original Tall Hunter Green UK6 US8,Hunter Womens Original Tall Hunter Green UK6 US8,FBALYB Amazon,90,90,0,0,0,0
,Hunter Womens Original Tall Hunter Green UK7 US9,Hunter Womens Original Tall Hunter Green UK7 US9,Default Ridgefield,200,200,0,0,0,72
,Hunter Womens Original Tall Hunter Green UK7 US9,Hunter Womens Original Tall Hunter Green UK7 US9,FBALYB Amazon,176,171,5,0,5,0
,Hunter Womens Original Tall Hunter Green UK8 US10,Hunter Womens Original Tall Hunter Green UK8 US10,Default,0,0,0,0,0,7
,Hunter Womens Original Tall Hunter Green UK8 US10,Hunter Womens Original Tall Hunter Green UK8 US10,Default Ridgefield,0,0,0,0,0,64
,Hunter Womens Original Tall Hunter Green UK8 US10,Hunter Womens Original Tall Hunter Green UK8 US10,FBALYB Amazon,113,113,0,0,0,0
,Hunter Womens Original Tall Navy UK4 EU37 US6 WFT1000RMA-NVY,Hunter Womens Original Tall Navy UK4 EU37 US6 WFT1000RMA-NVY,FBALYB Amazon,20,20,0,0,0,0
,Hunter Womens Original Tall Navy UK6 EU39 US8 WFT1000RMA-NVY,Hunter Womens Original Tall Navy UK6 EU39 US8 WFT1000RMA-NVY,FBALYB Amazon,28,28,0,0,0,0
,Hunter Womens Original Tall Navy UK8 EU42 US10 WFT1000RMA-NVY,Hunter Womens Original Tall Navy UK8 EU42 US10 WFT1000RMA-NVY,FBALYB Amazon,20,19,1,0,1,0
,Hunter Womens Playboot Short Black UK3 US5,Hunter Womens Playboot Short Black UK3 US5,Default Ridgefield,4,4,0,0,0,0
,Hunter Womens Playboot Short Black UK3 US5,Hunter Womens Playboot Short Black UK3 US5,FBALYB Amazon,35,35,0,0,0,0
,Hunter Womens Playboot Short Black UK8 US10,Hunter Womens Playboot Short Black UK8 US10,Default Ridgefield,1,1,0,0,0,0
,Hunter Womens Playboot Short Black UK9 US11,Hunter Womens Playboot Short Black UK9 US11,FBALYB Amazon,-20,-23,3,0,3,0
,Hunter Womens Short Gloss Boots Black UK5 US7,Hunter Womens Short Gloss Boots Black UK5 US7,FBALYB Amazon,-2,-2,0,0,0,0
,Hunter Womens Short Gloss Boots Black UK6 US8,Hunter Womens Short Gloss Boots Black UK6 US8,FBALYB Amazon,-12,-12,0,3,0,0
,Hunter Womens Short Gloss Boots Black UK7 US9,Hunter Womens Short Gloss Boots Black UK7 US9,FBALYB Amazon,-6,-6,0,0,0,0
,Hunter Womens Short Gloss Boots Black UK8 US10,Hunter Womens Short Gloss Boots Black UK8 US10,FBALYB Amazon,-2,-2,0,0,0,0
,Hunter Womens Short Gloss Boots Military Red UK4 US6,Hunter Womens Short Gloss Boots Military Red UK4 US6,FBALYB Amazon,51,51,0,1,0,0
,Hunter Womens Short Gloss Boots Military Red UK5 US7,Hunter Womens Short Gloss Boots Military Red UK5 US7,FBALYB Amazon,88,88,0,0,0,0
,Hunter Womens Short Gloss Boots Military Red UK6 US8,Hunter Womens Short Gloss Boots Military Red UK6 US8,FBALYB Amazon,165,165,0,0,0,0
,Hunter Womens Short Gloss Boots Military Red UK8 US10,Hunter Womens Short Gloss Boots Military Red UK8 US10,Default Ridgefield,4,4,0,0,0,0
,Hunter Womens Short Gloss Boots Military Red UK8 US10,Hunter Womens Short Gloss Boots Military Red UK8 US10,FBALYB Amazon,100,100,0,0,0,0
,Hunter Womens Short Gloss Boots Navy UK5 US7,Hunter Womens Short Gloss Boots Navy UK5 US7,Default Ridgefield,0,0,0,0,0,20
,Hunter Womens Short Gloss Boots Navy UK5 US7,Hunter Womens Short Gloss Boots Navy UK5 US7,FBALYB Amazon,-2,-2,0,0,0,0
,Hunter Womens Short Gloss Boots Navy UK6 US8,Hunter Womens Short Gloss Boots Navy UK6 US8,Default Ridgefield,0,0,0,0,0,40
,Hunter Womens Short Gloss Boots Navy UK6 US8,Hunter Womens Short Gloss Boots Navy UK6 US8,FBALYB Amazon,9,9,0,0,0,0
,Hunter Womens Short Gloss Boots Navy UK7 US9,Hunter Womens Short Gloss Boots Navy UK7 US9,Default Ridgefield,1,1,0,0,0,28
,Hunter Womens Short Gloss Boots Navy UK7 US9,Hunter Womens Short Gloss Boots Navy UK7 US9,FBALYB Amazon,-3,-3,0,0,0,0
,Hunter Womens Short Matte Boot Dark Olive UK5 US7,Hunter Womens Short Matte Boot Dark Olive UK5 US7,FBALYB Amazon,-2,-2,0,0,0,0
,Hunter Womens Short Matte Boot Dark Olive UK6 US8,Hunter Womens Short Matte Boot Dark Olive UK6 US8,FBALYB Amazon,-5,-5,0,0,0,0
,Hunter Womens Short Matte Boot Dark Olive UK7 US9,Hunter Womens Short Matte Boot Dark Olive UK7 US9,FBALYB Amazon,-2,-2,0,0,0,0
,Husky Clear Drawstring Bags,Husky Clear Drawstring Bags 70/39 gal,FBALYB Amazon,0,0,0,1,0,0
,"Huy Fong Foods Sriracha Sauce, 2 pk./28 oz.","Huy Fong Foods Sriracha Sauce, 2 pk./28 oz.",FBALYB Amazon,1,1,0,0,0,0
,Hydrapak A262- SHAPE-SHIFT 2L-2L,Hydrapak A262- SHAPE-SHIFT 2L-2L,FBALYB Amazon,141,135,6,0,6,0
,Hydrapak A262- SHAPE-SHIFT 2L-2L,Hydrapak A262- SHAPE-SHIFT 2L-2L,FBALYB Canada,17,17,0,0,0,0
,Hydrapak A263- SHAPE-SHIFT 3L,Hydrapak A263- SHAPE-SHIFT 3L,Default Ridgefield,1,1,0,0,0,0
,Hydrapak A263- SHAPE-SHIFT 3L,Hydrapak A263- SHAPE-SHIFT 3L,FBALYB Amazon,113,112,1,0,1,0
,Hydrapak A263- SHAPE-SHIFT 3L,Hydrapak A263- SHAPE-SHIFT 3L,FBALYB Canada,17,17,0,0,0,0
,Hydrapak A822M-SEEKER 2L,Hydrapak A822M-SEEKER 2L,FBALYB Amazon,-2,-3,1,0,1,0
,Hydrapak A822M-SEEKER 2L,Hydrapak A822M-SEEKER 2L,FBALYB Canada,9,9,0,0,0,0
,Hydrapak A823M-SEEKER 3L,Hydrapak A823M-SEEKER 3L,FBALYB Amazon,1,0,1,0,1,0
,Hydrapak A823M-SEEKER 3L,Hydrapak A823M-SEEKER 3L,FBALYB Canada,20,20,0,0,0,0
,Hydrapak A828M - SEEKER 4L,Hydrapak A828M - SEEKER 4L,Default Ridgefield,20,20,0,0,0,0
,Hydrapak A828M - SEEKER 4L,Hydrapak A828M - SEEKER 4L,FBALYB Amazon,71,70,1,0,1,0
,Hydrapak Force Reservoir 2L Mammoth Grey,Hydrapak Force Reservoir 2L Mammoth Grey,FBALYB Amazon,6,6,0,0,0,0
,Hydrapak GS330M- STOW BOTTLE 1L,Hydrapak GS330M- STOW BOTTLE 1L,FBALYB Amazon,92,92,0,0,0,0
,Hydrapak GS330M- STOW BOTTLE 1L,Hydrapak GS330M- STOW BOTTLE 1L,FBALYB Canada,17,17,0,0,0,0
,Hydrapak Softflask 750ml Malibu Blue,Hydrapak Softflask 750ml Malibu Blue,FBALYB Amazon,-3,-3,0,0,0,0
,Hydrapak Stow Bottle 1L Malibu Blue,Hydrapak Stow Bottle 1L Malibu Blue,FBALYB Amazon,1,0,1,0,1,0
,Hydrapak Ultraflask 500ml Malibu Blue,Hydrapak Ultraflask 500ml Malibu Blue,FBALYB Amazon,73,73,0,0,0,0
,Hydrapak Ultraflask 500ml Malibu Blue,Hydrapak Ultraflask 500ml Malibu Blue,FBALYB Canada,-1,-1,0,0,0,0
,Hydrapak Ultraflask 600ml Malibu Blue,Hydrapak Ultraflask 600ml Malibu Blue,FBALYB Amazon,8,2,6,0,6,0
,Hydrapak Ultraflask 600ml Malibu Blue,Hydrapak Ultraflask 600ml Malibu Blue,FBALYB Canada,-1,-1,0,0,0,0
,HydroBak 50 oz Black/Graphite,HydroBak 50 oz Black/Graphite,Default,44,44,0,0,0,0
,HydroBak 50 oz Black/Graphite,HydroBak 50 oz Black/Graphite,FBALYB Amazon,-101,-101,0,0,0,0
,HydroBak 50 oz Lapis Blue/Atomic Blue,HydroBak 50 oz Lapis Blue/Atomic Blue,FBALYB Amazon,-22,-22,0,0,0,0
,HydroBak 50 oz Safety Yellow/Navy,HydroBak 50 oz Safety Yellow/Navy,FBALYB Amazon,-4,-4,0,0,0,0
,Hydro Flask 12 OZ COFFEE MUG BLACK,Hydro Flask 12 OZ COFFEE MUG BLACK,Default Ridgefield,112,112,0,0,0,0
,Hydro Flask 12 OZ COFFEE MUG STONE,Hydro Flask 12 OZ COFFEE MUG STONE,Default Ridgefield,80,80,0,0,0,0
,Hydroflask 12 oz KIDS Wide Mouth Fog,Hydroflask 12 oz KIDS Wide Mouth Fog,FBALYB Amazon,63,59,4,0,4,0
,Hydroflask 12 oz KIDS Wide Mouth Frost,Hydroflask 12 oz KIDS Wide Mouth Frost,FBALYB Amazon,-3,-3,0,0,0,0
,Hydroflask 12 oz KIDS Wide Mouth Hibiscus,Hydroflask 12 oz KIDS Wide Mouth Hibiscus,FBALYB Amazon,-4,-4,0,0,0,0
,Hydroflask 12 oz KIDS Wide Mouth Lemon,Hydroflask 12 oz KIDS Wide Mouth Lemon,FBALYB Amazon,-1,-1,0,0,0,0
,Hydroflask 12 oz KIDS Wide Mouth Olive,Hydroflask 12 oz KIDS Wide Mouth Olive,FBALYB Amazon,43,34,9,0,9,0
,Hydroflask 12 oz KIDS Wide Mouth Pacific,Hydroflask 12 oz KIDS Wide Mouth Pacific,Default Ridgefield,1,1,0,0,0,0
,Hydroflask 12 oz KIDS Wide Mouth Pacific,Hydroflask 12 oz KIDS Wide Mouth Pacific,FBALYB Amazon,-3,-4,1,0,1,0
,Hydroflask 12 oz KIDS Wide Mouth Watermelon,Hydroflask 12 oz KIDS Wide Mouth Watermelon,FBALYB Amazon,-2,-2,0,0,0,0
,Hydroflask 12 oz Wide Mouth Flex Black,Hydroflask 12 oz Wide Mouth Flex Black,Default Ridgefield,0,0,0,0,0,96
,Hydroflask 12 oz Wide Mouth Flex Black,Hydroflask 12 oz Wide Mouth Flex Black,FBALYB Amazon,159,159,0,0,0,0
,Hydroflask 12 oz Wide Mouth Flex Hibiscus,Hydroflask 12 oz Wide Mouth Flex Hibiscus,FBALYB Amazon,5,4,1,0,1,0
,Hydroflask 12 oz Wide Mouth Flex Olive,Hydroflask 12 oz Wide Mouth Flex Olive,Default Ridgefield,0,0,0,0,0,72
,Hydroflask 12 oz Wide Mouth Flex Olive,Hydroflask 12 oz Wide Mouth Flex Olive,FBALYB Amazon,72,72,0,0,0,0
,Hydroflask 12 oz Wide Mouth Flex Sip Lid Pacific,Hydroflask 12 oz Wide Mouth Flex Sip Lid Pacific,Default Ridgefield,0,0,0,0,0,48
,Hydroflask 12 oz Wide Mouth Flex Sip Lid Stone,Hydroflask 12 oz Wide Mouth Flex Sip Lid Stone,FBALYB Amazon,1,1,0,0,0,0
,Hydroflask 12 oz Wide Mouth Flex Sip Lid White,Hydroflask 12 oz Wide Mouth Flex Sip Lid White,Default Ridgefield,0,0,0,0,0,24
,Hydroflask 12 oz Wide Mouth Flex Sip Lid White,Hydroflask 12 oz Wide Mouth Flex Sip Lid White,FBALYB Amazon,121,121,0,0,0,0
,Hydroflask 12 oz Wide Mouth Flex Spearmint,Hydroflask 12 oz Wide Mouth Flex Spearmint,FBALYB Amazon,-5,-6,1,1,1,0
,Hydroflask 12 oz Wide Mouth Sunflower,Hydroflask 12 oz Wide Mouth Sunflower,FBALYB Amazon,-7,-7,0,0,0,0
,Hydroflask 12 oz Wide Mouth Watermelon,Hydroflask 12 oz Wide Mouth Watermelon,FBALYB Amazon,-3,-3,0,0,0,0
,Hydroflask 12 oz Wide Mouth W Fog,Hydroflask 12 oz Wide Mouth W Fog,FBALYB Amazon,35,35,0,0,0,0
,Hydroflask 16 oz Wide Mouth Flex Black,Hydroflask 16 oz Wide Mouth Flex Black,Default Ridgefield,0,0,0,0,0,120
,Hydroflask 16 oz Wide Mouth Flex Black,Hydroflask 16 oz Wide Mouth Flex Black,FBALYB Amazon,-1,-1,0,0,0,0
,Hydroflask 16 oz Wide Mouth Flex Hibiscus,Hydroflask 16 oz Wide Mouth Flex Hibiscus,FBALYB Amazon,60,59,1,0,1,0
,Hydroflask 16 oz Wide Mouth Flex Olive,Hydroflask 16 oz Wide Mouth Flex Olive,Default Ridgefield,0,0,0,0,0,96
,Hydroflask 16 oz Wide Mouth Flex Olive,Hydroflask 16 oz Wide Mouth Flex Olive,FBALYB Amazon,-1,-1,0,0,0,0
,Hydroflask 16 oz Wide Mouth Flex Sip Lid Pacific,Hydroflask 16 oz Wide Mouth Flex Sip Lid Pacific,Default Ridgefield,0,0,0,0,0,48
,Hydroflask 16 oz Wide Mouth Flex Sip Lid Pacific,Hydroflask 16 oz Wide Mouth Flex Sip Lid Pacific,FBALYB Canada,4,4,0,0,0,0
,Hydroflask 16 oz Wide Mouth Flex Sip Lid Stone,Hydroflask 16 oz Wide Mouth Flex Sip Lid Stone,Default Ridgefield,1,1,0,0,0,96
,Hydroflask 16 oz Wide Mouth Flex Sip Lid Stone,Hydroflask 16 oz Wide Mouth Flex Sip Lid Stone,FBALYB Amazon,66,66,0,0,0,0
,Hydroflask 16 oz Wide Mouth Flex Sip Lid Stone,Hydroflask 16 oz Wide Mouth Flex Sip Lid Stone,FBALYB Canada,2,2,0,0,0,0
,Hydroflask 16 oz Wide Mouth Flex Sip Lid Sunflower,Hydroflask 16 oz Wide Mouth Flex Sip Lid Sunflower,FBALYB Amazon,2,1,1,0,1,0
,Hydroflask 16 oz Wide Mouth Flex Sip Lid Sunflower,Hydroflask 16 oz Wide Mouth Flex Sip Lid Sunflower,FBALYB Canada,2,2,0,0,0,0
,Hydroflask 16 oz Wide Mouth Flex Sip Lid Watermelon,Hydroflask 16 oz Wide Mouth Flex Sip Lid Watermelon,FBALYB Amazon,10,8,2,0,2,0
,Hydroflask 16 oz Wide Mouth Flex Sip Lid White,Hydroflask 16 oz Wide Mouth Flex Sip Lid White,Default Ridgefield,0,0,0,0,0,24
,Hydroflask 16 oz Wide Mouth Flex Sip Lid White,Hydroflask 16 oz Wide Mouth Flex Sip Lid White,FBALYB Amazon,10,10,0,0,0,0
,Hydroflask 16 oz Wide Mouth Flex Spearmint,Hydroflask 16 oz Wide Mouth Flex Spearmint,Default Ridgefield,5,5,0,0,0,0
,Hydroflask 16 oz Wide Mouth Flex Spearmint,Hydroflask 16 oz Wide Mouth Flex Spearmint,FBALYB Amazon,-3,-5,2,0,2,0
,Hydro Flask 18 OZ STANDARD FLEX CAP ALPINE,Hydro Flask 18 OZ STANDARD FLEX CAP ALPINE,FBALYB Amazon,22,20,2,0,2,0
,Hydro Flask 18 OZ STANDARD FLEX CAP CARNATION,Hydro Flask 18 OZ STANDARD FLEX CAP CARNATION,FBALYB Amazon,71,71,0,0,0,0
,Hydro Flask 18 OZ STANDARD FLEX CAP PINEAPPLE,Hydro Flask 18 OZ STANDARD FLEX CAP PINEAPPLE,FBALYB Amazon,81,79,2,0,2,0
,Hydro Flask 18 OZ STANDARD FLEX CAP RAIN,Hydro Flask 18 OZ STANDARD FLEX CAP RAIN,FBALYB Amazon,20,19,1,0,1,0
,Hydro Flask 18 OZ STANDARD MOUTH FLEX CAP STONE,Hydro Flask 18 OZ STANDARD MOUTH FLEX CAP STONE,FBALYB Amazon,76,75,1,0,1,0
,Hydroflask 20 oz Wide Mouth Black,Hydroflask 20 oz Wide Mouth Black,Default Ridgefield,162,162,0,0,0,72
,Hydroflask 20 oz Wide Mouth Black,Hydroflask 20 oz Wide Mouth Black,FBALYB Amazon,360,360,0,0,0,0
,Hydroflask 20 oz Wide Mouth Cobalt,Hydroflask 20 oz Wide Mouth Cobalt,Default Ridgefield,288,288,0,0,0,48
,Hydroflask 20 oz Wide Mouth Cobalt,Hydroflask 20 oz Wide Mouth Cobalt,FBALYB Amazon,91,91,0,0,0,0
,Hydroflask 20 oz Wide Mouth Fog,Hydroflask 20 oz Wide Mouth Fog,FBALYB Amazon,-2,-2,0,0,0,0
,Hydroflask 20 oz Wide Mouth Hibiscus,Hydroflask 20 oz Wide Mouth Hibiscus,FBALYB Amazon,-7,-7,0,0,0,0
,Hydroflask 20 oz Wide Mouth Olive,Hydroflask 20 oz Wide Mouth Olive,Default Ridgefield,1,1,0,0,0,48
,Hydroflask 20 oz Wide Mouth Olive,Hydroflask 20 oz Wide Mouth Olive,FBALYB Amazon,312,312,0,0,0,0
,Hydroflask 20 oz Wide Mouth Olive,Hydroflask 20 oz Wide Mouth Olive,FBALYB Canada,0,-7,7,10,7,0
,Hydroflask 20 oz Wide Mouth Pacific,Hydroflask 20 oz Wide Mouth Pacific,FBALYB Amazon,93,93,0,0,0,0
,Hydroflask 20 oz Wide Mouth Spearmint,Hydroflask 20 oz Wide Mouth Spearmint,FBALYB Amazon,-2,-2,0,0,0,0
,Hydroflask 20 oz Wide Mouth Stone,Hydroflask 20 oz Wide Mouth Stone,Default Ridgefield,128,128,0,0,0,24
,Hydroflask 20 oz Wide Mouth Stone,Hydroflask 20 oz Wide Mouth Stone,FBALYB Amazon,109,109,0,0,0,0
,Hydroflask 20 oz Wide Mouth Sunflower,Hydroflask 20 oz Wide Mouth Sunflower,FBALYB Amazon,-7,-7,0,0,0,0
,Hydroflask 20 oz Wide Mouth Watermelon,Hydroflask 20 oz Wide Mouth Watermelon,Default Ridgefield,1,1,0,0,0,0
,Hydroflask 20 oz Wide Mouth Watermelon,Hydroflask 20 oz Wide Mouth Watermelon,FBALYB Amazon,-7,-7,0,0,0,0
,Hydroflask 20 oz Wide Mouth White,Hydroflask 20 oz Wide Mouth White,Default Ridgefield,0,0,0,0,0,48
,Hydroflask 20 oz Wide Mouth White,Hydroflask 20 oz Wide Mouth White,FBALYB Amazon,237,237,0,0,0,0
,Hydro Flask 21 OZ STANDARD FLEX CAP ALPINE,Hydro Flask 21 OZ STANDARD FLEX CAP ALPINE,Default Ridgefield,112,112,0,0,0,0
,Hydro Flask 21 OZ STANDARD FLEX CAP CARNATION,Hydro Flask 21 OZ STANDARD FLEX CAP CARNATION,Default Ridgefield,0,0,0,0,0,24
,Hydro Flask 21 OZ STANDARD FLEX CAP CARNATION,Hydro Flask 21 OZ STANDARD FLEX CAP CARNATION,FBALYB Amazon,91,89,2,0,2,0
,Hydro Flask 21 OZ STANDARD FLEX CAP PINEAPPLE,Hydro Flask 21 OZ STANDARD FLEX CAP PINEAPPLE,Default Ridgefield,0,0,0,0,0,24
,Hydro Flask 21 OZ STANDARD FLEX CAP PINEAPPLE,Hydro Flask 21 OZ STANDARD FLEX CAP PINEAPPLE,FBALYB Amazon,85,85,0,0,0,0
,Hydro Flask 21 OZ STANDARD FLEX CAP RAIN,Hydro Flask 21 OZ STANDARD FLEX CAP RAIN,FBALYB Amazon,60,57,3,0,3,0
,Hydroflask 21 oz Standard Mouth Black,Hydroflask 21 oz Standard Mouth Black,Default Ridgefield,1,1,0,0,0,384
,Hydroflask 21 oz Standard Mouth Black,Hydroflask 21 oz Standard Mouth Black,FBALYB Amazon,194,193,1,0,1,0
,Hydroflask 21 oz Standard Mouth Black,Hydroflask 21 oz Standard Mouth Black,FBALYB Canada,0,0,0,1,0,0
,Hydroflask 21 oz Standard Mouth Cobalt,Hydroflask 21 oz Standard Mouth Cobalt,Default Ridgefield,288,288,0,0,0,240
,Hydroflask 21 oz Standard Mouth Cobalt,Hydroflask 21 oz Standard Mouth Cobalt,FBALYB Amazon,-2,-4,2,0,2,0
,Hydroflask 21 oz Standard Mouth Fog,Hydroflask 21 oz Standard Mouth Fog,FBALYB Amazon,-5,-5,0,0,0,0
,Hydroflask 21 oz Standard Mouth Graphite,Hydroflask 21 oz Standard Mouth Graphite,FBALYB Amazon,-10,-10,0,0,0,0
,Hydroflask 21 oz Standard Mouth Hibiscus,Hydroflask 21 oz Standard Mouth Hibiscus,FBALYB Amazon,87,87,0,0,0,0
,Hydroflask 21 oz Standard Mouth Olive,Hydroflask 21 oz Standard Mouth Olive,Default Ridgefield,0,0,0,0,0,144
,Hydroflask 21 oz Standard Mouth Olive,Hydroflask 21 oz Standard Mouth Olive,FBALYB Amazon,214,211,3,0,3,0
,Hydroflask 21 oz Standard Mouth Pacific,Hydroflask 21 oz Standard Mouth Pacific,Default Ridgefield,0,0,0,0,0,240
,Hydroflask 21 oz Standard Mouth Pacific,Hydroflask 21 oz Standard Mouth Pacific,FBALYB Amazon,279,278,1,24,1,0
,Hydroflask 21 oz Standard Mouth Spearmint,Hydroflask 21 oz Standard Mouth Spearmint,FBALYB Amazon,-7,-7,0,0,0,0
,Hydroflask 21 oz Standard Mouth Stone,Hydroflask 21 oz Standard Mouth Stone,Default Ridgefield,0,0,0,0,0,24
,Hydroflask 21 oz Standard Mouth Stone,Hydroflask 21 oz Standard Mouth Stone,FBALYB Amazon,32,25,7,0,7,0
,Hydroflask 21 oz Standard Mouth Sunflower,Hydroflask 21 oz Standard Mouth Sunflower,Default Ridgefield,157,157,0,0,0,0
,Hydroflask 21 oz Standard Mouth Sunflower,Hydroflask 21 oz Standard Mouth Sunflower,FBALYB Amazon,-3,-3,0,0,0,0
,Hydroflask 21 oz Standard Mouth Watermelon,Hydroflask 21 oz Standard Mouth Watermelon,Default Ridgefield,2,2,0,0,0,0
,Hydroflask 21 oz Standard Mouth Watermelon,Hydroflask 21 oz Standard Mouth Watermelon,FBALYB Amazon,-9,-9,0,0,0,0
,Hydroflask 21 oz Standard Mouth Watermelon,Hydroflask 21 oz Standard Mouth Watermelon,FBALYB Canada,8,8,0,0,0,0
,Hydroflask 21 oz Standard Mouth White,Hydroflask 21 oz Standard Mouth White,Default Ridgefield,3,3,0,0,0,240
,Hydroflask 21 oz Standard Mouth White,Hydroflask 21 oz Standard Mouth White,FBALYB Amazon,283,283,0,0,0,0
,Hydroflask 21 oz Standard Mouth White,Hydroflask 21 oz Standard Mouth White,FBALYB Canada,0,-4,4,25,4,0
,Hydroflask 24 oz Standard Mouth Black,Hydroflask 24 oz Standard Mouth Black,Default Ridgefield,1,1,0,0,0,528
,Hydroflask 24 oz Standard Mouth Black,Hydroflask 24 oz Standard Mouth Black,FBALYB Amazon,405,381,24,0,24,0
,Hydroflask 24 oz Standard Mouth Cobalt,Hydroflask 24 oz Standard Mouth Cobalt,Default Ridgefield,10,10,0,0,0,360
,Hydroflask 24 oz Standard Mouth Cobalt,Hydroflask 24 oz Standard Mouth Cobalt,FBALYB Amazon,315,315,0,0,0,0
,Hydroflask 24 oz Standard Mouth Cobalt,Hydroflask 24 oz Standard Mouth Cobalt,FBALYB Canada,0,0,0,30,0,0
,Hydroflask 24 oz Standard Mouth Fog,Hydroflask 24 oz Standard Mouth Fog,Default Ridgefield,1,1,0,0,0,0
,Hydroflask 24 oz Standard Mouth Fog,Hydroflask 24 oz Standard Mouth Fog,FBALYB Amazon,-8,-8,0,0,0,0
,Hydroflask 24 oz Standard Mouth Hibiscus,Hydroflask 24 oz Standard Mouth Hibiscus,FBALYB Amazon,-6,-6,0,0,0,0
,Hydroflask 24 oz Standard Mouth Olive,Hydroflask 24 oz Standard Mouth Olive,Default Ridgefield,1,1,0,0,0,240
,Hydroflask 24 oz Standard Mouth Olive,Hydroflask 24 oz Standard Mouth Olive,FBALYB Amazon,232,228,4,0,4,0
,Hydroflask 24 oz Standard Mouth Pacific,Hydroflask 24 oz Standard Mouth Pacific,Default Ridgefield,0,0,0,0,0,360
,Hydroflask 24 oz Standard Mouth Pacific,Hydroflask 24 oz Standard Mouth Pacific,FBALYB Amazon,1002,1000,2,0,2,0
,Hydroflask 24 oz Standard Mouth Spearmint,Hydroflask 24 oz Standard Mouth Spearmint,FBALYB Amazon,-5,-5,0,0,0,0
,Hydroflask 24 oz Standard Mouth Stone,Hydroflask 24 oz Standard Mouth Stone,Default Ridgefield,2,2,0,0,0,48
,Hydroflask 24 oz Standard Mouth Stone,Hydroflask 24 oz Standard Mouth Stone,FBALYB Amazon,-7,-8,1,1,1,0
,Hydroflask 24 oz Standard Mouth Sunflower,Hydroflask 24 oz Standard Mouth Sunflower,Default Ridgefield,16,16,0,0,0,0
,Hydroflask 24 oz Standard Mouth Sunflower,Hydroflask 24 oz Standard Mouth Sunflower,FBALYB Amazon,-9,-9,0,0,0,0
,Hydroflask 24 oz Standard Mouth Watermelon,Hydroflask 24 oz Standard Mouth Watermelon,Default Ridgefield,1,1,0,0,0,0
,Hydroflask 24 oz Standard Mouth Watermelon,Hydroflask 24 oz Standard Mouth Watermelon,FBALYB Amazon,-13,-13,0,0,0,0
,Hydroflask 24 oz Standard Mouth White,Hydroflask 24 oz Standard Mouth White,Default Ridgefield,634,634,0,0,0,240
,Hydroflask 24 oz Standard Mouth White,Hydroflask 24 oz Standard Mouth White,FBALYB Amazon,333,328,5,0,5,0
,Hydroflask 32 oz Wide Mouth 20 Cobalt,Hydroflask 32 oz Wide Mouth 20 Cobalt,Default Ridgefield,24,24,0,0,0,48
,Hydroflask 32 oz Wide Mouth 20 Cobalt,Hydroflask 32 oz Wide Mouth 20 Cobalt,FBALYB Amazon,267,267,0,1,0,0
,Hydroflask 32 oz Wide Mouth 2.0 Fog,Hydroflask 32 oz Wide Mouth 2.0 Fog,Default Ridgefield,2,2,0,0,0,0
,Hydroflask 32 oz Wide Mouth 2.0 Fog,Hydroflask 32 oz Wide Mouth 2.0 Fog,FBALYB Amazon,-1,-1,0,0,0,0
,Hydroflask 32 oz Wide Mouth 2.0 Hibiscus,Hydroflask 32 oz Wide Mouth 2.0 Hibiscus,FBALYB Amazon,-4,-4,0,1,0,0
,Hydroflask 32 oz Wide Mouth 20 Olive,Hydroflask 32 oz Wide Mouth 20 Olive,Default Ridgefield,1,1,0,0,0,288
,Hydroflask 32 oz Wide Mouth 20 Olive,Hydroflask 32 oz Wide Mouth 20 Olive,FBALYB Amazon,405,401,4,0,4,0
,Hydroflask 32 oz Wide Mouth 2.0 Pacific,Hydroflask 32 oz Wide Mouth 2.0 Pacific,Default Ridgefield,1,1,0,0,0,192
,Hydroflask 32 oz Wide Mouth 2.0 Pacific,Hydroflask 32 oz Wide Mouth 2.0 Pacific,FBALYB Amazon,249,249,0,0,0,0
,Hydroflask 32 oz Wide Mouth 2.0 Spearmint,Hydroflask 32 oz Wide Mouth 2.0 Spearmint,FBALYB Amazon,-4,-4,0,0,0,0
,Hydroflask 32 oz Wide Mouth 2.0 Watermelon,Hydroflask 32 oz Wide Mouth 2.0 Watermelon,FBALYB Amazon,-4,-4,0,0,0,0
,Hydroflask 32 oz Wide Mouth White,Hydroflask 32 oz Wide Mouth White,Default Ridgefield,1,1,0,0,0,240
,Hydroflask 32 oz Wide Mouth White,Hydroflask 32 oz Wide Mouth White,FBALYB Amazon,58,58,0,0,0,0
,Hydroflask 32 oz Wide Mouth With Flex Cap Black 2.0,Hydroflask 32 oz Wide Mouth With Flex Cap Black 2.0,Default Ridgefield,0,0,0,0,0,360
,Hydroflask 32 oz Wide Mouth With Flex Cap Black 2.0,Hydroflask 32 oz Wide Mouth With Flex Cap Black 2.0,FBALYB Amazon,575,573,2,0,2,0
,Hydroflask 32 oz Wide Mouth With Graphite,Hydroflask 32 oz Wide Mouth With Graphite,FBALYB Amazon,-5,-5,0,0,0,0
,Hydroflask 32 oz Wide Mouth With Stone 2.0,Hydroflask 32 oz Wide Mouth With Stone 2.0,Default Ridgefield,8,8,0,0,0,96
,Hydroflask 32 oz Wide Mouth With Stone 2.0,Hydroflask 32 oz Wide Mouth With Stone 2.0,FBALYB Amazon,-3,-3,0,0,0,0
,Hydroflask 32 oz Wide Mouth With Sunflower 2.0,Hydroflask 32 oz Wide Mouth With Sunflower 2.0,FBALYB Amazon,-4,-4,0,0,0,0
,HydroFlask 40oz Wide Mouth Black,HydroFlask 40 oz Wide Mouth Black,Default Ridgefield,0,0,0,0,0,168
,HydroFlask 40oz Wide Mouth Black,HydroFlask 40 oz Wide Mouth Black,FBALYB Amazon,389,389,0,3,0,0
,HydroFlask 40 oz Wide Mouth Olive,HydroFlask 40 oz Wide Mouth Olive,Default Ridgefield,0,0,0,0,0,144
,HydroFlask 40 oz Wide Mouth Olive,HydroFlask 40 oz Wide Mouth Olive,FBALYB Amazon,136,136,0,0,0,0
,HydroFlask 40oz Wide Mouth Pacific,HydroFlask 40oz Wide Mouth Pacific,Default Ridgefield,0,0,0,0,0,120
,HydroFlask 40oz Wide Mouth Pacific,HydroFlask 40oz Wide Mouth Pacific,FBALYB Amazon,188,187,1,0,1,0
,Hydro Flask Standard 18oz Black,Hydro Flask Standard 18oz Black,Default Ridgefield,0,0,0,0,0,240
,Hydro Flask Standard 18oz Black,Hydro Flask Standard 18oz Black,FBALYB Amazon,265,260,5,0,5,0
,Hydro Flask Standard 18oz Cobalt,Hydro Flask Standard 18oz Cobalt,Default Ridgefield,11,11,0,0,0,168
,Hydro Flask Standard 18oz Cobalt,Hydro Flask Standard 18oz Cobalt,FBALYB Amazon,29,27,2,0,2,0
,Hydro Flask Standard 18oz Hibiscus,Hydro Flask Standard 18oz Hibiscus,FBALYB Amazon,2,2,0,0,0,0
,Hydro Flask Standard 18oz Mouth Fog,Hydro Flask Standard 18oz Mouth Fog,FBALYB Amazon,-3,-3,0,0,0,0
,Hydro Flask Standard 18oz Olive,Hydro Flask Standard 18oz Olive,Default Ridgefield,1,1,0,0,0,48
,Hydro Flask Standard 18oz Olive,Hydro Flask Standard 18oz Olive,FBALYB Amazon,238,238,0,0,0,0
,Hydro Flask Standard 18oz Pacific,Hydro Flask Standard 18oz Pacific,Default Ridgefield,3,3,0,0,0,144
,Hydro Flask Standard 18oz Pacific,Hydro Flask Standard 18oz Pacific,FBALYB Amazon,258,258,0,0,0,0
,Hydro Flask Standard 18oz Spearmint,Hydro Flask Standard 18oz Spearmint,FBALYB Amazon,1,1,0,0,0,0
,Hydro Flask Standard 18oz Sunflower,Hydro Flask Standard 18oz Sunflower,FBALYB Amazon,-8,-8,0,0,0,0
,Hydro Flask Standard 18oz Watermelon,Hydro Flask Standard 18oz Watermelon,Default Ridgefield,1,1,0,0,0,0
,Hydro Flask Standard 18oz Watermelon,Hydro Flask Standard 18oz Watermelon,FBALYB Amazon,-6,-6,0,0,0,0
,Hydro Flask Standard 18oz White,Hydro Flask Standard 18oz White,Default Ridgefield,6,6,0,0,0,144
,Hydro Flask Standard 18oz White,Hydro Flask Standard 18oz White,FBALYB Amazon,414,414,0,0,0,0
,Hydroskin 220 ct,Hydroskin 220 ct,FBALYB Amazon,-3,-3,0,1,0,0
,Ice Spkr Glue 6.7oz  (bonus),Ice Spkr Glue 6.7oz  (bonus),FBALYB Amazon,-3,-3,0,9,0,0
,IF-P8YY-DLYF,Fisher-Price Thomas & Friends Take-N-Play Hank,FBALYB Amazon,5,5,0,0,0,0
,igi Bed Head Manipulator 2oz 3PACK,Tigi Bed Head Manipulator 2oz 3PACK,FBALYB Amazon,176,155,21,3,21,0
,igi Bed Head Manipulator 2oz 3PACK,Tigi Bed Head Manipulator 2oz 3PACK,FBALYB Canada,0,0,0,25,0,0
,"Ikea 172.283.40 Frakta Shopping Bag, Large, Blue","Ikea 172.283.40 Frakta Shopping Bag, Large, Blue",Default,0,-760,760,0,0,20
,"Ikea 172.283.40 Frakta Shopping Bag, Large, Blue","Ikea 172.283.40 Frakta Shopping Bag, Large, Blue",Default Oxford,1500,1500,0,0,0,0
,"Ikea 172.283.40 Frakta Shopping Bag, Large, Blue","Ikea 172.283.40 Frakta Shopping Bag, Large, Blue",Default Ridgefield,673,673,0,0,0,0
,Ikea 301.495.56 Plastis Dishwashing Brush,Ikea 301.495.56 Plastis Dishwashing Brush,Default,0,0,0,0,0,608
,Ikea 301.495.56 Plastis Dishwashing Brush,Ikea 301.495.56 Plastis Dishwashing Brush,Default Ridgefield,392,392,0,0,0,0
,Ikea 36-piece Dinnerware Set,Ikea 36-piece Dinnerware Set,FBALYB Amazon,-3,-4,1,0,1,0
,"Ikea 900.430.76 Fornuft 20-piece flatware set, stainless steel","Ikea 900.430.76 Fornuft 20-piece flatware set, stainless steel",FBALYB Amazon,-4,-4,0,0,0,0
,IKEA 901.119.80 Lill Sheer 98x110 4pk,IKEA 901.119.80 Lill Sheer 98x110 4pk,Default,0,-84,84,0,0,0
,IKEA 901.119.80 Lill Sheer 98x110 4pk,IKEA 901.119.80 Lill Sheer 98x110 4pk,FBALYB Amazon,-5,-5,0,0,0,0
,Ikea Duktig 9-Piece Fruit Basket Toy,Ikea Duktig 9-Piece Fruit Basket Toy,Default,0,0,0,0,0,74
,Ikea Duktig 9-Piece Fruit Basket Toy,Ikea Duktig 9-Piece Fruit Basket Toy,Default Ridgefield,26,26,0,0,0,0
,Ikea Fornuft 20-piece,Ikea Fornuft 20-piece,Default Ridgefield,194,194,0,0,0,0
,Ikea Frakta Large 10pk,Ikea Frakta Large 10pk,FBALYB Amazon,-17,-19,2,0,2,0
,Ikea Frakta Large 20pk,Ikea Frakta Large 20pk,FBALYB Amazon,-1,-5,4,0,4,0
,Ikea Frakta Medium 4 Pack 603.017.07,Ikea Frakta Medium 4 Pack 603.017.07,FBALYB Amazon,-3,-3,0,1,0,0
,Ikea Frakta Medium Bag 6Pack 603.017.07,Ikea Frakta Medium Bag 6Pack 603.017.07,FBALYB Amazon,79,79,0,0,0,0
,Ikea Galvanized Plant Pot Silver 3pk,Ikea Galvanized Plant Pot Silver 3pk,FBALYB Amazon,-4,-5,1,0,1,0
,"Ikea KALAS SET 18 Cutlery, 6Bowls, 6Plates, 6Cups","Ikea KALAS SET 18 Cutlery, 6Bowls, 6Plates, 6Cups ",FBALYB Amazon,-1,-1,0,0,0,0
,IKEA Knorrig Pig,IKEA Knorrig Pig,Default,2,2,0,0,0,0
,IKEA Knorrig Pig,IKEA Knorrig Pig,FBALYB Amazon,-2,-2,0,0,0,0
,Ikea Lill Sheer Curtains 2pk X 2 98x110,Ikea Lill Sheer Curtains 2pk X 2 98x110,FBALYB Amazon,-31,-32,1,6,1,0
,"IKEA Lillviken Lid, 203.178.52","IKEA Lillviken Lid, 203.178.52",Default Ridgefield,2,2,0,0,0,0
,Ikea Myskgras Duvet QUEEN,Ikea Myskgras Duvet QUEEN,Default Ridgefield,18,18,0,0,0,0
,Ikea Myskgras Duvet QUEEN,Ikea Myskgras Duvet QUEEN,FBALYB Amazon,-12,-12,0,1,0,0
,Ikea Myskgras Duvet TWIN,Ikea Myskgras Duvet TWIN,FBALYB Amazon,-4,-5,1,0,1,0
,Ikea NOT Lamp,Ikea NOT Lamp,Default,0,-1,1,0,0,303
,Ikea NOT Lamp,Ikea NOT Lamp,FBALYB Amazon,-112,-112,0,107,0,0
,Ikea NOT Lamp w E26 bulb,Ikea NOT Lamp w E26 bulb,FBALYB Amazon,-9,-9,0,0,0,0
,Ikea RYET LED bulb E26 400 lumen,Ikea RYET LED bulb E26 400 lumen,Default Ridgefield,0,-112,112,0,0,0
,Ikea RYET LED bulb E26 600 lumen,Ikea RYET LED bulb E26 600 lumen,Default Ridgefield,3,3,0,0,0,0
,Ikea RYET LED bulb E26 600 lumen,Ikea RYET LED bulb E26 600 lumen,FBALYB Amazon,0,-1,1,0,1,0
,Ikea Scratch Floor Mat,Ikea Scratch Floor Mat,Default,0,0,0,0,0,2
,Ikea Scratch Floor Mat,Ikea Scratch Floor Mat,Default Ridgefield,48,48,0,0,0,0
,IKEA SIGNUM Cable Management Rack,IKEA SIGNUM Cable Management Rack,Default,0,0,0,0,0,100
,IKEA SIGNUM Cable Management Rack,IKEA SIGNUM Cable Management Rack,FBALYB Amazon,-154,-154,0,149,0,0
,Ikea Socker plant Medium,Ikea Socker plant Medium,Default Ridgefield,5,5,0,0,0,0
,IKEA Socker Plant Pot Indoor/Outdoor,IKEA Socker Plant Pot Indoor/Outdoor,Default Ridgefield,11,11,0,0,0,0
,IKEA Socker Plant Pot Indoor/Outdoor,IKEA Socker Plant Pot Indoor/Outdoor,FBAFBA LYB JAPAN,355,355,0,0,0,0
,IKEA Socker Plant Pot Indoor/Outdoor 6pk,IKEA Socker Plant Pot Indoor/Outdoor 6pk,FBALYB Amazon,83,83,0,0,0,0
,IKEA SOTVATTEN Drinking Straw,IKEA SOTVATTEN Drinking Straw,Default,0,0,0,0,0,78
,Ikea Sotvatten Straws 100x2 (200pack),Ikea Sotvatten Straws 100x2 (200pack),FBALYB Amazon,-3,-3,0,4,0,0
,"IKEA SYLT LINGON, 103.086.26","IKEA SYLT LINGON, 103.086.26",FBALYB Amazon,-2,-2,0,2,0,0
,Ikea TAGARP Lamp 604.640.49,Ikea TAGARP Lamp 604.640.49,Default,0,0,0,0,0,9
,Ikea TAGARP Lamp 604.640.49,Ikea TAGARP Lamp 604.640.49,Default Ridgefield,2169,2169,0,0,0,0
,Ikea TAGARP Lamp 604.640.49,Ikea TAGARP Lamp 604.640.49,FBALYB Amazon,261,261,0,8,0,0
,iKEA UTRUSTA - 402.418.23 - Door damper for hinge 402.418.23,iKEA UTRUSTA - 402.418.23 - Door damper for hinge 402.418.23,Default Ridgefield,7,7,0,0,0,0
,IKEA UTRUSTA Door Hinge Damper for 153 Degrees (602.418.22),IKEA UTRUSTA Door Hinge Damper for 153 Degrees (602.418.22),Default Ridgefield,2,2,0,0,0,0
,IKEA UTRUSTA Hinge pack of 2 602.046.45,IKEA UTRUSTA Hinge pack of 2 602.046.45,Default Ridgefield,14,14,0,0,0,0
,IKEA UTRUSTA Hinges Wide Angle 153 Degree Opening 002.046.48,IKEA UTRUSTA Hinges Wide Angle 153 Degree Opening 002.046.48,Default Ridgefield,3,3,0,0,0,0
,Ikea Variera Plastic Bag Holder Wall Mount 800.102.22,Ikea Variera Plastic Bag Holder Wall Mount 800.102.22,Default,0,0,0,0,0,438
,Ikea Variera Plastic Bag Holder Wall Mount 800.102.22,Ikea Variera Plastic Bag Holder Wall Mount 800.102.22,Default Ridgefield,62,62,0,0,0,0
,IKEA Vattenkrasse Watering Can 2pk,IKEA Vattenkrasse Watering Can 2pk,FBALYB Amazon,-9,-10,1,0,1,0
,IKEA Vattenkrasse Watering Can Ivory Gold 403.941.18 Size 30 oz,IKEA Vattenkrasse Watering Can Ivory Gold 403.941.18 Size 30 oz,FBALYB Amazon,-11,-11,0,21,0,0
,Illy 3366 Medium Filter 2pk,Illy 3366 Medium Filter 2pk,FBALYB Amazon,165,164,1,0,1,0
,Illy 3366 Medium Filter 4pk,Illy 3366 Medium Filter 4pk,FBALYB Amazon,48,46,2,0,2,0
,illy 3369 Caffe Normale MOKA 8.8oz 2pk,illy 3369 Caffe Normale MOKA 8.8oz 2pk,FBALYB Amazon,246,240,6,7,6,0
,ILLY BEANS 250G DECAF,ILLY BEANS 250G DECAF,Default Ridgefield,5,5,0,0,0,0
,ILLY BEANS 250G DECAF,ILLY BEANS 250G DECAF,FBALYB Amazon,892,882,10,0,10,0
,ILLY BEANS 250G DECAF,ILLY BEANS 250G DECAF,FBALYB Canada,15,15,0,0,0,0
,ILLY BEANS 250G DECAF 2PK,ILLY BEANS 250G DECAF 2PK,FBALYB Canada,12,12,0,0,0,0
,illy Caffe Decaffeinated ESE Pods 2pk,illy Caffe Decaffeinated ESE Pods 2pk,FBALYB Amazon,0,0,0,1,0,0
,illy Caffe ESE Pods Dark Roast 6pk,illy Caffe ESE Pods Dark Roast 6pk,FBALYB Amazon,1,1,0,0,0,0
,illy Caffe ESE Pods Medium Roast 2pk,illy Caffe ESE Pods Medium Roast 2pk,FBALYB Amazon,7,7,0,49,0,0
,illy Coffee Moka Ground Medium Roast 4pk,illy Coffee Moka Ground Medium Roast 4pk,FBALYB Amazon,39,39,0,1,0,0
,Illy Dark Espresso Ground 250G 6PK,Illy Dark Espresso Ground 250G 6PK,Default Ridgefield,9,-3,12,0,0,0
,Illy Dark Espresso Ground 250G 6PK,Illy Dark Espresso Ground 250G 6PK,FBALYB Amazon,36,36,0,12,0,0
,Illy Dark + Medium Espresso Ground 250G 2PK,Illy Dark + Medium Espresso Ground 250G 2PK,FBALYB Amazon,86,59,27,6,27,0
,Illy Decaf Ground,Illy Decaf Ground,Default,0,-2808,2808,0,0,0
,Illy Decaf Ground,Illy Decaf Ground,Default Ridgefield,856,856,0,0,0,0
,Illy Decaf Ground 8.8oz 2pk,Illy Decaf Ground 8.8oz 2pk,FBALYB Amazon,308,300,8,0,8,0
,Illy Decaf Ground 8.8oz 4pk,Illy Decaf Ground 8.8oz 4pk,FBALYB Amazon,205,203,2,0,2,0
,Illy Espresso Classic Capsules 10,Illy Espresso Classic Capsules 10,Default Ridgefield,1761,1761,0,0,0,0
,Illy Espresso Classic Capsules 10,Illy Espresso Classic Capsules 10,FBALYB Amazon,-126,-146,20,0,20,0
,Illy Espresso Classic Capsules 10 4PACK,Illy Espresso Classic Capsules 10 4PACK,FBALYB Amazon,33,3,30,0,30,0
,Illy Espresso Classic Capsules 10   8PACK,Illy Espresso Classic Capsules 10   8PACK,FBALYB Amazon,51,41,10,0,10,0
,Illy Espresso Classic Capsules 10   8PACK,Illy Espresso Classic Capsules 10   8PACK,FBALYB Canada,0,0,0,5,0,0
,Illy Espresso ESE Pods Dark&Medium Roast,Illy Espresso ESE Pods Dark&Medium Roast,FBALYB Amazon,-196,-196,0,159,0,0
,Illy Espresso Intenso Capsules 10,Illy Espresso Intenso Capsules 10,Default Ridgefield,4084,4084,0,0,0,0
,Illy Espresso Intenso Capsules 10 ct 4pk,Illy Espresso Intenso Capsules 10 ct 4pk,FBALYB Amazon,-164,-186,22,300,22,0
,Illy Espresso Strong Capsules 10,Illy Espresso Strong Capsules 10,Default Ridgefield,58,58,0,0,0,0
,Illy Espresso Strong Capsules 10,Illy Espresso Strong Capsules 10,FBALYB Amazon,37,29,8,0,8,0
,Illy Espresso Strong Capsules 10 4PK,Illy Espresso Strong Capsules 10 4PK,FBALYB Amazon,1168,1128,40,0,40,0
,Illy Espresso Strong Capsules 10 4PK,Illy Espresso Strong Capsules 10 4PK,FBALYB Canada,0,0,0,12,0,0
,Illy Filter Bold Roast Intenso 250g,Illy Filter Bold Roast Intenso 250g,Default Ridgefield,983,983,0,0,0,0
,Illy Filter Bold Roast Intenso 250g,Illy Filter Bold Roast Intenso 250g,FBALYB Amazon,597,588,9,0,9,0
,Illy Filter Bold Roast Intenso 250g,Illy Filter Bold Roast Intenso 250g,FBALYB Canada,0,0,0,50,0,0
,Illy Filter Bold Roast Intenso 250g 2pk,Illy Filter Bold Roast Intenso 250g 2pk,FBALYB Amazon,63,63,0,0,0,0
,Illy Filter Bold Roast Intenso 250g 6pk,Illy Filter Bold Roast Intenso 250g 6pk,FBALYB Amazon,154,151,3,0,3,0
,Illy Ground Classic Roast 250g,Illy Ground Classic Roast 250g,Default Ridgefield,958,958,0,0,0,0
,illy Ground Espresso Dark Roast 4pk,illy Ground Espresso Dark Roast 4pk,FBALYB Amazon,13,-2,15,50,15,0
,Illy Ground Espresso Medium Roast 4pk,Illy Ground Espresso Medium Roast 4pk,FBALYB Amazon,-81,-81,0,242,0,0
,Illy intenso 6pk,Illy intenso 6pk,Default,0,-1001,1001,0,0,0
,Illy intenso 6pk,Illy intenso 6pk,FBALYB Amazon,427,334,93,56,93,0
,Illy intenso 6pk,Illy intenso 6pk,FBALYB Canada,7,6,1,0,1,0
,illy iperEspresso Capsules Dark 2pk,illy iperEspresso Capsules Dark 2pk,FBALYB Amazon,-156,-157,1,162,1,0
,illy iperEspresso Capsules DarkRoast 4pk,illy iperEspresso Capsules DarkRoast 4pk,FBALYB Amazon,-5,-8,3,108,3,0
,Illy iperEspresso Lungo/medium 6pk,Illy iperEspresso Lungo/medium 6pk,FBALYB Amazon,1,0,1,207,1,0
,Illy Lungo Classic Capsules 10,Illy Lungo Classic Capsules 10,Default Ridgefield,3536,3536,0,0,0,0
,Illy Lungo Classic Capsules 10pack of 10ct (100ct total),Illy Lungo Classic Capsules 10pack of 10ct (100ct total),FBALYB Amazon,45,11,34,29,34,0
,Illy Lungo Classic Capsules 4pack of 10ct (40ct total),Illy Lungo Classic Capsules 4pack of 10ct (40ct total),FBALYB Amazon,604,590,14,0,14,0
,Illy Medium espresso 250g 2pk,Illy Medium espresso 250g 2pk,FBALYB Amazon,267,227,40,2,40,0
,Illy Medium Filter Coffee 2pk,Illy Medium Filter Coffee 2pk,Default Ridgefield,1,0,1,0,0,0
,Illy Medium Filter Coffee 2pk,Illy Medium Filter Coffee 2pk,FBALYB Amazon,-7,-7,0,7,0,0
,Illy Medium Roast Decaf 6pk,Illy Medium Roast Decaf 6pk,FBALYB Amazon,328,327,1,2,1,0
,Illy MOKA 8.8oz 6pk 3369,Illy MOKA 8.8oz 6pk 3369,FBALYB Amazon,89,80,9,81,9,0
,Illy MOKA 8.8oz 6pk 3369,Illy MOKA 8.8oz 6pk 3369,FBALYB Canada,4,3,1,0,1,0
,Illy whole bean 6 pk medium roast,Illy whole bean 6 pk medium roast,FBALYB Amazon,618,513,105,57,105,0
,Illy whole bean 6 pk medium roast,Illy whole bean 6 pk medium roast,FBALYB Canada,0,0,0,10,0,0
,Illy Whole Bean Brazil 250 G,Illy Whole Bean Brazil 250 G,FBALYB Amazon,160,159,1,0,1,0
,Illy Whole Bean Brazil 250 G 6PK,Illy Whole Bean Brazil 250 G 6PK,FBALYB Amazon,40,40,0,0,0,0
,"Illy Whole Bean Brazil, Ethiopia, Guatemala Variety Bundle","Illy Whole Bean Brazil, Ethiopia, Guatemala Variety Bundle",FBALYB Amazon,-2,-2,0,0,0,0
,Illy Whole Bean Coffee Ethiopia 250g,Illy Whole Bean Coffee Ethiopia 250g ,Default Ridgefield,9,-7,16,0,0,0
,Illy Whole Bean Coffee Ethiopia 250g 2pk,Illy Whole Bean Coffee Ethiopia 250g 2pk,FBALYB Amazon,4,3,1,8,1,0
,Illy Whole Bean Coffee Ethiopia 250g 6PK,Illy Whole Bean Coffee Ethiopia 250g 6PK,FBALYB Amazon,1,1,0,0,0,0
,Illy Whole Bean Coffee Guatemala 250g,Illy Whole Bean Coffee Guatemala 250g,Default Ridgefield,0,-1,1,0,0,0
,Illy Whole Bean Coffee Guatemala 250g,Illy Whole Bean Coffee Guatemala 250g,FBALYB Amazon,57,53,4,8,4,0
,Illy Whole Bean Coffee Guatemala 250g 6PK,Illy Whole Bean Coffee Guatemala 250g 6PK,Default,0,-89,89,0,0,0
,Illy Whole Bean Coffee Guatemala 250g 6PK,Illy Whole Bean Coffee Guatemala 250g 6PK,FBALYB Amazon,41,40,1,1,1,0
,IL Soap Original 6for4 100g,IL Soap Original 6for4 100g,Default,0,-2772,2772,0,0,0
,IL Soap Original 6for4 100g,IL Soap Original 6for4 100g,Default CT,2664,2664,0,0,0,0
,IL Soap Original 6for4 100g 12 pk,IL Soap Original 6for4 100g 12 pk,FBALYB Amazon,4,2,2,0,2,0
,IL Soap Original 6for4 100g 6 pk,IL Soap Original 6for4 100g 6 pk,FBALYB Amazon,3,2,1,0,1,0
,Imaginetics Beauty Shop Playset,Imaginetics Beauty Shop Playset,FBALYB Amazon,2,2,0,0,0,0
,Imaginetics Dress Me Up Set,Imaginetics Dress Me Up Set,FBALYB Amazon,4,4,0,0,0,0
,Imaginetics Fire House Playset,Imaginetics Fire House Playset,FBALYB Amazon,-1,-1,0,1,0,0
,Imaginetics Fun at The Beach,Imaginetics Fun at The Beach,FBALYB Amazon,39,39,0,1,0,0
,Imaginetics Mermaids Set,Imaginetics Mermaids Set,FBALYB Amazon,1,1,0,0,0,0
,Imaginext Dino Fortress,Imaginext Dino Fortress ,FBALYB Amazon,-4,-4,0,0,0,0
,Imodium Multi-Symptom Relief,Imodium Multi-Symptom Relief ,FBALYB Amazon,-930,-944,14,593,14,0
,Imodium Multi-Symptom Relief 2pk,Imodium Multi-Symptom Relief 2pk,FBALYB Amazon,339,335,4,3,4,0
,Imperial Leather Original Talcum Powder 300 g,Imperial Leather Original Talcum Powder 300 g,FBALYB Amazon,-20,-20,0,290,0,0
,Impossible PRD4514 Polaroid 600 Color,"Impossible PRD4514 Polaroid 600 and Instant Lab Film, Color",FBALYB Amazon,-3,-3,0,0,0,0
,"Ims Trading Gourmet Pressed Bone, 8.5"" 6ct","Ims Trading Gourmet Pressed Bone, 8.5"" ‑ 6 pack",Default,0,0,0,0,0,1
,India ink PITT artist pen col.199 4x,India ink PITT artist pen col.199 4x,FBALYB Amazon,3,3,0,3,0,0
,India ink PITT artist pen col. 199 8x,India ink PITT artist pen col. 199 8x,FBALYB Amazon,10,10,0,0,0,0
,Indoor with Hairball Care Cat Food,Chicken Soup for the Soul Indoor with Hairball Care Cat Food,FBALYB Amazon,47,47,0,1,0,0
,Innofood Dark Choc Almond Clusters,Innofood Dark Choc Almond Clusters,FBALYB Amazon,2,2,0,1,0,0
,"Insignia 11.6"" 32gb Black","Insignia 11.6"" 32gb Black NS-P11W7100",FBALYB Amazon,-2,-2,0,2,0,0
,Instant Baby Brine Shrimp 0.7oz,Instant Baby Brine Shrimp 0.7oz,FBALYB Amazon,0,0,0,1,0,0
,Instant Baby Brine Shrimp 0.7oz 2pk,Instant Baby Brine Shrimp 0.7oz 2pk,FBALYB Amazon,-2,-2,0,0,0,0
,"Instant Ocean Sea Salt, 10-Gallon","Instant Ocean Sea Salt, 10-Gallon ",FBALYB Amazon,3,3,0,1,0,0
,Instant Ocean SeaTest Hydrometer,Instant Ocean SeaTest Hydrometer,FBALYB Amazon,-1,-1,0,0,0,0
,Instant Pot Ultra 6 qt Cooker,"Instant Pot Ultra 6 qt Pressure Cooker, Silver",Default,0,0,0,0,0,1
,Invisible Glass Premium Glass Cleaner 2pk,Invisible Glass Premium Glass Cleaner 2pk,FBALYB Amazon,-2,-2,0,0,0,0
,ION Pathfinder Rugged Bluetooth Portable Speaker,ION Pathfinder Rugged Bluetooth Portable Speaker,FBALYB Amazon,0,0,0,1,0,0
,iPad mini 2 32 gab space grey,Apple ME277LL/A 8-inch iPad Mini 2 with Retina Display (1.30GHz     Dual-core...,FBALYB Amazon,-1,-1,0,0,0,0
,iPad mini 2 black,"Apple iPad mini 2 ME276LL/A (16GB, Wi-Fi) Black with Space Gray",FBALYB Amazon,-1,-1,0,0,0,0
,iPad mini 4 128 gab silver,"Apple iPad mini 4 (128GB, Wi-Fi, Silver)",FBALYB Amazon,1,1,0,0,0,0
,iPad mini 4 128gb gold,"Apple iPad mini 4 (128GB, Wi-Fi, Gold)",FBALYB Amazon,-2,-2,0,0,0,0
,iPad mini 4 128gb space grey,"Apple iPad mini 4 (128GB, Wi-Fi, Space Gray)",FBALYB Amazon,1,1,0,0,0,0
,iperEspresso 21ct Classico / Medium 2pk,iperEspresso 21ct Classico / Medium 2pk,FBALYB Amazon,13,13,0,151,0,0
,Irish Spring Aloe 20ct,Irish Spring Aloe 20ct,Default,0,-100,100,0,0,0
,Irish Spring Aloe 20ct,Irish Spring Aloe 20ct,FBALYB Amazon,-78,-79,1,98,1,0
,Irish Spring Original 20ct,Irish Spring Original 20ct,FBALYB Amazon,116,116,0,59,0,0
,iRobot Roomba 761 Vacuuming Robot ‑ Grey,iRobot Roomba 761 Vacuuming Robot ‑ Grey,FBALYB Amazon,1,1,0,0,0,0
,Iron Kids Gummies Omega-3 200ct,Iron Kids Gummies Omega-3 200ct,Default,0,0,0,0,0,2
,IS-110C-ICHF,Impossible Project I-1 Analog Instant Camera,FBALYB Amazon,4,4,0,0,0,0
,IS-110C-ICHF,Impossible Project I-1 Analog Instant Camera,Oregon,-4,-4,0,0,0,0
,Itty Bitty 7oz 3pk bundle,Itty Bitty 7oz 3pk bundle,FBALYB Amazon,-1,-1,0,0,0,0
,Ivory Snow Detergent,Ivory Snow Detergent,FBALYB Amazon,2,2,0,0,0,0
,IV-ZV96-7IMR,"FUGOO Tough - Portable, Waterproof, Rugged Bluetooth Wireless Go Anywhere Spe...",FBALYB Amazon,-1,-2,1,0,1,0
,IZOD Men's 1/4 Zip Sweater Black Large,IZOD Men's 1/4 Zip Sweater Black Large,FBALYB Amazon,-6,-6,0,0,0,0
,IZOD Men's 1/4 Zip Sweater Black M,IZOD Men's 1/4 Zip Sweater Black M,Default Ridgefield,0,-1,1,0,0,0
,IZOD Men's 1/4 Zip Sweater Black M,IZOD Men's 1/4 Zip Sweater Black M,FBALYB Amazon,-5,-6,1,0,1,0
,IZOD Men's 1/4 Zip Sweater Black S,IZOD Men's 1/4 Zip Sweater Black S,Default,0,-2,2,0,0,0
,IZOD Men's 1/4 Zip Sweater Black S,IZOD Men's 1/4 Zip Sweater Black S,Default Ridgefield,0,-21,21,0,0,0
,IZOD Men's 1/4 Zip Sweater Black S,IZOD Men's 1/4 Zip Sweater Black S,FBALYB Amazon,-1,-1,0,0,0,0
,IZOD Men's 1/4 Zip Sweater Black S,IZOD Men's 1/4 Zip Sweater Black S,Joes Playground (Testing),0,-1,1,0,0,0
,IZOD Men's 1/4 Zip Sweater Black XL,IZOD Men's 1/4 Zip Sweater Black XL,Default,0,-1,1,0,0,0
,IZOD Men's 1/4 Zip Sweater Black XL,IZOD Men's 1/4 Zip Sweater Black XL,FBALYB Amazon,-2,-2,0,0,0,0
,IZOD Men's 1/4 Zip Sweater Black XXL,IZOD Men's 1/4 Zip Sweater Black XXL,Default,0,-56,56,0,0,0
,IZOD Men's 1/4 Zip Sweater Black XXL,IZOD Men's 1/4 Zip Sweater Black XXL,Default Oxford,0,-1,1,0,0,0
,IZOD Men's 1/4 Zip Sweater Black XXL,IZOD Men's 1/4 Zip Sweater Black XXL,Default Ridgefield,0,-32,32,0,0,0
,IZOD Men's 1/4 Zip Sweater Navy Large,Izod Sweater Large NAVY ,FBALYB Amazon,-2,-2,0,0,0,0
,IZOD Men's 1/4 Zip Sweater Navy M,Izod Sweater MEDIUM NAVY ,FBALYB Amazon,-2,-2,0,0,0,0
,IZOD Men's 1/4 Zip Sweater Navy Small,Izod Sweater SMALL NAVY ,FBALYB Amazon,-1,-2,1,0,1,0
,IZOD Men's 1/4 Zip Sweater Navy XL,Izod Sweater X Large NAVY ,FBALYB Amazon,-1,-1,0,0,0,0
,IZOD Men's 1/4 Zip Sweater Red Large,IZOD Men's 1/4 Zip Sweater Red Large,FBALYB Amazon,-7,-8,1,0,1,0
,IZOD Men's 1/4 Zip Sweater Red M,IZOD Men's 1/4 Zip Sweater Red M,FBALYB Amazon,-4,-5,1,0,1,0
,IZOD Men's 1/4 Zip Sweater Red S,IZOD Men's 1/4 Zip Sweater Red S,Default Ridgefield,0,-1,1,0,0,0
,IZOD Men's 1/4 Zip Sweater Red S,IZOD Men's 1/4 Zip Sweater Red S,FBALYB Amazon,-2,-2,0,0,0,0
,IZOD Men's 1/4 Zip Sweater Red XL,IZOD Men's 1/4 Zip Sweater Red XL,FBALYB Amazon,-5,-5,0,0,0,0
,Izod Men's Shorts 32 Black,Izod Men's Shorts 32 Black,Default,0,0,0,0,0,23
,Izod Men's Shorts 32 Club Blue,Izod Men's Shorts 32 Club Blue,Default,0,0,0,0,0,8
,Izod Men's Shorts 32 Khaki,Izod Men's Shorts 32 Khaki,Default,0,0,0,0,0,10
,Izod Men's Shorts 32 Smoked Pearl,Izod Men's Shorts 32 Smoked Pearl,Default,0,0,0,0,0,20
,Izod Men's Shorts 34 Black,Izod Men's Shorts 34 Black,Default,0,0,0,0,0,34
,Izod Men's Shorts 34 Khaki,Izod Men's Shorts 34 Khaki,Default,0,0,0,0,0,20
,Izod Men's Shorts 34 Smoked Pearl,Izod Men's Shorts 34 Smoked Pearl,Default,0,0,0,0,0,14
,Izod Men's Shorts 36 Black,Izod Men's Shorts 36 Black,Default,0,0,0,0,0,30
,Izod Men's Shorts 36 Club Blue,Izod Men's Shorts 36 Club Blue,Default,0,0,0,0,0,9
,Izod Men's Shorts 36 Khaki,Izod Men's Shorts 36 Khaki,Default,0,0,0,0,0,25
,Izod Men's Shorts 36 Smoked Pearl,Izod Men's Shorts 36 Smoked Pearl,Default,0,0,0,0,0,12
,Izod Men's Shorts 38 Black,Izod Men's Shorts 38 Black,Default,0,0,0,0,0,5
,Izod Men's Shorts 38 Club Blue,Izod Men's Shorts 38 Club Blue,Default,0,0,0,0,0,16
,Izod Men's Shorts 38 Khaki,Izod Men's Shorts 38 Khaki,Default,0,0,0,0,0,9
,Izod Men's Shorts 38 Smoked Pearl,Izod Men's Shorts 38 Smoked Pearl,Default,0,0,0,0,0,18
,Izod Men's Shorts 40 Black,Izod Men's Shorts 40 Black,Default,0,0,0,0,0,6
,Izod Men's Shorts 40 Club Blue,Izod Men's Shorts 40 Club Blue,Default,0,0,0,0,0,2
,Izod Men's Shorts 40 Khaki,Izod Men's Shorts 40 Khaki,Default,0,0,0,0,0,21
,Izod Men's Shorts 40 Smoked Pearl,Izod Men's Shorts 40 Smoked Pearl,Default,0,0,0,0,0,10
,Izod Men's Shorts 42 Black,Izod Men's Shorts 42 Black,Default,0,0,0,0,0,3
,Izod Men's Shorts 42 Club Blue,Izod Men's Shorts 42 Club Blue,Default,0,0,0,0,0,1
,J5-E80S-GKLD,Microsoft Type Cover for Surface Pro 4 - Red (QC7-00005),FBALYB Amazon,-2,-2,0,0,0,0
,Jacks girlfriend Blue flannel Small,"Jachs Girlfriend Ladies Flannel Shirt, Brushed Flannel, 2 Front Pockets with...",FBALYB Amazon,-1,-1,0,0,0,0
,Jackson Galaxy Air Prey Wand Cat Toy,Jackson Galaxy Air Prey Wand Cat Toy,FBALYB Amazon,-1,-1,0,0,0,0
,Jacobs Instant Kronung 200g,Jacobs Instant Kronung 200g,Default Ridgefield,25,25,0,0,0,0
,Jacobs Instant Kronung 200g,Jacobs Instant Kronung 200g,FBALYB Amazon,13,9,4,1,4,0
,Jacobs Instant Kronung 200g 6pk,Jacobs Instant Kronung 200g 6pk,FBALYB Amazon,1,1,0,6,0,0
,Jacobs Kronung Coffee 500g 3pk,Jacobs Kronung Coffee 500g 3pk,FBALYB Amazon,804,800,4,361,4,0
,Jacobs Kronung Coffee 500g 6pk,Jacobs Kronung Coffee 500g 6pk,FBALYB Amazon,-879,-881,2,1023,2,0
,Jacobs Kronung Ground 500g Coffee,Jacobs Kronung Ground 500g Coffee,Default Oxford,0,-120,120,0,0,0
,Jacobs Kronung Ground 500g Coffee,Jacobs Kronung Ground 500g Coffee,Default Ridgefield,129,129,0,0,0,0
,Jacobs Kronung Ground 500g Coffee,Jacobs Kronung Ground 500g Coffee,FBALYB Amazon,0,0,0,1,0,0
,Jacobs Kronung Ground 500g Coffee 12pk,Jacobs Kronung Ground 500g Coffee 12pk,FBALYB Amazon,12,8,4,0,4,0
,Jacobs Kronung Ground 500g Coffee 4pk,Jacobs Kronung Ground 500g Coffee 4pk,FBALYB Amazon,-1,-1,0,0,0,0
,Jacobs Kronung Ground Coffee 2pk,Jacobs Kronung Ground Coffee 2pk,FBALYB Amazon,7,7,0,0,0,0
,Jah B Coffee 8oz,Jah B Coffee 8oz,FBASKCK Amazon,476,476,0,0,0,0
,Jah B Coffee 8oz 2pk,Jah B Coffee 8oz 2pk,FBASKCK Amazon,214,214,0,0,0,0
,Jansjo Black Lamp Regular,Jansjo Black Lamp Regular,Default,0,-48,48,0,0,0
,Jansjo Black Lamp Regular,Jansjo Black Lamp Regular,FBALYB Amazon,-3,-3,0,2,0,0
,Jansjo Lamp Black Clip,Jansjo Lamp Black Clip,FBALYB Amazon,-1,-1,0,0,0,0
,Jansjo Lamp White Clip,Jansjo Lamp White Clip,FBALYB Amazon,-1,-1,0,0,0,0
,Jansjo White Lamp,Jansjo White Lamp,FBALYB Amazon,97,97,0,3,0,0
,Jansport Superbreak - Black Backpack JS0A4QUT008,Jansport Superbreak - Black Backpack JS0A4QUT008,Default,0,0,0,0,0,184
,Jansport Superbreak - Black Backpack JS0A4QUT008,Jansport Superbreak - Black Backpack JS0A4QUT008,Default Ridgefield,0,-1,1,0,0,0
,Jansport Superbreak - Black Backpack JS0A4QUT008,Jansport Superbreak - Black Backpack JS0A4QUT008,FBAFBA LYB AUSTRALIA,0,0,0,25,0,0
,Jansport Superbreak - Black Backpack JS0A4QUT008,Jansport Superbreak - Black Backpack JS0A4QUT008,FBALYB Amazon,-88,-93,5,4,5,0
,Jansport Superbreak - Black Backpack JS0A4QUT008,Jansport Superbreak - Black Backpack JS0A4QUT008,FBALYB Canada,-4,-4,0,0,0,0
,Jansport Superbreak - Navy Backpack JS0A4QUT003,Jansport Superbreak - Navy Backpack JS0A4QUT003,Default,0,0,0,0,0,45
,Jansport Superbreak - Navy Backpack JS0A4QUT003,Jansport Superbreak - Navy Backpack JS0A4QUT003,Default Ridgefield,256,256,0,0,0,0
,Jansport Superbreak - Navy Backpack JS0A4QUT003,Jansport Superbreak - Navy Backpack JS0A4QUT003,FBALYB Amazon,124,120,4,0,4,0
,Jansport Superbreak Plus - Animal Mix Backpack JS0A4QUE77S,Jansport Superbreak Plus - Animal Mix Backpack JS0A4QUE77S,FBALYB Amazon,-2,-3,1,0,1,0
,Jansport Superbreak Plus - Black Backpack JS0A4QUE008,Jansport Superbreak Plus - Black Backpack JS0A4QUE008,Default Ridgefield,240,240,0,0,0,0
,Jansport Superbreak Plus - Black Backpack JS0A4QUE008,Jansport Superbreak Plus - Black Backpack JS0A4QUE008,FBALYB Amazon,-13,-15,2,0,2,0
,Jansport Superbreak Plus - Blackberry Mousse Backpack JS0A4QUE69G,Jansport Superbreak Plus - Blackberry Mousse Backpack JS0A4QUE69G,FBALYB Amazon,-5,-5,0,0,0,0
,Jansport Superbreak Plus - Blue Agave Backpack JS0A4QUE72K,Jansport Superbreak Plus - Blue Agave Backpack JS0A4QUE72K,FBALYB Amazon,-13,-13,0,1,0,0
,Jansport Superbreak Plus - Botanical Garden Backpack JS0A4QUE73T,Jansport Superbreak Plus - Botanical Garden Backpack JS0A4QUE73T,FBALYB Amazon,70,68,2,0,2,0
,Jansport Superbreak Plus - Buffalo Check Mix Backpack JS0A4QUE74U,Jansport Superbreak Plus - Buffalo Check Mix Backpack JS0A4QUE74U,FBALYB Amazon,-4,-4,0,0,0,0
,Jansport Superbreak Plus - Chevron Fade Backpack JS0A4QUE78E,Jansport Superbreak Plus - Chevron Fade Backpack JS0A4QUE78E,FBALYB Amazon,-1,-5,4,0,4,0
,Jansport Superbreak Plus - Classic Python Backpack JS0A4QUE73M,Jansport Superbreak Plus - Classic Python Backpack JS0A4QUE73M,FBALYB Amazon,45,38,7,42,7,0
,Jansport Superbreak Plus - Classic Teal Backpack JS0A4QUE72P,Jansport Superbreak Plus - Classic Teal Backpack JS0A4QUE72P,FBALYB Amazon,-9,-9,0,1,0,0
,Jansport Superbreak Plus - Dark Slate Backpack JS0A4QUE47G,Jansport Superbreak Plus - Dark Slate Backpack JS0A4QUE47G,FBALYB Amazon,-7,-7,0,0,0,0
,Jansport Superbreak Plus - Enchanted Garden Backpack JS0A4QUE77B,Jansport Superbreak Plus - Enchanted Garden Backpack JS0A4QUE77B,FBALYB Amazon,19,8,11,7,11,0
,Jansport Superbreak Plus - Floral Breeze Backpack JS0A4QUE73L,Jansport Superbreak Plus - Floral Breeze Backpack JS0A4QUE73L,FBALYB Amazon,-7,-9,2,0,2,0
,Jansport Superbreak Plus - Iridescent Sky Backpack JS0A4QUE73R,Jansport Superbreak Plus - Iridescent Sky Backpack JS0A4QUE73R,FBALYB Amazon,-1,-3,2,0,2,0
,Jansport Superbreak Plus - Leopard Life Backpack JS0A4QUE7E1,Jansport Superbreak Plus - Leopard Life Backpack JS0A4QUE7E1,FBALYB Amazon,-3,-3,0,0,0,0
,Jansport Superbreak Plus - Lunar Space Backpack JS0A4QUE73Q,Jansport Superbreak Plus - Lunar Space Backpack JS0A4QUE73Q,FBALYB Amazon,21,19,2,0,2,0
,Jansport Superbreak Plus - Red Tape Backpack JS0A4QUE5XP,Jansport Superbreak Plus - Red Tape Backpack JS0A4QUE5XP,FBALYB Amazon,-201,-201,0,198,0,0
,Jansport Superbreak Plus - Soft Tan Backpack JS0A4QUE00Y,Jansport Superbreak Plus - Soft Tan Backpack JS0A4QUE00Y,FBALYB Amazon,-1,-1,0,0,0,0
,Jansport Superbreak Plus - Sunflower Field Backpack JS0A4QUE74T,Jansport Superbreak Plus - Sunflower Field Backpack JS0A4QUE74T,Default,0,0,0,0,0,1
,Jansport Superbreak Plus - Sunflower Field Backpack JS0A4QUE74T,Jansport Superbreak Plus - Sunflower Field Backpack JS0A4QUE74T,FBALYB Amazon,24,21,3,0,3,0
,Jansport Superbreak Plus - Sunshine Poppies Backpack JS0A4QUE74V,Jansport Superbreak Plus - Sunshine Poppies Backpack JS0A4QUE74V,FBALYB Amazon,-4,-8,4,0,4,0
,Jansport Superbreak Plus - Super Blazed Backpack JS0A4QUE73N,Jansport Superbreak Plus - Super Blazed Backpack JS0A4QUE73N,FBALYB Amazon,2,-5,7,0,7,0
,Jansport Superbreak - Red Tape Backpack JS0A4QUT5XP,Jansport Superbreak - Red Tape Backpack JS0A4QUT5XP,Default Ridgefield,2,2,0,0,0,0
,Jansport Superbreak - Red Tape Backpack JS0A4QUT5XP,Jansport Superbreak - Red Tape Backpack JS0A4QUT5XP,FBALYB Amazon,165,150,15,0,15,0
,Jansport Superbreak - Red Tape Backpack JS0A4QUT5XP,Jansport Superbreak - Red Tape Backpack JS0A4QUT5XP,FBALYB Canada,20,20,0,0,0,0
,Jason Aloe Vera Body Wash 30 oz,Jason Aloe Vera Body Wash 30 oz,Default,0,0,0,0,0,34
,Jawbone BIG JAMBOX  Bluetooth Speaker,Jawbone BIG JAMBOX Wireless Bluetooth Speaker - Red Dot - Retail Packaging,Default,0,0,0,0,0,1
,JBL Charge 3 Bluetooth Speaker Black,JBL Charge 3 Waterproof Portable Bluetooth Speaker (Black),Default,0,0,0,0,0,3
,JBL Endurance Jump Wireless Bluetooth Sport Headphones - Black/Yellow,JBL Endurance Jump Wireless Bluetooth Sport Headphones - Black/Yellow,Default Ridgefield,716,716,0,0,0,0
,JBL Endurance Jump Wireless Bluetooth Sport Headphones - Black/Yellow,JBL Endurance Jump Wireless Bluetooth Sport Headphones - Black/Yellow,FBALYB Amazon,31,31,0,0,0,0
,JBL Flip 4 Speaker Black,JBL Flip 4 Speaker Black,Default,0,0,0,0,0,2
,JBL Reflect Flow TWS True Wireless Sport Headphones - Black,JBL Reflect Flow TWS True Wireless Sport Headphones - Black,Default Ridgefield,2,2,0,0,0,0
,JBL Reflect Flow TWS True Wireless Sport Headphones - Black,JBL Reflect Flow TWS True Wireless Sport Headphones - Black,FBALYB Amazon,418,418,0,0,0,0
,JBL Tune 120TWS True Wireless In-Ear - Blue,JBL Tune 120TWS True Wireless In-Ear - Blue,FBALYB Amazon,175,175,0,0,0,0
,JBL Tune 120TWS True Wireless In-Ear - White,JBL Tune 120TWS True Wireless In-Ear - White,FBALYB Amazon,-3,-3,0,0,0,0
,JBL Tune 600BTNC Wireless Noise Cancelling Headphones - Pink,JBL Tune 600BTNC Wireless Noise Cancelling Headphones - Pink,FBALYB Amazon,30,30,0,0,0,0
,JBL Tune 600BTNC Wireless Noise Cancelling Headphones - White,JBL Tune 600BTNC Wireless Noise Cancelling Headphones - White,Default Ridgefield,162,162,0,0,0,0
,JBL Tune 600BTNC Wireless Noise Cancelling Headphones - White,JBL Tune 600BTNC Wireless Noise Cancelling Headphones - White,FBALYB Amazon,50,50,0,0,0,0
,JBL Xtreme Speaker Blue,JBL - Xtreme Portable Bluetooth Speaker - Blue,FBALYB Amazon,1,1,0,0,0,0
,JB-RYCD-A46J,"Margaritaville Bahamas Frozen Concoction Maker with No Brainer Mixer, DM0700",Default,0,-1,1,0,0,0
,JB-RYCD-A46J,"Margaritaville Bahamas Frozen Concoction Maker with No Brainer Mixer, DM0700",FBALYB Amazon,-2,-2,0,0,0,0
,Jelly Belly 50 Flavor 3 lbs.,"Jelly Belly 50 Flavor Gourmet Jelly Beans, 3 lbs.",Default,0,-1,1,0,0,0
,Jelly Belly 50 Flavor 3 lbs.,"Jelly Belly 50 Flavor Gourmet Jelly Beans, 3 lbs.",FBALYB Amazon,-379,-379,0,415,0,0
,Jerky Treats Dog Snacks,Jerky Treats Tender Beef Strips Dog Snacks,Default,0,0,0,0,0,98
,Jerky Treats Dog Snacks,Jerky Treats Tender Beef Strips Dog Snacks,FBALYB Amazon,5,5,0,0,0,0
,Jerky Treats Dog Snacks 2pk, Jerky Treats Dog Snacks 2pk,FBALYB Amazon,-4,-4,0,6,0,0
,Jessicurl Aloeba Daily Conditioner - Citrus Lavender 8oz,Jessicurl Aloeba Daily Conditioner - Citrus Lavender 8oz,Default Ridgefield,110,110,0,0,0,0
,Jessicurl Aloeba Daily Conditioner - Citrus Lavender 8oz,Jessicurl Aloeba Daily Conditioner - Citrus Lavender 8oz,FBALYB Amazon,-2,-2,0,0,0,0
,Jessicurl Aloeba Daily Conditioner - No Fragrance 8oz,Jessicurl Aloeba Daily Conditioner - No Fragrance 8oz,FBALYB Amazon,49,49,0,0,0,0
,Jessicurl Awe Inspiraling Spray - Island Fantasy - 8 OZ,Jessicurl Awe Inspiraling Spray - Island Fantasy - 8 OZ,Default,0,0,0,0,0,120
,Jessicurl Awe Inspiraling Spray - Island Fantasy - 8 OZ,Jessicurl Awe Inspiraling Spray - Island Fantasy - 8 OZ,FBALYB Amazon,28,27,1,0,1,0
,Jessicurl Rockin Ringlets Styling Potion - No Fragrance 8oz,Jessicurl Rockin Ringlets Styling Potion - No Fragrance 8oz,FBALYB Amazon,-5,-5,0,0,0,0
,Jessicurl Spiralicious Styling Gel - Citrus Lavender - 8 OZ,Jessicurl Spiralicious Styling Gel - Citrus Lavender - 8 OZ,Default,1,1,0,0,0,600
,Jessicurl Spiralicious Styling Gel - Citrus Lavender - 8 OZ,Jessicurl Spiralicious Styling Gel - Citrus Lavender - 8 OZ,FBALYB Amazon,-45,-45,0,0,0,0
,Jessicurl Spiralicious Styling Gel - No Fragrance - 8 OZ,Jessicurl Spiralicious Styling Gel - No Fragrance - 8 OZ,Default Ridgefield,123,123,0,0,0,0
,Jessicurl Spiralicious Styling Gel - No Fragrance - 8 OZ,Jessicurl Spiralicious Styling Gel - No Fragrance - 8 OZ,FBALYB Amazon,424,423,1,0,1,0
,Jessicurl Too Shea Extra Moisturizing Conditioner - Citrus Lavender 32oz,Jessicurl Too Shea Extra Moisturizing Conditioner - Citrus Lavender 32oz,FBALYB Amazon,-1,-1,0,0,0,0
,Jessicurl Too Shea Extra Moisturizing Conditioner - Island Fantasy 32oz,Jessicurl Too Shea Extra Moisturizing Conditioner - Island Fantasy 32oz,FBALYB Amazon,-1,-1,0,0,0,0
,Jessicurl Too Shea Extra Moisturizing Conditioner - No Fragrance 32oz,Jessicurl Too Shea Extra Moisturizing Conditioner - No Fragrance 32oz,FBALYB Amazon,-3,-3,0,0,0,0
,Jetboil Coffee Press - Silicone CFPS,Jetboil Coffee Press - Silicone CFPS,FBALYB Amazon,-2,-7,5,1,5,0
,Jetboil Flash Camo FLCM,Jetboil Flash Camo FLCM,FBALYB Amazon,-2,-2,0,0,0,0
,Jetboil Flash Carbon FLCBN,Jetboil Flash Carbon FLCBN,FBALYB Amazon,-3,-3,0,0,0,0
,Jetboil Flash Java Ecto FLJVEC,Jetboil Flash Java Ecto FLJVEC,FBALYB Amazon,-4,-4,0,1,0,0
,Jetboil Flash Matrix FLMX,Jetboil Flash Matrix FLMX,FBALYB Amazon,-3,-3,0,0,0,0
,Jetboil Flash Wilderness FLWD,Jetboil Flash Wilderness FLWD,FBALYB Amazon,-4,-4,0,1,0,0
,Jetboil Grande Coffee Press - Silicone CFPGS,Jetboil Grande Coffee Press - Silicone CFPGS,FBALYB Amazon,-3,-6,3,0,3,0
,Jetboil JetGauge JTG,Jetboil JetGauge JTG,Default,0,0,0,0,0,48
,Jetboil MicroMo Carbon MCMCB,Jetboil MicroMo Carbon MCMCB,FBALYB Amazon,108,108,0,0,0,0
,Jetboil MicroMo Tamale MCMTM,Jetboil MicroMo Tamale MCMTM,FBALYB Amazon,51,51,0,0,0,0
,Jetboil MightyMo MTYM,Jetboil MightyMo MTYM,FBALYB Amazon,168,168,0,0,0,0
,Jetboil MiniMo Adventure MNMAD,Jetboil MiniMo Adventure MNMAD,FBALYB Amazon,75,75,0,0,0,0
,Jetboil MiniMo Camo MNMCM,Jetboil MiniMo Camo MNMCM,FBALYB Amazon,24,24,0,0,0,0
,Jetboil MiniMo Carbon MNMCB,Jetboil MiniMo Carbon MNMCB,FBALYB Amazon,108,108,0,0,0,0
,Jetboil MiniMo Sunset MNMSS,Jetboil MiniMo Sunset MNMSS,FBALYB Amazon,104,104,0,1,0,0
,Jetboil Pot Support PSUP,Jetboil Pot Support PSUP,FBALYB Amazon,-1,-1,0,0,0,0
,Jetboil Summit Skillet SKLT,Jetboil Summit Skillet SKLT,FBALYB Amazon,0,-12,12,0,12,0
,Jetboil SUMO SUMOCB,Jetboil SUMO SUMOCB,FBALYB Amazon,-2,-2,0,0,0,0
,Jetboil Zip Carbon ZPCB,Jetboil Zip Carbon ZPCB,FBALYB Amazon,-7,-7,0,1,0,0
,JG-JNKO-TVCK,"Dole Mandarin Oranges Fruit Cups, 64 Ounce",FBALYB Amazon,1,1,0,0,0,0
,Jif Peanut Butter 36 cups,"Jif Creamy Peanut Butter, 36-1.5 oz (43g)cups",FBALYB Amazon,64,64,0,5,0,0
,J&J Baby Lotion 50ML 3pk,J&J Baby Lotion 50ML 3pk,FBALYB Amazon,1250,1250,0,0,0,0
,J&J Baby Lotion 50ML 3pk,J&J Baby Lotion 50ML 3pk,WFS,-61,-61,0,0,0,0
,J&J Baby Shampoo,J&J Baby Shampoo Value Pack (total 57.8 oz),FBALYB Amazon,1,1,0,0,0,0
,J&J cotton buds 200s 3pk,J&J cotton buds 200s 3pk,FBALYB Amazon,-22,-22,0,2,0,0
,"J&J Reach Mint Floss, 5 pk.","Johnson & Johnson Reach Mint Waxed Dental Floss, 5 pk./100 yds.",FBALYB Amazon,1,0,1,0,1,0
,Johnson's Baby Lotion 3pk,Johnson's Baby Lotion (Pack of 3) 2-27 oz & 1-9 oz ,FBALYB Amazon,1,1,0,0,0,0
,Joico - 1N Black 2.5 oz,Joico - 1N Black 2.5 oz,FBALYB Amazon,-4,-4,0,0,0,0
,Joico - 5N Medium Brown 2.5 oz,Joico - 5N Medium Brown 2.5 oz,Default Ridgefield,4,4,0,0,0,0
,Joico - 5N Medium Brown 2.5 oz,Joico - 5N Medium Brown 2.5 oz,FBALYB Amazon,144,144,0,1,0,0
,Joico - 5N Medium Brown 2.5 oz,Joico - 5N Medium Brown 2.5 oz,WFS,-81,-81,0,0,0,0
,Joico - 6NG+ Light Natural Brown 2.5 oz,Joico - 6NG+ Light Natural Brown 2.5 oz,Default,0,0,0,0,0,180
,Joico - 6NG+ Light Natural Brown 2.5 oz,Joico - 6NG+ Light Natural Brown 2.5 oz,Default Ridgefield,72,72,0,0,0,0
,Joico - 7G Dark Golden Blonde 2.5 oz,Joico - 7G Dark Golden Blonde 2.5 oz,FBALYB Amazon,71,71,0,0,0,0
,Joico - 7G Dark Golden Blonde 2.5 oz,Joico - 7G Dark Golden Blonde 2.5 oz,WFS,-33,-33,0,0,0,0
,Joico - 7N Dark Blonde 2.5 oz,Joico - 7N Dark Blonde 2.5 oz,FBALYB Amazon,167,167,0,0,0,0
,Joico - 7N Dark Blonde 2.5 oz,Joico - 7N Dark Blonde 2.5 oz,WFS,-33,-33,0,0,0,0
,Joico - Blonde Life Brightening Conditioner - Liter,Joico - Blonde Life Brightening Conditioner - Liter,Default,0,0,0,0,0,488
,Joico - Blonde Life Brightening Conditioner - Liter,Joico - Blonde Life Brightening Conditioner - Liter,FBALYB Amazon,1,1,0,0,0,0
,Joico - Blonde Life Brightening Masque - 5.1 Oz,Joico - Blonde Life Brightening Masque - 5.1 Oz,Default,0,0,0,0,0,208
,Joico - Blonde Life Brightening Masque - 5.1 Oz,Joico - Blonde Life Brightening Masque - 5.1 Oz,FBALYB Amazon,109,106,3,1,3,0
,Joico - Blonde Life Brightening Masque - 5.1 Oz,Joico - Blonde Life Brightening Masque - 5.1 Oz,WFS,-34,-34,0,0,0,0
,Joico - Blonde Life Brightening Shampoo 33.8 oz & Conditioner 33.8 oz Set,Joico - Blonde Life Brightening Shampoo 33.8 oz & Conditioner 33.8 oz Set,FBALYB Amazon,25,25,0,175,0,0
,Joico - Blonde Life Brightening Shampoo - Liter,Joico - Blonde Life Brightening Shampoo - Liter ,FBALYB Amazon,9,9,0,0,0,0
,Joico - Blonde Life Brightening Veil - 5.1 Oz,Joico - Blonde Life Brightening Veil - 5.1 Oz,Default Ridgefield,10,10,0,0,0,0
,Joico - Blonde Life Brightening Veil - 5.1 Oz,Joico - Blonde Life Brightening Veil - 5.1 Oz,FBALYB Amazon,14,14,0,2,0,0
,Joico - Blonde Life Brilliant Glow Brightening Oil - 3.4 Oz,Joico - Blonde Life Brilliant Glow Brightening Oil - 3.4 Oz,Default Ridgefield,20,10,10,0,0,0
,Joico - Blonde Life Brilliant Glow Brightening Oil - 3.4 Oz,Joico - Blonde Life Brilliant Glow Brightening Oil - 3.4 Oz,FBALYB Amazon,-15,-25,10,0,0,0
,Joico - Blonde Life Violet Conditioner - 8.5  Oz,Joico - Blonde Life Violet Conditioner - 8.5  Oz,Default,0,0,0,0,0,626
,Joico - Blonde Life Violet Shampoo - 10.1 Oz,Joico - Blonde Life Violet Shampoo - 10.1 Oz,Default,0,0,0,0,0,626
,Joico Blonde Life Violet Shampoo/Conditioner 10.1 oz + 8.5 oz DUO,Joico Blonde Life Violet Shampoo/Conditioner 10.1 oz + 8.5 oz DUO,Default,0,-191,191,0,0,0
,Joico Blonde Life Violet Shampoo/Conditioner 10.1 oz + 8.5 oz DUO,Joico Blonde Life Violet Shampoo/Conditioner 10.1 oz + 8.5 oz DUO,FBALYB Amazon,-181,-181,0,0,0,0
,Joico Body Luxe Volumizing Conditioner 33.8 fl oz,Joico Body Luxe Volumizing Conditioner 33.8 fl oz,FBALYB Amazon,191,191,0,0,0,0
,Joico Body Luxe Volumizing Conditioner 33.8 fl oz,Joico Body Luxe Volumizing Conditioner 33.8 fl oz,WFS,-63,-63,0,0,0,0
,Joico - Color Balance Blue Conditioner - Liter,Joico - Color Balance Blue Conditioner - Liter,Default,0,0,0,0,0,408
,Joico - Color Balance Blue Conditioner - Liter,Joico - Color Balance Blue Conditioner - Liter,FBALYB Amazon,4,2,2,0,2,0
,Joico - Color Balance Blue Shampoo - Liter,Joico - Color Balance Blue Shampoo - Liter,Default,0,0,0,0,0,193
,Joico - Color Balance Blue Shampoo - Liter,Joico - Color Balance Blue Shampoo - Liter,Default Ridgefield,18,15,3,0,0,0
,Joico - Color Balance Blue Shampoo - Liter,Joico - Color Balance Blue Shampoo - Liter,FBALYB Amazon,4,0,4,13,1,0
,Joico Color Balance Purple 10.1oz Shampoo,Joico Color Balance Purple 10.1oz Shampoo,Default,0,-315,315,0,0,0
,Joico Color Balance Purple 10.1oz Shampoo,Joico Color Balance Purple 10.1oz Shampoo,Default Ridgefield,4,4,0,0,0,0
,Joico - Color Balance Purple Conditioner - 10.1 Oz,Joico - Color Balance Purple Conditioner - 10.1 Oz,Default,0,-315,315,0,0,0
,Joico - Color Balance Purple Conditioner -  Liter,Joico - Color Balance Purple Conditioner -  Liter,Default,0,0,0,0,0,79
,Joico - Color Balance Purple Conditioner -  Liter,Joico - Color Balance Purple Conditioner -  Liter,Default Ridgefield,26,26,0,0,0,0
,Joico - Color Balance Purple Conditioner -  Liter,Joico - Color Balance Purple Conditioner -  Liter,FBALYB Amazon,-4,-4,0,0,0,0
,Joico - Color Balance Purple Shampoo + Conditioner 33.8 oz Set,Joico - Color Balance Purple Shampoo + Conditioner 33.8 oz Set,FBALYB Amazon,-16,-17,1,11,1,0
,Joico - Color Balance Purple Shampoo - Liter,Joico - Color Balance Purple Shampoo - Liter,Default,0,0,0,0,0,783
,Joico - Color Balance Purple Shampoo - Liter,Joico - Color Balance Purple Shampoo - Liter,Default Ridgefield,24,24,0,0,0,0
,Joico - Color Balance Purple Shampoo - Liter,Joico - Color Balance Purple Shampoo - Liter,FBALYB Amazon,21,21,0,0,0,0
,Joico Color Balance Shamp & Condit 10oz,Joico Color Balance Shamp & Condit 10oz,FBALYB Amazon,-16,-16,0,29,0,0
,Joico - Color Endure Conditioner For Long Lasting Color - Gallon,Joico - Color Endure Conditioner For Long Lasting Color - Gallon,Default,0,0,0,0,0,32
,Joico - Color Infuse Red Conditioner - 10.1 Oz,Joico - Color Infuse Red Conditioner - 10.1 Oz,Default,0,-486,486,0,0,2
,Joico - Color Infuse Red Conditioner - 10.1 Oz,Joico - Color Infuse Red Conditioner - 10.1 Oz,FBALYB Amazon,-2,-2,0,0,0,0
,Joico Color Infuse Red Shampoo 10.01 oz & Conditioner 10.1 oz,Joico Color Infuse Red Shampoo 10.01 oz & Conditioner 10.1 oz,Default,0,-243,243,0,0,0
,Joico Color Infuse Red Shampoo 10.01 oz & Conditioner 10.1 oz,Joico Color Infuse Red Shampoo 10.01 oz & Conditioner 10.1 oz,FBALYB Amazon,10,10,0,0,0,0
,Joico - Color Infuse Red Shampoo - 10.1 Oz,Joico - Color Infuse Red Shampoo - 10.1 Oz,Default,0,-486,486,0,0,6
,Joico - Color Infuse Red Shampoo - 10.1 Oz,Joico - Color Infuse Red Shampoo - 10.1 Oz,Default Ridgefield,84,84,0,0,0,0
,Joico - Color Infuse Red Shampoo - 10.1 Oz,Joico - Color Infuse Red Shampoo - 10.1 Oz,FBALYB Amazon,-6,-6,0,0,0,0
,Joico - Color Intensity Amethyst Purple 4 oz,Joico - Color Intensity Amethyst Purple 4 oz,Default,0,-200,200,0,0,0
,Joico - Color Intensity Amethyst Purple 4 oz,Joico - Color Intensity Amethyst Purple 4 oz,FBALYB Amazon,-2,-2,0,0,0,0
,Joico - Color Intensity Cobalt Blue 4 oz,Joico - Color Intensity Cobalt Blue 4 oz,Default Ridgefield,193,193,0,0,0,0
,Joico - Color Intensity Color Butter Red - 6 Oz.,Joico - Color Intensity Color Butter Red - 6 Oz.,Default,0,0,0,0,0,96
,Joico - Color Intensity Mauve Quartz 4 oz,Joico - Color Intensity Mauve Quartz 4 oz,Default Ridgefield,24,24,0,0,0,0
,Joico - Color Intensity Mermaid Blue 4 oz,Joico - Color Intensity Mermaid Blue 4 oz,Default Ridgefield,190,190,0,0,0,0
,Joico - Color Intensity Orchid 4 oz,Joico - Color Intensity Orchid 4 oz,Default Ridgefield,192,192,0,0,0,0
,Joico - Color Intensity Sapphire Blue 4 oz,Joico - Color Intensity Sapphire Blue 4 oz,FBALYB Amazon,-3,-3,0,0,0,0
,Joico - Defy Damage ProSeries 2 Bond- strengthening color treatment,Joico - Defy Damage ProSeries 2 Bond- strengthening color treatment,Default,0,0,0,0,0,204
,Joico - Defy Damage Protective Conditioner - 8.5 Oz,Joico - Defy Damage Protective Conditioner - 8.5 Oz,Default,0,-286,286,0,0,408
,Joico - Defy Damage Protective Conditioner - 8.5 Oz,Joico - Defy Damage Protective Conditioner - 8.5 Oz,FBALYB Amazon,-2,-2,0,0,0,0
,Joico - Defy Damage Protective Conditioner -  Liter,Joico - Defy Damage Protective Conditioner -  Liter,FBALYB Amazon,5,5,0,0,0,0
,Joico - Defy Damage Protective Masque - 5.1 Oz,Joico - Defy Damage Protective Masque - 5.1 Oz,FBALYB Amazon,2,2,0,7,0,0
,Joico - Defy Damage Protective Shampoo - 10.1 Oz,Joico - Defy Damage Protective Shampoo - 10.1 Oz,Default,0,-286,286,0,0,44
,Joico - Defy Damage Protective Shampoo - 10.1 Oz,Joico - Defy Damage Protective Shampoo - 10.1 Oz,FBALYB Amazon,13,13,0,1,0,0
,Joico Defy Damage Protective Shampoo 10oz and Conditioner 8.5oz duo,Joico Defy Damage Protective Shampoo 10oz and Conditioner 8.5oz duo,FBALYB Amazon,-4,-4,0,10,0,0
,Joico Defy Damage Protective Shampoo and Conditioner 33.8 Liter Duo,Joico Defy Damage Protective Shampoo and Conditioner 33.8 Liter Duo,FBALYB Amazon,-350,-350,0,365,0,0
,Joico - Defy Damage Protective Shampoo - Liter,Joico - Defy Damage Protective Shampoo - Liter,FBALYB Amazon,17,17,0,1,0,0
,Joico - Defy Damage Protective Shield - 3.38 Oz,Joico - Defy Damage Protective Shield - 3.38 Oz,Default Ridgefield,180,180,0,0,0,0
,Joico - Defy Damage Protective Shield - 3.38 Oz,Joico - Defy Damage Protective Shield - 3.38 Oz,FBALYB Amazon,23,22,1,1,1,0
,Joico - Hair Shake Liquid Texturizing Finisher 5.1oz,Joico - Hair Shake Liquid Texturizing Finisher 5.1oz,FBALYB Amazon,9,9,0,0,0,0
,Joico - Heat Set Blowout Perfecting Crème - 5.1 Oz,Joico - Heat Set Blowout Perfecting Crème - 5.1 Oz,Default,0,0,0,0,0,408
,Joico - Heat Set Blowout Perfecting Crème - 5.1 Oz,Joico - Heat Set Blowout Perfecting Crème - 5.1 Oz,FBALYB Amazon,221,221,0,2,0,0
,Joico - Heat Set Blowout Perfecting Crème - 5.1 Oz,Joico - Heat Set Blowout Perfecting Crème - 5.1 Oz,WFS,-108,-108,0,0,0,0
,Joico - HLA High Lift Ash Blonde 2.5 oz,Joico - HLA High Lift Ash Blonde 2.5 oz,Default,0,0,0,0,0,72
,Joico - HLA High Lift Ash Blonde 2.5 oz,Joico - HLA High Lift Ash Blonde 2.5 oz,FBALYB Amazon,-1,-1,0,0,0,0
,Joico - HydraSplash Hydrating Conditioner for fine hair 8.5 oz,Joico - HydraSplash Hydrating Conditioner for fine hair 8.5 oz,Default,0,0,0,0,0,1
,Joico - HydraSplash Hydrating Conditioner for fine hair 8.5 oz,Joico - HydraSplash Hydrating Conditioner for fine hair 8.5 oz,Default Ridgefield,16,16,0,0,0,0
,Joico - HydraSplash Hydrating Conditioner for fine hair 8.5 oz,Joico - HydraSplash Hydrating Conditioner for fine hair 8.5 oz,FBALYB Amazon,1,1,0,0,0,0
,Joico - HydraSplash Hydrating Conditioner for fine hair - liter,Joico - HydraSplash Hydrating Conditioner for fine hair - liter,Default,0,0,0,0,0,25
,Joico - HydraSplash Hydrating Conditioner for fine hair - liter,Joico - HydraSplash Hydrating Conditioner for fine hair - liter,FBALYB Amazon,1,1,0,0,0,0
,Joico - HydraSplash Hydrating Shampoo for  fine hair 10.1 oz,Joico - HydraSplash Hydrating Shampoo for  fine hair 10.1 oz,Default,0,0,0,0,0,57
,Joico - HydraSplash Hydrating Shampoo for  fine hair 10.1 oz,Joico - HydraSplash Hydrating Shampoo for  fine hair 10.1 oz,FBALYB Amazon,2,2,0,0,0,0
,Joico - HydraSplash Hydrating Shampoo for fine hair liter,Joico - HydraSplash Hydrating Shampoo for fine hair liter,Default,0,0,0,0,0,1
,Joico - HydraSplash Hydrating Shampoo for fine hair liter,Joico - HydraSplash Hydrating Shampoo for fine hair liter,FBALYB Amazon,6,6,0,0,0,0
,Joico - HydraSplash Replenishing Leave-In  for fine hair 3.38 oz,Joico - HydraSplash Replenishing Leave-In  for fine hair 3.38 oz,Default,0,0,0,0,0,144
,Joico - HydraSplash Replenishing Leave-In  for fine hair 3.38 oz,Joico - HydraSplash Replenishing Leave-In  for fine hair 3.38 oz,FBALYB Amazon,-13,-13,0,0,0,0
,Joico Ice Spiker Glue 2pk,Joico Ice Spiker Glue 2pk,FBALYB Amazon,-2,-2,0,1,0,0
,Joico - Ironclad Thermal Protectant - 7 Oz,Joico - Ironclad Thermal Protectant - 7 Oz,Default,0,0,0,0,0,1812
,Joico - Ironclad Thermal Protectant - 7 Oz,Joico - Ironclad Thermal Protectant - 7 Oz,Default Ridgefield,192,192,0,0,0,0
,Joico - Ironclad Thermal Protectant - 7 Oz,Joico - Ironclad Thermal Protectant - 7 Oz,FBALYB Amazon,1,1,0,0,0,0
,Joico- Iso Tamer Cleanser Gallon,Joico- Iso Tamer Cleanser Gallon,Default Ridgefield,93,93,0,0,0,0
,Joico- Iso Tamer Cleanser Gallon,Joico- Iso Tamer Cleanser Gallon,FBALYB Amazon,146,146,0,0,0,0
,Joico - Joifull Volumizing Conditioner - Liter,Joico - Joifull Volumizing Conditioner - Liter,Default,0,0,0,0,0,266
,Joico - Joifull Volumizing Shampoo - 10.1 Oz,Joico - Joifull Volumizing Shampoo - 10.1 Oz,FBALYB Amazon,0,0,0,2,0,0
,Joico - Joifull Volumizing Shampoo - Liter,Joico - Joifull Volumizing Shampoo - Liter,Default,0,0,0,0,0,63
,Joico - Joifull Volumizing Shampoo - Liter,Joico - Joifull Volumizing Shampoo - Liter,Default Ridgefield,1,1,0,0,0,0
,Joico - Joifull Volumizing Shampoo - Liter,Joico - Joifull Volumizing Shampoo - Liter,FBALYB Amazon,-4,-4,0,14,0,0
,Joico - Joifull Volumizing Styler - 3.4 Oz,Joico - Joifull Volumizing Styler - 3.4 Oz,FBALYB Amazon,-4,-4,0,0,0,0
,Joico - Joigel Medium Styling Gel - 8.5 Oz,Joico - Joigel Medium Styling Gel - 8.5 Oz,FBALYB Amazon,1,1,0,0,0,0
,Joico - Joilotion Sculpting Lotion - 10.1Oz,Joico - Joilotion Sculpting Lotion - 10.1Oz,Default,0,0,0,0,0,456
,Joico - Joilotion Sculpting Lotion - 10.1Oz,Joico - Joilotion Sculpting Lotion - 10.1Oz,FBALYB Amazon,30,30,0,1,0,0
,Joico - K-PAK Color Therapy Conditioner - 10.1 Oz,Joico - K-PAK Color Therapy Conditioner - 10.1 Oz,Default,0,-408,408,0,0,360
,Joico - K-PAK Color Therapy Conditioner - 10.1 Oz,Joico - K-PAK Color Therapy Conditioner - 10.1 Oz,Default Ridgefield,192,192,0,0,0,0
,Joico - K-PAK Color Therapy Conditioner - 10.1 Oz,Joico - K-PAK Color Therapy Conditioner - 10.1 Oz,FBALYB Amazon,-5,-5,0,0,0,0
,Joico - K-PAK Color Therapy Conditioner -  Liter,Joico - K-PAK Color Therapy Conditioner -  Liter,Default,0,0,0,0,0,360
,Joico - K-PAK Color Therapy Conditioner -  Liter,Joico - K-PAK Color Therapy Conditioner -  Liter,FBALYB Amazon,-4,-4,0,1,0,0
,Joico - K-PAK Color Therapy Luster Lock Instant Shine & Repair Treatment - 4.7 Oz,Joico - K-PAK Color Therapy Luster Lock Instant Shine & Repair Treatment - 4.7 Oz ,Chicago,-502,-502,0,0,0,0
,Joico - K-PAK Color Therapy Luster Lock Instant Shine & Repair Treatment - 4.7 Oz,Joico - K-PAK Color Therapy Luster Lock Instant Shine & Repair Treatment - 4.7 Oz ,Default,0,0,0,0,0,93
,Joico - K-PAK Color Therapy Luster Lock Instant Shine & Repair Treatment - 4.7 Oz,Joico - K-PAK Color Therapy Luster Lock Instant Shine & Repair Treatment - 4.7 Oz ,Default Ridgefield,224,224,0,0,0,0
,Joico - K-PAK Color Therapy Luster Lock Instant Shine & Repair Treatment - 4.7 Oz,Joico - K-PAK Color Therapy Luster Lock Instant Shine & Repair Treatment - 4.7 Oz ,FBALYB Amazon,512,512,0,4,0,0
,Joico - K-PAK Color Therapy Luster Lock Instant Shine & Repair Treatment - 4.7 Oz,Joico - K-PAK Color Therapy Luster Lock Instant Shine & Repair Treatment - 4.7 Oz ,WFS,-97,-97,0,0,0,0
,Joico - K-PAK Color Therapy Luster Lock Instant Shine & Repair Treatment - 8.5 Oz,Joico - K-PAK Color Therapy Luster Lock Instant Shine & Repair Treatment - 8.5 Oz,FBALYB Amazon,11,11,0,25,0,0
,Joico K-Pak Color Therapy Luster Lock Multi Protect Daily Shine Spray 6.7oz,Joico K-Pak Color Therapy Luster Lock Multi Protect Daily Shine Spray 6.7oz,Default,0,0,0,0,0,2016
,Joico K-Pak Color Therapy Luster Lock Multi Protect Daily Shine Spray 6.7oz,Joico K-Pak Color Therapy Luster Lock Multi Protect Daily Shine Spray 6.7oz,FBALYB Amazon,4,4,0,0,0,0
,Joico - K-PAK Color Therapy Restorative Styling Oil - 3.4 Oz,Joico - K-PAK Color Therapy Restorative Styling Oil - 3.4 Oz,Default,0,0,0,0,0,4
,Joico - K-PAK Color Therapy Restorative Styling Oil - 3.4 Oz,Joico - K-PAK Color Therapy Restorative Styling Oil - 3.4 Oz,Default Ridgefield,158,158,0,0,0,0
,Joico - K-PAK Color Therapy Restorative Styling Oil - 3.4 Oz,Joico - K-PAK Color Therapy Restorative Styling Oil - 3.4 Oz,FBALYB Amazon,10,10,0,1,0,0
,Joico - K-PAK Color Therapy Shampoo - 10.1 Oz.,Joico - K-PAK Color Therapy Shampoo - 10.1 Oz.,Default,0,-408,408,0,0,408
,Joico - K-PAK Color Therapy Shampoo - Liter,Joico - K-PAK Color Therapy Shampoo - Liter ,FBALYB Amazon,17,17,0,0,0,0
,Joico - K-PAK Daily Conditioner To Repair  Damage - Liter,Joico - K-PAK Daily Conditioner To Repair  Damage - Liter,Default Ridgefield,15,14,1,0,0,0
,Joico - K-PAK Daily Conditioner To Repair  Damage - Liter,Joico - K-PAK Daily Conditioner To Repair  Damage - Liter,FBALYB Amazon,84,83,1,0,0,0
,"Joico - K-PAK Intense Hydrator Treatment For Dry, Damaged Hair - 8.5 Oz","Joico - K-PAK Intense Hydrator Treatment For Dry, Damaged Hair - 8.5 Oz",FBALYB Amazon,153,149,4,18,4,0
,"Joico - K-PAK Liquid Reconstructor For Fine,  Damaged Hair - 10.1 Oz","Joico - K-PAK Liquid Reconstructor For Fine,  Damaged Hair - 10.1 Oz",Default,0,0,0,0,0,72
,"Joico - K-PAK Liquid Reconstructor For Fine,  Damaged Hair - 10.1 Oz","Joico - K-PAK Liquid Reconstructor For Fine,  Damaged Hair - 10.1 Oz",FBALYB Amazon,-3,-3,0,3,0,0
,Joico K-Pak Luster Lock Instant Shine 16.2oz,Joico K-Pak Luster Lock Instant Shine 16.2oz,FBALYB Amazon,23,23,0,0,0,0
,Joico - K-PAK Protective Hair Spray For Medium Hold 55% Voc - 9.3 Oz.,Joico - K-PAK Protective Hair Spray For Medium Hold 55% Voc - 9.3 Oz.,Default,0,0,0,0,0,108
,Joico - K-PAK Protective Hair Spray For Medium Hold 55% Voc - 9.3 Oz.,Joico - K-PAK Protective Hair Spray For Medium Hold 55% Voc - 9.3 Oz.,FBALYB Amazon,4,4,0,0,0,0
,Joico - K-PAK Protect & Shine Serum - 1.7 Oz,Joico - K-PAK Protect & Shine Serum - 1.7 Oz,Default,0,0,0,0,0,120
,Joico - K-PAK Protect & Shine Serum - 1.7 Oz,Joico - K-PAK Protect & Shine Serum - 1.7 Oz,Default Ridgefield,192,192,0,0,0,0
,Joico - K-PAK Reconstructor Treatment For  Damaged Hair - 5.1 Oz,Joico - K-PAK Reconstructor Treatment For  Damaged Hair - 5.1 Oz,Default,0,0,0,0,0,240
,Joico - K-PAK Shampoo To Repair Damage -  Liter,Joico - K-PAK Shampoo To Repair Damage -  Liter,Default,0,0,0,0,0,312
,Joico - Leave-In Detangler For All Hair Types - 10.1 Oz,Joico - Leave-In Detangler For All Hair Types - 10.1 Oz,Default,0,0,0,0,0,576
,Joico - Leave-In Detangler For All Hair Types - 10.1 Oz,Joico - Leave-In Detangler For All Hair Types - 10.1 Oz,FBALYB Amazon,-186,-186,0,191,0,0
,Joico - Moisture Recovery Conditioner for dry hair 33 oz,Joico - Moisture Recovery Conditioner for dry hair 33 oz,Default,0,0,0,0,0,1367
,Joico - Moisture Recovery Conditioner for dry hair 33 oz,Joico - Moisture Recovery Conditioner for dry hair 33 oz,Default Ridgefield,145,145,0,0,0,0
,Joico - Moisture Recovery Conditioner for dry hair 33 oz,Joico - Moisture Recovery Conditioner for dry hair 33 oz,FBALYB Amazon,-5,-5,0,2,0,0
,Joico - Moisture Recovery Conditioner For Dry Hair - Gallon,Joico - Moisture Recovery Conditioner For Dry Hair - Gallon,FBALYB Amazon,-35,-38,3,45,3,0
,Joico - Moisture Recovery Shampoo BIO ADV Peptide Complex - Liter,Joico - Moisture Recovery Shampoo BIO ADV Peptide Complex - Liter,Default,0,0,0,0,0,2004
,Joico - Moisture Recovery Shampoo For Dry Hair - Gallon,Joico - Moisture Recovery Shampoo For Dry Hair - Gallon ,FBALYB Amazon,96,96,0,0,0,0
,Joico - Moisture Recovery Shampoo For Dry Hair - Gallon,Joico - Moisture Recovery Shampoo For Dry Hair - Gallon ,WFS,-22,-22,0,0,0,0
,Joico - Moisture Recovery Shampoo For Dry Hair - Liter,Joico - Moisture Recovery Shampoo For Dry Hair - Liter,Default,0,0,0,0,0,1327
,Joico - Moisture Recovery Shampoo For Dry Hair - Liter,Joico - Moisture Recovery Shampoo For Dry Hair - Liter,Default Ridgefield,401,401,0,0,0,0
,Joico - Moisture Recovery Shampoo For Dry Hair - Liter,Joico - Moisture Recovery Shampoo For Dry Hair - Liter,FBALYB Amazon,-3,-3,0,0,0,0
,Joico - Moisture Recovery Treatment Balm For Thick/Coarse Dry Hair - 8.5 Oz,Joico - Moisture Recovery Treatment Balm For Thick/Coarse Dry Hair - 8.5 Oz,FBALYB Amazon,1263,1263,0,0,0,0
,Joico - Moisture Recovery Treatment Balm For Thick/Coarse Dry Hair - 8.5 Oz,Joico - Moisture Recovery Treatment Balm For Thick/Coarse Dry Hair - 8.5 Oz,WFS,-795,-795,0,0,0,0
,Joico - Moisture Recovery Treatment Balm Thick Dry Hair - 16.9 Oz,Joico - Moisture Recovery Treatment Balm Thick Dry Hair - 16.9 Oz,FBALYB Amazon,1,1,0,47,0,0
,Joico - Natural Dark Blonde 2.5 oz,Joico - Natural Dark Blonde 2.5 oz,Default,0,0,0,0,0,216
,Joico - Natural Dark Brown 2.5 oz,Joico - Natural Dark Brown 2.5 oz,Default,0,0,0,0,0,108
,Joico - Natural Medium Brown 2.5 oz,Joico - Natural Medium Brown 2.5 oz,Default,0,0,0,0,0,180
,Joico - Power Gel Sculpting Gel - 8.5 Oz,Joico - Power Gel Sculpting Gel - 8.5 Oz,Default,0,0,0,0,0,24
,Joico - Power Gel Sculpting Gel - 8.5 Oz,Joico - Power Gel Sculpting Gel - 8.5 Oz,FBALYB Amazon,-8,-8,0,0,0,0
,Joico - Spiker Styling Glue 5.1 oz,Joico - Spiker Styling Glue 5.1 oz,Default,0,0,0,0,0,240
,Joico - Spiker Styling Glue 5.1 oz,Joico - Spiker Styling Glue 5.1 oz,FBALYB Amazon,2,2,0,0,0,0
,Joico - Weekend Hair Dry Shampoo - 5.5 Oz,Joico - Weekend Hair Dry Shampoo - 5.5 Oz,Default,0,0,0,0,0,108
,Joico - Weekend Hair Dry Shampoo - 5.5 Oz,Joico - Weekend Hair Dry Shampoo - 5.5 Oz,FBALYB Amazon,192,192,0,0,0,0
,Joico - Weekend Hair Dry Shampoo - 5.5 Oz,Joico - Weekend Hair Dry Shampoo - 5.5 Oz,WFS,-108,-108,0,0,0,0
,Joimist Firm Finishing Spray 9.1OZ 2pk,Joimist Firm Finishing Spray 9.1OZ 2pk,FBALYB Amazon,3,3,0,0,0,0
,Joint Juice 2 Pack, Joint Juice 2 Pack,FBALYB Amazon,6,6,0,0,0,0
,Joint Juice Glucosamine Drink 30 ct 8 oz,Joint Juice Glucosamine Drink 30 ct 8 oz,Default,0,-1,1,0,0,0
,Jumbler Football (Assorted Medium‑Large),Jumbler Football (Assorted Medium‑Large),FBALYB Amazon,-3,-3,0,0,0,0
,Just Dance 2018 Game,Just Dance 2018 Game for Xbox One,Default,0,0,0,0,0,7
,Just Dance 2018 Game,Just Dance 2018 Game for Xbox One,FBALYB Amazon,-6,-6,0,0,0,0
,Justin's Almond Butter 10count x3,Justin's Almond Butter 10count x3,FBALYB Amazon,-1,-1,0,0,0,0
,"Justin's Almond Butter, Honey 1.15oz","Justin's Almond Butter, Honey 1.15oz",Default,0,0,0,0,0,871
,JW Pet Activitoy Fun House Mirror,JW Pet Activitoy Fun House Mirror,Default,0,0,0,0,0,76
,JW Pet Dog Bowl Large (Blue/White),JW Pet Slow Feed Non-Skid Dog Bowl Large (Blue/White),FBALYB Amazon,-2,-2,0,0,0,0
,JW Pet Megalast Ball Medium,JW Pet Megalast Ball Medium,Default,0,0,0,0,0,5
,JW Pet SkidStop Slow Feed Bowl Medium,JW Pet SkidStop Slow Feed Bowl Medium,Default Ridgefield,2,2,0,0,0,0
,JW Pet SkidStop Slow Feed Bowl Medium,JW Pet SkidStop Slow Feed Bowl Medium,FBALYB Amazon,71,71,0,0,0,0
,JW-TR1H-JPWA,Nutri Ninja Ninja Blender Duo with Auto-iQ (BL642),FBALYB Amazon,1,1,0,1,0,0
,K10 mini platinum,"Keurig K10 Mini Plus Brewing System, Platinum",Default,0,0,0,0,0,1
,K10 mini platinum,"Keurig K10 Mini Plus Brewing System, Platinum",FBALYB Amazon,1,1,0,0,0,0
,K15 Denim Blue,K15 Denim Blue,Default,0,-2,2,0,0,0
,K250 Black Old Packaging (9/28/16),"Keurig K250 Single Serve, Programmable K-Cup Pod Coffee Maker, Black (Discont...",FBALYB Amazon,-1,-1,0,0,0,0
,K250 Imperial Red,K250 Imperial Red,Default,0,0,0,0,0,1
,K250 Peacock Blue,Keurig 2.0 K250 Coffee Maker ‑ Peacock Blue,FBALYB Amazon,-1,-1,0,0,0,0
,K250 Sandy Pearl,Keurig 2.0 K250 Coffee Maker ‑ Sandy Pearl,FBALYB Amazon,-1,-1,0,0,0,0
,k425 Black,k425 Black,Default,0,0,0,0,0,1
,K450 Sandy Pearl,K450 Sandy Pearl,Default,0,-2,2,0,0,0
,K475 black,Keurig K475 Single Serve Programmable K- Cup Pod Coffee Maker with 12 oz brew...,Default,0,0,0,0,0,3
,K475 black,Keurig K475 Single Serve Programmable K- Cup Pod Coffee Maker with 12 oz brew...,FBALYB Amazon,1,1,0,4,0,0
,K55 red,"Keurig K55 Single Serve Programmable K-Cup Pod Coffee Maker, Rhubarb",Default,0,-2,2,0,0,0
,K55 red,"Keurig K55 Single Serve Programmable K-Cup Pod Coffee Maker, Rhubarb",FBALYB Amazon,3,3,0,3,0,0
,K575 Matte Black,K575 Matte Black,Default,0,0,0,0,0,12
,K80 Matte Black,K80 Matte Black,FBALYB Amazon,0,0,0,5,0,0
,Kahlua K Cups 48ct,Kahlua K Cups 48ct,FBALYB Amazon,-1,-10,9,3,9,0
,KALAS Bowl 6ct,KALAS Bowl 6ct,Default Ridgefield,92,-8,100,0,0,0
,KALAS Bowl 6ct,KALAS Bowl 6ct,FBALYB Amazon,113,105,8,0,8,0
,KALAS Bowl 6ct + KALAS Plate 6ct + KALAS Tumbler 6ct PARTIAL SET,KALAS Bowl 6ct + KALAS Plate 6ct + KALAS Tumbler 6ct PARTIAL SET,FBALYB Amazon,218,216,2,0,2,0
,KALAS flatware set 18 piece,KALAS flatware set 18 piece,FBALYB Amazon,-1,-2,1,0,1,0
,KALAS Plate 6ct,KALAS Plate 6ct,Default Ridgefield,795,695,100,0,0,0
,KALAS Tumbler 6ct,KALAS Tumbler 6ct,Default Ridgefield,409,309,100,0,0,0
,Karen number German 2 white stripe,"Karen Neuburger Women's Lounge Pant, Pack of 2 (Medium)",FBALYB Amazon,-1,-1,0,0,0,0
,Kaytee Alfalfa Free Rabbit Food 4.5lb,Kaytee Alfalfa Free Rabbit Food 4.5lb,Default,0,0,0,0,0,78
,Kaytee Alfalfa Free Rabbit Food 4.5lb,Kaytee Alfalfa Free Rabbit Food 4.5lb,FBALYB Amazon,12,12,0,3,0,0
,"Kaytee Bird Food for Parakeets, 5lb","Kaytee Bird Food for Parakeets, 5lb",Default,0,0,0,0,0,96
,"Kaytee Bird Food for Parakeets, 5lb","Kaytee Bird Food for Parakeets, 5lb",FBALYB Amazon,3,3,0,0,0,0
,Kaytee Bird Treats 10oz,Kaytee Orange Blossom Bird Treats 10oz,FBALYB Amazon,-6,-6,0,6,0,0
,"Kaytee Chew-Proof Water Bottle, 26oz","Kaytee Chew-Proof Water Bottle, 26-Ounce",FBALYB Amazon,-5,-5,0,0,0,0
,Kaytee Chinchilla Dust Bath Powder 2.5lb,Kaytee Chinchilla Dust Bath Powder 2.5lb,FBALYB Amazon,22,22,0,0,0,0
,Kaytee Chinchilla Dust Bath Powder 2.5lb 2pk,Kaytee Chinchilla Dust Bath Powder 2.5lb 2pk,FBALYB Amazon,1,1,0,0,0,0
,Kaytee Clean and Cozy Small Animal Bedding,Kaytee Clean and Cozy Small Animal Bedding,Default Ridgefield,1,1,0,0,0,0
,Kaytee Clean & Cozy Bedding 55L,Kaytee Clean & Cozy Bedding 55L,FBALYB Amazon,99,99,0,0,0,0
,Kaytee Exact Handfeeding Baby Bird 18oz,Kaytee Exact Handfeeding Baby Bird 18oz,Default,0,0,0,0,0,3
,Kaytee Exact Handfeeding High Fat 5LB,Kaytee Exact Handfeeding High Fat 5LB,FBALYB Amazon,-1,-1,0,0,0,0
,Kaytee Fiesta Food for Chinchillas (2.5 lbs.),Kaytee Fiesta Food for Chinchillas (2.5 lbs.),FBALYB Amazon,135,135,0,0,0,0
,Kaytee Fiesta Hamster Gerbil 2.5lb,Kaytee Fiesta Hamster Gerbil 2.5lb,FBALYB Amazon,83,83,0,4,0,0
,Kaytee Fiesta Papaya Treat 2.5oz bag,Kaytee Fiesta Papaya Treat 2.5oz bag,FBALYB Amazon,0,0,0,1,0,0
,Kaytee Fiesta Papaya Treat 2.5oz bag 2pk,Kaytee Fiesta Papaya Treat 2.5oz bag 2pk,FBALYB Amazon,-1,-1,0,0,0,0
,Kaytee Forti-Diet Canary Songbird 9oz Jar,Kaytee Forti-Diet Canary Songbird 9oz Jar,Default,0,0,0,0,0,6
,Kaytee Forti-Diet Canary Songbird 9oz Jar 2pk,Kaytee Forti-Diet Canary Songbird 9oz Jar 2pk,FBALYB Amazon,-1,-1,0,0,0,0
,Kaytee Forti-Diet Guinea Pig 5lb,Kaytee Forti-Diet Pro Health Guinea Pig 5lb,FBALYB Amazon,6,6,0,2,0,0
,Kaytee Forti Diet Pro Guinea Pig 5lb 2pk,Kaytee Forti Diet Pro Guinea Pig 5lb 2pk,FBALYB Amazon,85,85,0,1,0,0
,Kaytee Forti-Diet Pro Health Ferret 3lb,Kaytee Forti-Diet Pro Health Ferret 3lb,Default,0,0,0,0,0,4
,Kaytee Forti-Diet Pro Health Ferret 3lb 2pk,Kaytee Forti-Diet Pro Health Ferret 3lb 2pk,FBALYB Amazon,0,0,0,6,0,0
,Kaytee Forti-Diet Pro Health Hamster Gerbil 3lb,Kaytee Forti-Diet Pro Health Hamster Gerbil 3lb,FBALYB Amazon,282,281,1,0,1,0
,"Kaytee Forti-Diet Small Birds, 21oz 2pk","Kaytee Forti-Diet Small Birds, 21oz 2pk",FBALYB Amazon,7,7,0,0,0,0
,"Kaytee Health Bird Food for Parakeet, 5lb","Kaytee Health Bird Food for Parakeet, 5lb",Default,0,0,0,0,0,25
,"Kaytee Health Bird Food for Parakeet, 5lb","Kaytee Health Bird Food for Parakeet, 5lb",FBALYB Amazon,75,75,0,0,0,0
,"Kaytee Health Young Rabbit Food, 5lb","Kaytee Health Young Rabbit Food, 5lb",Default,0,0,0,0,0,2
,"Kaytee Health Young Rabbit Food, 5lb","Kaytee Health Young Rabbit Food, 5lb",FBALYB Amazon,12,12,0,0,0,0
,Kaytee Large Igloo Hide‑Out,Kaytee Large Igloo Hide‑Out,Default Ridgefield,1,1,0,0,0,0
,Kaytee Large Igloo Hide‑Out,Kaytee Large Igloo Hide‑Out,FBALYB Amazon,-24,-24,0,26,0,0
,Kaytee Large Igloo Hide Out 2pk,Kaytee Large Igloo Hide Out 2pk,FBALYB Amazon,73,72,1,20,1,0
,Kaytee Large Tropical Fiddle Sticks Hideout,Kaytee Large Tropical Fiddle Sticks Hideout,FBALYB Amazon,-1,-1,0,0,0,0
,Kaytee Orchard Grass 16oz,Kaytee Orchard Grass 16oz,FBALYB Amazon,3,3,0,0,0,0
,Kaytee Perfect Chew 2 Pack GP,Kaytee Perfect Chew 2 Pack GP,FBALYB Amazon,-1,-1,0,0,0,0
,Kaytee Perfect Chews for Chinchillas,Kaytee Perfect Chews for Chinchillas,FBALYB Amazon,2,2,0,0,0,0
,Kaytee Perfect Chews for Guinea Pigs,Kaytee Perfect Chews for Guinea Pigs,FBALYB Amazon,299,299,0,0,0,0
,"Kaytee Products Inc Supreme, Dove, 5lb","Kaytee Products Inc Supreme, Dove, 5lb",FBALYB Amazon,12,12,0,3,0,0
,"Kaytee Small Exercise Ball Clear 7""","Kaytee Small Exercise Ball Clear 7""",Default Ridgefield,1,-112,113,0,0,0
,"Kaytee Small Exercise Ball Clear 7""","Kaytee Small Exercise Ball Clear 7""",FBALYB Amazon,1,1,0,0,0,0
,Kaytee Supreme Cockatiel 5lb,Kaytee Supreme Cockatiel 5lb,FBALYB Amazon,9,9,0,0,0,0
,Kaytee Supreme Mouse Rat 4lb,Kaytee Supreme Mouse Rat 4lb,Default,0,0,0,0,0,60
,Kaytee Supreme Rabbit 10lb,Kaytee Supreme Rabbit 10lb,Default,0,0,0,0,0,4
,Kaytee Supreme Rabbit 10lb,Kaytee Supreme Rabbit 10lb,FBALYB Amazon,6,5,1,0,1,0
,Kaytee Timothy Chinchilla 3lb,Kaytee Timothy Chinchilla 3lb,Default,0,0,0,0,0,1
,Kaytee Timothy Chinchilla 3lb 2pk,Kaytee Timothy Chinchilla 3lb 2pk,FBALYB Amazon,1,1,0,0,0,0
,K cups 8 pack Newman's own blend,Keurig 2.0 Newman's Own Special Blend K-carafe Packs (8),FBALYB Amazon,-3,-3,0,0,0,0
,Keen Mens Kona Flip Flop Bungee Cord/Raven Size 10.0,Keen Mens Kona Flip Flop Bungee Cord/Raven Size 10.0,FBALYB Amazon,-3,-3,0,0,0,0
,Keen Mens Kona Flip Flop Bungee Cord/Raven Size 12.0,Keen Mens Kona Flip Flop Bungee Cord/Raven Size 12.0,Default Ridgefield,3,3,0,0,0,0
,Keen Mens Kona Flip Flop Bungee Cord/Raven Size 7.0,Keen Mens Kona Flip Flop Bungee Cord/Raven Size 7.0,FBALYB Amazon,2,2,0,0,0,0
,Keen Mens Kona Flip Flop Bungee Cord/Raven Size 7.5,Keen Mens Kona Flip Flop Bungee Cord/Raven Size 7.5,FBALYB Amazon,-1,-1,0,0,0,0
,Keen Mens Waimea H2 Sandal Camo/Navy Size 10.0,Keen Mens Waimea H2 Sandal Camo/Navy Size 10.0,FBALYB Amazon,-2,-2,0,0,0,0
,Keen Mens Waimea H2 Sandal Camo/Navy Size 10.5,Keen Mens Waimea H2 Sandal Camo/Navy Size 10.5,FBALYB Amazon,-1,-1,0,0,0,0
,Keen Mens Waimea H2 Sandal Camo/Navy Size 11.0,Keen Mens Waimea H2 Sandal Camo/Navy Size 11.0,FBALYB Amazon,-2,-2,0,0,0,0
,Keen Mens Waimea H2 Sandal Camo/Navy Size 12.0,Keen Mens Waimea H2 Sandal Camo/Navy Size 12.0,FBALYB Amazon,-2,-2,0,0,0,0
,Keen Mens Waimea H2 Sandal Camo/Navy Size 9.5,Keen Mens Waimea H2 Sandal Camo/Navy Size 9.5,FBALYB Amazon,-2,-2,0,0,0,0
,Keen Womens Bali Strap Sandal Black/Steel Grey Size 10.5,Keen Womens Bali Strap Sandal Black/Steel Grey Size 10.5,FBALYB Amazon,-1,-1,0,0,0,0
,Keen Womens Bali Strap Sandal Black/Steel Grey Size 5.0,Keen Womens Bali Strap Sandal Black/Steel Grey Size 5.0,FBALYB Amazon,-5,-5,0,0,0,0
,Keen Womens Bali Strap Sandal Black/Steel Grey Size 6.0,Keen Womens Bali Strap Sandal Black/Steel Grey Size 6.0,FBALYB Amazon,-2,-2,0,0,0,0
,Keen Womens Bali Strap Sandal Black/Steel Grey Size 8.5,Keen Womens Bali Strap Sandal Black/Steel Grey Size 8.5,FBALYB Amazon,-2,-2,0,0,0,0
,Keen Womens Bali Strap Sandal Black/Steel Grey Size 9.0,Keen Womens Bali Strap Sandal Black/Steel Grey Size 9.0,FBALYB Amazon,-4,-4,0,0,0,0
,Keen Womens Bali Strap Sandal Radiance/Algiers Size 10.0,Keen Womens Bali Strap Sandal Radiance/Algiers Size 10.0,FBALYB Amazon,-10,-10,0,0,0,0
,Keen Womens Bali Strap Sandal Radiance/Algiers Size 10.5,Keen Womens Bali Strap Sandal Radiance/Algiers Size 10.5,FBALYB Amazon,-8,-8,0,0,0,0
,Keen Womens Bali Strap Sandal Radiance/Algiers Size 6.0,Keen Womens Bali Strap Sandal Radiance/Algiers Size 6.0,FBALYB Amazon,-22,-22,0,2,0,0
,Keen Womens Bali Strap Sandal Radiance/Algiers Size 6.5,Keen Womens Bali Strap Sandal Radiance/Algiers Size 6.5,FBALYB Amazon,-15,-15,0,0,0,0
,Keen Womens Bali Strap Sandal Radiance/Algiers Size 7.0,Keen Womens Bali Strap Sandal Radiance/Algiers Size 7.0,FBALYB Amazon,-18,-18,0,0,0,0
,Keen Womens Bali Strap Sandal Radiance/Algiers Size 7.5,Keen Womens Bali Strap Sandal Radiance/Algiers Size 7.5,FBALYB Amazon,-34,-34,0,0,0,0
,Keen Womens Bali Strap Sandal Radiance/Algiers Size 8.0,Keen Womens Bali Strap Sandal Radiance/Algiers Size 8.0,FBALYB Amazon,-5,-5,0,0,0,0
,Keen Womens Bali Strap Sandal Radiance/Algiers Size 8.5,Keen Womens Bali Strap Sandal Radiance/Algiers Size 8.5,FBALYB Amazon,-13,-13,0,0,0,0
,Keen Womens Bali Strap Sandal Radiance/Algiers Size 9.5,Keen Womens Bali Strap Sandal Radiance/Algiers Size 9.5,FBALYB Amazon,-6,-6,0,0,0,0
,Keen Womens Kaci II Oxford Black/Black Size 10.0,Keen Womens Kaci II Oxford Black/Black Size 10.0,FBALYB Amazon,-1,-1,0,0,0,0
,Keen Womens Kaci II Oxford Black/Black Size 10.5,Keen Womens Kaci II Oxford Black/Black Size 10.5,FBALYB Amazon,-5,-5,0,0,0,0
,Keen Womens Kaci II Oxford Black/Black Size 11.0,Keen Womens Kaci II Oxford Black/Black Size 11.0,FBALYB Amazon,-2,-2,0,0,0,0
,Keen Womens Kaci II Oxford Black/Black Size 5.5,Keen Womens Kaci II Oxford Black/Black Size 5.5,FBALYB Amazon,5,5,0,0,0,0
,Keen Womens Kaci II Oxford Black/Black Size 7.0,Keen Womens Kaci II Oxford Black/Black Size 7.0,FBALYB Amazon,14,14,0,1,0,0
,Keen Womens Kaci II Oxford Black/Black Size 8.0,Keen Womens Kaci II Oxford Black/Black Size 8.0,FBALYB Amazon,-2,-2,0,0,0,0
,Keen Womens Kaci II Oxford Black/Black Size 8.5,Keen Womens Kaci II Oxford Black/Black Size 8.5,FBALYB Amazon,-2,-2,0,0,0,0
,Keen Womens Kaci II Oxford Black/Black Size 9.5,Keen Womens Kaci II Oxford Black/Black Size 9.5,FBALYB Amazon,-1,-1,0,0,0,0
,Kellogg's Original Rice Krispies Treats 60ct,Kellogg's Original Rice Krispies Treats 60ct,FBALYB Amazon,-10,-10,0,60,0,0
,Kellogg's Raisin Bran 56.6 oz.,"Kellogg's Raisin Bran Crunch, 56.6 oz.",FBALYB Amazon,2,2,0,0,0,0
,Kelo Cote 15g 2pack,Kelo Cote 15g 2pack,Default,0,-1,1,0,0,0
,Kelo Cote 15g 2pack,Kelo Cote 15g 2pack,FBALYB Amazon,312,260,52,11,52,0
,Kelo Cote Advanced Formula Scar Gel 60g,Kelo Cote Advanced Formula Scar Gel 60g,Default Ridgefield,20,20,0,0,0,0
,Kelo Cote Advanced Formula Scar Gel 60g,Kelo Cote Advanced Formula Scar Gel 60g,FBALYB Amazon,462,462,0,0,0,0
,Kelo Cote Gel for Scars 6g,Kelo Cote Gel for Scars 6g,FBALYB Amazon,0,0,0,3,0,0
,Kelo Cote Sinclair Gel for Scars 15g,Kelo Cote Sinclair Gel for Scars 15g,Default,0,-1500,1500,0,0,0
,Kelo Cote Sinclair Gel for Scars 15g,Kelo Cote Sinclair Gel for Scars 15g,Default Ridgefield,1,1,0,0,0,0
,Kelo Cote Sinclair Gel for Scars 15g,Kelo Cote Sinclair Gel for Scars 15g,FBALYB Amazon,0,-2,2,98,2,0
,Kent Marine Acrylic/Glass Cleaner/Polisher 8oz,Kent Marine Acrylic/Glass Cleaner/Polisher 8oz,Default,0,0,0,0,0,3
,Kent Marine Acrylic/Glass Cleaner/Polisher 8oz,Kent Marine Acrylic/Glass Cleaner/Polisher 8oz,FBALYB Amazon,4,4,0,0,0,0
,KERASTASE 120ML BLOND BOOSTER CICA VA21,KERASTASE 120ML BLOND BOOSTER CICA VA21,Default Ridgefield,18,18,0,0,0,0
,KERASTASE 120ML BLOND BOOSTER CICA VA21,KERASTASE 120ML BLOND BOOSTER CICA VA21,FBALYB Amazon,58,55,3,0,3,0
,KERASTASE BLOND MASQ ULTRAVIO 500ML VF62,KERASTASE BLOND MASQ ULTRAVIO 500ML VF62,FBALYB Amazon,-2,-2,0,1,0,0
,KERASTASE BOOSTER 120ML REFLECTION BRILLIANCE,KERASTASE BOOSTER 120ML REFLECTION BRILLIANCE,Default Ridgefield,209,209,0,0,0,0
,KERASTASE BOOSTER 120ML REFLECTION BRILLIANCE,KERASTASE BOOSTER 120ML REFLECTION BRILLIANCE,FBALYB Amazon,16,15,1,0,1,0
,KERASTASE CONCENTRE 12MLX10 REFLECTION,KERASTASE CONCENTRE 12MLX10 REFLECTION,FBALYB Amazon,46,42,4,0,4,0
,KERASTASE CONDITIONER 1000ML LAIT VITAL,KERASTASE CONDITIONER 1000ML LAIT VITAL,FBALYB Amazon,-3,-3,0,0,0,0
,KERASTASE CONDITIONER 200ML LAIT VITAL,KERASTASE CONDITIONER 200ML LAIT VITAL,Default Ridgefield,100,100,0,0,0,0
,KERASTASE CONDITIONER 200ML LAIT VITAL,KERASTASE CONDITIONER 200ML LAIT VITAL,FBALYB Amazon,-3,-3,0,0,0,0
,KERASTASE DISCIPLINE 120ML BOOSTER,KERASTASE DISCIPLINE 120ML BOOSTER,FBALYB Amazon,-1,-1,0,0,0,0
,KERASTASE FLUID 150ML FLUIDISSIME,KERASTASE FLUID 150ML FLUIDISSIME,FBALYB Amazon,322,306,16,3,16,0
,KERASTASE FONDANT 200ML RES CONDI EXTENTIO V434,KERASTASE FONDANT 200ML RES CONDI EXTENTIO V434,FBALYB Amazon,-8,-8,0,1,0,0
,KERASTASE FONDANT 250ML BLOND CICAFLASH 250ML VF4,KERASTASE FONDANT 250ML BLOND CICAFLASH 250ML VF4,Default,0,-72,72,0,0,0
,KERASTASE FONDANT 250ML BLOND CICAFLASH 250ML VF4,KERASTASE FONDANT 250ML BLOND CICAFLASH 250ML VF4,FBALYB Amazon,1,0,1,0,1,0
,KERASTASE MASK 200ML BLOND ULTRAVIO VF62,KERASTASE MASK 200ML BLOND ULTRAVIO VF62,Avrami - Ebay,12,12,0,0,0,0
,KERASTASE MASK 200ML BLOND ULTRAVIO VF62,KERASTASE MASK 200ML BLOND ULTRAVIO VF62,Default Ridgefield,5,5,0,0,0,0
,KERASTASE MASK 200ML BLOND ULTRAVIO VF62,KERASTASE MASK 200ML BLOND ULTRAVIO VF62,FBALYB Amazon,-6,-7,1,0,1,0
,KERASTASE MASK 200ML BLOND ULTRAVIO VF62,KERASTASE MASK 200ML BLOND ULTRAVIO VF62,WFS,-7,-7,0,0,0,0
,KERASTASE MASK 200ML DISCIPLINE,KERASTASE MASK 200ML DISCIPLINE,FBALYB Amazon,-2,-2,0,0,0,0
,KERASTASE MASK 200ML MASQUINTENSE THICK,KERASTASE MASK 200ML MASQUINTENSE THICK,Default Ridgefield,19,19,0,0,0,0
,KERASTASE MASK 200ML MASQUINTENSE THICK,KERASTASE MASK 200ML MASQUINTENSE THICK,FBALYB Amazon,-25,-25,0,5,0,0
,KERASTASE MASK 500ML INTENSE FINE HAIR,KERASTASE MASK 500ML INTENSE FINE HAIR,FBALYB Amazon,-1,-1,0,0,0,0
,KERASTASE NUTRITIVE 10X12ML CONCENTRE,KERASTASE NUTRITIVE 10X12ML CONCENTRE,Default Ridgefield,10,8,2,0,0,0
,KERASTASE NUTRITIVE 10X12ML CONCENTRE,KERASTASE NUTRITIVE 10X12ML CONCENTRE,FBALYB Amazon,1,0,1,0,1,0
,KERASTASE OIL 100ML ELIXIR ULTIMATE,KERASTASE OIL 100ML ELIXIR ULTIMATE,FBALYB Amazon,-13,-13,0,0,0,0
,KERASTASE OIL 100ML ELIXIR ULTIMATE,KERASTASE OIL 100ML ELIXIR ULTIMATE,WFS,-74,-74,0,0,0,0
,KERASTASE OIL 100ML ELIXIR ULTIMATE HUILE ROSE,KERASTASE OIL 100ML ELIXIR ULTIMATE HUILE ROSE,Default Ridgefield,-1,-1,0,0,0,0
,KERASTASE OIL 100ML ELIXIR ULTIMATE HUILE ROSE,KERASTASE OIL 100ML ELIXIR ULTIMATE HUILE ROSE,FBALYB Amazon,5,1,4,0,4,0
,KERASTASE REFLECTION FONDANT 200ML CHROMATIQUE,KERASTASE REFLECTION FONDANT 200ML CHROMATIQUE,Default Ridgefield,3,3,0,0,0,0
,KERASTASE REFLECTION FONDANT 200ML CHROMATIQUE,KERASTASE REFLECTION FONDANT 200ML CHROMATIQUE,FBALYB Amazon,-6,-6,0,0,0,0
,KERASTASE RESISTANCE 150ML CIMENT THERMIQUE,KERASTASE RESISTANCE 150ML CIMENT THERMIQUE,FBALYB Amazon,-2,-2,0,0,0,0
,KERASTASE RESISTANCE SERUM 120ML BOOSTER,KERASTASE RESISTANCE SERUM 120ML BOOSTER,FBALYB Amazon,2,2,0,0,0,0
,KERASTASE RESISTANCE SERUM 200ML SOIN,KERASTASE RESISTANCE SERUM 200ML SOIN,FBALYB Amazon,-1,-1,0,0,0,0
,KERASTASE SHAMPOO 1000ML CHRONOLOGISTE,KERASTASE SHAMPOO 1000ML CHRONOLOGISTE,FBALYB Amazon,-1,-1,0,0,0,0
,KERASTASE SHAMPOO 1000ML EXTENSIONISTE,KERASTASE SHAMPOO 1000ML EXTENSIONISTE,FBALYB Amazon,1,1,0,0,0,0
,KERASTASE SHAMPOO 1000ML FLUIDEALISTE SULFATE FREE,KERASTASE SHAMPOO 1000ML FLUIDEALISTE SULFATE FREE,FBALYB Amazon,-17,-17,0,16,0,0
,KERASTASE SHAMPOO 1000ML SATIN NO 1,KERASTASE SHAMPOO 1000ML SATIN NO 1,FBALYB Amazon,-2,-2,0,0,0,0
,KERASTASE SHAMPOO 250ML BAIN DENSITE HOMME,KERASTASE SHAMPOO 250ML BAIN DENSITE HOMME,FBALYB Amazon,-5,-5,0,0,0,0
,KERASTASE SHAMPOO 250ML BAIN SATIN 1,KERASTASE SHAMPOO 250ML BAIN SATIN 1,FBALYB Amazon,-5,-5,0,0,0,0
,KERASTASE SHAMPOO 250ML BLOND BAIN UVIOLET V235,KERASTASE SHAMPOO 250ML BLOND BAIN UVIOLET V235,Default,5,5,0,0,0,0
,KERASTASE SHAMPOO 250ML BLOND BAIN UVIOLET V235,KERASTASE SHAMPOO 250ML BLOND BAIN UVIOLET V235,FBALYB Amazon,-16,-16,0,0,0,0
,KERASTASE SHAMPOO 250ML CHROMATIQUE SULFATE FREE,KERASTASE SHAMPOO 250ML CHROMATIQUE SULFATE FREE,Default Ridgefield,79,79,0,0,0,0
,KERASTASE SHAMPOO 250ML CHROMATIQUE SULFATE FREE,KERASTASE SHAMPOO 250ML CHROMATIQUE SULFATE FREE,FBALYB Amazon,23,23,0,0,0,0
,KERASTASE SHAMPOO 250ML FLUIDEALISTE,KERASTASE SHAMPOO 250ML FLUIDEALISTE,Avrami - Ebay,24,24,0,0,0,0
,KERASTASE SHAMPOO 250ML FLUIDEALISTE,KERASTASE SHAMPOO 250ML FLUIDEALISTE,Default Ridgefield,10,10,0,0,0,0
,KERASTASE SHAMPOO 250ML FLUIDEALISTE,KERASTASE SHAMPOO 250ML FLUIDEALISTE,FBALYB Amazon,38,19,19,0,19,0
,KERASTASE SHAMPOO 250ML FLUIDEALISTE,KERASTASE SHAMPOO 250ML FLUIDEALISTE,WFS,-1,-1,0,0,0,0
,Keratin Blondeshell Complex Shampoo + Conditioner 13.5,Keratin Blondeshell Complex Shampoo + Conditioner 13.5,FBALYB Amazon,79,72,7,25,7,0
,Keratin Color care 13.5 Shampoo Conditioner Duo,Keratin Color care 13.5 Shampoo Conditioner Duo,FBALYB Amazon,-1917,-1917,0,20,0,0
,Keratin color care 33.8 oz Shampoo conditioner Duo,Keratin color care 33.8 oz Shampoo conditioner Duo,FBALYB Amazon,242,238,4,8,4,0
,Keratin Complex Blondeshell Conditioner 13.5 oz,,Default Ridgefield,292,292,0,0,0,0
,Keratin Complex Blondeshell Conditioner 13.5 oz,,FBALYB Amazon,-6,-6,0,0,0,0
,Keratin Complex Blondeshell Shampoo 13.5oz,,Default Ridgefield,245,245,0,0,0,0
,Keratin Complex Blondeshell Shampoo 13.5oz,,FBALYB Amazon,222,217,5,0,5,0
,Keratin Complex Color Care Conditioner 13.5oz,Keratin Complex Color Care Conditioner 13.5oz,FBALYB Amazon,4,4,0,0,0,0
,Keratin Complex Color Care Smoothing Conditioner 33.8oz,Keratin Complex Color Care Smoothing Conditioner 33.8oz,Default,0,-720,720,0,0,0
,Keratin Complex Color Care Smoothing Conditioner 33.8oz,Keratin Complex Color Care Smoothing Conditioner 33.8oz,FBALYB Amazon,-7,-7,0,20,0,0
,Keratin Complex Color Care Smoothing Shampoo 33.8oz,Keratin Complex Color Care Smoothing Shampoo 33.8oz,Default,0,-1140,1140,0,0,0
,Keratin Complex Color Care Smoothing Shampoo 33.8oz,Keratin Complex Color Care Smoothing Shampoo 33.8oz,Default Ridgefield,60,60,0,0,0,0
,Keratin Complex Color Care Smoothing Shampoo 33.8oz,Keratin Complex Color Care Smoothing Shampoo 33.8oz,FBALYB Amazon,15,15,0,17,0,0
,Keratin Complex Infusion Replenisher 2.5 oz,,Default Ridgefield,140,140,0,0,0,0
,Keratin Complex Infusion Therapy 4 Oz,,FBALYB Amazon,-10,-10,0,0,0,0
,Keratin Complex Smoothing Therapy Keratin Color Care Shampoo - 13.5 Oz,Keratin Complex Smoothing Therapy Keratin Color Care Shampoo - 13.5 Oz,Avrami - Ebay,24,24,0,0,0,0
,Keratin Complex Smoothing Therapy Keratin Color Care Shampoo - 13.5 Oz,Keratin Complex Smoothing Therapy Keratin Color Care Shampoo - 13.5 Oz,Default Ridgefield,21,21,0,0,0,0
,Keratin Complex Smoothing Therapy Keratin Color Care Shampoo - 13.5 Oz,Keratin Complex Smoothing Therapy Keratin Color Care Shampoo - 13.5 Oz,FBALYB Amazon,1900,1900,0,20,0,0
,Keratin Complex Timeless Color Fade Defy Conditioner 13.5 Oz,,Default Ridgefield,1261,1261,0,0,0,0
,Keratin Complex Timeless Color Fade Defy Conditioner 13.5 Oz,,FBALYB Amazon,3,3,0,21,0,0
,Keratin Complex Timeless Color Fade Defy Shampoo 13.5 oz,,Default Ridgefield,928,928,0,0,0,0
,Keratin Complex Timeless Color Fade Defy Shampoo and conditioner 33.8oz duo,Keratin Complex Timeless Color Fade Defy Shampoo and conditioner 33.8oz duo,FBALYB Amazon,242,242,0,15,0,0
,Keratin Infusion 4oz 2pk,Keratin Infusion 4oz 2pk,FBALYB Amazon,-4,-4,0,0,0,0
,Keratin Timeless Color Fade-Defy Shampoo + Conditioner 13.5,Keratin Timeless Color Fade-Defy Shampoo + Conditioner 13.5,FBALYB Amazon,27,26,1,0,1,0
,Keri Lotion 946ML/32 OZ,Keri Lotion 946ML/32 OZ,Default,0,-1501,1501,0,0,0
,Keri Lotion 946ML/32 OZ,Keri Lotion 946ML/32 OZ,FBALYB Amazon,2,2,0,0,0,0
,Keri Original Intense Lotion 2pk,Keri Original Intense Lotion 2pk,FBALYB Amazon,18,18,0,8,0,0
,KEURIG K.Elite single serve coffee maker,KEURIG K.Elite single serve coffee maker,FBASKCK Amazon,100,100,0,0,0,0
,"Keurig K-Mini Basic Single-Serve Coffee Maker, Matte Black","Keurig K-Mini Basic Single-Serve Coffee Maker, Matte Black",FBASKCK Amazon,398,398,0,1,0,0
,Keurig Supreme Plus,Keurig Supreme Plus,Avrami - Ebay,218,218,0,0,0,0
,Keurig Supreme Plus,Keurig Supreme Plus,Default Ridgefield,0,-1,1,0,0,0
,Keurig Supreme Plus,Keurig Supreme Plus,FBALYB Amazon,3,3,0,5,0,0
,Keurig Supreme Plus,Keurig Supreme Plus,WFS,-221,-221,0,0,0,0
,KeviM PlumpingShampoo n Conditioner 33oz,KeviM PlumpingShampoo n Conditioner 33oz,FBALYB Amazon,-2,-2,0,1,0,0
,Kevin Murphy Angel Rinse 1000ml,Kevin Murphy Angel Rinse 1000ml,Avrami - Ebay,6,6,0,0,0,0
,Kevin Murphy Angel Rinse 1000ml,Kevin Murphy Angel Rinse 1000ml,FBALYB Amazon,1,1,0,1,0,0
,Kevin Murphy Angel Rinse 250ml,Kevin Murphy Angel Rinse 250ml,Avrami - Ebay,3,3,0,0,0,0
,Kevin Murphy Angel Rinse 250ml,Kevin Murphy Angel Rinse 250ml,Default Ridgefield,36,36,0,0,0,0
,Kevin Murphy Angel Rinse 250ml,Kevin Murphy Angel Rinse 250ml,FBALYB Amazon,-4,-4,0,0,0,0
,Kevin Murphy Angel Rinse 250ml+Kevin Murphy Angel Wash 250ml,Kevin Murphy Angel Rinse 250ml+Kevin Murphy Angel Wash 250ml,FBALYB Amazon,24,19,5,0,5,0
,"Kevin Murphy Angel Rinse for Fine Coloured Hair, 8.4 Ounce","Kevin Murphy Angel Rinse for Fine Coloured Hair, 8.4 Ounce",Default,0,-62,62,0,0,0
,Kevin Murphy Angel Wash 1000ml,Kevin Murphy Angel Wash 1000ml,Avrami - Ebay,1,1,0,0,0,0
,Kevin Murphy Angel Wash 1000ml,Kevin Murphy Angel Wash 1000ml,FBALYB Amazon,1,1,0,0,0,0
,Kevin Murphy Angel Wash 250ml,Kevin Murphy Angel Wash 250ml,Default Ridgefield,36,36,0,0,0,0
,Kevin Murphy Angel Wash 250ml,Kevin Murphy Angel Wash 250ml,WFS,-19,-19,0,0,0,0
,"Kevin Murphy Angel Wash, 8.4 Ounce","Kevin Murphy Angel Wash, 8.4 Ounce",Default,0,-62,62,0,0,2
,Kevin Murphy Angel Wash and Rinse- Duo Set,Kevin Murphy Angel Wash and Rinse- Duo Set,FBALYB Amazon,-2,-2,0,0,0,0
,"Kevin Murphy Anti Gravity Oil Free Volumiser, 5.1 Ounce","Kevin Murphy Anti Gravity Oil Free Volumiser, 5.1 Ounce",Avrami - Ebay,54,54,0,0,0,0
,"Kevin Murphy Anti Gravity Oil Free Volumiser, 5.1 Ounce","Kevin Murphy Anti Gravity Oil Free Volumiser, 5.1 Ounce",Default,0,0,0,0,0,1
,"Kevin Murphy Anti Gravity Oil Free Volumiser, 5.1 Ounce","Kevin Murphy Anti Gravity Oil Free Volumiser, 5.1 Ounce",FBALYB Amazon,-1,-1,0,0,0,0
,"Kevin Murphy Anti Gravity Oil Free Volumiser, 5.1 Ounce","Kevin Murphy Anti Gravity Oil Free Volumiser, 5.1 Ounce",WFS,-15,-15,0,0,0,0
,Kevin Murphy Bedroom Hair Flexible Texturising Hairspray 7.9oz,Kevin Murphy Bedroom Hair Flexible Texturising Hairspray 7.9oz,Default,0,0,0,0,0,2
,Kevin Murphy Blonde Angel Treatment 250ml,Kevin Murphy Blonde Angel Treatment 250ml,Avrami - Ebay,3,3,0,0,0,0
,Kevin Murphy Blonde Angel Wash 250ml,Kevin Murphy Blonde Angel Wash 250ml,FBALYB Amazon,1,1,0,0,0,0
,Kevin Murphy Blonde Angel Wash 8oz,Kevin Murphy Blonde Angel Wash 8oz,FBALYB Amazon,-1,-1,0,0,0,0
,Kevin Murphy BODY MASS 100 ML/ 3.4 OZ,Kevin Murphy BODY MASS 100 ML/ 3.4 OZ,FBALYB Amazon,1,1,0,0,0,0
,Kevin Murphy Doo Over Dry Powder Spray 8.5 FL Oz,Kevin Murphy Doo Over Dry Powder Spray 8.5 FL Oz,Default,0,0,0,0,0,24
,Kevin Murphy Doo Over Dry Powder Spray 8.5 FL Oz,Kevin Murphy Doo Over Dry Powder Spray 8.5 FL Oz,FBALYB Amazon,2,2,0,0,0,0
,Kevin Murphy Easy Rider 3.4,Kevin Murphy Easy Rider 3.4,FBALYB Amazon,31,23,8,0,8,0
,Kevin Murphy Easy Rider 3.4 2pack,Kevin Murphy Easy Rider 3.4 2pack,FBALYB Amazon,50,50,0,0,0,0
,Kevin Murphy FREE HOLD 100G/3.4 OZ,Kevin Murphy FREE HOLD 100G/3.4 OZ,Default Ridgefield,2,2,0,0,0,0
,Kevin Murphy FREE HOLD 100G/3.4 OZ,Kevin Murphy FREE HOLD 100G/3.4 OZ,FBALYB Amazon,48,29,19,2,19,0
,Kevin Murphy Hydrate Me Rinse 8.4 oz,Kevin Murphy Hydrate Me Rinse 8.4 oz ,Avrami - Ebay,3,3,0,0,0,0
,Kevin Murphy Hydrate Me Rinse 8.4 oz,Kevin Murphy Hydrate Me Rinse 8.4 oz ,Default,0,-63,63,0,0,0
,Kevin Murphy Hydrate Me Rinse 8.4 oz,Kevin Murphy Hydrate Me Rinse 8.4 oz ,Default Ridgefield,2,2,0,0,0,0
,Kevin Murphy Hydrate Me Wash 8.4 oz,Kevin Murphy Hydrate Me Wash 8.4 oz,Default,0,-63,63,0,0,0
,Kevin Murphy Hydrate Me Wash 8.4 oz,Kevin Murphy Hydrate Me Wash 8.4 oz,Default Ridgefield,2,2,0,0,0,0
,Kevin Murphy Hydrate Me Wash 8.4 oz,Kevin Murphy Hydrate Me Wash 8.4 oz,FBALYB Amazon,168,164,4,0,4,0
,Kevin Murphy  Hydrate me Wash & Rinse Duo Set,Kevin Murphy  Hydrate me Wash & Rinse Duo Set,FBALYB Amazon,38,28,10,18,10,0
,"Kevin Murphy - Kevin Murphy Young Again, 3.4 Ounce","Kevin Murphy - Kevin Murphy Young Again, 3.4 Ounce",FBALYB Amazon,-5,-5,0,18,0,0
,KEVIN MURPHY- KILLER CURLS 200ML/6.7 OZ,KEVIN MURPHY- KILLER CURLS 200ML/6.7 OZ,Default,0,0,0,0,0,4
,KEVIN MURPHY- KILLER CURLS 200ML/6.7 OZ,KEVIN MURPHY- KILLER CURLS 200ML/6.7 OZ,FBALYB Amazon,-4,-6,2,2,2,0
,Kevin Murphy Maxi Wash 8.4oz,Kevin Murphy Maxi Wash 8.4oz,FBALYB Amazon,-2,-2,0,1,0,0
,Kevin Murphy NIGHT RIDER 100G/3.4 OZ,Kevin Murphy NIGHT RIDER 100G/3.4 OZ,FBALYB Amazon,-5,-5,0,0,0,0
,Kevin Murphy Plumping Rinse 1000ml,Kevin Murphy Plumping Rinse 1000ml,WFS,-1,-1,0,0,0,0
,Kevin Murphy Plumping Rinse Conditioner 250ml/8.4oz,Kevin Murphy Plumping Rinse Conditioner 250ml/8.4oz,Avrami - Ebay,4,4,0,0,0,0
,Kevin Murphy Plumping Rinse Conditioner 250ml/8.4oz,Kevin Murphy Plumping Rinse Conditioner 250ml/8.4oz,Default Ridgefield,12,12,0,0,0,0
,Kevin Murphy Plumping Rinse Conditioner 250ml/8.4oz,Kevin Murphy Plumping Rinse Conditioner 250ml/8.4oz,FBALYB Amazon,1,1,0,0,0,0
,Kevin Murphy Plumping Wash 1000ml,Kevin Murphy Plumping Wash 1000ml,Avrami - Ebay,6,6,0,0,0,0
,Kevin Murphy Plumping Wash 1000ml,Kevin Murphy Plumping Wash 1000ml,Default Ridgefield,12,12,0,0,0,0
,"Kevin Murphy Plumping. Wash, 8.4 oz","Kevin Murphy Plumping. Wash, 8.4 oz",Default,0,0,0,0,0,6
,"Kevin Murphy Plumping. Wash, 8.4 oz+Kevin Murphy Plumping Rinse Conditioner 250ml/8.4oz","Kevin Murphy Plumping. Wash, 8.4 oz+Kevin Murphy Plumping Rinse Conditioner 250ml/8.4oz",FBALYB Amazon,40,39,1,0,1,0
,Kevin Murphy Repair Me Rinse,Kevin Murphy Repair Me Rinse,Default,0,0,0,0,0,1
,Kevin Murphy Repair Me Rinse,Kevin Murphy Repair Me Rinse,Default Ridgefield,4,4,0,0,0,0
,Kevin Murphy Repair Me Rinse,Kevin Murphy Repair Me Rinse,FBALYB Amazon,9,9,0,0,0,0
,Kevin Murphy Repair Me Wash 250ml,Kevin Murphy Repair Me Wash 250ml,Default Ridgefield,3,3,0,0,0,0
,Kevin Murphy Repair Me Wash 250ml+Kevin Murphy Repair Me Rinse,Kevin Murphy Repair Me Wash 250ml+Kevin Murphy Repair Me Rinse,FBALYB Amazon,75,72,3,0,3,0
,Kevin MurphyRepair Me Wash n Rinse Duo,Kevin MurphyRepair Me Wash n Rinse Duo,FBALYB Amazon,-2,-2,0,2,0,0
,KEVIN MURPHY- ROUGH RIDER 100G/3.4 OZ,KEVIN MURPHY- ROUGH RIDER 100G/3.4 OZ,FBALYB Amazon,-1,-2,1,2,1,0
,Kevin Murphy Session Spray 400ml,Kevin Murphy Session Spray 400ml,FBALYB Amazon,7,7,0,0,0,0
,"Kevin Murphy Smooth Again, 6.7","Kevin Murphy Smooth Again, 6.7",Default Ridgefield,3,3,0,0,0,0
,"Kevin Murphy Smooth Again, 6.7","Kevin Murphy Smooth Again, 6.7",FBALYB Amazon,534,520,14,4,14,0
,Kevin Murphy Smooth Again 8.4oz Smoothing Conditioner,Kevin Murphy Smooth Again 8.4oz Smoothing Conditioner,Default,0,0,0,0,0,4
,Kevin Murphy Smooth Again 8.4oz Smoothing Conditioner,Kevin Murphy Smooth Again 8.4oz Smoothing Conditioner,FBALYB Amazon,1,1,0,0,0,0
,"Kevin Murphy Smooth Again Wash, 8.4 Ounce","Kevin Murphy Smooth Again Wash, 8.4 Ounce",Default,0,0,0,0,0,4
,"Kevin Murphy Smooth Again Wash, 8.4 Ounce","Kevin Murphy Smooth Again Wash, 8.4 Ounce",FBALYB Amazon,-2,-2,0,0,0,0
,Kevin Murphy Smooth Again Wash and Rinse Duo Set,Kevin Murphy Smooth Again Wash and Rinse Duo Set,FBALYB Amazon,-5,-5,0,0,0,0
,Kevin Murphy Styling Motion Lotion 150ml,Kevin Murphy Styling Motion Lotion 150ml,FBALYB Amazon,-1,-1,0,0,0,0
,Kevin Murphy Un Dressed 100g,Kevin Murphy Un Dressed 100g,FBALYB Amazon,-1,-1,0,0,0,0
,Kevin Murphy UN Tangled 150ml,,FBALYB Amazon,-2,-2,0,0,0,0
,Kevin Murphy Young Again Rinse 250ml,Kevin Murphy Young Again Rinse 250ml,Avrami - Ebay,4,4,0,0,0,0
,Kevin Murphy Young Again Wash 1000ml,Kevin Murphy Young Again Wash 1000ml,Avrami - Ebay,6,6,0,0,0,0
,Kevin Murphy Young Again Wash 8.4oz,Kevin Murphy Young Again Wash 8.4oz,Default,0,0,0,0,0,16
,Kevin Murphy Young Again Wash 8.4oz,Kevin Murphy Young Again Wash 8.4oz,FBALYB Amazon,103,103,0,0,0,0
,Khombu Boot Brown Size 9,Khombu Boot Brown Size 9,Default,5,4,1,0,0,0
,Khombu Boot Brown Size 9,Khombu Boot Brown Size 9,FBALYB Amazon,-12,-12,0,0,0,0
,KHOMBU Women's All-Weather Lindsey Suede Boots Size 10/Black,KHOMBU Women's All-Weather Lindsey Suede Boots Size 10/Black,Default Ridgefield,1,1,0,0,0,0
,KHOMBU Women's All-Weather Lindsey Suede Boots Size 10/Brown,KHOMBU Women's All-Weather Lindsey Suede Boots Size 10/Brown,Default Ridgefield,6,6,0,0,0,0
,KHOMBU Women's All-Weather Lindsey Suede Boots Size 6 /Black,KHOMBU Women's All-Weather Lindsey Suede Boots Size 6 /Black,Default Ridgefield,1,1,0,0,0,0
,KHOMBU Women's All-Weather Lindsey Suede Boots Size 7/Black,KHOMBU Women's All-Weather Lindsey Suede Boots Size 7/Black,Default Ridgefield,1,1,0,0,0,0
,KHOMBU Women's All-Weather Lindsey Suede Boots Size 8/Brown,KHOMBU Women's All-Weather Lindsey Suede Boots Size 8/Brown,FBALYB Amazon,31,31,0,0,0,0
,KHOMBU Women's All-Weather Lindsey Suede Boots Size 9/Black,KHOMBU Women's All-Weather Lindsey Suede Boots Size 9/Black,Default Ridgefield,23,23,0,0,0,0
,KHOMBU Women's Side zip closure All-Weather Lindsey Suede Boots Size 8/Black,KHOMBU Women's Side zip closure All-Weather Lindsey Suede Boots Size 8/Black,Default Ridgefield,8,8,0,0,0,0
,Kidde 21006677 CO and Gas Alarm,Kidde 21006677 Carbon Monoxide and Gas Alarm,Default,0,-1628,1628,0,0,0
,Kidde 21006677 CO and Gas Alarm,Kidde 21006677 Carbon Monoxide and Gas Alarm,Default CT,0,-1,1,0,0,0
,Kidde 21006677 CO and Gas Alarm,Kidde 21006677 Carbon Monoxide and Gas Alarm,Default Ridgefield,1816,1814,2,0,1,0
,Kidde 21006677 CO and Gas Alarm,Kidde 21006677 Carbon Monoxide and Gas Alarm,FBALYB Amazon,3294,3061,233,727,233,0
,Kidde 21006677 CO and Gas Alarm,Kidde 21006677 Carbon Monoxide and Gas Alarm,FBALYB Canada,0,-12,12,102,12,0
,Kidde 21006677 CO and Gas Alarm,Kidde 21006677 Carbon Monoxide and Gas Alarm,WFS,451,451,0,0,0,0
,Kidde 21006677 CO and Gas Alarm 2pk,Kidde 21006677 CO and Gas Alarm 2pk,FBALYB Amazon,621,617,4,14,4,0
,Kidde 21006677 CO and Gas Alarm 3pk,Kidde 21006677 CO and Gas Alarm 3pk,FBALYB Amazon,-218,-218,0,220,0,0
,Kidde Combo Smoke Carbon Monoxide Alarm,Kidde Combo Smoke Carbon Monoxide Alarm,Default Ridgefield,55,55,0,0,0,0
,Kidde Combo Smoke Carbon Monoxide Alarm,Kidde Combo Smoke Carbon Monoxide Alarm,FBALYB Amazon,-170,-170,0,24,0,0
,Kidde Combo Smoke Carbon Monoxide Alarm,Kidde Combo Smoke Carbon Monoxide Alarm,WFS,-6,-6,0,0,0,0
,Kidde Copp3 2pk,Kidde Copp3 2pk,FBALYB Amazon,-330,-332,2,346,2,0
,Kidde copp3 4pk,Kidde copp3 4pk,FBALYB Amazon,-9,-11,2,1,2,0
,Kidde Copp 3 Alarm,Kidde Copp 3 Alarm,FBALYB Amazon,-62,-62,0,10,0,0
,"Kikkoman Less Sodium Soy Sauce, 40 oz.","Kikkoman Less Sodium Soy Sauce, 40 oz.",FBALYB Amazon,38,38,0,0,0,0
,Kimberly Clark Kleen Guard Automotive Painting Coverall  Size XL,Kimberly Clark Kleen Guard Automotive Painting Coverall  Size XL,Default Ridgefield,10,10,0,0,0,0
,Kimberly Clark White Shoe Cover EXTRA Traction Universal Size 100 count,Kimberly Clark White Shoe Cover EXTRA Traction Universal Size 100 count,Default Ridgefield,4,4,0,0,0,0
,Kinder Bueno 20pk Chocolate,Kinder Bueno 20pk Chocolate,Default Oxford,6,6,0,0,0,0
,Kinder Bueno 20pk Chocolate,Kinder Bueno 20pk Chocolate,FBALYB Amazon,82,82,0,1,0,0
,Kinder Surprise 20g 24ct,Kinder Surprise 20g 24ct,Default,0,0,0,0,0,100
,Kinex Play Toy Cyborg,Kinex Play Toy Cyborg,FBALYB Amazon,0,0,0,1,0,0
,Kirkland 60ct Flushable Wipes 3Pack,Kirkland 60ct Flushable Wipes 3Pack,FBALYB Amazon,-6,-6,0,3,0,0
,Kirkland Acetaminophen 500 MG,Kirkland Signature Extra Strength Rapid Release Pain Reliever Acetaminophen 500 MG 400 rapid release gelcaps,FBALYB Amazon,-1,-1,0,0,0,0
,Kirkland Acetaminophen PM 375 ct,Kirkland Acetaminophen PM 375 ct,Default,0,0,0,0,0,29
,Kirkland Adult Multi 320 ct,Kirkland Signature Adult Multi Gummies - 320 ct - 2 pk,FBALYB Amazon,204,204,0,0,0,0
,Kirkland AllerClear 365 Tablets,"Kirkland Signature Non Drowsy Allerclear Loratadine Tablets, Antihistamine, 10mg, 365-Count",FBALYB Amazon,-1,-1,0,0,0,0
,Kirkland Aller-Flo 5 Count,Kirkland Aller-Flo Fluticasone Propionate 5 bottles x 120 Metered Sprays .54 Fl OZ per bottle ,FBALYB Amazon,-5,-5,0,0,0,0
,"Kirkland Aller-Tec, 365 Tablets","Kirkland Signature Aller-Tec Cetirizine Hydrochloride Tablets, 10 mg, 365 Count",FBALYB Amazon,-1,-1,0,1,0,0
,Kirkland B12 300 tablets,Kirkland B12 300 tablets,FBALYB Amazon,-1,-1,0,4,0,0
,Kirkland Baby Wipes 100ct,Kirkland Baby Wipes 100ct,Default,0,-756,756,0,0,0
,Kirkland Baby Wipes 100ct,Kirkland Baby Wipes 100ct,FBALYB Amazon,-4,-4,0,0,0,0
,Kirkland Baby Wipes 100ct 3pk,Kirkland Baby Wipes 100ct 3pk,FBALYB Amazon,-10,-11,1,14,1,0
,Kirkland Baby Wipes 100ct 4pk,Kirkland Baby Wipes 100ct 4pk,FBALYB Amazon,-4,-4,0,1,0,0
,Kirkland Baby Wipes 100ct 6pk,Kirkland Baby Wipes 100ct 6pk,FBALYB Amazon,7,7,0,2,0,0
,Kirkland Calcium 240Ct,Kirkland Signature Calcium Gummy ‑ 240 Count (2 bottles of 120),Default,0,0,0,0,0,14
,Kirkland Chewable Vitamin C,Kirkland Signature Chewable Vitamin C 500MG 500 Count,Default,0,0,0,0,0,36
,Kirkland Chewable Vitamin C,Kirkland Signature Chewable Vitamin C 500MG 500 Count,FBALYB Amazon,-1,-1,0,0,0,0
,Kirkland Chewable Vitamin C 2pk,Kirkland Chewable Vitamin C 2pk,FBALYB Amazon,-13,-13,0,21,0,0
,Kirkland Chicken Broth 6 ct,Kirkland Chicken Broth 6 ct,FBALYB Amazon,1128,1128,0,1,0,0
,Kirkland Chicken Can 6 Count,Kirkland Chicken Can 6 Count,Default,0,-31,31,0,0,0
,Kirkland Chicken Can 6 Count,Kirkland Chicken Can 6 Count,Default Ridgefield,480,480,0,0,0,0
,Kirkland Chicken Can 6 Count,Kirkland Chicken Can 6 Count,FBALYB Amazon,8,6,2,394,2,0
,Kirkland Chicken Can 6 Count 2 pk,Kirkland Chicken Can 6 Count 2 pk,FBALYB Amazon,8,7,1,14,1,0
,Kirkland Childrens multi 1pk,Kirkland Childrens multi 320 1pk,Default,0,0,0,0,0,20
,Kirkland Childrens Multi 320,Kirkland Childrens Multivitamin Gummies 320 ct 2pk,Default,0,0,0,0,0,2
,Kirkland Childrens Multi 320,Kirkland Childrens Multivitamin Gummies 320 ct 2pk,FBALYB Amazon,300,300,0,0,0,0
,"Kirkland Children's Multi-vitamin Gummies, 250 ct","Kirkland Children's Multi-vitamin Gummies, 250 ct",FBALYB Amazon,115,115,0,0,0,0
,Kirkland Crepes Biscuits w Belgian Chocolate,Kirkland Crepes Biscuits w Belgian Chocolate,FBALYB Amazon,1,1,0,3,0,0
,Kirkland Daily facial towelettes 30 count 7.4 inches x 7.75 inches,Kirkland Daily facial towelettes 30 count 7.4 inches x 7.75 inches,Default Ridgefield,1,1,0,0,0,0
,Kirkland Daily Multi Vitamins 500,Kirkland Daily Multi Vitamins 500,FBALYB Amazon,110,110,0,1,0,0
,Kirkland Daily Multi Vitamins 500 2pk,Kirkland Daily Multi Vitamins 500 2pk,FBALYB Amazon,16,16,0,0,0,0
,Kirkland EVOO Olive Oil 2L,Kirkland EVOO Olive Oil 2L,Default Ridgefield,5,5,0,0,0,0
,Kirkland EVOO Olive Oil 2L,Kirkland EVOO Olive Oil 2L,FBALYB Amazon,85,78,7,0,7,0
,Kirkland EVOO Olive Oil 2L 2pk,Kirkland EVOO Olive Oil 2L 2pk,FBALYB Amazon,110,109,1,0,1,0
,Kirkland Facial Wipes,Kirkland Facial Wipes,Default Ridgefield,3,3,0,0,0,0
,Kirkland Facial Wipes,Kirkland Facial Wipes,FBALYB Amazon,-44,-46,2,95,2,0
,"Kirkland Fish Oil, 1000mg (2 Pack)","Kirkland Fish Oil, 1000mg (2 Pack)",FBALYB Amazon,-9,-9,0,1,0,0
,"Kirkland Fish Oil, 400 Softgels","Kirkland Signature Fish Oil 1000 mg., 400 Softgels",Default,0,0,0,0,0,2
,"Kirkland Fish Oil, 400 Softgels","Kirkland Signature Fish Oil 1000 mg., 400 Softgels",FBALYB Amazon,-2,-2,0,0,0,0
,Kirkland Flushable Wipes,Kirkland Flushable Wipes,FBALYB Amazon,-1,-1,0,2,0,0
,Kirkland Flushable Wipes 600+ ct case,Kirkland Flushable Wipes 600+ ct case,Default Ridgefield,0,-1500,1500,0,0,0
,Kirkland Flushable Wipes 600+ ct case,Kirkland Flushable Wipes 600+ ct case,FBALYB Amazon,-109,-125,16,163,16,0
,Kirkland Garbage Bag Ontario,Kirkland Garbage Bag Ontario,Default Ridgefield,345,345,0,0,0,0
,Kirkland Garbage Bag Ontario,Kirkland Garbage Bag Ontario,FBALYB Amazon,6,6,0,3,0,0
,Kirkland Glucosamine,Kirkland Signature Glucosamine 1500 Chondroitin 1200 220CT,FBALYB Amazon,9,0,9,0,9,0
,Kirkland Glucosamine 375 ct 2pk,Kirkland Glucosamine 375 ct 2pk,FBALYB Amazon,-1,-1,0,1,0,0
,Kirkland Moist Flushable Wipes 60ct,Kirkland Moist Flushable Wipes 60ct,Default Ridgefield,1340,1340,0,0,0,0
,Kirkland Moist Flushable Wipes 60ct 3 pack,Kirkland Moist Flushable Wipes 60ct 3 pack,FBALYB Amazon,2,0,2,0,2,0
,Kirkland Naproxen Sodium 400ct,Kirkland Naproxen Sodium 400ct,Default,0,0,0,0,0,1
,Kirkland Naproxen Sodium 400ct,Kirkland Naproxen Sodium 400ct,FBALYB Amazon,1,1,0,0,0,0
,Kirkland Nut Bars 30/1.4,Kirkland Nut Bars 30/1.4,FBALYB Amazon,9,9,0,0,0,0
,"Kirkland OPTIFIBER, 25.6 Ounces","Kirkland Signature OPTIFIBER, 25.6 Ounces",FBALYB Amazon,20,20,0,0,0,0
,"Kirkland OPTIFIBER, 25.6 Ounces, 3 Pack","Kirkland OPTIFIBER, 25.6 Ounces, 3 Pack",FBALYB Amazon,-2,-2,0,0,0,0
,Kirkland Pacific Bold K Cups,Kirkland Pacific Bold K Cups,Default,0,-1,1,0,0,0
,Kirkland Pacific Bold K Cups,Kirkland Pacific Bold K Cups,Default Ridgefield,238,222,16,0,16,0
,Kirkland Pacific Bold K Cups,Kirkland Pacific Bold K Cups,FBALYB Amazon,283,280,3,593,3,0
,"Kirkland Signature Adults 50+ Mature Multi, 400 Tablets","Kirkland Signature Adults 50+ Mature Multi, 400 Tablets",FBALYB Amazon,2,2,0,0,0,0
,Kirkland Signature Calcium 500 tab 2pk,"Kirkland Signature Calcium 600 mg. + D3, 500 Tablets 2pk",FBALYB Amazon,-24,-25,1,30,1,0
,Kirkland Signature Jelly Beans 4lb,"Kirkland Signature Jelly Belly Gourmet Beans, 49 Flavors ‑ 4lb",Default,0,0,0,0,0,2
,Kirkland Signature Jelly Beans 4lb 2pk,Kirkland Signature Jelly Beans 4lb 2pk,Default,-6,-6,0,0,0,0
,"Kirkland Signature Krill Oil, 160 ct","Kirkland Signature Krill Oil, 500 mg, Softgels ‑ 160 count",FBALYB Amazon,0,0,0,1,0,0
,Kirkland Signature  T Shirt White Medium,Kirkland Signature Men's 100% Pima Cotton 4-Pack V-Neck T-Shirts Medium White,FBALYB Amazon,3,3,0,0,0,0
,Kirkland Soft & Chewy 64 Bars,Kirkland Soft & Chewy 64 Bars,FBALYB Amazon,3,3,0,6,0,0
,Kirkland Super B Complex 500,Kirkland Super B Complex 500,Default,0,0,0,0,0,1
,Kirkland Super B Complex 500,Kirkland Super B Complex 500,FBALYB Amazon,0,-5,5,0,5,0
,Kirkland Triple Action Joint Health 110ct,Kirkland Triple Action Joint Health 110ct,Default,0,0,0,0,0,5
,Kirkland Triple Action Joint Health 110ct,Kirkland Triple Action Joint Health 110ct,FBALYB Amazon,-1,-1,0,0,0,0
,Kirkland Vitamin C 1000mg 500ct,Kirkland Vitamin C 1000mg 500ct,Default,0,0,0,0,0,43
,Kirkland Vitamin C Gummies,Kirkland Signature Vitamin C Adult Gummies ‑ 320ct,Default,0,0,0,0,0,2
,Kirkland Vitamin C Gummies,Kirkland Signature Vitamin C Adult Gummies ‑ 320ct,FBALYB Amazon,74,74,0,55,0,0
,Kirkland Vitamin E 2 Pack,Kirkland Vitamin E 2 Pack,FBALYB Amazon,1,1,0,0,0,0
,Kirkland Vitamin E 500 Count,"Kirkland Signature Vitamin E 400 I.U. 500 Softgels, Bottle",FBALYB Amazon,-5,-5,0,1,0,0
,Kirklland Vitamin C Adult Gummies 4Pack,Kirklland Vitamin C Adult Gummies 4Pack,FBALYB Amazon,-1,-1,0,0,0,0
,Kirk's Castile 3-in-1 Fresh 32oz 2PK,Kirk's Castile 3-in-1 Fresh 32oz 2PK,FBALYB Amazon,109,108,1,0,1,0
,Kirk’s Castile Bar Soap 3pk( 16 pack 48 total),Kirk’s Castile Bar Soap 3pk( 16 pack 48 total),FBALYB Amazon,20,12,8,0,8,0
,Kirk’s Castile Bar Soap 3pk( 8 pack 24 total),Kirk’s Castile Bar Soap 3pk( 8 pack 24 total),FBALYB Amazon,163,155,8,0,8,0
,Kirk's Hand Soap Eucalyptus 12oz 4 pack,Kirk's Hand Soap Eucalyptus 12oz 4 pack,FBALYB Amazon,166,161,5,0,5,0
,Kirks Rosemar & Sge Hnd Wsh 12oz 4 pack,Kirks Rosemar & Sge Hnd Wsh 12oz 4 pack,FBALYB Amazon,45,43,2,0,2,0
,Kitten Dry Cat Food 5lb,Chicken Soup for The Soul Kitten Dry Cat Food 5lb,FBALYB Amazon,78,78,0,0,0,0
,Kiwi Express Shine Sponge Black 3pk,Kiwi Express Shine Sponge Black 3pk,FBALYB Amazon,52,52,0,0,0,0
,Kiwi Express Shine Sponge Neutral 3pk,Kiwi Express Shine Sponge Neutral 3pk,FBALYB Amazon,135,135,0,20,0,0
,KIWI Shine & Protect Shoe Polish Black 75 ml,KIWI Shine & Protect Shoe Polish Black 75 ml,Default CT,180,180,0,0,0,0
,KIWI Shine & Protect Shoe Polish Black 75 ml,KIWI Shine & Protect Shoe Polish Black 75 ml,Default Ridgefield,40,40,0,0,0,0
,KIWI Shine & Protect Shoe Polish Black 75 ml 3pk,KIWI Shine & Protect Shoe Polish Black 75 ml 3pk,Default,0,-150,150,0,0,0
,KIWI Shine & Protect Shoe Polish Black 75 ml 3pk,KIWI Shine & Protect Shoe Polish Black 75 ml 3pk,FBALYB Amazon,3,3,0,2,0,0
,Kneadable eraser grey w/plastic box 18x,Kneadable eraser grey w/plastic box 18x,Default,0,0,0,0,0,21060
,Kneadable eraser grey w/plastic box 18x,Kneadable eraser grey w/plastic box 18x,Default Ridgefield,540,540,0,0,0,0
,Kodak - Ektra 32GB Black,Kodak - Ektra 4G LTE with 32GB Memory Cell Phone (Unlocked) - Black,FBALYB Amazon,-7,-7,0,0,0,0
,Kodiak Cakes Waffle Flapjack 4.5 lb,Kodiak Cakes Waffle Flapjack 4.5 lb,FBALYB Amazon,602,600,2,7,2,0
,KONG AirDog Bone Dog Toy Large,KONG AirDog Bone Dog Toy Large,FBALYB Amazon,-1,-1,0,0,0,0
,Kong Bacon and Cheese Snacks 11 Oz,Kong Bacon and Cheese Snacks 11 Oz,FBALYB Amazon,-11,-11,0,11,0,0
,Kong Bacon and Cheese Snacks 11 Oz 2pk,Kong Bacon and Cheese Snacks 11 Oz 2pk,FBALYB Amazon,1,1,0,0,0,0
,Kong Company Wubba for Cats,"Kong Company Wubba for Cats, Original ‑ Wc51",FBALYB Amazon,-1,-1,0,1,0,0
,Kong Cozies Dog Squeaky Toy Marvin The Moose XL,Kong Cozies Dog Squeaky Toy Marvin The Moose XL,FBALYB Amazon,-3,-3,0,0,0,0
,KONG Dog toy Medium 12pk,KONG Dog toy Medium 12pk ,FBALYB Amazon,-4,-4,0,0,0,0
,KONG Dog toy Medium 6pk,KONG AirDog Squeakair Ball Dog toy ‑ Medium: 6‑Pack,Default Ridgefield,9,9,0,0,0,0
,Kong Goodie Bone Large,"Kong Goodie Bone, Treat Dispensing Dog Toy Size: Large",FBALYB Amazon,-6,-6,0,0,0,0
,Kong Goodie Bone Large Red,Kong Company Goodie Bone Large Red 269491,FBALYB Amazon,-3,-3,0,0,0,0
,"KONG Jumbler Ball Toy, Large/X-Large","KONG Jumbler Ball Toy, Large/X-Large (colors may vary)",FBALYB Amazon,5,5,0,0,0,0
,"KONG Wubba Classic Dog Toy, X‑Large","KONG Wubba Classic Dog Toy, X‑Large",FBALYB Amazon,-1,-1,0,0,0,0
,"Kool-Aid Jammers, 40 pk./6 oz.","Kool-Aid Jammers, 40 pk./6 oz.",FBALYB Amazon,2,2,0,0,0,0
,"Kool-Aid Tropical Punch, 34 qt","Kool-Aid Tropical Punch, 34 qt",FBALYB Amazon,-51,-53,2,51,2,0
,Kool Kubes Reusable Ice Cubes 60 ct, Kool Kubes Reusable Ice Cubes 60 ct,FBALYB Amazon,-1,-1,0,0,0,0
,Kordon Amquel Plus 16oz,Kordon Amquel Plus for Aquarium 16oz,FBALYB Amazon,40,40,0,0,0,0
,Kordon Malachite Green 4oz,Kordon Malachite Green 4oz,Default,0,0,0,0,0,13
,Kordon Malachite Green 4oz 3pk,Kordon Malachite Green 4oz 3pk,FBALYB Amazon,100,100,0,0,0,0
,Kotex Lightdays Liners 192 ct.,Kotex Lightdays Liners 192 ct.,FBALYB Amazon,-1,-1,0,0,0,0
,Kotex Natural Balance Long 22 count,Kotex Natural Balance Long 22 count,Default Ridgefield,5,5,0,0,0,0
,Kotex Natural Balance Ultra Thin Pads Long 20 count,Kotex Natural Balance Ultra Thin Pads Long 20 count,Default Ridgefield,8,8,0,0,0,0
,Kotex Pantiliners Light days Long Unscented 48 count,Kotex Pantiliners Light days Long Unscented 48 count,Default Ridgefield,3,3,0,0,0,0
,Kotex Security Tampons Super Absorbency Unscented 18 count,Kotex Security Tampons Super Absorbency Unscented 18 count,Default Ridgefield,6,6,0,0,0,0
,K-PAK Color Therapy Shampoo + Conditioner 10.1 oz,K-PAK Color Therapy Shampoo + Conditioner 10.1 oz,FBALYB Amazon,-1,-15,14,0,14,0
,Kraft Original 18ct,Kraft Easy Mac & Cheese Original 18 count,FBALYB Amazon,2,2,0,0,0,0
,Krispy Kreme smooth 12 pack,"Krispy Kreme Smooth K Cups, 12 ct",FBALYB Amazon,-1,-1,0,0,0,0
,Krusteaz Pancake Mix,Krusteaz Pancake Mix,Default,0,0,0,0,0,20
,Krusteaz Pancake Mix,Krusteaz Pancake Mix,FBALYB Amazon,99,99,0,0,0,0
,Kuumba Made Black Coconut Fragrance Oil Roll-On 1/8 Oz,Kuumba Made Black Coconut Fragrance Oil Roll-On 1/8 Oz,Default,0,0,0,0,0,100
,Kuumba Made Black Coconut Fragrance Oil Roll-On 1/8 Oz,Kuumba Made Black Coconut Fragrance Oil Roll-On 1/8 Oz,Default Ridgefield,125,125,0,0,0,0
,Kuumba Made Black Coconut Fragrance Oil Roll-On 1/8 Oz,Kuumba Made Black Coconut Fragrance Oil Roll-On 1/8 Oz,FBALYB Amazon,2,2,0,0,0,0
,Kuumba Made Egyptian Musk Fragrance Oil Roll-On 1/8 Oz,Kuumba Made Egyptian Musk Fragrance Oil Roll-On 1/8 Oz,Default,0,0,0,0,0,900
,Kuumba Made Egyptian Musk Fragrance Oil Roll-On 1/8 Oz,Kuumba Made Egyptian Musk Fragrance Oil Roll-On 1/8 Oz,Default Ridgefield,6,6,0,0,0,0
,Kuumba Made Egyptian Musk Fragrance Oil Roll-On 1/8 Oz,Kuumba Made Egyptian Musk Fragrance Oil Roll-On 1/8 Oz,FBALYB Amazon,272,272,0,6,0,0
,Kuumba Made Egyptian Musk Fragrance Oil Roll-On 1/8 Oz 2PACK,Kuumba Made Egyptian Musk Fragrance Oil Roll-On 1/8 Oz 2PACK,FBALYB Amazon,136,136,0,0,0,0
,Kuumba Made Persian Garden 1/2 oz,Kuumba Made Persian Garden 1/2 oz,Default Ridgefield,2,2,0,0,0,0
,Kuumba Made Persian Garden 1/2 oz,Kuumba Made Persian Garden 1/2 oz,FBALYB Amazon,-2,-2,0,2,0,0
,Kuumba Made Tunisian Opium Fragrance Oil Roll-On 1/8 Oz,Kuumba Made Tunisian Opium Fragrance Oil Roll-On 1/8 Oz,Default,0,0,0,0,0,160
,Kuumba Made Tunisian Opium Fragrance Oil Roll-On 1/8 Oz,Kuumba Made Tunisian Opium Fragrance Oil Roll-On 1/8 Oz,Default Ridgefield,126,126,0,0,0,0
,Kuumba Made Tunisian Opium Fragrance Oil Roll-On 1/8 Oz,Kuumba Made Tunisian Opium Fragrance Oil Roll-On 1/8 Oz,FBALYB Amazon,4,4,0,0,0,0
,Kuumba Made Tunisian Patchouli Fragrance Oil Roll-On 1/8 Oz,Kuumba Made Tunisian Patchouli Fragrance Oil Roll-On 1/8 Oz,Default,0,0,0,0,0,324
,Kuumba Made Tunisian Patchouli Fragrance Oil Roll-On 1/8 Oz,Kuumba Made Tunisian Patchouli Fragrance Oil Roll-On 1/8 Oz,Default Ridgefield,2,2,0,0,0,0
,Kuumba Made Tunisian Patchouli Fragrance Oil Roll-On 1/8 Oz,Kuumba Made Tunisian Patchouli Fragrance Oil Roll-On 1/8 Oz,FBALYB Amazon,16,16,0,1,0,0
,Kuumba Made Vanilla Bean Fragrance Oil Roll-On 1/8 Oz,Kuumba Made Vanilla Bean Fragrance Oil Roll-On 1/8 Oz,Default,0,0,0,0,0,648
,Kuumba Made Vanilla Bean Fragrance Oil Roll-On 1/8 Oz,Kuumba Made Vanilla Bean Fragrance Oil Roll-On 1/8 Oz,Default Ridgefield,2,2,0,0,0,0
,Kuumba Made Vanilla Bean Fragrance Oil Roll-On 1/8 Oz,Kuumba Made Vanilla Bean Fragrance Oil Roll-On 1/8 Oz,FBALYB Amazon,8,8,0,0,0,0
,Kuumba Made Vanilla Bean Fragrance Oil Roll-On 1/8 Oz,Kuumba Made Vanilla Bean Fragrance Oil Roll-On 1/8 Oz,FBALYB Canada,1,1,0,0,0,0
,"Kyocera Advanced Ceramic Horizontal Y Peeler, Red","Kyocera Advanced Ceramic Horizontal Y Peeler, Red",FBALYB Amazon,-3,-3,0,0,0,0
,"Kyocera Advanced Ceramic Horizontal Y Peeler, White","Kyocera Advanced Ceramic Horizontal Y Peeler, White",FBALYB Amazon,93,91,2,0,2,0
,"Kyocera Advanced Ceramic Revolution Series 4.5-inch Utility Knife and Y-Peeler Gift Set, Green","Kyocera Advanced Ceramic Revolution Series 4.5-inch Utility Knife and Y-Peeler Gift Set, Green",FBALYB Amazon,-1,-1,0,0,0,0
,"Kyocera Advanced Ceramic Revolution Series 4.5-inch Utility Knife, Black Handle, White Blade - FK-110 WH","Kyocera Advanced Ceramic Revolution Series 4.5-inch Utility Knife, Black Handle, White Blade - FK-110 WH",FBALYB Amazon,-9,-9,0,0,0,0
,"Kyocera Advanced Ceramic Revolution Series 4.5-inch Utility Knife, Red Handle, White Blade","Kyocera Advanced Ceramic Revolution Series 4.5-inch Utility Knife, Red Handle, White Blade",FBALYB Amazon,-1,-1,0,0,0,0
,"Kyocera Advanced Ceramic Revolution Series 5-1/2-inch Santoku Knife and Y Peeler Set, Black","Kyocera Advanced Ceramic Revolution Series 5-1/2-inch Santoku Knife and Y Peeler Set, Black",FBALYB Amazon,2,2,0,0,0,0
,"Kyocera Advanced Ceramic Revolution Series 5-1/2-inch Santoku Knife, Black Handle, White Blade","Kyocera Advanced Ceramic Revolution Series 5-1/2-inch Santoku Knife, Black Handle, White Blade",Default Ridgefield,56,56,0,0,0,0
,"Kyocera Advanced Ceramic Revolution Series 5-1/2-inch Santoku Knife, Black Handle, White Blade","Kyocera Advanced Ceramic Revolution Series 5-1/2-inch Santoku Knife, Black Handle, White Blade",FBALYB Amazon,-3,-3,0,0,0,0
,Kyocera Advanced Ceramics – Revolution Series 3-Piece Ceramic Knife Set: Includes 6-inch Chef's Knife; 5-inch Micro Serrated Knife; and 3-inch Paring Knife; Black Handles with White Blades,Kyocera Advanced Ceramics – Revolution Series 3-Piece Ceramic Knife Set: Includes 6-inch Chef's Knife; 5-inch Micro Serrated Knife; and 3-inch Paring Knife; Black Handles with White Blades,FBALYB Amazon,130,129,1,0,1,0
,"Kyocera FK-3PC BK 3Piece Advanced ceramic Revolution Series Knife Set, Blade Sizes: 5.5"", 4.5"", 3"", Black","Kyocera FK-3PC BK 3Piece Advanced ceramic Revolution Series Knife Set, Blade Sizes: 5.5"", 4.5"", 3"", Black",FBALYB Amazon,-5,-5,0,0,0,0
,Kyolic Aged Garlic Extract Curcumin 100 Capsules,Kyolic Aged Garlic Extract Curcumin 100 Capsules,FBALYB Amazon,48,48,0,0,0,0
,Kyolic Aged Garlic Extract Curcumin 100 Capsules,Kyolic Aged Garlic Extract Curcumin 100 Capsules,WFS,-7,-7,0,0,0,0
,KZ-T9TF-SBWI,Milk Bone Brushing Chews (Small/Medium) 40 Dental Treats 31.4oz by Milk-Bone,FBALYB Amazon,-15,-15,0,90,0,0
,LACK Wall shelf unit white,LACK Wall shelf unit white,Default,0,-102,102,0,0,0
,LACK Wall shelf unit white,LACK Wall shelf unit white,Default Ridgefield,0,-109,109,0,0,0
,LACK Wall shelf unit white,LACK Wall shelf unit white,FBALYB Amazon,1,-2,3,4,3,0
,La Colombe Draft Latte 12,La Colombe Draft Latte 12,Default,0,0,0,0,0,2
,La Colombe Draft Latte 12,La Colombe Draft Latte 12,FBALYB Amazon,18,18,0,2,0,0
,Lactaid 96ct,Lactaid 96ct,FBALYB Amazon,1,1,0,0,0,0
,Ladies' Blouse Blue Wave Large,Ladies' Blouse Blue Wave Large,FBALYB Amazon,-2,-2,0,0,0,0
,Ladies' Blouse Blue Wave Medium,Ladies' Blouse Blue Wave Medium,FBALYB Amazon,-1,-1,0,0,0,0
,Ladies' Blouse Blue Wave Small,Ladies' Blouse Blue Wave Small,FBALYB Amazon,-1,-1,0,0,0,0
,Ladies' Blouse Chambray Pink Medium,Ladies' Blouse Chambray Pink Medium,FBALYB Amazon,-1,-1,0,0,0,0
,Ladies' Blouse Silver Medium,Ladies' Blouse Silver Medium,FBALYB Amazon,-3,-3,0,0,0,0
,Ladies' Blouse Silver Small,Ladies' Blouse Silver Small,FBALYB Amazon,-2,-2,0,0,0,0
,Ladies' Blouse Silver XX-Large,Ladies' Blouse Silver XX-Large,FBALYB Amazon,-3,-3,0,0,0,0
,Ladies' Blouse White Large,Ladies' Blouse White Large,FBALYB Amazon,-5,-5,0,0,0,0
,Ladies' Blouse White XX-Large,Ladies' Blouse White XX-Large,FBALYB Amazon,-1,-1,0,0,0,0
,LADY MITCHUM CLEARGEL POWDER 2pk,LADY MITCHUM CLEARGEL POWDER 2pk,FBALYB Amazon,1,1,0,0,0,0
,Lafeber Avi Cakes Small Bird Food 8oz 3pk,Lafeber Avi Cakes Small Bird Food 8oz 3pk,Default,3,3,0,0,0,0
,Lafeber Avi Cakes Small Bird Food 8oz 3pk,Lafeber Avi Cakes Small Bird Food 8oz 3pk,FBALYB Amazon,-3,-3,0,0,0,0
,Lafeber Nutri-Berries Parakeet Bird Food 4lb,Lafeber Nutri-Berries Parakeet Bird Food 4lb,FBALYB Amazon,1,1,0,0,0,0
,Lafeber Nutri-Berries Parrot Bird Food 3.25lb,Lafeber Nutri-Berries Parrot Bird Food 3.25lb,FBALYB Amazon,-2,-2,0,0,0,0
,Lafeber Nutriberries Variety 4pk,Lafeber Nutriberries Variety 4pk,FBALYB Amazon,1,1,0,0,0,0
,Lafeber Premium Cockatiel Bird Food 5lb,Lafeber Premium Cockatiel Bird Food 5lb,FBALYB Amazon,1,1,0,0,0,0
,Lafeber's Nutri-Berries Parrot Food (20 lbs.),Lafeber's Nutri-Berries Parrot Food (20 lbs.),FBALYB Amazon,-1,-1,0,0,0,0
,Lafeber Tropical Fruit Parrot 3lb 2pk,Lafeber Tropical Fruit Parrot 3lb 2pk,FBALYB Amazon,1,1,0,0,0,0
,LA MER 200ML THE TONIC,LA MER 200ML THE TONIC,Default Ridgefield,2,2,0,0,0,0
,LA MER 200ML THE TONIC,LA MER 200ML THE TONIC,FBALYB Amazon,-2,-2,0,0,0,0
,LA MER THE CLEANSING FOAM 125ML,LA MER THE CLEANSING FOAM 125ML,Default Ridgefield,103,103,0,0,0,0
,LA MER THE CLEANSING GEL 200ML,LA MER THE CLEANSING GEL 200ML,FBALYB Amazon,-2,-2,0,0,0,0
,LA MER THE CONCENTRATE 50 ML,LA MER THE CONCENTRATE 50 ML,FBALYB Amazon,-1,-1,0,0,0,0
,LA MER THE EYE BALM INTENSE 15ML,LA MER THE EYE BALM INTENSE 15ML,FBALYB Amazon,-1,-1,0,0,0,0
,LA MER THE EYE CONCENTRATE 15ML,LA MER THE EYE CONCENTRATE 15ML,FBALYB Amazon,-1,-1,0,0,0,0
,LA MER THE EYE CONCENTRATE 15 ML,LA MER THE EYE CONCENTRATE 15 ML,FBALYB Amazon,-1,-1,0,0,0,0
,LA MER THE MOISTURIZING CREAM 100ML,LA MER THE MOISTURIZING CREAM 100ML,FBALYB Amazon,-3,-3,0,0,0,0
,LA MER THE MOISTURIZING CREME 30ML,LA MER THE MOISTURIZING CREME 30ML,FBALYB Amazon,-2,-2,0,0,0,0
,LA MER THE MOISTURIZING CREME 60ML,LA MER THE MOISTURIZING CREME 60ML,FBALYB Amazon,-14,-15,1,0,1,0
,LA MER THE MOISTURIZING SOFT CREAM 30ML,LA MER THE MOISTURIZING SOFT CREAM 30ML,Default Ridgefield,1,1,0,0,0,0
,LA MER THE MOISTURIZING SOFT CREAM 30ML,LA MER THE MOISTURIZING SOFT CREAM 30ML,FBALYB Amazon,0,0,0,1,0,0
,LA MER THE MOISTURIZING SOFT CREAM 60ML,LA MER THE MOISTURIZING SOFT CREAM 60ML,Default Ridgefield,2,2,0,0,0,0
,LA MER THE MOISTURIZING SOFT CREAM 60ML,LA MER THE MOISTURIZING SOFT CREAM 60ML,FBALYB Amazon,15,15,0,0,0,0
,LA MER THE RENEWAL OIL 30ML,LA MER THE RENEWAL OIL 30ML,Default Ridgefield,3,3,0,0,0,0
,LA MER THE RENEWAL OIL 30ML,LA MER THE RENEWAL OIL 30ML,FBALYB Amazon,46,41,5,1,5,0
,LA MER THE TREATMENT LOTION 150ML,LA MER THE TREATMENT LOTION 150ML,Default,1,1,0,0,0,0
,LA MER THE TREATMENT LOTION 150ML,LA MER THE TREATMENT LOTION 150ML,FBALYB Amazon,-6,-6,0,0,0,0
,Lamy AL-Star 29F plus 5 Black Ink,Lamy AL-Star 29F plus 5 Black Ink,FBALYB Amazon,127,126,1,0,1,0
,Lamy Al Star Blue Pen plus 5 Black Ink,Lamy Al Star Blue Pen plus 5 Black Ink,FBALYB Amazon,34,33,1,4,1,0
,Lamy AlStar Graphite 26F and 5 Black Ink,Lamy AlStar Graphite 26F and 5 Black Ink,FBALYB Amazon,1,0,1,0,1,0
,Lamy Black T10 Ink 4 PACK,Lamy Black T10 Ink 4 PACK,FBALYB Amazon,-55,-69,14,21,14,0
,Lamy Blue Ink 4 PACK LT10BLB,Lamy Blue Ink 4 PACK LT10BLB,Default,194,-605,799,0,0,0
,Lamy Blue Ink 4 PACK LT10BLB,Lamy Blue Ink 4 PACK LT10BLB,FBALYB Amazon,-816,-816,0,1,0,0
,Lamy Joy Fountain Calligraphy Pen - Shiny Black - 1.9mm,Lamy Joy Fountain Calligraphy Pen - Shiny Black - 1.9mm,Default Ridgefield,30,30,0,0,0,0
,Lamy Ocean Blue L28M plus 5 Black Ink,Lamy Ocean Blue L28M plus 5 Black Ink,FBALYB Amazon,-1,-1,0,0,0,0
,Lamy Pen Ink Bundle 7 colors B01N1A2H4Q,Lamy Pen Ink Bundle 7 colors ,Default,3,0,3,0,0,0
,Lamy Pen Ink Bundle 7 colors B01N1A2H4Q,Lamy Pen Ink Bundle 7 colors ,FBALYB Amazon,-11,-14,3,2,3,0
,Lamy Safari 19M Black plus 5 Black Ink,Lamy Safari 19M Black plus 5 Black Ink,FBALYB Amazon,-3,-3,0,1,0,0
,Lamy Safari 19M plus 5 Black Ink,Lamy Safari 19M plus 5 Black Ink,Default,0,-90,90,0,0,0
,Lamy Safari 19M plus 5 Black Ink,Lamy Safari 19M plus 5 Black Ink,Default Ridgefield,0,-72,72,0,0,0
,Lamy Safari 19M plus 5 Black Ink,Lamy Safari 19M plus 5 Black Ink,FBALYB Amazon,237,237,0,10,0,0
,Lamy Safari 19M plus 5 Black Ink,Lamy Safari 19M plus 5 Black Ink,WFS,-22,-22,0,0,0,0
,Lamy Safari Pen plus 5 Black Ink Bundle,Lamy Safari Pen plus 5 Black Ink Bundle,FBALYB Amazon,-72,-72,0,12,0,0
,Lamy Safari Umber (M) plus 5 Black Ink,Lamy Safari Umber (M) plus 5 Black Ink,FBALYB Amazon,76,-4,80,0,80,0
,Lamy Safari Yellow 14M plus 5 Black Ink,Lamy Safari Yellow 14M plus 5 Black Ink,FBALYB Amazon,45,44,1,1,1,0
,Lamy Turqoise T10 Ink 4 PACK,Lamy Turqoise T10 Ink 4 PACK,FBALYB Amazon,-1,-1,0,0,0,0
,Laura Secord Hot Chocolate 24ct K Cups,Laura Secord Hot Chocolate 24ct K Cups,FBALYB Amazon,5,5,0,1,0,0
,Lavazza Aroma Top Whole Coffee Beans - 2.2 lbs,Lavazza Aroma Top Whole Coffee Beans - 2.2 lbs,FBALYB Amazon,289,289,0,0,0,0
,Lavazza Caffe Espresso 2.2LB 2pack (1),Lavazza Caffe Espresso 2.2LB 2pack (1),FBALYB Amazon,533,533,0,0,0,0
,"Lavazza Caffe Espresso  Medium Roast, 2.2LB Bag","Lavazza Caffe Espresso  Medium Roast, 2.2LB Bag",Default,0,-1080,1080,0,0,0
,"Lavazza Caffe Espresso  Medium Roast, 2.2LB Bag","Lavazza Caffe Espresso  Medium Roast, 2.2LB Bag",FBALYB Amazon,269,269,0,17,0,0
,Lavazza Classico 24ct,Lavazza Classico 24ct,FBALYB Amazon,3,3,0,0,0,0
,Lavazza Classico 24ct 4pk,Lavazza Classico 24ct 4pk,Default,-50,-50,0,0,0,0
,Lavazza Classico 24ct 4pk,Lavazza Classico 24ct 4pk,FBALYB Amazon,-1,-1,0,1,0,0
,Lavazza Crema e Aroma 2.2LB 2pk,Lavazza Crema e Aroma 2.2LB 2pk,FBALYB Amazon,-333,-335,2,370,2,0
,Lavazza Crema e Gusto 250g 3pk,Lavazza Crema e Gusto 250g 3pk,FBALYB Amazon,48,48,0,3,0,0
,LavAzza Crema e Gusto 2pk,LavAzza Crema e Gusto 2pk,FBALYB Amazon,73,73,0,0,0,0
,LavAzza Crema e Gusto 4pk,LavAzza Crema e Gusto 4pk,FBALYB Amazon,1232,1232,0,927,0,0
,LavAzza Crema e Gusto 8pk,LavAzza Crema e Gusto 8pk,FBALYB Amazon,535,535,0,7,0,0
,Lavazza Crema Gusto 250g Bag,Lavazza Crema Gusto 250g Bag,Default,0,-18774,18774,0,0,0
,Lavazza Creme Aroma Brown Whole Coffee Beans 2.2lbs,Lavazza Creme Aroma Brown Whole Coffee Beans 2.2lbs,Default,0,-1440,1440,0,0,0
,Lavazza Espresso Gusto Pieno Coffee Beans 2.2lbs.,Lavazza Espresso Gusto Pieno Coffee Beans 2.2lbs.,FBALYB Amazon,266,266,0,0,0,0
,Lavazza Grand Espresso Cfe 2.2lb bg 2pck,Lavazza Grand Espresso Cfe 2.2lb bg 2pck,FBALYB Amazon,81,81,0,0,0,0
,Lavazza Grand Espresso Whole Coffee Beans 2.2lbs,Lavazza Grand Espresso Whole Coffee Beans 2.2lbs,Default,0,-24,24,0,0,0
,Lavazza Grand Espresso Whole Coffee Beans 2.2lbs,Lavazza Grand Espresso Whole Coffee Beans 2.2lbs,Default Ridgefield,63,63,0,0,0,0
,Lavazza Gran Selezione 24ct,Lavazza Gran Selezione 24ct,FBALYB Amazon,-12,-12,0,30,0,0
,Lavazza Gran Selezione 24ct 4pk,Lavazza Gran Selezione 24ct 4pk,FBALYB Amazon,1,1,0,0,0,0
,Lavazza Italian Crema Gusto 20pk,Lavazza Italian Crema Gusto 20pk,Default,0,-165,165,0,0,0
,Lavazza Italian Crema Gusto 20pk,Lavazza Italian Crema Gusto 20pk,FBALYB Amazon,-124,-128,4,0,4,0
,Lavazza Pienaroma Whole Coffee Beans 2.2lbs,Lavazza Pienaroma Whole Coffee Beans 2.2lbs,FBALYB Amazon,131,131,0,0,0,0
,Lavazza Qualita Oro Whole Coffee Beans 2.2lbs,Lavazza Qualita Oro Whole Coffee Beans 2.2lbs,Default,0,-508,508,0,0,0
,Lavazza Qualita Rossa 12pk,Lavazza Qualita Rossa 12pk,FBALYB Amazon,139,139,0,6,0,0
,Lavazza Qualita Rossa 1kg,Lavazza Qualita Rossa 1kg ,Default,0,-74,74,0,0,0
,Lavazza Qualita Rossa 1kg,Lavazza Qualita Rossa 1kg ,FBALYB Amazon,80,80,0,0,0,0
,Lavazza Qualita Rossa 1kg 2pk,Lavazza Qualita Rossa 1kg 2pk,FBALYB Amazon,1,1,0,0,0,0
,Lavazza Qualita Rossa 20pk,Lavazza Qualita Rossa 20pk,FBALYB Amazon,0,0,0,1,0,0
,Lavazza Qualita Rossa 250g 3pk,Lavazza Qualita Rossa 250g 3pk,FBALYB Amazon,-1,-1,0,0,0,0
,Lavazza Qualita Rossa 250g Bag,Lavazza Qualita Rossa 250g Bag,Default,0,-2148,2148,0,0,0
,Lavazza Qualita Rossa 4pk,Lavazza Qualita Rossa 4pk,FBALYB Amazon,879,877,2,31,2,0
,Lavazza Quality Oro Beans 2.2lb bg 2pack,Lavazza Quality Oro Beans 2.2lb bg 2pack,FBALYB Amazon,275,44,231,11,231,0
,Lavazza Super Crema Coffee 2.2lb bg 3pk,Lavazza Super Crema Coffee 2.2lb bg 3pk,FBALYB Amazon,186,186,0,0,0,0
,Lavazza Super Crema Coffee 2.2lb bg 6pk,Lavazza Super Crema Coffee 2.2lb bg 6pk,FBALYB Amazon,215,215,0,1,0,0
,Lavazza Super Crema Espresso2.2lb bg 2pk,Lavazza Super Crema Espresso2.2lb bg 2pk,FBALYB Amazon,79,77,2,3,2,0
,Lavazza Super Crema Whole Bean 2.2 2pk,Lavazza Super Crema Whole Bean 2.2 2pk,FBALYB Amazon,6,6,0,0,0,0
,Lavazza Super Crema Whole Coffee Beans 2.2lbs,Lavazza Super Crema Whole Coffee Beans 2.2lbs,Default,0,-1372,1372,0,0,0
,Lavazza Top Class Coffee 2.2lb bg 2pk,Lavazza Top Class Coffee 2.2lb bg 2pk,FBALYB Amazon,10,10,0,0,0,0
,"Lawry's Seasoned Salt, 40 oz. 2pk","Lawry's Seasoned Salt, 40 oz. 2pk",FBALYB Amazon,-8,-8,0,8,0,0
,Lee's Plastic Mealworm Dish 2pk,Lee's Plastic Mealworm Dish 2pk,FBALYB Amazon,-1,-1,0,0,0,0
,Legends Marvel's Nuke,Marvel 6-Inch Legends Series Marvel's Nuke,FBALYB Amazon,1,1,0,0,0,0
,Legends Red Guardian,Marvel 6-Inch Legends Series Red Guardian,FBALYB Amazon,2,2,0,0,0,0
,LEGO Friends Heartlake,LEGO Friends Heartlake Performance School,Default,0,0,0,0,0,14
,LEGO Laval Alarm Clock 9000560,LEGO Kids Legends of Chima Laval Alarm Clock 9000560,Default,0,-12,12,0,0,0
,"Lenovo 15.6"" Laptop 80TJ00LRUS","Lenovo 15.6"" Laptop 80TJ00LRUS",FBALYB Amazon,-1,-1,0,0,0,0
,"Lenovo Yoga 910 2-in-1 14"" 16gb Silver 80VF007TUS","Lenovo Yoga 910 2-in-1 14"" 16gb Silver 80VF007TUS",FBALYB Amazon,-1,-1,0,0,0,0
,Lexar LSD512CBEU633 / LSD512CBNL633 512GB SDXC,Lexar LSD512CBEU633 / LSD512CBNL633 512GB SDXC,FBALYB Amazon,-5,-5,0,0,0,0
,LG UP875 Blu-ray Player,LG UP875 4K Ultra HD 3D Blu-ray Player - Black,FBALYB Amazon,-1,-1,0,1,0,0
,LIFESVRS 50 OZ WINTERGRN-BAG,LIFESVRS 50 OZ WINTERGRN-BAG,FBALYB Amazon,1,1,0,0,0,0
,Light led 4 pack ge,"GE Lighting 67616 Dimmable LED A19 Light Bulb with Medium Base, 10.5-Watt, Da...",FBALYB Amazon,-2,-3,1,0,1,0
,Lil Critters Omega-3 Gummy 180 ct,Lil Critters Omega-3 Gummy Fish With Dha-180 Fish,FBALYB Amazon,-2,-2,0,0,0,0
,Lil Links Pork and Apple 6pack,Lil Links Pork and Apple 6pack,FBALYB Amazon,1,1,0,0,0,0
,LILLVIKEN Sink strainer with stopper 503.254.26,LILLVIKEN Sink strainer with stopper 503.254.26,Default Ridgefield,2,2,0,0,0,0
,Lindsay Olives Green Ripe Medium Pitted 6 oz 6pk,Lindsay Olives Green Ripe Medium Pitted 6 oz 6pk,FBALYB Amazon,1,1,0,0,0,0
,Lindt Chocolate,Lindt Chocolate,FBALYB Amazon,40,40,0,0,0,0
,Lindt Chocolate Hello Emojis 65ct,"Lindt Chocolate Hello Emojis, Milk Chocolate, Pack of 65",FBALYB Amazon,1,1,0,0,0,0
,"Lipton Iced Tea, Lemon Canister","Lipton Iced Tea Mix, Natural Lemon",FBALYB Amazon,7,7,0,0,0,0
,Listerine Cool Mint 2 pk./1.5L,Listerine Cool Mint 2 pk./1.5L,Default,0,-10,10,0,0,0
,Listerine Cool Mint 2 pk./1.5L,Listerine Cool Mint 2 pk./1.5L,FBALYB Amazon,0,0,0,6,0,0
,Listerine Cool Mint 4 Pack,Listerine Cool Mint 4 Pack,Default,-1,-1,0,0,0,0
,Listerine Fresh Burst 2 pk/1.5L,Listerine Fresh Burst 2 pk/1.5L,FBALYB Amazon,-48,-48,0,48,0,0
,Listerine Mint Strips,Listerine Cool Mint Pocketpaks Strips 12/24ct,FBALYB Amazon,645,645,0,5,0,0
,Listerine PocketPacks 3ct (72 Strips),Listerine PocketPacks 3ct (72 Strips),FBALYB Canada,1,1,0,0,0,0
,Listerine PocketPacks 3ct (72 Strips) 4pk,Listerine PocketPacks 3ct (72 Strips) 4pk,FBALYB Amazon,28,-41,69,5,69,0
,Listerine PocketPacks 3ct (72 Strips) 4pk,Listerine PocketPacks 3ct (72 Strips) 4pk,FBALYB Canada,31,31,0,0,0,0
,Listerine PocketPacks 3ct (72 Strips) 6pk,Listerine PocketPacks 3ct (72 Strips) 6pk,FBALYB Amazon,25,25,0,0,0,0
,Listerine PocketPacks 3ct (72 Strips) 6pk,Listerine PocketPacks 3ct (72 Strips) 6pk,FBALYB Canada,7,7,0,0,0,0
,Listerine PocketPacks 3ct (72 Strips) 8pk,Listerine PocketPacks 3ct (72 Strips) 8pk,FBALYB Amazon,58,40,18,12,18,0
,Listerine Pocket Paks 288 x 2pk (566),Listerine Pocket Paks 288 x 2pk (566),FBALYB Amazon,-1,-1,0,2,0,0
,"Listerine Ultraclean 1.5L, 2pk Arctic Fresh Canada","Listerine Ultraclean 1.5L, 2pk Arctic Fresh Canada",FBALYB Amazon,-161,-161,0,188,0,0
,Little Giant Automatic Poultry Waterer,Little Giant Automatic Poultry Waterer,Default,0,0,0,0,0,1
,Little Giant Automatic Poultry Waterer,Little Giant Automatic Poultry Waterer,FBALYB Amazon,-16,-16,0,16,0,0
,Little Lost Kitties Multi Pack E4458,Little Lost Kitties Multi Pack E4458,Default Ridgefield,43,43,0,0,0,0
,Little Lost Kitties Multi Pack E4458,Little Lost Kitties Multi Pack E4458,FBALYB Amazon,1357,1346,11,2,11,0
,Little People Disney Princess Songs Palace,Little People Disney Princess Songs Palace,Default,4,4,0,0,0,7
,Little People Disney Princess Songs Palace,Little People Disney Princess Songs Palace,FBALYB Amazon,-4,-4,0,0,0,0
,Living Proof Full Conditioner 8oz,Living Proof Full Conditioner 8oz,Default,0,-804,804,0,0,0
,Living Proof Full Dry Volume Blast 7.5oz,Living Proof Full Dry Volume Blast 7.5oz,FBALYB Amazon,862,862,0,0,0,0
,Living Proof Full Shampoo 8oz,Living Proof Full Shampoo 8oz,Default,0,-804,804,0,0,0
,Living Proof Full Shampoo + Conditioner Duo Set,Living Proof Full Shampoo + Conditioner Duo Set,FBALYB Amazon,337,337,0,1,0,0
,Living Proof Full Shampoo + Conditioner + Thickening Cream,Living Proof Full Shampoo + Conditioner + Thickening Cream,FBALYB Amazon,82,82,0,0,0,0
,Living Proof Full Thickening Mousse  5oz,Living Proof Full Thickening Mousse  5oz,FBALYB Amazon,134,134,0,0,0,0
,Living Proof No Frizz Humidity Shield 5.5oz,Living Proof No Frizz Humidity Shield 5.5oz,FBALYB Amazon,56,56,0,0,0,0
,Living Proof No Frizz Shampoo + Conditioner Duo Set,Living Proof No Frizz Shampoo + Conditioner Duo Set,FBALYB Amazon,37,37,0,0,0,0
,Living Proof No Frizz Shampoo + Conditioner (liter) Duo Set,Living Proof No Frizz Shampoo + Conditioner (liter) Duo Set,FBALYB Amazon,-1,-1,0,1,0,0
,Living Proof Perfect hair Day (PhD) Conditioner,Living Proof Perfect hair Day (PhD) Conditioner ,Default,0,-794,794,0,0,0
,Living Proof Perfect hair Day (PhD) Dry Shampoo 1.8oz,Living Proof Perfect hair Day (PhD) Dry Shampoo 1.8oz,Avrami - Ebay,500,500,0,0,0,0
,Living Proof Perfect hair Day (PhD) Dry Shampoo 1.8oz,Living Proof Perfect hair Day (PhD) Dry Shampoo 1.8oz,WFS,-149,-149,0,0,0,0
,Living Proof Perfect Hair Day PHD Shampoo,Living Proof Perfect Hair Day PHD Shampoo ,Default,0,-794,794,0,0,0
,Living Proof Perfect Hair Day Shampoo + Conditioner Duo Set,Living Proof Perfect Hair Day Shampoo + Conditioner Duo Set,FBALYB Amazon,-6,-6,0,5,0,0
,Lixit Chinchilla Blue Cloud Dust ‑ 3 lb,Lixit Chinchilla Blue Cloud Dust ‑ 3 lb,FBALYB Amazon,13,13,0,0,0,0
,Lixit Hand Feeding Syringe 35ml,Lixit Hand Feeding Syringe 35ml,FBALYB Amazon,-3,-3,0,0,0,0
,Lixit Small Dog Water Bottle 16oz,Lixit Small Dog Water Bottle 16oz,FBALYB Amazon,-2,-2,0,0,0,0
,Lock-N-Litter Pan for Small Pets,"Ware Manufacturing Plastic Lock-N-Litter Pan for Small Pets, Colors May Vary",FBALYB Amazon,-26,-26,0,0,0,0
,Lock-N-Litter Pan Jumbo,Ware Critter Scatterless Lock-N-Litter Pan Jumbo,Default Ridgefield,9,9,0,0,0,0
,Lock-N-Litter Pan Jumbo,Ware Critter Scatterless Lock-N-Litter Pan Jumbo,FBALYB Amazon,-3,-3,0,1,0,0
,Logitech G613 Keyboard,Logitech G613 Wireless Mechanical Gaming Keyboard,FBALYB Amazon,-2,-2,0,0,0,0
,Logitech G910 Keyboard,Logitech G910 Orion Spectrum RGB Mechanical Gaming Keyboard USB (920-008012),FBALYB Amazon,1,1,0,0,0,0
,Logitech G933 Headset White,"Logitech - G933 Artemis Spectrum Snow Limited Edition Wireless 7.1 Virtual Surround Sound Gaming Headset for PS4, Windows, Xbox One - White",FBALYB Amazon,-1,-1,0,0,0,0
,Logitech Harmony Elite Remote Control,Logitech Harmony Elite Remote Control,Default,0,0,0,0,0,1
,Logitech K480 White,Logitech K480 White,Default,0,0,0,0,0,2
,Logitech K480 White,Logitech K480 White,FBALYB Amazon,-1,-1,0,0,0,0
,Logitech Prodigy Gaming Combo,Logitech Prodigy G403 Gaming Mouse & G213 Gaming Keyboard Combo,Default,0,0,0,0,0,3
,Logitech Spotlight Remote Slate,Logitech Spotlight Presentation Remote Slate,Default,0,0,0,0,0,5
,Logitech Webcam - Black,Logitech - 1080p Pro Stream Webcam - Black,Default,0,0,0,0,0,2
,Loreal Color 10 In 1 Vitamino Color 190ml,Loreal Color 10 In 1 Vitamino Color 190ml,Default Ridgefield,69,69,0,0,0,0
,Loreal Color 10 In 1 Vitamino Color 190ml,Loreal Color 10 In 1 Vitamino Color 190ml,FBALYB Amazon,130,130,0,0,0,0
,Loreal Color 10 In 1 Vitamino Color 190ml,Loreal Color 10 In 1 Vitamino Color 190ml,WFS,-25,-25,0,0,0,0
,Loreal Masque Absolut Repair 500ml,Loreal Masque Absolut Repair 500ml,FBALYB Amazon,1,1,0,0,0,0
,Loreal Masque Inforcer 500ml,Loreal Masque Inforcer 500ml,Default Ridgefield,3,3,0,0,0,0
,Loreal Masque Inforcer 500ml,Loreal Masque Inforcer 500ml,FBALYB Amazon,-2,-2,0,0,0,0
,Loreal Masque Nutrifier 500ml,Loreal Masque Nutrifier 500ml,Default Ridgefield,50,50,0,0,0,0
,Loreal Masque Nutrifier 500ml,Loreal Masque Nutrifier 500ml,FBALYB Amazon,1,1,0,0,0,0
,L'Oreal Paris Studio Line Clear Minded Clean Gel -  Strong Hold 6.8 fl. oz.,L'Oreal Paris Studio Line Clear Minded Clean Gel -  Strong Hold 6.8 fl. oz.,Default Ridgefield,2012,2012,0,0,0,0
,L'Oreal Paris Studio Line Clear Minded Clean Gel -  Strong Hold 6.8 fl. oz 3pk, L'Oreal Paris Studio Line Clear Minded Clean Gel -  Strong Hold 6.8 fl. oz 3pk,FBALYB Amazon,607,597,10,0,10,0
,L'Oreal Paris Studio Line Clear Minded Clean Gel -  Strong Hold 6.8 fl. oz 4pk,L'Oreal Paris Studio Line Clear Minded Clean Gel -  Strong Hold 6.8 fl. oz 4pk,FBALYB Amazon,-485,-485,0,0,0,0
,L'OREAL SE CONDITIONER  1000ML BLONDIFIER,L'OREAL SE CONDITIONER  1000ML BLONDIFIER,FBALYB Amazon,-1,-1,0,0,0,0
,L'OREAL SE CONDITIONER  1000ML COLOR  VITAMINO,L'OREAL SE CONDITIONER  1000ML COLOR  VITAMINO,Default Ridgefield,200,200,0,0,0,0
,L'OREAL SE CONDITIONER  1000ML COLOR  VITAMINO,L'OREAL SE CONDITIONER  1000ML COLOR  VITAMINO,FBALYB Amazon,318,318,0,0,0,0
,L'OREAL SE CONDITIONER 1000ML GOLD QUINOA,L'OREAL SE CONDITIONER 1000ML GOLD QUINOA,Default Ridgefield,170,170,0,0,0,0
,L'OREAL SE CONDITIONER 1000ML GOLD QUINOA,L'OREAL SE CONDITIONER 1000ML GOLD QUINOA,FBALYB Amazon,-4,-4,0,0,0,0
,L'OREAL SE CONDITIONER 1000ML GOLD QUINOA,L'OREAL SE CONDITIONER 1000ML GOLD QUINOA,FBALYB Canada,0,0,0,50,0,0
,L'OREAL SE CONDITIONER 1000ML INFORCER,L'OREAL SE CONDITIONER 1000ML INFORCER,FBALYB Amazon,22,19,3,0,3,0
,L'OREAL SE CONDITIONER 1000ML NUTRIFIER,L'OREAL SE CONDITIONER 1000ML NUTRIFIER,Default Ridgefield,0,-21,21,0,0,0
,L'OREAL SE CONDITIONER 1000ML NUTRIFIER,L'OREAL SE CONDITIONER 1000ML NUTRIFIER,FBALYB Amazon,-1,-1,0,0,0,0
,L'OREAL SE CONDITIONER  1000ML VOLUMETRY,L'OREAL SE CONDITIONER  1000ML VOLUMETRY,FBALYB Amazon,57,57,0,0,0,0
,L'OREAL SE CONDITIONER  200ML BLONDIFIER,L'OREAL SE CONDITIONER  200ML BLONDIFIER,Default,1,1,0,0,0,0
,L'OREAL SE CONDITIONER  200ML BLONDIFIER,L'OREAL SE CONDITIONER  200ML BLONDIFIER,FBALYB Amazon,-5,-5,0,0,0,0
,L'OREAL SE CONDITIONER 200ML QUINOA GOLD,L'OREAL SE CONDITIONER 200ML QUINOA GOLD,Default Ridgefield,160,160,0,0,0,0
,L'OREAL SE CONDITIONER 200ML QUINOA GOLD,L'OREAL SE CONDITIONER 200ML QUINOA GOLD,FBALYB Amazon,259,259,0,0,0,0
,L'OREAL SE CONDITIONER  200ML VITAMINO COLOR,L'OREAL SE CONDITIONER  200ML VITAMINO COLOR,Default Ridgefield,404,404,0,0,0,0
,L'OREAL SE CREAM 125ML ABSOLUT REPAIR BRUSHING,L'OREAL SE CREAM 125ML ABSOLUT REPAIR BRUSHING,Default Ridgefield,60,60,0,0,0,0
,L'OREAL SE MASK  250ML BLONDIFIER,L'OREAL SE MASK  250ML BLONDIFIER,FBALYB Amazon,-2,-2,0,2,0,0
,L'OREAL SE MASK  250ML GOLD QUINOA  +  PROTEIN,L'OREAL SE MASK  250ML GOLD QUINOA  +  PROTEIN,Default Ridgefield,36,36,0,0,0,0
,L'OREAL SE MASK  250ML GOLD QUINOA  +  PROTEIN,L'OREAL SE MASK  250ML GOLD QUINOA  +  PROTEIN,FBALYB Amazon,-1,-1,0,0,0,0
,L'OREAL SE MASK  250ML IN FORCER,L'OREAL SE MASK  250ML IN FORCER,Default Ridgefield,36,36,0,0,0,0
,L'OREAL SE MASK  250ML IN FORCER,L'OREAL SE MASK  250ML IN FORCER,FBALYB Amazon,115,114,1,25,1,0
,L'OREAL SE MASK  250ML LISS UNLIMITED,L'OREAL SE MASK  250ML LISS UNLIMITED,FBALYB Amazon,114,114,0,0,0,0
,L'OREAL SE MASK  250ML VITAMINO  COLOR,L'OREAL SE MASK  250ML VITAMINO  COLOR,Default Ridgefield,234,234,0,0,0,0
,L'OREAL SE MASK  250ML VITAMINO  COLOR,L'OREAL SE MASK  250ML VITAMINO  COLOR,FBALYB Amazon,1,1,0,0,0,0
,L'OREAL SE MASK  500ML GOLD QUINOA  +  PROTEIN,"L'OREAL SE MASK  500ML GOLD QUINOA  +  PROTEIN	",Default Ridgefield,55,55,0,0,0,0
,L'OREAL SE MASK  500ML GOLD QUINOA  +  PROTEIN,"L'OREAL SE MASK  500ML GOLD QUINOA  +  PROTEIN	",FBALYB Amazon,165,165,0,0,0,0
,L'OREAL SE MASK  500ML LISS UNLIMITED  NEW  PACK,L'OREAL SE MASK  500ML LISS UNLIMITED  NEW  PACK,Default Ridgefield,148,148,0,0,0,0
,L'OREAL SE MASK  500ML LISS UNLIMITED  NEW  PACK,L'OREAL SE MASK  500ML LISS UNLIMITED  NEW  PACK,FBALYB Amazon,1,1,0,0,0,0
,L'OREAL SE MASK  500ML LISS UNLIMITED  NEW  PACK,L'OREAL SE MASK  500ML LISS UNLIMITED  NEW  PACK,FBALYB Canada,0,0,0,50,0,0
,L'OREAL SE MASK  500ML VITAMINO  COLOR  NEW  PACK,L'OREAL SE MASK  500ML VITAMINO  COLOR  NEW  PACK,Default Ridgefield,31,31,0,0,0,0
,L'OREAL SE MASK  500ML VITAMINO  COLOR  NEW  PACK,L'OREAL SE MASK  500ML VITAMINO  COLOR  NEW  PACK,FBALYB Amazon,36,36,0,18,0,0
,L'OREAL SE SHAMPOO  1500ML BLONDIFIER  COOL,L'OREAL SE SHAMPOO  1500ML BLONDIFIER  COOL,Default Ridgefield,4,4,0,0,0,0
,L'OREAL SE SHAMPOO  1500ML BLONDIFIER  COOL,L'OREAL SE SHAMPOO  1500ML BLONDIFIER  COOL,FBALYB Amazon,-1,-1,0,4,0,0
,L'OREAL SE SHAMPOO  1500ML GOLD QUINOA,L'OREAL SE SHAMPOO  1500ML GOLD QUINOA,Default Ridgefield,100,100,0,0,0,0
,L'OREAL SE SHAMPOO  1500ML GOLD QUINOA,L'OREAL SE SHAMPOO  1500ML GOLD QUINOA,FBALYB Amazon,-133,-133,0,0,0,0
,L'OREAL SE SHAMPOO 1500ML NUTRIFIER GLYCEROL,L'OREAL SE SHAMPOO 1500ML NUTRIFIER GLYCEROL,Default Ridgefield,78,78,0,0,0,0
,L'OREAL SE SHAMPOO  1500ML PURE RESOURCE  NEW  PACK,L'OREAL SE SHAMPOO  1500ML PURE RESOURCE  NEW  PACK,Default Ridgefield,71,71,0,0,0,0
,L'OREAL SE SHAMPOO  1500ML SILVER NEW  PACK,L'OREAL SE SHAMPOO  1500ML SILVER NEW  PACK,Default Ridgefield,463,463,0,0,0,0
,L'OREAL SE SHAMPOO  1500ML SILVER NEW  PACK,L'OREAL SE SHAMPOO  1500ML SILVER NEW  PACK,FBALYB Amazon,2,2,0,0,0,0
,L'OREAL SE SHAMPOO  1500ML VITAMINO  COLOR,L'OREAL SE SHAMPOO  1500ML VITAMINO  COLOR,Default Ridgefield,308,308,0,0,0,0
,L'OREAL SE SHAMPOO  1500ML VITAMINO  COLOR,L'OREAL SE SHAMPOO  1500ML VITAMINO  COLOR,FBALYB Amazon,17,17,0,1,0,0
,L'OREAL SE SHAMPOO 300ML ABSOLUTE REPAIR,L'OREAL SE SHAMPOO 300ML ABSOLUTE REPAIR,FBALYB Amazon,-4,-4,0,0,0,0
,L'Oreal SE SHAMPOO 300ML BLONDIFIER GLOSS,L'Oreal SE SHAMPOO 300ML BLONDIFIER GLOSS,FBALYB Amazon,4,2,2,0,2,0
,L'OREAL SE SHAMPOO  300ML PURE RESOURCE,L'OREAL SE SHAMPOO  300ML PURE RESOURCE,FBALYB Amazon,-1,-1,0,0,0,0
,L'OREAL SE SHAMPOO 300ML SILVER MAGNESIUM,L'OREAL SE SHAMPOO 300ML SILVER MAGNESIUM,Default Ridgefield,400,400,0,0,0,0
,L'OREAL SE SHAMPOO  300ML VITAMINO  A-OX,L'OREAL SE SHAMPOO  300ML VITAMINO  A-OX,Default Ridgefield,109,109,0,0,0,0
,L'OREAL SE SHAMPOO  300ML VITAMINO  A-OX,L'OREAL SE SHAMPOO  300ML VITAMINO  A-OX,FBALYB Amazon,1,-1,2,3,2,0
,L'OREAL SE SHAMPOO  500ML BLONDIFIER COOL,L'OREAL SE SHAMPOO  500ML BLONDIFIER COOL,FBALYB Amazon,-1,-1,0,0,0,0
,L'OREAL SE SHAMPOO  500ML BLONDIFIER  GLOSS,L'OREAL SE SHAMPOO  500ML BLONDIFIER  GLOSS,FBALYB Amazon,0,0,0,11,0,0
,L'OREAL SE SHAMPOO 500ML GOLD QUINOA,L'OREAL SE SHAMPOO 500ML GOLD QUINOA,Default Ridgefield,4,4,0,0,0,0
,L'OREAL SE SHAMPOO 500ML GOLD QUINOA,L'OREAL SE SHAMPOO 500ML GOLD QUINOA,FBALYB Amazon,-1,-1,0,0,0,0
,L'OREAL SE SHAMPOO  500ML LISS UNLIMITED  NEW  PACK,L'OREAL SE SHAMPOO  500ML LISS UNLIMITED  NEW  PACK,Default Ridgefield,49,49,0,0,0,0
,L'OREAL SE SHAMPOO  500ML LISS UNLIMITED  NEW  PACK,L'OREAL SE SHAMPOO  500ML LISS UNLIMITED  NEW  PACK,FBALYB Amazon,4,4,0,0,0,0
,L'OREAL SE SHAMPOO  500ML NUTRIFIER NEW  PACK,L'OREAL SE SHAMPOO  500ML NUTRIFIER NEW  PACK,Default Ridgefield,500,500,0,0,0,0
,L'OREAL SE SHAMPOO  500ML NUTRIFIER NEW  PACK,L'OREAL SE SHAMPOO  500ML NUTRIFIER NEW  PACK,FBALYB Amazon,-12,-12,0,19,0,0
,L'OREAL SE SHAMPOO  500ML PURE RESOURCE  NEW  PACK,L'OREAL SE SHAMPOO  500ML PURE RESOURCE  NEW  PACK,FBALYB Amazon,-1,-2,1,0,1,0
,L'OREAL SE SHAMPOO 500ML SENSI BALANCE NEW PACK,L'OREAL SE SHAMPOO 500ML SENSI BALANCE NEW PACK,FBALYB Amazon,12,12,0,0,0,0
,L'OREAL SE SHAMPOO  500ML VITAMINO  COLOR NEW  PACK,L'OREAL SE SHAMPOO  500ML VITAMINO  COLOR NEW  PACK,Default Ridgefield,403,403,0,0,0,0
,L'OREAL SE SHAMPOO  500ML VITAMINO  COLOR NEW  PACK,L'OREAL SE SHAMPOO  500ML VITAMINO  COLOR NEW  PACK,FBALYB Amazon,-16,-16,0,0,0,0
,L'Oreal Se Tecni Art 100Ml Density Material,L'Oreal Se Tecni Art 100Ml Density Material,Default Ridgefield,264,264,0,0,0,0
,L'Oreal Se Tecni Art 100Ml Depolish Wax,L'Oreal Se Tecni Art 100Ml Depolish Wax,FBALYB Amazon,95,95,0,0,0,0
,L'Oreal Se Tecni Art 150Ml Beach Waves,L'Oreal Se Tecni Art 150Ml Beach Waves,Default Ridgefield,203,203,0,0,0,0
,L'Oreal Se Tecni Art 150Ml Web,L'Oreal Se Tecni Art 150Ml Web,FBALYB Amazon,-2,-2,0,0,0,0
,L'Oreal Se Tecni Art 50Ml Liss Control Plus,L'Oreal Se Tecni Art 50Ml Liss Control Plus,Default Ridgefield,139,139,0,0,0,0
,L'Oreal Se Tecni Art 7G Super Dust,L'Oreal Se Tecni Art 7G Super Dust,Default Ridgefield,62,62,0,0,0,0
,L'Oreal Se Tecni Art Gel 200Ml Fix Max,L'Oreal Se Tecni Art Gel 200Ml Fix Max,Default Ridgefield,4,4,0,0,0,0
,L'Oreal Se Tecni Art Gel 200Ml Fix Max,L'Oreal Se Tecni Art Gel 200Ml Fix Max,FBALYB Amazon,74,74,0,0,0,0
,L'Oreal Se Tecni Art Spray 200Ml Fix Design,L'Oreal Se Tecni Art Spray 200Ml Fix Design,Default Ridgefield,401,401,0,0,0,0
,L'Oreal Se Tecni Art Spray 250Ml Volume Full Ex,L'Oreal Se Tecni Art Spray 250Ml Volume Full Ex,Default Ridgefield,616,616,0,0,0,0
,Loreal Shampooing Absolut Repair 1500ml,Loreal Shampooing Absolut Repair 1500ml,FBALYB Amazon,133,133,0,0,0,0
,Loreal Shampooing Inforcer 500ml,Loreal Shampooing Inforcer 500ml,Default Ridgefield,75,75,0,0,0,0
,Loreal Shampooing Inforcer 500ml,Loreal Shampooing Inforcer 500ml,FBALYB Amazon,12,12,0,0,0,0
,Loreal Shampooing Silver 500ml,Loreal Shampooing Silver 500ml,Default Ridgefield,236,236,0,0,0,0
,Loreal Shampooing Silver 500ml,Loreal Shampooing Silver 500ml,FBALYB Amazon,14,14,0,20,0,0
,Lorna Doone 2 Pack,Lorna Doone 2 Pack,FBALYB Amazon,35,35,0,28,0,0
,Louis Belgium Black Eyeglasses Case w/ Lens Wipe Cloth,Louis Belgium Black Eyeglasses Case w/ Lens Wipe Cloth,Default Ridgefield,35,35,0,0,0,0
,Love grown Trulysea stars Toasted rice & Bean Cereal,Love grown Trulysea stars Toasted rice & Bean Cereal,Default Ridgefield,6,6,0,0,0,0
,Love Sexy City by Parfums Parisienne's Women EDP Perfume Spray 3.3oz,Love Sexy City by Parfums Parisienne's Women EDP Perfume Spray 3.3oz,Default Ridgefield,504,504,0,0,0,0
,Loving Pet Bella Bowl Copper X-Large,Loving Pet Bella Bowl Copper X-Large,FBALYB Amazon,33,33,0,4,0,0
,Loving Pet Bella Bowl Espresso X-Large,Loving Pet Bella Bowl Espresso X-Large,FBALYB Amazon,-1,-1,0,0,0,0
,Loving pets 7481 bowl canister espresso,Loving pets 7481 bowl canister espresso,Default,0,0,0,0,0,12
,Loving pets 7481 bowl canister espresso,Loving pets 7481 bowl canister espresso,FBALYB Amazon,-5,-7,2,1,2,0
,"Loving Pets Bella Bowl Medium, Grape","Loving Pets Bella Bowl Medium, Grape",FBALYB Amazon,15,15,0,0,0,0
,"Loving Pets Bella Bowl Small, Grape","Loving Pets Bella Bowl Small, Grape",FBALYB Amazon,-2,-2,0,0,0,0
,Loving Pets Duck Jerky Strips Glucos12oz,Loving Pets Duck Jerky Strips Glucos12oz,FBALYB Amazon,0,0,0,2,0,0
,"Loving Pets Gobble Stopper for Dogs, Medium","Loving Pets Gobble Stopper for Dogs, Medium",Default,0,0,0,0,0,24
,"Loving Pets Gobble Stopper for Dogs, Medium","Loving Pets Gobble Stopper for Dogs, Medium",FBALYB Amazon,-1,-1,0,0,0,0
,LPS Blind Bag Series,Littlest Pet Shop See You In The City Blind Bag Series,FBALYB Amazon,46,46,0,0,0,0
,Lubriderm Lotion 3 Count,"Lubriderm Daily Moisture Lotion 2-pack, 24 FL OZ + 6 FL OZ",FBALYB Amazon,1,1,0,0,0,0
,Lumify Redness Reliever 2ct 7.5ml,Lumify Redness Reliever 2ct 7.5ml,FBALYB Amazon,-1,-1,0,0,0,0
,Lumina650,"Microsoft Lumia 650 (RM-1154) 16GB Black, 5"", Dual Sim, Unlocked Internationa...",FBALYB Amazon,-1,-1,0,0,0,0
,Lust Sexy City by Parfums Parisienne's Women EDP Perfume Spray 3.3oz,Lust Sexy City by Parfums Parisienne's Women EDP Perfume Spray 3.3oz,Default Ridgefield,381,381,0,0,0,0
,Luvabella Newborn Interactive Blonde Baby Doll,,FBALYB Amazon,-3,-3,0,0,0,0
,Luxardo Maraschino Cherries 400g 2pk,Luxardo Maraschino Cherries 400g 2pk,Default,24,24,0,0,0,0
,Luxardo Maraschino Cherries 400g 2pk,Luxardo Maraschino Cherries 400g 2pk,Default Ridgefield,471,416,55,0,55,0
,Luxardo Maraschino Cherries 400g 2pk,Luxardo Maraschino Cherries 400g 2pk,FBALYB Amazon,-1122,-1126,4,1366,4,0
,Luxardo Maraschino Cherries 400g 2pk,Luxardo Maraschino Cherries 400g 2pk,WFS,-981,-981,0,0,0,0
,Luxardo Maraschino Cherries 400g 3pk,Luxardo Maraschino Cherries 400g 3pk,Default,0,-20,20,0,0,0
,Luxardo Maraschino Cherries 400g 3pk,Luxardo Maraschino Cherries 400g 3pk,Default Ridgefield,60,36,24,0,24,0
,Luxardo Maraschino Cherries 400g 3pk,Luxardo Maraschino Cherries 400g 3pk,FBALYB Amazon,148,148,0,4,0,0
,Luxardo Maraschino Cherries 400g 3pk,Luxardo Maraschino Cherries 400g 3pk,WFS,-34,-34,0,0,0,0
,Luxardo Maraschino Cherry Jar,Luxardo Maraschino Cherry Jar,Avrami - Ebay,5218,5218,0,0,0,0
,Luxardo Maraschino Cherry Jar,Luxardo Maraschino Cherry Jar,Default Ridgefield,7481,7481,0,0,0,0
,Luxardo Maraschino Cherry Jar,Luxardo Maraschino Cherry Jar,FBALYB Amazon,-547,-553,6,689,6,0
,Luxardo Maraschino Cherry Jar,Luxardo Maraschino Cherry Jar,WFS,-3,-3,0,0,0,0
,"Lysol Advanced Disinfecting Wipes, 6x100 Citrus & Spring","Lysol Advanced Disinfecting Wipes, 6x100 Citrus & Spring",FBALYB Amazon,4,4,0,8,0,0
,Lysol Brand Disinfectant Toilet Bowl Cleaner 946 ml 2pk,Lysol Brand Disinfectant Toilet Bowl Cleaner 946 ml 2pk,Default Ridgefield,0,-600,600,0,0,0
,Lysol Brand Disinfectant Toilet Bowl Cleaner 946 ml 2pk,Lysol Brand Disinfectant Toilet Bowl Cleaner 946 ml 2pk,FBALYB Amazon,49,49,0,0,0,0
,Lysol Brand Disinfectant Toilet Bowl Cleaner 946 ml 4pk,Lysol Brand Disinfectant Toilet Bowl Cleaner 946 ml 4pk,Default Ridgefield,57,57,0,0,0,0
,Lysol Brand Disinfectant Toilet Bowl Cleaner 946 ml 4pk,Lysol Brand Disinfectant Toilet Bowl Cleaner 946 ml 4pk,FBALYB Amazon,15,15,0,0,0,0
,Lysol Simply All-purpose cleaner (No harsh),Lysol Simply All-purpose cleaner (No harsh),Default Ridgefield,1849,1849,0,0,0,0
,Lysol Simply All-purpose cleaner (No harsh),Lysol Simply All-purpose cleaner (No harsh),FBALYB Amazon,271,268,3,0,3,0
,Lysol Toilet Cleaner 32oz 2pack,Lysol Toilet Cleaner 32oz 2pack,Default Ridgefield,0,-300,300,0,0,0
,Lysol Toilet Cleaner 32oz 2pack,Lysol Toilet Cleaner 32oz 2pack,FBALYB Amazon,-5,-5,0,12,0,0
,Lysol Wipes 6 pack,"Lysol Disinfecting Wipes, 6 pack",Default,0,0,0,0,0,234
,Lysol Wipes 6 pack,"Lysol Disinfecting Wipes, 6 pack",FBALYB Amazon,-161,-161,0,53,0,0
,"MacroLife Naturals Miracle Reds Super Food, 10 Oz","MacroLife Naturals Miracle Reds Super Food, 20 Oz",FBALYB Amazon,199,199,0,0,0,0
,MadeGood Granola Mini 20ct 2pk,MadeGood Granola Mini 20ct (choc/berry) 2pk,FBALYB Amazon,-35,-35,0,38,0,0
,MadeGood Granola Mini 20ct (choc/berry),MadeGood Granola Mini 20ct (choc/berry),FBALYB Amazon,290,290,0,419,0,0
,"Made In Nature Organic Figs, 40 oz","Made In Nature Organic Figs, 40 oz",Default,0,0,0,0,0,2
,Magazine  Record Holder,Magazine  Record Holder,FBALYB Amazon,22,22,0,0,0,0
,Magic Tracks Mega Set,Magic Tracks Mega Set,Default,0,0,0,0,0,145
,Magic Tracks Mega Set,Magic Tracks Mega Set,FBALYB Amazon,-5,-5,0,12,0,0
,Magic Tracks Race Track,Magic Tracks Race Track (Random Car Color),FBALYB Amazon,-2,-2,0,0,0,0
,Maine Crisps Cranberry Almond 4oz,Maine Crisps Cranberry Almond Crisps 4oz,Default Ridgefield,10,10,0,0,0,0
,Mammoth Cottonblend 3 Knot Dog Rope Toy,Mammoth Cottonblend 3 Knot Dog Rope Toy,FBALYB Amazon,66,66,0,0,0,0
,Mammoth Large Color Monkey Fist Bar 18in,Mammoth Large Color Monkey Fist Bar 18in,Default,0,0,0,0,0,1
,Mammoth Large Color Monkey Fist Bar 18in,Mammoth Large Color Monkey Fist Bar 18in,FBALYB Amazon,35,34,1,0,1,0
,"Mammoth Pet Cottonblend 5 Knot XL 36""","Mammoth Pet Cottonblend 5 Knot XL 36""",FBALYB Amazon,91,91,0,0,0,0
,Mammoth TireBiters Large Chew Toy with Rope,Mammoth TireBiters Large Chew Toy with Rope,FBALYB Amazon,-1,-1,0,1,0,0
,Mammoth TireBiters Medium Chew Toy with Rope,Mammoth TireBiters Medium Chew Toy with Rope,FBALYB Amazon,-2,-2,0,0,0,0
,Mammoth Tirebiter Tire Dog Toy Large,Mammoth Tirebiter Tire Dog Toy Large,FBALYB Amazon,0,-9,9,0,9,0
,Mammoth Tirebiter Tire Dog Toy Medium,Mammoth Tirebiter Tire Dog Toy Medium,FBALYB Amazon,-1,-1,0,0,0,0
,Manduka Yoga Mat Black,Manduka Yoga Mat Black,Default,1,1,0,0,0,0
,Manduka Yoga Mat Black,Manduka Yoga Mat Black,FBALYB Amazon,-4,-4,0,0,0,0
,Manduka Yoga Mat Purple,Manduka Yoga Mat Purple,Default,2,2,0,0,0,0
,Manduka Yoga Mat Purple,Manduka Yoga Mat Purple,FBALYB Amazon,-3,-3,0,0,0,0
,Mane 'n Tail Detangler Spray 1 Gal,Mane 'n Tail Detangler Spray 1 Gal,Default,0,0,0,0,0,3
,Mane 'n Tail Detangler Spray 1 Gal,Mane 'n Tail Detangler Spray 1 Gal,FBALYB Amazon,12,12,0,0,0,0
,MANE & TANE SHAMPOO  2pk,MANE & TANE SHAMPOO  2pk,FBALYB Amazon,5,5,0,7,0,0
,MANE & TANE SHAMPOO  4pk,MANE & TANE SHAMPOO  4pk,FBALYB Amazon,-6,-6,0,15,0,0
,"Manic Panic - Amplified Cream Formula, After Midnight®","Manic Panic - Amplified Cream Formula, After Midnight®",FBALYB Amazon,243,240,3,0,3,0
,"Manic Panic - Amplified Cream Formula, After Midnight®","Manic Panic - Amplified Cream Formula, After Midnight®",FBALYB Canada,10,10,0,0,0,0
,"Manic Panic - Amplified Cream Formula, Cotton Candy? Pink","Manic Panic - Amplified Cream Formula, Cotton Candy? Pink",Default Ridgefield,99,99,0,0,0,0
,"Manic Panic - Amplified Cream Formula, Cotton Candy? Pink","Manic Panic - Amplified Cream Formula, Cotton Candy? Pink",FBALYB Amazon,306,306,0,0,0,0
,"Manic Panic - Amplified Cream Formula, Cotton Candy? Pink","Manic Panic - Amplified Cream Formula, Cotton Candy? Pink",FBALYB Canada,9,9,0,0,0,0
,"Manic Panic - Amplified Cream Formula, Enchanted Forest?","Manic Panic - Amplified Cream Formula, Enchanted Forest?",Default Ridgefield,84,84,0,0,0,0
,"Manic Panic - Amplified Cream Formula, Enchanted Forest?","Manic Panic - Amplified Cream Formula, Enchanted Forest?",FBALYB Amazon,118,113,5,0,5,0
,"Manic Panic - Amplified Cream Formula, Enchanted Forest?","Manic Panic - Amplified Cream Formula, Enchanted Forest?",FBALYB Canada,7,7,0,0,0,0
,"Manic Panic - Amplified Cream Formula, Green Envy?","Manic Panic - Amplified Cream Formula, Green Envy?",FBALYB Amazon,36,35,1,0,1,0
,"Manic Panic - Amplified Cream Formula, Green Envy?","Manic Panic - Amplified Cream Formula, Green Envy?",FBALYB Canada,7,7,0,0,0,0
,"Manic Panic - Amplified Cream Formula, Hot Hot? Pink","Manic Panic - Amplified Cream Formula, Hot Hot? Pink",FBALYB Amazon,103,103,0,0,0,0
,"Manic Panic - Amplified Cream Formula, Hot Hot? Pink","Manic Panic - Amplified Cream Formula, Hot Hot? Pink",FBALYB Canada,0,0,0,10,0,0
,"Manic Panic - Amplified Cream Formula, Rockabilly® Blue","Manic Panic - Amplified Cream Formula, Rockabilly® Blue",FBALYB Amazon,135,135,0,0,0,0
,"Manic Panic - Amplified Cream Formula, Rockabilly® Blue","Manic Panic - Amplified Cream Formula, Rockabilly® Blue",FBALYB Canada,5,5,0,0,0,0
,"Manic Panic - Amplified Cream Formula, Shocking? Blue","Manic Panic - Amplified Cream Formula, Shocking? Blue",FBALYB Amazon,97,97,0,0,0,0
,"Manic Panic - Amplified Cream Formula, Violet Night?","Manic Panic - Amplified Cream Formula, Violet Night?",Default Ridgefield,72,72,0,0,0,0
,"Manic Panic - Amplified Cream Formula, Violet Night?","Manic Panic - Amplified Cream Formula, Violet Night?",FBALYB Amazon,27,22,5,0,5,0
,"Manic Panic - Amplified Cream Formula, Virgin Snow?","Manic Panic - Amplified Cream Formula, Virgin Snow?",Default Ridgefield,192,192,0,0,0,0
,"Manic Panic - Amplified Cream Formula, Virgin Snow?","Manic Panic - Amplified Cream Formula, Virgin Snow?",FBALYB Amazon,173,168,5,0,5,0
,"Manic Panic - Amplified Cream Formula, Virgin Snow?","Manic Panic - Amplified Cream Formula, Virgin Snow?",FBALYB Canada,4,3,1,0,1,0
,Manic Panic Amplified UltraViolet,"Manic Panic - Amplified Cream Formula, Ultra? Violet",Default Ridgefield,143,143,0,0,0,0
,"Manic Panic - Blue Lightning Bleach Kit, Blue Lightning 30 Volume Box Kit","Manic Panic - Blue Lightning Bleach Kit, Blue Lightning 30 Volume Box Kit",Default Ridgefield,51,49,2,0,0,0
,"Manic Panic - Blue Lightning Bleach Kit, Blue Lightning 30 Volume Box Kit","Manic Panic - Blue Lightning Bleach Kit, Blue Lightning 30 Volume Box Kit",FBALYB Amazon,0,0,0,744,0,0
,"Manic Panic - Blue Lightning Bleach Kit, Blue Lightning 30 Volume Box Kit","Manic Panic - Blue Lightning Bleach Kit, Blue Lightning 30 Volume Box Kit",FBALYB Canada,3,3,0,0,0,0
,"Manic Panic - Blue Lightning Bleach Kit, Blue Lightning 30 Volume Box Kit 2 PACK","Manic Panic - Blue Lightning Bleach Kit, Blue Lightning 30 Volume Box Kit 2 PACK",Default Ridgefield,0,-1,1,0,0,0
,"Manic Panic - Blue Lightning Bleach Kit, Blue Lightning 30 Volume Box Kit 2 PACK","Manic Panic - Blue Lightning Bleach Kit, Blue Lightning 30 Volume Box Kit 2 PACK",FBALYB Amazon,0,0,0,30,0,0
,Manic Panic FleursDuMal Creamtone,"Manic Panic - Creamtones, Fleurs Du Mal? Creamtone",Default Ridgefield,95,95,0,0,0,0
,"Manic Panic - High Voltage Classic Cream Formula, After Midnight®","Manic Panic - High Voltage Classic Cream Formula, After Midnight®",Default Ridgefield,879,879,0,0,0,0
,"Manic Panic - High Voltage Classic Cream Formula, After Midnight®","Manic Panic - High Voltage Classic Cream Formula, After Midnight®",FBALYB Amazon,328,326,2,0,2,0
,"Manic Panic - High Voltage Classic Cream Formula, After Midnight 2 PACK","Manic Panic - High Voltage Classic Cream Formula, After Midnight 2 PACK",FBALYB Amazon,43,41,2,0,2,0
,"Manic Panic - High Voltage Classic Cream Formula, After Midnight 3 PACK","Manic Panic - High Voltage Classic Cream Formula, After Midnight 3 PACK",FBALYB Amazon,46,46,0,0,0,0
,"Manic Panic - High Voltage Classic Cream Formula, Alien Grey?","Manic Panic - High Voltage Classic Cream Formula, Alien Grey?",Default Ridgefield,110,110,0,0,0,0
,"Manic Panic - High Voltage Classic Cream Formula, Alien Grey?","Manic Panic - High Voltage Classic Cream Formula, Alien Grey?",FBALYB Amazon,410,406,4,0,4,0
,"Manic Panic - High Voltage Classic Cream Formula, Alien Grey?","Manic Panic - High Voltage Classic Cream Formula, Alien Grey?",FBALYB Canada,0,0,0,70,0,0
,"Manic Panic - High Voltage Classic Cream Formula, Amethyst Ashes?","Manic Panic - High Voltage Classic Cream Formula, Amethyst Ashes?",FBALYB Amazon,71,71,0,0,0,0
,"Manic Panic - High Voltage Classic Cream Formula, Atomic? Turquoise","Manic Panic - High Voltage Classic Cream Formula, Atomic? Turquoise",Default Ridgefield,436,436,0,0,0,0
,"Manic Panic - High Voltage Classic Cream Formula, Atomic? Turquoise 2 PACK","Manic Panic - High Voltage Classic Cream Formula, Atomic? Turquoise 2 PACK",FBALYB Amazon,91,90,1,0,1,0
,"Manic Panic - High Voltage Classic Cream Formula, Bad Boy? Blue","Manic Panic - High Voltage Classic Cream Formula, Bad Boy? Blue",Default Ridgefield,72,72,0,0,0,0
,"Manic Panic - High Voltage Classic Cream Formula, Bad Boy? Blue 2 PACK","Manic Panic - High Voltage Classic Cream Formula, Bad Boy? Blue 2 PACK",FBALYB Amazon,67,67,0,0,0,0
,"Manic Panic - High Voltage Classic Cream Formula, Bad Boy Blue 3 pack","Manic Panic - High Voltage Classic Cream Formula, Bad Boy Blue 3 pack",FBALYB Amazon,238,238,0,0,0,0
,"Manic Panic - High Voltage Classic Cream Formula, Bad Boy Blue 3 pack","Manic Panic - High Voltage Classic Cream Formula, Bad Boy Blue 3 pack",FBALYB Canada,6,6,0,0,0,0
,"Manic Panic - High Voltage Classic Cream Formula, Cotton Candy? Pink","Manic Panic - High Voltage Classic Cream Formula, Cotton Candy? Pink",Default Ridgefield,8,8,0,0,0,0
,"Manic Panic - High Voltage Classic Cream Formula, Cotton Candy? Pink","Manic Panic - High Voltage Classic Cream Formula, Cotton Candy? Pink",FBALYB Amazon,958,945,13,0,13,0
,"Manic Panic - High Voltage Classic Cream Formula, Dark Star","Manic Panic - High Voltage Classic Cream Formula, Dark Star",Default Ridgefield,145,145,0,0,0,0
,"Manic Panic - High Voltage Classic Cream Formula, Dark Star","Manic Panic - High Voltage Classic Cream Formula, Dark Star",FBALYB Amazon,43,40,3,0,3,0
,"Manic Panic - High Voltage Classic Cream Formula, Electric Banana®","Manic Panic - High Voltage Classic Cream Formula, Electric Banana®",FBALYB Amazon,248,247,1,0,1,0
,"Manic Panic - High Voltage Classic Cream Formula, Electric Lizard?","Manic Panic - High Voltage Classic Cream Formula, Electric Lizard?",FBALYB Amazon,809,787,22,0,22,0
,"Manic Panic - High Voltage Classic Cream Formula, Electric Lizard?","Manic Panic - High Voltage Classic Cream Formula, Electric Lizard?",FBALYB Canada,1,1,0,0,0,0
,"Manic Panic - High Voltage Classic Cream Formula, Enchanted Forest?","Manic Panic - High Voltage Classic Cream Formula, Enchanted Forest?",Default Ridgefield,10,10,0,0,0,0
,"Manic Panic - High Voltage Classic Cream Formula, Enchanted Forest?","Manic Panic - High Voltage Classic Cream Formula, Enchanted Forest?",FBALYB Amazon,233,228,5,0,5,0
,"Manic Panic - High Voltage Classic Cream Formula, Hot Hot? Pink","Manic Panic - High Voltage Classic Cream Formula, Hot Hot? Pink",Default Ridgefield,72,72,0,0,0,0
,"Manic Panic - High Voltage Classic Cream Formula, Hot Hot Pink 2 pack","Manic Panic - High Voltage Classic Cream Formula, Hot Hot Pink 2 pack",FBALYB Amazon,51,51,0,0,0,0
,"Manic Panic - High Voltage Classic Cream Formula, Plum Passion?","Manic Panic - High Voltage Classic Cream Formula, Plum Passion?",FBALYB Amazon,214,207,7,0,7,0
,"Manic Panic - High Voltage Classic Cream Formula, Psychedelic Sunset?","Manic Panic - High Voltage Classic Cream Formula, Psychedelic Sunset?",FBALYB Amazon,-46,-56,10,64,10,0
,"Manic Panic - High Voltage Classic Cream Formula, Psychedelic Sunset?","Manic Panic - High Voltage Classic Cream Formula, Psychedelic Sunset?",FBALYB Canada,1,1,0,43,0,0
,"Manic Panic - High Voltage Classic Cream Formula, Psychedelic Sunset 2PACK","Manic Panic - High Voltage Classic Cream Formula, Psychedelic Sunset 2PACK",FBALYB Amazon,85,84,1,0,1,0
,"Manic Panic - High Voltage Classic Cream Formula, Red Passion?","Manic Panic - High Voltage Classic Cream Formula, Red Passion?",Default Ridgefield,254,254,0,0,0,0
,"Manic Panic - High Voltage Classic Cream Formula, Red Passion?","Manic Panic - High Voltage Classic Cream Formula, Red Passion?",FBALYB Amazon,191,188,3,0,3,0
,"Manic Panic - High Voltage Classic Cream Formula, Red Passion?","Manic Panic - High Voltage Classic Cream Formula, Red Passion?",FBALYB Canada,7,7,0,0,0,0
,"Manic Panic - High Voltage Classic Cream Formula, Red Passion 2 PACK","Manic Panic - High Voltage Classic Cream Formula, Red Passion 2 PACK",FBALYB Amazon,68,67,1,0,1,0
,"Manic Panic - High Voltage Classic Cream Formula, Rockabilly® Blue","Manic Panic - High Voltage Classic Cream Formula, Rockabilly® Blue",Default Ridgefield,799,799,0,0,0,0
,"Manic Panic - High Voltage Classic Cream Formula, Rockabilly® Blue","Manic Panic - High Voltage Classic Cream Formula, Rockabilly® Blue",FBALYB Amazon,191,191,0,14,0,0
,"Manic Panic - High Voltage Classic Cream Formula, Rockabilly® Blue","Manic Panic - High Voltage Classic Cream Formula, Rockabilly® Blue",FBALYB Canada,-10,-10,0,85,0,0
,"Manic Panic - High Voltage Classic Cream Formula, Rockabilly Blue 2 PACK","Manic Panic - High Voltage Classic Cream Formula, Rockabilly Blue 2 PACK",FBALYB Amazon,37,37,0,0,0,0
,"Manic Panic - High Voltage Classic Cream Formula, Rock 'N' Roll® Red","Manic Panic - High Voltage Classic Cream Formula, Rock 'N' Roll® Red",FBALYB Amazon,203,197,6,0,6,0
,"Manic Panic - High Voltage Classic Cream Formula, Rock 'N' Roll® Red","Manic Panic - High Voltage Classic Cream Formula, Rock 'N' Roll® Red",FBALYB Canada,10,10,0,0,0,0
,"Manic Panic - High Voltage Classic Cream Formula, Shocking? Blue","Manic Panic - High Voltage Classic Cream Formula, Shocking? Blue",Default Ridgefield,478,478,0,0,0,0
,"Manic Panic - High Voltage Classic Cream Formula, Vampire? Red","Manic Panic - High Voltage Classic Cream Formula, Vampire? Red",FBALYB Amazon,766,758,8,0,8,0
,"Manic Panic - High Voltage Classic Cream Formula, Vampire? Red","Manic Panic - High Voltage Classic Cream Formula, Vampire? Red",FBALYB Canada,0,0,0,10,0,0
,Manic Panic HVCCF Elec Pssyct Pnk,Manic Panic - High Voltage Classic Cream Formula Electric Pussycat Pink,Default Ridgefield,456,456,0,0,0,0
,Manic Panic HVCCF Ultra? Violet,"Manic Panic - High Voltage Classic Cream Formula, Ultra? Violet",Default Ridgefield,1212,1212,0,0,0,0
,"Manic Panic - Manic Mixer/Pastel-Izer, Manic Mixer/Pastel-Izer","Manic Panic - Manic Mixer/Pastel-Izer, Manic Mixer/Pastel-Izer",Default Ridgefield,72,72,0,0,0,0
,"Manic Panic - Manic Mixer/Pastel-Izer, Manic Mixer/Pastel-Izer","Manic Panic - Manic Mixer/Pastel-Izer, Manic Mixer/Pastel-Izer",FBALYB Amazon,59,56,3,0,3,0
,"Manic Panic - Manic Mixer/Pastel-Izer, Manic Mixer/Pastel-Izer","Manic Panic - Manic Mixer/Pastel-Izer, Manic Mixer/Pastel-Izer",FBALYB Canada,1,1,0,0,0,0
,Manna Color Changing Cups 12 ct,Manna Color Changing Cups 12 ct,Default Ridgefield,1966,1966,0,0,0,0
,Manna Color Changing Cups 12 ct,Manna Color Changing Cups 12 ct,FBALYB Amazon,168,161,7,0,7,0
,Manna Pro Chick Grit 5lb 2pk,Manna Pro Chick Grit 5lb 2pk,FBALYB Amazon,6,6,0,0,0,0
,Maple brown sugar oatmeal 4 pack,"Quaker Instant Oatmeal, Maple Brown Sugar, 8 Packets Per Box (Pack of 4)",FBALYB Amazon,2,2,0,0,0,0
,Marc Anthony Argan Oil Shampoo 2 x 1L,Marc Anthony Argan Oil Shampoo & Conditioner 1L,Default Ridgefield,355,355,0,0,0,0
,Marc Anthony Argan Oil Shampoo 2 x 1L,Marc Anthony Argan Oil Shampoo & Conditioner 1L,FBALYB Amazon,497,497,0,12,0,0
,Margaritaville Concoction Maker,Margaritaville Jimmy Buffet Signature Frozen Concoction Maker DM1946,FBALYB Amazon,-4,-5,1,0,1,0
,Marineland Filter Cartridge Rite-size Z 3ct. 2pk,Marineland Filter Cartridge Rite-size Z 3ct. 2pk,Default,0,-656,656,0,0,0
,Marineland Filter Cartridge Rite-size Z 3ct. 2pk,Marineland Filter Cartridge Rite-size Z 3ct. 2pk,FBALYB Amazon,65,57,8,6,8,0
,Marineland Filter Cartridge Rite-size Z 3ct. 4pk,Marineland Filter Cartridge Rite-size Z 3ct. 4pk,Default,0,-41,41,0,0,0
,Marineland Filter Cartridge Rite-size Z 3ct. 4pk,Marineland Filter Cartridge Rite-size Z 3ct. 4pk,Default Ridgefield,60,0,60,0,0,0
,Marineland Filter Cartridge Rite-size Z 3ct. 4pk,Marineland Filter Cartridge Rite-size Z 3ct. 4pk,FBALYB Amazon,731,725,6,31,6,0
,Marineland Filter Cartridge Rite-size Z 3pk,Marineland Filter Cartridge Rite-size Z 3pk,Default,0,-2624,2624,0,0,88
,Marineland Filter Cartridge Rite-size Z 3pk,Marineland Filter Cartridge Rite-size Z 3pk,Default Ridgefield,5944,5944,0,0,0,52
,Marineland Filter Cartridge Rite-size Z 3pk,Marineland Filter Cartridge Rite-size Z 3pk,FBALYB Amazon,101,101,0,13,0,0
,MarineLand Magnum Polishing Internal Filter JH Cartridge 3ct,MarineLand Magnum Polishing Internal Filter JH Cartridge 3ct,Default,0,-274,274,0,0,0
,MarineLand Magnum Polishing Internal Filter JH Cartridge 3ct,MarineLand Magnum Polishing Internal Filter JH Cartridge 3ct,Default Ridgefield,995,995,0,0,0,128
,MarineLand Magnum Polishing Internal Filter JH Cartridge 3ct 2pk,MarineLand Magnum Polishing Internal Filter JH Cartridge 3ct 2pk,FBALYB Amazon,90,88,2,0,2,0
,MarineLand Magnum Polishing Internal Filter JH Cartridge 3ct 3PK,MarineLand Magnum Polishing Internal Filter JH Cartridge 3ct 3PK,FBALYB Amazon,2,2,0,0,0,0
,"Marineland PA0382 Neutralizing Crystals, 50oz","Marineland PA0382 White Diamond Ammonia Neutralizing Crystals, 50oz",Default Ridgefield,16,16,0,0,0,0
,"Marineland PA0382 Neutralizing Crystals, 50oz","Marineland PA0382 White Diamond Ammonia Neutralizing Crystals, 50oz",FBALYB Amazon,48,48,0,0,0,0
,Marineland Penguin 200/350 Cartridge 2pk,Marineland Penguin 200/350 Cartridge 2pk,FBALYB Amazon,-1,-1,0,0,0,0
,Marineland Penguin Rite-Size A 6ct,Marineland Penguin Rite-Size A 6ct,Default Oxford,68,68,0,0,0,0
,Marineland Penguin Rite-Size A 6ct,Marineland Penguin Rite-Size A 6ct,Default Ridgefield,78,78,0,0,0,0
,Marineland Penguin Rite-Size A 6ct 2pk,Marineland Penguin Rite-Size A 6ct 2pk,FBALYB Amazon,14,8,6,159,6,0
,Marineland Penguin Rite-Size B 6ct,Marineland Penguin Rite-Size B 6ct,Default,0,0,0,0,0,439
,Marineland Penguin Rite-Size B 6ct,Marineland Penguin Rite-Size B 6ct,Default Ridgefield,82,82,0,0,0,265
,Marineland Penguin Rite-Size B 6ct,Marineland Penguin Rite-Size B 6ct,FBALYB Amazon,-213,-220,7,276,7,0
,Marineland Penguin Rite-Size B 6ct,Marineland Penguin Rite-Size B 6ct,FBALYB Canada,21,21,0,0,0,0
,Marineland Penguin Rite-Size B 6ct 2pk,Marineland Penguin Rite-Size B 6ct 2pk,Default,0,-1,1,0,0,0
,Marineland Penguin Rite-Size B 6ct 2pk,Marineland Penguin Rite-Size B 6ct 2pk,FBALYB Amazon,156,146,10,0,10,0
,Marineland pH Regulator 8oz,Marineland pH Regulator 8oz,FBALYB Amazon,1,1,0,0,0,0
,Marmite 125G,Marmite 125G,Default,0,-240,240,0,0,0
,Marmite 125g 3pk,Marmite 125g 3pk,FBALYB Amazon,8,8,0,40,0,0
,Marmite Yeast Extract - 2 pack,Marmite Yeast Extract - 2 pack,FBALYB Amazon,59,58,1,166,1,0
,Marmite Yeast Extract 4pk,Marmite Yeast Extract 4pk,FBALYB Amazon,6,6,0,0,0,0
,Mars Chocolate Mix 205 Pieces,"Mars Chocolate Mix, 62.6 Oz, Pack Of 205 Pieces",Default,0,0,0,0,0,1
,Mars Chocolate Mix 205 Pieces,"Mars Chocolate Mix, 62.6 Oz, Pack Of 205 Pieces",FBALYB Amazon,6,6,0,0,0,0
,Mars Fishcare Shrimp Pellet 7.9oz 2pk,Mars Fishcare Shrimp Pellet 7.9oz 2pk,Default,-9,-9,0,0,0,0
,Mars Fishcare Shrimp Pellet 7.9oz 2pk,Mars Fishcare Shrimp Pellet 7.9oz 2pk,FBALYB Amazon,-1,-1,0,10,0,0
,"Marshall Baby Fresh Daily Spritz for Ferrets, 8 oz","Marshall Baby Fresh Daily Spritz for Ferrets, 8 oz",Default,0,0,0,0,0,7
,"Marshall Baby Fresh Daily Spritz for Ferrets, 8 oz","Marshall Baby Fresh Daily Spritz for Ferrets, 8 oz",FBALYB Amazon,-3,-3,0,0,0,0
,Marshall Ferret Sweatshirt Small,Marshall Ferret Sweatshirt Small,Default,3,3,0,0,0,0
,Marshall Ferret Sweatshirt Small,Marshall Ferret Sweatshirt Small,FBALYB Amazon,-5,-5,0,0,0,0
,Marshall Pet Ferret Pop-n-play,Marshall Pet Ferret Pop-n-play,Default,0,0,0,0,0,15
,Marshall Pet Ferret Pop-n-play,Marshall Pet Ferret Pop-n-play,FBALYB Amazon,-3,-3,0,0,0,0
,Marshall Pet Woven Grass Hut,Marshall Pet Products ‑ Woven Grass‑ Hut Medium ‑ RGP‑532,FBALYB Amazon,-4,-4,0,1,0,0
,Marshall Stanmore Speaker Cream,Marshall Stanmore Speaker Cream,Default,0,0,0,5,0,0
,Marshall Stanmore Speaker Cream,Marshall Stanmore Speaker Cream,Oregon,5,5,0,0,0,0
,Marvel MVA-281 Avengers Waffle Maker,"Marvel MVA-281 Avengers Waffle Maker, Blue",FBAAP Amazon,1,1,0,0,0,0
,MARYS CRACKER Variety 5.5oz Basil Garlic + Everything Seed + Rosemary + Seaweed,"MARYS CRACKER Variety 5.5oz Basil Garlic + Everything Seed + Rosemary + Seaweed	",FBALYB Amazon,136,134,2,0,2,0
,Marys Gone BlacPep NoGlute 6.5Oz,Mary's Gone Cracker Black Pepper Gluten Free 6.5 Oz,Default Ridgefield,144,144,0,0,0,0
,Mary's Gone Crackers,Mary's Gone Crackers Organic Crackers 20oz (1.25LB),Default,0,-392,392,0,0,0
,Mary's Gone Crackers,Mary's Gone Crackers Organic Crackers 20oz (1.25LB),Default Ridgefield,77,77,0,0,0,0
,Mary's Gone Crackers,Mary's Gone Crackers Organic Crackers 20oz (1.25LB),FBALYB Amazon,568,554,14,33,14,0
,Mary's Gone Crackers Crackers 20oz 2pk,Mary's Gone Crackers Crackers 20oz 2pk,FBALYB Amazon,146,143,3,13,3,0
,MARYS GONE CRACKERS SUPER SEED SEAWEED & BLACK SESAME 5.5 OZ 6pk,MARYS GONE CRACKERS SUPER SEED SEAWEED & BLACK SESAME 5.5 OZ 6pk,FBALYB Amazon,2,2,0,0,0,0
,Marys Gone Organic Herb 6.5Oz,Mary's Gone Crackers Organic Herb 6.5 Oz,Default Ridgefield,150,150,0,0,0,0
,Marys Gone Orig 6.5Oz,Mary's Gone Crackers Original 6.5 Oz,Default Ridgefield,4,4,0,0,0,0
,Marys Gone Orig 6.5Oz,Mary's Gone Crackers Original 6.5 Oz,FBALYB Amazon,163,163,0,0,0,0
,Marys Gone Orig 6.5Oz 6 pack,Marys Gone Orig 6.5Oz 6 pack,FBALYB Amazon,3,3,0,5,0,0
,Marys Gone SuperSeedBasGarl 5.5Oz,Mary’s Gone Crackers Super Seed Basil & Garlic 5.5 Oz,Default Ridgefield,10,10,0,0,0,0
,Marys Gone SuperSeedBasGarl 5.5Oz 6 pack,Marys Gone SuperSeedBasGarl 5.5Oz 6 pack,FBALYB Amazon,43,43,0,0,0,0
,Marys Gone SuperSeedEveryth 5.5Oz,MARY’s GONE CRACKERS SUPER SEED EVERYTHING 5.5 OZ,Default Ridgefield,5,5,0,0,0,0
,Marys Gone SuperSeedEveryth 5.5Oz 6 pack,Marys Gone SuperSeedEveryth 5.5Oz 6 pack,FBALYB Amazon,2,2,0,0,0,0
,Marys Gone SuperSeedOrganic 5.5Oz,Mary's Gone Crackers Super Seed Organic Crackers 5.5oz,Default Ridgefield,45,45,0,0,0,0
,Marys Gone SuperSeedOrganic 5.5Oz,Mary's Gone Crackers Super Seed Organic Crackers 5.5oz,FBALYB Amazon,3,1,2,0,2,0
,Marys Gone SuperSeedOrganic 5.5Oz 6 pack,Marys Gone SuperSeedOrganic 5.5Oz 6 pack,FBALYB Amazon,41,40,1,0,1,0
,Marys Gone SuperSeedRosemary 5 Oz 6pk,Marys Gone SuperSeedRosemary 5 Oz 6pk,Default Ridgefield,3,3,0,0,0,0
,Marys Gone SuperSeedRosemary 5 Oz 6pk,Marys Gone SuperSeedRosemary 5 Oz 6pk,FBALYB Amazon,-1,-1,0,0,0,0
,Marys Gone SuperSeedSeaWeed 5.5Oz,MARYS GONE CRACKERS SUPER SEED SEAWEED & BLACK SESAME 5.5 OZ,Default Ridgefield,3,3,0,0,0,0
,Marys Gone SuperSeedSeaWeed 5.5Oz,MARYS GONE CRACKERS SUPER SEED SEAWEED & BLACK SESAME 5.5 OZ,FBALYB Amazon,139,139,0,1,0,0
,Matrix Antioxidant Shampoo&Conditioner,Matrix Antioxidant Shampoo&Conditioner,FBALYB Amazon,76,76,0,1,0,0
,Matrix Curl Please Shampoo & Conditioner,Matrix Curl Please Shampoo & Conditioner,FBALYB Amazon,6,6,0,0,0,0
,Matrix Damage Shampoo&Conditioner 10oz,Matrix Damage Shampoo&Conditioner 10oz,FBALYB Amazon,48,48,0,1,0,0
,Matrix Design Pulse Thermo Glide Express Blowout Creme 5oz,Matrix Design Pulse Thermo Glide Express Blowout Creme 5oz,Default Ridgefield,10,10,0,0,0,0
,Matrix High Amplify Shampoo&Conditioner,Matrix High Amplify Shampoo&Conditioner,FBALYB Amazon,37,37,0,0,0,0
,Matrix Men Design Pulse Loosely Defined Texture Cream 150ml,Matrix Men Design Pulse Loosely Defined Texture Cream 150ml,Default Ridgefield,4,4,0,0,0,0
,Matrix MeRich Shampoo&Conditioner 33.8oz,Matrix MeRich Shampoo&Conditioner 33.8oz,FBALYB Amazon,0,0,0,1,0,0
,Matrix Shampoo & Conditioner 10.1 oz,Matrix Shampoo & Conditioner 10.1 oz,FBALYB Amazon,3,3,0,0,0,0
,Matrix Sleek Shampoo&Conditioner 10.1oz,Matrix Sleek Shampoo&Conditioner 10.1oz,FBALYB Amazon,-4,-4,0,28,0,0
,Matrix Sleek Shampoo&Conditioner 33.8oz,Matrix Sleek Shampoo&Conditioner 33.8oz,FBALYB Amazon,0,0,0,3,0,0
,Matrix Total Results Brass Off BLONDE THREESOME CREAM 150ML,Matrix Total Results Brass Off BLONDE THREESOME CREAM 150ML,FBALYB Amazon,31,31,0,0,0,0
,Matrix Total Results High Amplify Shampoo 1 Liter,Matrix Total Results High Amplify Shampoo 1 Liter,FBALYB Amazon,-1,-1,0,0,0,0
,Matrix Total Results So Silver Shampoo 10.1oz 300ML,Matrix Total Results So Silver Shampoo 10.1oz 300ML,FBALYB Amazon,-1,-1,0,0,0,0
,Matty m black splatter large,"Matty M Womens Soft Pants (Large, Black Splatter)",FBALYB Amazon,-1,-1,0,0,0,0
,Matty m black splatter small,"Matty M Womens Soft Pants (Small, Black Splatter)",FBALYB Amazon,-2,-2,0,0,0,0
,Matty m chevron black small,"Matty M Womens Soft Pants (Small, Black Chevron)",FBALYB Amazon,-2,-2,0,0,0,0
,Matty m med charcol,"MATTY M SOFT JERSEY MATERIAL PULL ON PANT, Charcoal, Size Medium",FBALYB Amazon,-1,-1,0,0,0,0
,"Mauna Loa Macadamia Nuts, 11 oz. 3pk","Mauna Loa Macadamia Nuts, 11 oz. 3pk",FBALYB Amazon,2,2,0,0,0,0
,Maxwell House 42.5oz,"Maxwell House The Original Roast Ground Coffee, 42.5oz",Default,0,0,0,0,0,35
,Maxwell House 42.5oz 2pk,Maxwell House 42.5oz 2pk,FBALYB Amazon,-12,-12,0,74,0,0
,Maxwell house house blend pods,"MAXWELL HOUSE House Blend Coffee, K-CUP Pods, 18 count",FBALYB Amazon,1,1,0,0,0,0
,McCormick Black Pepper 13Oz,McCormick Whole Black Pepper 13 Oz. Shaker,FBALYB Amazon,67,67,0,0,0,0
,"McCormick Fine Garlic Powder, 21 oz.","McCormick Fine Garlic Powder, 21 oz.",FBALYB Amazon,18,18,0,0,0,0
,McCormick Grill Mates Montreal Steak Seasoning 29 oz jar,McCormick Grill Mates Montreal Steak Seasoning 29 oz jar,FBALYB Amazon,-57,-57,0,754,0,0
,"McCormick Ground Cinnamon, 18 oz.","McCormick Ground Cinnamon, 18 oz.",FBALYB Amazon,-1,-1,0,0,0,0
,"McCormick Italian Seasoning, 6.25 oz.","McCormick Italian Seasoning, 6.25 oz.",FBALYB Amazon,45,45,0,0,0,0
,McCormick Montreal Chicken 23oz 2pk,McCormick Montreal Chicken 23oz 2pk,FBALYB Amazon,1,1,0,0,0,0
,McCormick Montreal Steak Spice 29oz 2pk,McCormick Montreal Steak Spice 29oz 2pk,FBALYB Amazon,1,1,0,0,0,0
,McCormick Onion Powder 22oz,McCormick Onion Powder 22oz,FBALYB Amazon,140,140,0,2,0,0
,"McCormick Oregano, 5 oz.","McCormick Oregano, 5 oz.",FBALYB Amazon,5,5,0,0,0,0
,"McCormick Oregano, 5 oz.","McCormick Oregano, 5 oz.",FBALYB Canada,10,10,0,0,0,0
,"McCormick Parsley Flakes, 2.7 oz.","McCormick Parsley Flakes, 2.7 oz.",FBALYB Amazon,-4,-4,0,0,0,0
,McCormick Steak & Chicken Bundle,Mccormick Grill Mates Montreal Steak & Chicken Seasonings Bundle,FBALYB Amazon,-18,-20,2,20,2,0
,McCormick Thyme Leaves ‑ 4 oz,McCormick Thyme Leaves ‑ 4 oz,FBALYB Amazon,2,1,1,0,1,0
,"McIlhenny Co. Tabasco Sauce, 12 oz.","McIlhenny Co. Tabasco Sauce, 12 oz.",Default Ridgefield,6,6,0,0,0,0
,"McIlhenny Co. Tabasco Sauce, 12 oz. 2pk","McIlhenny Co. Tabasco Sauce, 12 oz. 2pk",FBALYB Amazon,-440,-441,1,534,1,0
,McVities 400 gram biscuits,McVities 400 gram biscuits,Default Ridgefield,466,466,0,0,0,0
,McVities 400 gram biscuits,McVities 400 gram biscuits,FBALYB Canada,18,18,0,0,0,0
,McVities 400 gram biscuits 2PK,McVities 400 gram biscuits 2PK,FBALYB Amazon,28,27,1,0,1,0
,McVities 400 gram biscuits 3pk,McVities 400 gram biscuits 3pk,FBALYB Amazon,722,697,25,31,25,0
,McVities 400 gram biscuits 3pk,McVities 400 gram biscuits 3pk,FBALYB Canada,-1,-1,0,0,0,0
,McVities 400 gram biscuits 4pk,McVities 400 gram biscuits 4pk,FBALYB Amazon,36,34,2,11,2,0
,McVities 400 gram biscuits 4pk,McVities 400 gram biscuits 4pk,FBALYB Canada,16,16,0,0,0,0
,McVities 400 gram biscuits 6pk,McVities 400 gram biscuits 6pk,FBALYB Amazon,9,9,0,95,0,0
,McVities 400 gram biscuits 8PK,McVities 400 gram biscuits 8PK,FBALYB Amazon,57,55,2,0,2,0
,McVities Ginger Nuts 250g,McVities Ginger Nuts 250g,Default Ridgefield,4,4,0,0,0,0
,McVities Ginger Nuts 250g,McVities Ginger Nuts 250g,FBALYB Amazon,3,3,0,0,0,0
,McVities Ginger Nuts 250g 3PK,McVities Ginger Nuts 250g 3PK,FBALYB Amazon,8,8,0,0,0,0
,McVities Ginger Nuts 250g 4pk,McVities Ginger Nuts 250g 4pk,FBALYB Amazon,21,21,0,0,0,0
,McVities Ginger Nuts 250g 6pk,McVities Ginger Nuts 250g 6pk,FBALYB Amazon,-11,-11,0,1,0,0
,Mcvities Hobnob 300g 6pk,Mcvities Hobnob 300g 6pk,FBALYB Amazon,56,56,0,0,0,0
,Mcvities Hob Nops 300g,Mcvities Hob Nops 300g,Default Oxford,600,600,0,0,0,0
,Mcvities Hob Nops 300g,Mcvities Hob Nops 300g,Default Ridgefield,31,31,0,0,0,0
,Mcvities Hob Nops 300g 2PK,Mcvities Hob Nops 300g 2PK,FBALYB Amazon,-7,-10,3,0,3,0
,McVities Milk Chocolate 266g 3pk,McVities Milk Chocolate 266g 3pk,FBALYB Amazon,6,6,0,0,0,0
,McVitie's Original Hobnobs 300g 3pk,McVitie's Original Hobnobs 300g 3pk,FBALYB Amazon,-15,-17,2,0,2,0
,Mcvities Rich Tea 300g,Mcvities Rich Tea 300g,Default Ridgefield,2,2,0,0,0,0
,Mcvities Rich Tea 300g,Mcvities Rich Tea 300g,FBALYB Amazon,202,202,0,0,0,0
,Mcvities Rich Tea 300g 2PK,Mcvities Rich Tea 300g 2PK,FBALYB Amazon,4,1,3,0,3,0
,Mcvities Rich Tea 300g 3PK,Mcvities Rich Tea 300g 3PK,FBALYB Amazon,5,3,2,0,2,0
,Mcvities Rich Tea 300g 4pk,Mcvities Rich Tea 300g 4pk,FBALYB Amazon,23,13,10,0,10,0
,McVitie's Rich Tea Biscuits 300g 6pk,McVitie's Rich Tea Biscuits 300g 6pk,FBALYB Amazon,5,4,1,0,1,0
,Mcvitites Ginger Nuts 300g 4pk,Mcvitites Ginger Nuts 300g 4pk,FBALYB Amazon,6,6,0,0,0,0
,Mcvitites Ginger Nuts 300g 6pk,Mcvitites Ginger Nuts 300g 6pk,FBALYB Amazon,16,16,0,0,0,0
,Medegen Emesis Basin 500cc Gold,Medegen Emesis Basin 500cc Gold,Default Ridgefield,2146,2146,0,0,0,0
,Medical Barrier Cream 2.5 oz,Medical Barrier Cream 2.5 oz,Default Ridgefield,12,12,0,0,0,0
,Medical Barrier Cream 8.0 oz,Medical Barrier Cream 8.0 oz,Default Ridgefield,84,84,0,0,0,0
,Mega Bloks Animal Adventures,Mega Bloks Animal Adventures Playset,FBALYB Amazon,-2,-2,0,0,0,0
,Mega Bloks Cat Cement Mixer,Mega Bloks Cat Cement Mixer,FBALYB Amazon,1,1,0,0,0,0
,Mega Bloks Cat Front Loader,Mega Bloks Cat Front Loader,Default,0,-3,3,0,0,0
,Mega Bloks Cat Service Truck,Mega Bloks Service Truck Cat Tiny N Tuff,FBALYB Amazon,-1,-1,0,0,0,0
,Mega Bloks Lil' Tractor 08280q,Mega Bloks First Builders Lil' Tractor 08280q,FBALYB Amazon,3,3,0,0,0,0
,Mega Bloks Ninja Turtles Leo,Mega Bloks Teenage Mutant Ninja Turtles Animation Leo,FBALYB Amazon,11,11,0,0,0,0
,Mega Bloks Ninja Turtles Raph,Mega Bloks Teenage Mutant Ninja Turtles Animation Raph,FBALYB Amazon,12,12,0,0,0,0
,Mega Bloks Sesame Street Cookie Monsters Foodie Truck-GFG08,Mega Bloks Sesame Street Cookie Monsters Foodie Truck-GFG08,Default Oxford,1,1,0,0,0,0
,Mega Bloks Sesame Street Cookie Monsters Foodie Truck-GFG08,Mega Bloks Sesame Street Cookie Monsters Foodie Truck-GFG08,Default Ridgefield,199,199,0,0,0,0
,Mega Bloks Sesame Street Cookie Monsters Foodie Truck-GFG08,Mega Bloks Sesame Street Cookie Monsters Foodie Truck-GFG08,FBALYB Amazon,166,164,2,0,2,0
,Mega Bloks Sonny School Bus,Mega Bloks Sonny School Bus,FBALYB Amazon,4,4,0,0,0,0
,Mega Red 4in1 60ct,Mega Red 4in1 60ct,FBALYB Amazon,443,443,0,305,0,0
,MegaRed 4in1 60ct 2pk,MegaRed 4in1 60ct 2pk,FBALYB Amazon,137,137,0,0,0,0
,Mega Red 4in1 60ct 2PK,Mega Red 4in1 60ct 2PK,FBALYB Amazon,139,139,0,0,0,0
,Melitta 600 ct Coffee Filters,Melitta 600 ct Coffee Filters,FBALYB Amazon,-1,-1,0,0,0,0
,Mens Puma Master Kit 9/1/2020,Mens Puma Master Kit 9/1/2020,Avrami - Ebay,352,352,0,0,0,0
,Mens Puma Master Kit 9/1/2020,Mens Puma Master Kit 9/1/2020,Default Oxford,65,65,0,0,0,0
,Mens Puma Master Kit 9/1/2020,Mens Puma Master Kit 9/1/2020,Default Ridgefield,3,3,0,0,0,0
,Men's Sea Kite Sport Moc Boat Shoe - M 090 Dark Tan,,Default Ridgefield,15,15,0,0,0,0
,Men's Sea Kite Sport Moc Boat Shoe - M 095 Dark Tan,,Default Ridgefield,12,12,0,0,0,0
,Men's Sea Kite Sport Moc Boat Shoe - M 095 Gray,,Default Ridgefield,3,3,0,0,0,0
,Men's Sea Kite Sport Moc Boat Shoe - M 105 Dark Tan,,Default Ridgefield,15,15,0,0,0,0
,Men's Sea Kite Sport Moc Boat Shoe - M 110 Dark Tan,,Default Ridgefield,15,15,0,0,0,0
,Men's Sea Kite Sport Moc Boat Shoe - M 115 Dark Tan,,Default Ridgefield,15,15,0,0,0,0
,Men's Sea Kite Sport Moc Boat Shoe - M 120 Dark Tan,,Default Ridgefield,15,15,0,0,0,0
,Men's Skechers Black 10,Men's Skechers Black 10,Default,0,-1,1,0,0,0
,Men's Skechers Size 9.5 Black,Men's Skechers Size 9.5 Black,FBALYB Amazon,-3,-3,0,0,0,0
,"Men's Urban Star Premium Apparel Jeans / Relaxed Fit, Straight Leg (36 X 34)","Men's Urban Star Premium Apparel Jeans / Relaxed Fit, Straight Leg (36 X 34)",Default Ridgefield,5,5,0,0,0,0
,Men's Urban Star Premium Apparel Straight Leg Dark Wash Jeans Size 38x30,Men's Urban Star Premium Apparel Straight Leg Dark Wash Jeans Size 38x30,Default Ridgefield,3,3,0,0,0,0
,Mens Urban Star Straight Leg Stretch Dark Rinse Jeans Size 34x30,Mens Urban Star Straight Leg Stretch Dark Rinse Jeans Size 34x30,Default Ridgefield,4,4,0,0,0,0
,Mens Urban Star Straight Leg Stretch Grey Jeans Size 42x30,Mens Urban Star Straight Leg Stretch Grey Jeans Size 42x30,Default Ridgefield,1,1,0,0,0,0
,Mens Urban Star Straight Leg Stretch Grey Jeans Size 44x32,Mens Urban Star Straight Leg Stretch Grey Jeans Size 44x32,Default Ridgefield,1,1,0,0,0,0
,Mens Urban Star Stretch Straight Leg Relaxed Fit Jeans Midnight Blue 32 X 30,Mens Urban Star Stretch Straight Leg Relaxed Fit Jeans Midnight Blue 32 X 30,Default Ridgefield,1,1,0,0,0,0
,Mens Weatherproof Charcoal Gray Comfort Stretch Pants Sz 38 W 30 L,Mens Weatherproof Charcoal Gray Comfort Stretch Pants Sz 38 W 30 L,Default Ridgefield,1,1,0,0,0,0
,Mens Weatherproof Vintage Gray Comfort Stretch Pants ITEM # 1231034 Size 36*32 L,Mens Weatherproof Vintage Gray Comfort Stretch Pants ITEM # 1231034 Size 36*32 L,Default Ridgefield,4,4,0,0,0,0
,Mens Weatherproof Vintage Gray Comfort Stretch Pants ITEM # 1231034 Size 40*32 L,Mens Weatherproof Vintage Gray Comfort Stretch Pants ITEM # 1231034 Size 40*32 L,Default Ridgefield,6,6,0,0,0,0
,Merci Chocolate Variety Pack,Merci Chocolate Variety Pack ,Default Ridgefield,9,9,0,0,0,0
,Merci Chocolate Variety Pack,Merci Chocolate Variety Pack ,FBALYB Amazon,-33,-33,0,32,0,0
,Merell J91827 Dark Earth 10,Merell J91827 Dark Earth 10,FBALYB Amazon,-2,-2,0,0,0,0
,Merell J91827 Dark Earth 11.5,Merell J91827 Dark Earth 11.5,Default Ridgefield,10,10,0,0,0,0
,Merell J91827 Dark Earth 13,Merell J91827 Dark Earth 13,FBALYB Amazon,1,1,0,4,0,0
,Merell J91827 Dark Earth 8.5,Merell J91827 Dark Earth 8.5,FBALYB Amazon,1,1,0,0,0,0
,Merell J91827 Dark Earth 9,Merell J91827 Dark Earth 9,FBALYB Amazon,-3,-3,0,0,0,0
,Merell J91827 Dark Earth 9.5,Merell J91827 Dark Earth 9.5,FBALYB Amazon,-4,-5,1,0,1,0
,Merell MC57109 Gunsmoke/Orange 10,Merell MC57109 Gunsmoke/Orange 10,Default Ridgefield,14,14,0,0,0,0
,Merell MC57109 Gunsmoke/Orange 10.5,Merell MC57109 Gunsmoke/Orange 10.5,FBALYB Amazon,-2,-2,0,0,0,0
,Merell MC57109 Gunsmoke/Orange 13,Merell MC57109 Gunsmoke/Orange 13,FBALYB Amazon,-2,-2,0,0,0,0
,Merrell J000552 - Size 10,Merrell J000552 - Size 10,FBALYB Amazon,-8,-8,0,0,0,0
,Merrell J000552 - Size 11,Merrell J000552 - Size 11,FBALYB Amazon,-2,-2,0,0,0,0
,Merrell J000552 - Size 6,Merrell J000552 - Size 6,FBALYB Amazon,-2,-2,0,0,0,0
,Merrell J000552 - Size 6.5,Merrell J000552 - Size 6.5,FBALYB Amazon,-4,-4,0,0,0,0
,Merrell J000552 - Size 7,Merrell J000552 - Size 7,FBALYB Amazon,-11,-12,1,1,1,0
,Merrell J000552 - Size 7.5,Merrell J000552 - Size 7.5,FBALYB Amazon,-15,-15,0,1,0,0
,Merrell J000552 - Size 8,Merrell J000552 - Size 8,FBALYB Amazon,-9,-9,0,0,0,0
,Merrell J000552 - Size 8.5,Merrell J000552 - Size 8.5,FBALYB Amazon,-9,-9,0,0,0,0
,Merrell J000552 - Size 9,Merrell J000552 - Size 9,FBALYB Amazon,-14,-14,0,0,0,0
,Merrell J000552 - Size 9.5,Merrell J000552 - Size 9.5,FBALYB Amazon,-6,-6,0,0,0,0
,Merrell J000554 - Size 10,Merrell J000554 - Size 10,FBALYB Amazon,-5,-5,0,0,0,0
,Merrell J000554 - Size 6,Merrell J000554 - Size 6,FBALYB Amazon,-2,-2,0,0,0,0
,Merrell J000554 - Size 6.5,Merrell J000554 - Size 6.5,FBALYB Amazon,-1,-1,0,0,0,0
,Merrell J000554 - Size 7,Merrell J000554 - Size 7,FBALYB Amazon,-6,-6,0,0,0,0
,Merrell J000554 - Size 7.5,Merrell J000554 - Size 7.5,FBALYB Amazon,-14,-14,0,0,0,0
,Merrell J000554 - Size 8,Merrell J000554 - Size 8,FBALYB Amazon,-5,-5,0,0,0,0
,Merrell J000554 - Size 8.5,Merrell J000554 - Size 8.5,FBALYB Amazon,-7,-7,0,0,0,0
,Merrell J000554 - Size 9,Merrell J000554 - Size 9,FBALYB Amazon,-9,-9,0,1,0,0
,Merrell J000554 - Size 9.5,Merrell J000554 - Size 9.5,FBALYB Amazon,-3,-3,0,0,0,0
,Merrell J00970 - Size 9.5,Merrell J00970 - Size 9.5,FBALYB Amazon,-2,-2,0,0,0,0
,Merrell J033323 - Size 10,Merrell J033323 - Size 10,FBALYB Amazon,-11,-11,0,0,0,0
,Merrell J033323 - Size 10.5,Merrell J033323 - Size 10.5,FBALYB Amazon,-10,-10,0,0,0,0
,Merrell J033323 - Size 11,Merrell J033323 - Size 11,FBALYB Amazon,-9,-9,0,0,0,0
,Merrell J033323 - Size 11.5,Merrell J033323 - Size 11.5,FBALYB Amazon,-4,-4,0,0,0,0
,Merrell J033323 - Size 12,Merrell J033323 - Size 12,FBALYB Amazon,-3,-3,0,0,0,0
,Merrell J033323 - Size 13,Merrell J033323 - Size 13,FBALYB Amazon,-6,-6,0,0,0,0
,Merrell J033323 - Size 14,Merrell J033323 - Size 14,FBALYB Amazon,-1,-1,0,0,0,0
,Merrell J033323 - Size 8,Merrell J033323 - Size 8,FBALYB Amazon,-9,-9,0,0,0,0
,Merrell J033323 - Size 8.5,Merrell J033323 - Size 8.5,FBALYB Amazon,-4,-4,0,0,0,0
,Merrell J033323 - Size 9,Merrell J033323 - Size 9,FBALYB Amazon,-13,-13,0,0,0,0
,Merrell J033323 - Size 9.5,Merrell J033323 - Size 9.5,FBALYB Amazon,-10,-10,0,0,0,0
,Merrell J033341 - Size 10,Merrell J033341 - Size 10,Default Ridgefield,0,0,0,0,0,28
,Merrell J033341 - Size 10,Merrell J033341 - Size 10,FBALYB Amazon,3,2,1,0,1,0
,Merrell J033341 - Size 10.5,Merrell J033341 - Size 10.5,Default Ridgefield,0,0,0,0,0,28
,Merrell J033341 - Size 10.5,Merrell J033341 - Size 10.5,FBALYB Amazon,12,10,2,0,2,0
,Merrell J033341 - Size 11,Merrell J033341 - Size 11,Default Ridgefield,0,0,0,0,0,28
,Merrell J033341 - Size 11,Merrell J033341 - Size 11,FBALYB Amazon,8,4,4,0,4,0
,Merrell J033341 - Size 11.5,Merrell J033341 - Size 11.5,Default Ridgefield,0,0,0,0,0,16
,Merrell J033341 - Size 11.5,Merrell J033341 - Size 11.5,FBALYB Amazon,7,7,0,0,0,0
,Merrell J033341 - Size 12,Merrell J033341 - Size 12,Default Ridgefield,0,0,0,0,0,16
,Merrell J033341 - Size 12,Merrell J033341 - Size 12,FBALYB Amazon,3,2,1,0,1,0
,Merrell J033341 - Size 13,Merrell J033341 - Size 13,Default Ridgefield,1,1,0,0,0,16
,Merrell J033341 - Size 13,Merrell J033341 - Size 13,FBALYB Amazon,7,7,0,0,0,0
,Merrell J033341 - Size 7.5,Merrell J033341 - Size 7.5,FBALYB Amazon,-3,-3,0,0,0,0
,Merrell J033341 - Size 8.5,Merrell J033341 - Size 8.5,Default Ridgefield,0,0,0,0,0,16
,Merrell J033341 - Size 8.5,Merrell J033341 - Size 8.5,FBALYB Amazon,1,-1,2,0,2,0
,Merrell J033341 - Size 9,Merrell J033341 - Size 9,Default Ridgefield,0,0,0,0,0,16
,Merrell J033341 - Size 9,Merrell J033341 - Size 9,FBALYB Amazon,-6,-6,0,0,0,0
,Merrell J033341 - Size 9.5,Merrell J033341 - Size 9.5,Default Ridgefield,0,0,0,0,0,16
,Merrell J033341 - Size 9.5,Merrell J033341 - Size 9.5,FBALYB Amazon,-7,-8,1,0,1,0
,Merrell J033347 - Size 10,Merrell J033347 - Size 10,FBALYB Amazon,-3,-3,0,0,0,0
,Merrell J033347 - Size 10.5,Merrell J033347 - Size 10.5,FBALYB Amazon,-2,-2,0,0,0,0
,Merrell J033347 - Size 11,Merrell J033347 - Size 11,FBALYB Amazon,-7,-7,0,0,0,0
,Merrell J033347 - Size 11.5,Merrell J033347 - Size 11.5,FBALYB Amazon,-2,-2,0,0,0,0
,Merrell J033347 - Size 12,Merrell J033347 - Size 12,FBALYB Amazon,-3,-3,0,0,0,0
,Merrell J033347 - Size 13,Merrell J033347 - Size 13,FBALYB Amazon,-1,-1,0,0,0,0
,Merrell J033347 - Size 14,Merrell J033347 - Size 14,FBALYB Amazon,-1,-1,0,0,0,0
,Merrell J033347 - Size 8.5,Merrell J033347 - Size 8.5,FBALYB Amazon,-1,-1,0,0,0,0
,Merrell J033347 - Size 9,Merrell J033347 - Size 9,Default,1,1,0,0,0,0
,Merrell J033347 - Size 9,Merrell J033347 - Size 9,FBALYB Amazon,-1,-1,0,0,0,0
,Merrell J033347 - Size 9.5,Merrell J033347 - Size 9.5,FBALYB Amazon,1,1,0,0,0,0
,Merrell J034205 - Size 10,Merrell J034205 - Size 10,FBALYB Amazon,-7,-7,0,0,0,0
,Merrell J034205 - Size 10.5,Merrell J034205 - Size 10.5,FBALYB Amazon,-3,-3,0,0,0,0
,Merrell J034205 - Size 11,Merrell J034205 - Size 11,FBALYB Amazon,-11,-11,0,0,0,0
,Merrell J034205 - Size 11.5,Merrell J034205 - Size 11.5,FBALYB Amazon,-4,-4,0,0,0,0
,Merrell J034205 - Size 12,Merrell J034205 - Size 12,FBALYB Amazon,-5,-5,0,0,0,0
,Merrell J034205 - Size 13,Merrell J034205 - Size 13,FBALYB Amazon,-5,-5,0,0,0,0
,Merrell J034205 - Size 14,Merrell J034205 - Size 14,FBALYB Amazon,-3,-3,0,0,0,0
,Merrell J034205 - Size 7.5,Merrell J034205 - Size 7.5,FBALYB Amazon,-2,-2,0,0,0,0
,MERRELL J034205 - SIZE 8,MERRELL J034205 - SIZE 8 ,FBALYB Amazon,-3,-3,0,0,0,0
,Merrell J034205 - Size 9,Merrell J034205 - Size 9,FBALYB Amazon,-1,-1,0,0,0,0
,Merrell J034205 - Size 9.5,Merrell J034205 - Size 9.5,FBALYB Amazon,-8,-8,0,0,0,0
,Merrell J034207 - Size 10,Merrell J034207 - Size 10,FBALYB Amazon,-3,-3,0,0,0,0
,Merrell J034207 - Size 10.5,Merrell J034207 - Size 10.5,FBALYB Amazon,-5,-5,0,0,0,0
,Merrell J034207 - Size 11,Merrell J034207 - Size 11,FBALYB Amazon,-4,-4,0,0,0,0
,Merrell J034207 - Size 11.5,Merrell J034207 - Size 11.5,FBALYB Amazon,-6,-6,0,0,0,0
,Merrell J034207 - Size 12,Merrell J034207 - Size 12,FBALYB Amazon,-1,-1,0,0,0,0
,Merrell J034207 - Size 13,Merrell J034207 - Size 13,FBALYB Amazon,-1,-1,0,0,0,0
,Merrell J034207 - Size 14,Merrell J034207 - Size 14,FBALYB Amazon,-1,-1,0,0,0,0
,Merrell J034207 - Size 7.5,Merrell J034207 - Size 7.5,FBALYB Amazon,-2,-2,0,0,0,0
,Merrell J034207 - Size 8,Merrell J034207 - Size 8,FBALYB Amazon,-1,-1,0,0,0,0
,Merrell J034207 - Size 9,Merrell J034207 - Size 9,FBALYB Amazon,-3,-3,0,0,0,0
,Merrell J034207 - Size 9.5,Merrell J034207 - Size 9.5,FBALYB Amazon,-5,-5,0,0,0,0
,Merrell J06011 - Size 10,Merrell J06011 - Size 10,Default,1,0,1,0,0,72
,Merrell J06011 - Size 10,Merrell J06011 - Size 10,Default Ridgefield,2,2,0,0,0,408
,Merrell J06011 - Size 10,Merrell J06011 - Size 10,FBALYB Amazon,12,6,6,0,6,0
,Merrell J06011 - Size 10.5,Merrell J06011 - Size 10.5,Default,0,0,0,0,0,60
,Merrell J06011 - Size 10.5,Merrell J06011 - Size 10.5,Default Ridgefield,0,0,0,0,0,408
,Merrell J06011 - Size 10.5,Merrell J06011 - Size 10.5,FBALYB Amazon,-72,-77,5,2,5,0
,Merrell J06011 - Size 11,Merrell J06011 - Size 11,Default,0,0,0,0,0,72
,Merrell J06011 - Size 11,Merrell J06011 - Size 11,Default Ridgefield,0,0,0,0,0,408
,Merrell J06011 - Size 11,Merrell J06011 - Size 11,FBALYB Amazon,21,10,11,0,11,0
,Merrell J06011 - Size 11.5,Merrell J06011 - Size 11.5,Default,0,0,0,0,0,24
,Merrell J06011 - Size 11.5,Merrell J06011 - Size 11.5,Default Ridgefield,0,0,0,0,0,288
,Merrell J06011 - Size 11.5,Merrell J06011 - Size 11.5,FBALYB Amazon,78,68,10,1,10,0
,Merrell J06011 - Size 12,Merrell J06011 - Size 12,Default,0,0,0,0,0,36
,Merrell J06011 - Size 12,Merrell J06011 - Size 12,Default Ridgefield,0,0,0,0,0,324
,Merrell J06011 - Size 12,Merrell J06011 - Size 12,FBALYB Amazon,-34,-34,0,0,0,0
,Merrell J06011 - Size 13,Merrell J06011 - Size 13,Default,0,0,0,0,0,12
,Merrell J06011 - Size 13,Merrell J06011 - Size 13,Default Ridgefield,0,0,0,0,0,288
,Merrell J06011 - Size 13,Merrell J06011 - Size 13,FBALYB Amazon,-7,-8,1,0,1,0
,Merrell J06011 - Size 14,Merrell J06011 - Size 14,FBALYB Amazon,-1,-1,0,0,0,0
,Merrell J06011 - Size 7.5,Merrell J06011 - Size 7.5,Default Ridgefield,0,0,0,0,0,36
,Merrell J06011 - Size 7.5,Merrell J06011 - Size 7.5,FBALYB Amazon,35,31,4,0,4,0
,Merrell J06011 - Size 8,Merrell J06011 - Size 8,Default Ridgefield,13,13,0,0,0,84
,Merrell J06011 - Size 8,Merrell J06011 - Size 8,FBALYB Amazon,-15,-19,4,0,4,0
,Merrell J06011 - Size 8.5,Merrell J06011 - Size 8.5,Default,0,0,0,0,0,12
,Merrell J06011 - Size 8.5,Merrell J06011 - Size 8.5,Default Ridgefield,2,2,0,0,0,156
,Merrell J06011 - Size 8.5,Merrell J06011 - Size 8.5,FBALYB Amazon,110,100,10,36,10,0
,Merrell J06011 - Size 9,Merrell J06011 - Size 9,Default,0,0,0,0,0,24
,Merrell J06011 - Size 9,Merrell J06011 - Size 9,Default Ridgefield,1,1,0,0,0,240
,Merrell J06011 - Size 9,Merrell J06011 - Size 9,FBALYB Amazon,-20,-38,18,0,18,0
,Merrell J06011 - Size 9.5,Merrell J06011 - Size 9.5,Default,0,0,0,0,0,48
,Merrell J06011 - Size 9.5,Merrell J06011 - Size 9.5,Default Ridgefield,0,0,0,0,0,288
,Merrell J06011 - Size 9.5,Merrell J06011 - Size 9.5,FBALYB Amazon,-49,-56,7,0,7,0
,Merrell J06011W - Size 10,Merrell J06011W - Size 10,Default Ridgefield,31,31,0,0,0,84
,Merrell J06011W - Size 10,Merrell J06011W - Size 10,FBALYB Amazon,15,13,2,0,2,0
,Merrell J06011W - Size 10.5,Merrell J06011W - Size 10.5,Default Ridgefield,0,0,0,0,0,84
,Merrell J06011W - Size 10.5,Merrell J06011W - Size 10.5,FBALYB Amazon,24,20,4,14,4,0
,Merrell J06011W - Size 11,Merrell J06011W - Size 11,Default,0,0,0,0,0,1
,Merrell J06011W - Size 11,Merrell J06011W - Size 11,Default Ridgefield,0,0,0,0,0,84
,Merrell J06011W - Size 11,Merrell J06011W - Size 11,FBALYB Amazon,-32,-34,2,0,2,0
,Merrell J06011W - Size 11.5,Merrell J06011W - Size 11.5,Default Ridgefield,0,0,0,0,0,60
,Merrell J06011W - Size 11.5,Merrell J06011W - Size 11.5,FBALYB Amazon,13,11,2,0,2,0
,Merrell J06011W - Size 12,Merrell J06011W - Size 12,Default Ridgefield,29,29,0,0,0,72
,Merrell J06011W - Size 12,Merrell J06011W - Size 12,FBALYB Amazon,-27,-27,0,1,0,0
,Merrell J06011W - Size 13,Merrell J06011W - Size 13,Default Ridgefield,0,0,0,0,0,60
,Merrell J06011W - Size 13,Merrell J06011W - Size 13,FBALYB Amazon,-2,-2,0,0,0,0
,Merrell J06011W - Size 14,Merrell J06011W - Size 14,FBALYB Amazon,63,63,0,0,0,0
,Merrell J06011W - Size 8,Merrell J06011W - Size 8,Default Ridgefield,4,4,0,0,0,12
,Merrell J06011W - Size 8,Merrell J06011W - Size 8,FBALYB Amazon,20,18,2,0,2,0
,Merrell J06011W - Size 8.5,Merrell J06011W - Size 8.5,Default Ridgefield,18,18,0,0,0,36
,Merrell J06011W - Size 8.5,Merrell J06011W - Size 8.5,FBALYB Amazon,22,19,3,0,3,0
,Merrell J06011W - Size 9,Merrell J06011W - Size 9,Default Ridgefield,1,1,0,0,0,48
,Merrell J06011W - Size 9,Merrell J06011W - Size 9,FBALYB Amazon,87,84,3,0,3,0
,Merrell J06011W - Size 9.5,Merrell J06011W - Size 9.5,Default Ridgefield,0,0,0,0,0,60
,Merrell J06011W - Size 9.5,Merrell J06011W - Size 9.5,FBALYB Amazon,241,237,4,0,4,0
,Merrell J06013 - Size 10,Merrell J06013 - Size 10,Default Ridgefield,0,0,0,0,0,120
,Merrell J06013 - Size 10,Merrell J06013 - Size 10,FBALYB Amazon,-2,-2,0,0,0,0
,Merrell J06013 - Size 10.5,Merrell J06013 - Size 10.5,Default Ridgefield,0,0,0,0,0,120
,Merrell J06013 - Size 10.5,Merrell J06013 - Size 10.5,FBALYB Amazon,-6,-6,0,0,0,0
,Merrell J06013 - Size 11,Merrell J06013 - Size 11,Default Ridgefield,0,0,0,0,0,120
,Merrell J06013 - Size 11,Merrell J06013 - Size 11,FBALYB Amazon,-10,-10,0,6,0,0
,Merrell J06013 - Size 11.5,Merrell J06013 - Size 11.5,Default Ridgefield,0,0,0,0,0,96
,Merrell J06013 - Size 11.5,Merrell J06013 - Size 11.5,FBALYB Amazon,10,10,0,0,0,0
,Merrell J06013 - Size 12,Merrell J06013 - Size 12,Default,18,18,0,0,0,0
,Merrell J06013 - Size 12,Merrell J06013 - Size 12,Default Ridgefield,0,0,0,0,0,96
,Merrell J06013 - Size 12,Merrell J06013 - Size 12,FBALYB Amazon,-18,-18,0,0,0,0
,Merrell J06013 - Size 13,Merrell J06013 - Size 13,Default Ridgefield,0,0,0,0,0,96
,Merrell J06013 - Size 14,Merrell J06013 - Size 14,FBALYB Amazon,-3,-3,0,0,0,0
,Merrell J06013 - Size 8,Merrell J06013 - Size 8,Default Ridgefield,0,0,0,0,0,24
,Merrell J06013 - Size 8,Merrell J06013 - Size 8,FBALYB Amazon,-9,-9,0,0,0,0
,Merrell J06013 - Size 8.5,Merrell J06013 - Size 8.5,Default Ridgefield,0,0,0,0,0,48
,Merrell J06013 - Size 8.5,Merrell J06013 - Size 8.5,FBALYB Amazon,-2,-2,0,0,0,0
,Merrell J06013 - Size 9,Merrell J06013 - Size 9,Default Ridgefield,0,0,0,0,0,72
,Merrell J06013 - Size 9.5,Merrell J06013 - Size 9.5,Default Ridgefield,0,0,0,0,0,96
,Merrell J06013 - Size 9.5,Merrell J06013 - Size 9.5,FBALYB Amazon,-8,-8,0,0,0,0
,Merrell J06014 - Size 10,Merrell J06014 - Size 10,Default Ridgefield,84,84,0,0,0,84
,Merrell J06014 - Size 10,Merrell J06014 - Size 10,FBALYB Amazon,-54,-62,8,71,8,0
,Merrell J06014 - Size 10.5,Merrell J06014 - Size 10.5,Default Ridgefield,48,48,0,0,0,48
,Merrell J06014 - Size 10.5,Merrell J06014 - Size 10.5,FBALYB Amazon,-7,-8,1,1,1,0
,Merrell J06014 - Size 11,Merrell J06014 - Size 11,Default,0,-1,1,0,0,0
,Merrell J06014 - Size 11,Merrell J06014 - Size 11,Default Ridgefield,36,36,0,0,0,36
,Merrell J06014 - Size 11,Merrell J06014 - Size 11,FBALYB Amazon,44,43,1,0,1,0
,Merrell J06014 - Size 5.5,Merrell J06014 - Size 5.5,Default Ridgefield,58,58,0,0,0,36
,Merrell J06014 - Size 5.5,Merrell J06014 - Size 5.5,FBALYB Amazon,21,21,0,0,0,0
,Merrell J06014 - Size 6,Merrell J06014 - Size 6,Default Ridgefield,60,60,0,0,0,60
,Merrell J06014 - Size 6,Merrell J06014 - Size 6,FBALYB Amazon,18,13,5,0,5,0
,Merrell J06014 - Size 6.5,Merrell J06014 - Size 6.5,Default Ridgefield,161,161,0,0,0,84
,Merrell J06014 - Size 6.5,Merrell J06014 - Size 6.5,FBALYB Amazon,4,2,2,0,2,0
,Merrell J06014 - Size 7,Merrell J06014 - Size 7,Default Ridgefield,173,173,0,0,0,168
,Merrell J06014 - Size 7,Merrell J06014 - Size 7,FBALYB Amazon,39,31,8,1,8,0
,Merrell J06014 - Size 7.5,Merrell J06014 - Size 7.5,Default Ridgefield,189,189,0,0,0,120
,Merrell J06014 - Size 7.5,Merrell J06014 - Size 7.5,FBALYB Amazon,-190,-205,15,137,15,0
,Merrell J06014 - Size 8,Merrell J06014 - Size 8,Default Ridgefield,169,169,0,0,0,168
,Merrell J06014 - Size 8,Merrell J06014 - Size 8,FBALYB Amazon,63,53,10,1,10,0
,Merrell J06014 - Size 8.5,Merrell J06014 - Size 8.5,Default Ridgefield,2,2,0,0,0,168
,Merrell J06014 - Size 8.5,Merrell J06014 - Size 8.5,FBALYB Amazon,2,-6,8,115,8,0
,Merrell J06014 - Size 9,Merrell J06014 - Size 9,Default Ridgefield,75,75,0,0,0,168
,Merrell J06014 - Size 9,Merrell J06014 - Size 9,FBALYB Amazon,-94,-110,16,140,16,0
,Merrell J06014 - Size 9.5,Merrell J06014 - Size 9.5,Default Ridgefield,144,144,0,0,0,120
,Merrell J06014 - Size 9.5,Merrell J06014 - Size 9.5,FBALYB Amazon,-1,-10,9,70,9,0
,Merrell J06014W - Size 10,Merrell J06014W - Size 10,Default Ridgefield,0,0,0,0,0,36
,Merrell J06014W - Size 10,Merrell J06014W - Size 10,FBALYB Amazon,24,22,2,0,2,0
,Merrell J06014W - Size 10.5,Merrell J06014W - Size 10.5,Default Ridgefield,0,0,0,0,0,24
,Merrell J06014W - Size 10.5,Merrell J06014W - Size 10.5,FBALYB Amazon,-4,-4,0,0,0,0
,Merrell J06014W - Size 11,Merrell J06014W - Size 11,Default Ridgefield,0,0,0,0,0,12
,Merrell J06014W - Size 11,Merrell J06014W - Size 11,FBALYB Amazon,23,23,0,0,0,0
,Merrell J06014W - Size 6.5,Merrell J06014W - Size 6.5,Default Ridgefield,2,2,0,0,0,36
,Merrell J06014W - Size 6.5,Merrell J06014W - Size 6.5,FBALYB Amazon,54,53,1,0,1,0
,Merrell J06014W - Size 7,Merrell J06014W - Size 7,Default Ridgefield,-1,-1,0,0,0,60
,Merrell J06014W - Size 7,Merrell J06014W - Size 7,FBALYB Amazon,-4,-4,0,1,0,0
,Merrell J06014W - Size 7.5,Merrell J06014W - Size 7.5,Default Ridgefield,0,0,0,0,0,48
,Merrell J06014W - Size 7.5,Merrell J06014W - Size 7.5,FBALYB Amazon,32,31,1,0,1,0
,Merrell J06014W - Size 8,Merrell J06014W - Size 8,Default Ridgefield,5,5,0,0,0,60
,Merrell J06014W - Size 8,Merrell J06014W - Size 8,FBALYB Amazon,10,8,2,0,2,0
,Merrell J06014W - Size 8.5,Merrell J06014W - Size 8.5,Default Ridgefield,3,3,0,0,0,60
,Merrell J06014W - Size 8.5,Merrell J06014W - Size 8.5,FBALYB Amazon,42,42,0,0,0,0
,Merrell J06014W - Size 9,Merrell J06014W - Size 9,Default Ridgefield,0,0,0,0,0,60
,Merrell J06014W - Size 9,Merrell J06014W - Size 9,FBALYB Amazon,31,31,0,0,0,0
,Merrell J06014W - Size 9.5,Merrell J06014W - Size 9.5,Default Ridgefield,0,0,0,0,0,48
,Merrell J06014W - Size 9.5,Merrell J06014W - Size 9.5,FBALYB Amazon,90,90,0,0,0,0
,Merrell J06015 - Size 10,Merrell J06015 - Size 10,Default Ridgefield,144,144,0,0,0,144
,Merrell J06015 - Size 10,Merrell J06015 - Size 10,FBALYB Amazon,-7,-7,0,0,0,0
,Merrell J06015 - Size 10.5,Merrell J06015 - Size 10.5,Default Ridgefield,144,144,0,0,0,144
,Merrell J06015 - Size 10.5,Merrell J06015 - Size 10.5,FBALYB Amazon,-13,-13,0,0,0,0
,Merrell J06015 - Size 11,Merrell J06015 - Size 11,Default Ridgefield,144,144,0,0,0,144
,Merrell J06015 - Size 11,Merrell J06015 - Size 11,FBALYB Amazon,-8,-8,0,0,0,0
,Merrell J06015 - Size 11.5,Merrell J06015 - Size 11.5,Default Ridgefield,96,96,0,0,0,96
,Merrell J06015 - Size 11.5,Merrell J06015 - Size 11.5,FBALYB Amazon,-7,-7,0,0,0,0
,Merrell J06015 - Size 12,Merrell J06015 - Size 12,Default Ridgefield,108,108,0,0,0,108
,Merrell J06015 - Size 12,Merrell J06015 - Size 12,FBALYB Amazon,-1,-1,0,0,0,0
,Merrell J06015 - Size 13,Merrell J06015 - Size 13,Default Ridgefield,96,96,0,0,0,96
,Merrell J06015 - Size 13,Merrell J06015 - Size 13,FBALYB Amazon,-2,-2,0,0,0,0
,Merrell J06015 - Size 14,Merrell J06015 - Size 14,FBALYB Amazon,-1,-1,0,0,0,0
,Merrell J06015 - Size 7.5,Merrell J06015 - Size 7.5,Default Ridgefield,12,12,0,0,0,12
,Merrell J06015 - Size 7.5,Merrell J06015 - Size 7.5,FBALYB Amazon,-1,-1,0,0,0,0
,Merrell J06015 - Size 8,Merrell J06015 - Size 8,Default Ridgefield,24,24,0,0,0,24
,Merrell J06015 - Size 8,Merrell J06015 - Size 8,FBALYB Amazon,-3,-3,0,0,0,0
,Merrell J06015 - Size 8.5,Merrell J06015 - Size 8.5,Default Ridgefield,60,60,0,0,0,60
,Merrell J06015 - Size 9,Merrell J06015 - Size 9,Default Ridgefield,84,84,0,0,0,84
,Merrell J06015 - Size 9,Merrell J06015 - Size 9,FBALYB Amazon,-4,-4,0,0,0,0
,Merrell J06015 - Size 9.5,Merrell J06015 - Size 9.5,Default Ridgefield,96,96,0,0,0,96
,Merrell J06015 - Size 9.5,Merrell J06015 - Size 9.5,FBALYB Amazon,-7,-7,0,0,0,0
,Merrell J06015W - Size 10,Merrell J06015W - Size 10,Default Ridgefield,12,12,0,0,0,48
,Merrell J06015W - Size 10,Merrell J06015W - Size 10,FBALYB Amazon,41,39,2,0,2,0
,Merrell J06015W - Size 10.5,Merrell J06015W - Size 10.5,Default Ridgefield,0,0,0,0,0,48
,Merrell J06015W - Size 10.5,Merrell J06015W - Size 10.5,FBALYB Amazon,-5,-5,0,0,0,0
,Merrell J06015W - Size 11,Merrell J06015W - Size 11,Default Ridgefield,1,1,0,0,0,48
,Merrell J06015W - Size 11,Merrell J06015W - Size 11,FBALYB Amazon,17,15,2,0,2,0
,Merrell J06015W - Size 11.5,Merrell J06015W - Size 11.5,Default Ridgefield,0,0,0,0,0,36
,Merrell J06015W - Size 11.5,Merrell J06015W - Size 11.5,FBALYB Amazon,65,64,1,0,1,0
,Merrell J06015W - Size 12,Merrell J06015W - Size 12,Default Ridgefield,0,0,0,0,0,36
,Merrell J06015W - Size 12,Merrell J06015W - Size 12,FBALYB Amazon,-17,-17,0,0,0,0
,Merrell J06015W - Size 13,Merrell J06015W - Size 13,Default Ridgefield,0,0,0,0,0,36
,Merrell J06015W - Size 13,Merrell J06015W - Size 13,FBALYB Amazon,-1,-1,0,0,0,0
,Merrell J06015W - Size 7.5,Merrell J06015W - Size 7.5,FBALYB Amazon,2,-1,3,5,3,0
,Merrell J06015W - Size 8,Merrell J06015W - Size 8,Default Ridgefield,0,-1,1,0,0,12
,Merrell J06015W - Size 8,Merrell J06015W - Size 8,FBALYB Amazon,14,14,0,8,0,0
,Merrell J06015W - Size 8.5,Merrell J06015W - Size 8.5,Default Ridgefield,2,2,0,0,0,12
,Merrell J06015W - Size 8.5,Merrell J06015W - Size 8.5,FBALYB Amazon,35,35,0,0,0,0
,Merrell J06015W - Size 9,Merrell J06015W - Size 9,Default,2,2,0,0,0,0
,Merrell J06015W - Size 9,Merrell J06015W - Size 9,Default Ridgefield,1,1,0,0,0,24
,Merrell J06015W - Size 9,Merrell J06015W - Size 9,FBALYB Amazon,62,61,1,0,1,0
,Merrell J06015W - Size 9.5,Merrell J06015W - Size 9.5,Default Ridgefield,1,1,0,0,0,36
,Merrell J06015W - Size 9.5,Merrell J06015W - Size 9.5,FBALYB Amazon,3,2,1,6,1,0
,Merrell J06017 - Size 10,Merrell J06017 - Size 10,Default,0,0,0,0,0,72
,Merrell J06017 - Size 10,Merrell J06017 - Size 10,Default Ridgefield,0,0,0,0,0,384
,Merrell J06017 - Size 10,Merrell J06017 - Size 10,FBALYB Amazon,1,0,1,28,1,0
,Merrell J06017 - Size 10.5,Merrell J06017 - Size 10.5,Default,0,0,0,0,0,60
,Merrell J06017 - Size 10.5,Merrell J06017 - Size 10.5,Default Ridgefield,0,0,0,0,0,384
,Merrell J06017 - Size 10.5,Merrell J06017 - Size 10.5,FBALYB Amazon,-17,-17,0,2,0,0
,Merrell J06017 - Size 11,Merrell J06017 - Size 11,Default,0,0,0,0,0,72
,Merrell J06017 - Size 11,Merrell J06017 - Size 11,Default Ridgefield,0,0,0,0,0,384
,Merrell J06017 - Size 11,Merrell J06017 - Size 11,FBALYB Amazon,-48,-48,0,25,0,0
,Merrell J06017 - Size 11.5,Merrell J06017 - Size 11.5,Default,0,0,0,0,0,24
,Merrell J06017 - Size 11.5,Merrell J06017 - Size 11.5,Default Ridgefield,0,0,0,0,0,288
,Merrell J06017 - Size 11.5,Merrell J06017 - Size 11.5,FBALYB Amazon,-53,-53,0,0,0,0
,Merrell J06017 - Size 12,Merrell J06017 - Size 12,Default,0,0,0,0,0,36
,Merrell J06017 - Size 12,Merrell J06017 - Size 12,Default Ridgefield,0,0,0,0,0,312
,Merrell J06017 - Size 12,Merrell J06017 - Size 12,FBALYB Amazon,-21,-21,0,3,0,0
,Merrell J06017 - Size 13,Merrell J06017 - Size 13,Default,0,0,0,0,0,12
,Merrell J06017 - Size 13,Merrell J06017 - Size 13,Default Ridgefield,0,0,0,0,0,288
,Merrell J06017 - Size 13,Merrell J06017 - Size 13,FBALYB Amazon,-5,-5,0,0,0,0
,Merrell J06017 - Size 14,Merrell J06017 - Size 14,FBALYB Amazon,-1,-2,1,0,1,0
,Merrell J06017 - Size 7.5,Merrell J06017 - Size 7.5,Default Ridgefield,0,0,0,0,0,48
,Merrell J06017 - Size 7.5,Merrell J06017 - Size 7.5,FBALYB Amazon,-2,-2,0,13,0,0
,Merrell J06017 - Size 8,Merrell J06017 - Size 8,Default,0,0,0,0,0,12
,Merrell J06017 - Size 8,Merrell J06017 - Size 8,Default Ridgefield,0,0,0,0,0,72
,Merrell J06017 - Size 8,Merrell J06017 - Size 8,FBALYB Amazon,12,12,0,21,0,0
,Merrell J06017 - Size 8.5,Merrell J06017 - Size 8.5,Default,0,0,0,0,0,24
,Merrell J06017 - Size 8.5,Merrell J06017 - Size 8.5,Default Ridgefield,0,0,0,0,0,144
,Merrell J06017 - Size 8.5,Merrell J06017 - Size 8.5,FBALYB Amazon,36,36,0,20,0,0
,Merrell J06017 - Size 9,Merrell J06017 - Size 9,Default Ridgefield,72,72,0,0,0,216
,Merrell J06017 - Size 9,Merrell J06017 - Size 9,FBALYB Amazon,-15,-16,1,0,1,0
,Merrell J06017 - Size 9.5,Merrell J06017 - Size 9.5,Default,0,0,0,0,0,48
,Merrell J06017 - Size 9.5,Merrell J06017 - Size 9.5,Default Ridgefield,12,12,0,0,0,288
,Merrell J06017 - Size 9.5,Merrell J06017 - Size 9.5,FBALYB Amazon,27,27,0,0,0,0
,Merrell J06018 - Size 10,Merrell J06018 - Size 10,Default Ridgefield,36,36,0,0,0,72
,Merrell J06018 - Size 10,Merrell J06018 - Size 10,FBALYB Amazon,24,24,0,0,0,0
,Merrell J06018 - Size 10.5,Merrell J06018 - Size 10.5,Default Ridgefield,24,24,0,0,0,48
,Merrell J06018 - Size 10.5,Merrell J06018 - Size 10.5,FBALYB Amazon,12,12,0,0,0,0
,Merrell J06018 - Size 11,Merrell J06018 - Size 11,Default Ridgefield,12,12,0,0,0,24
,Merrell J06018 - Size 11,Merrell J06018 - Size 11,FBALYB Amazon,17,17,0,0,0,0
,Merrell J06018 - Size 11.5,Merrell J06018 - Size 11.5,Default Ridgefield,20,20,0,0,0,0
,Merrell J06018 - Size 11.5,Merrell J06018 - Size 11.5,FBALYB Amazon,-11,-11,0,0,0,0
,Merrell J06018 - Size 12,Merrell J06018 - Size 12,Default Ridgefield,15,15,0,0,0,0
,Merrell J06018 - Size 12,Merrell J06018 - Size 12,FBALYB Amazon,1,1,0,0,0,0
,Merrell J06018 - Size 5.5,Merrell J06018 - Size 5.5,Default Ridgefield,12,12,0,0,0,24
,Merrell J06018 - Size 5.5,Merrell J06018 - Size 5.5,FBALYB Amazon,9,9,0,0,0,0
,Merrell J06018 - Size 6,Merrell J06018 - Size 6,Default Ridgefield,24,24,0,0,0,48
,Merrell J06018 - Size 6,Merrell J06018 - Size 6,FBALYB Amazon,3,2,1,0,1,0
,Merrell J06018 - Size 6.5,Merrell J06018 - Size 6.5,Default Ridgefield,12,12,0,0,0,72
,Merrell J06018 - Size 6.5,Merrell J06018 - Size 6.5,FBALYB Amazon,-5,-6,1,24,1,0
,Merrell J06018 - Size 7,Merrell J06018 - Size 7,Default Ridgefield,60,60,0,0,0,120
,Merrell J06018 - Size 7,Merrell J06018 - Size 7,FBALYB Amazon,1,1,0,0,0,0
,Merrell J06018 - Size 7.5,Merrell J06018 - Size 7.5,Default Ridgefield,48,48,0,0,0,96
,Merrell J06018 - Size 7.5,Merrell J06018 - Size 7.5,FBALYB Amazon,9,5,4,0,4,0
,Merrell J06018 - Size 8,Merrell J06018 - Size 8,Default Ridgefield,36,36,0,0,0,144
,Merrell J06018 - Size 8,Merrell J06018 - Size 8,FBALYB Amazon,-5,-7,2,0,2,0
,Merrell J06018 - Size 8.5,Merrell J06018 - Size 8.5,Default Ridgefield,60,60,0,0,0,144
,Merrell J06018 - Size 8.5,Merrell J06018 - Size 8.5,FBALYB Amazon,2,1,1,12,1,0
,Merrell J06018 - Size 9,Merrell J06018 - Size 9,Default Ridgefield,73,73,0,0,0,144
,Merrell J06018 - Size 9.5,Merrell J06018 - Size 9.5,Default Ridgefield,54,54,0,0,0,96
,Merrell J06018 - Size 9.5,Merrell J06018 - Size 9.5,FBALYB Amazon,2,0,2,0,2,0
,Merrell J06020 - Size 10,Merrell J06020 - Size 10,Default,18,18,0,0,0,0
,Merrell J06020 - Size 10,Merrell J06020 - Size 10,Default Ridgefield,36,36,0,0,0,72
,Merrell J06020 - Size 10,Merrell J06020 - Size 10,FBALYB Amazon,-15,-15,0,0,0,0
,Merrell J06020 - Size 10.5,Merrell J06020 - Size 10.5,Default Ridgefield,12,12,0,0,0,48
,Merrell J06020 - Size 10.5,Merrell J06020 - Size 10.5,FBALYB Amazon,1,0,1,0,1,0
,Merrell J06020 - Size 11,Merrell J06020 - Size 11,Default Ridgefield,3,3,0,0,0,24
,Merrell J06020 - Size 11,Merrell J06020 - Size 11,FBALYB Amazon,22,21,1,0,1,0
,Merrell J06020 - Size 5.5,Merrell J06020 - Size 5.5,Default Ridgefield,22,22,0,0,0,24
,Merrell J06020 - Size 5.5,Merrell J06020 - Size 5.5,FBALYB Amazon,10,10,0,0,0,0
,Merrell J06020 - Size 6,Merrell J06020 - Size 6,Default Ridgefield,6,6,0,0,0,48
,Merrell J06020 - Size 6,Merrell J06020 - Size 6,FBALYB Amazon,-2,-2,0,18,0,0
,Merrell J06020 - Size 6.5,Merrell J06020 - Size 6.5,Default,12,12,0,0,0,0
,Merrell J06020 - Size 6.5,Merrell J06020 - Size 6.5,Default Ridgefield,36,36,0,0,0,72
,Merrell J06020 - Size 6.5,Merrell J06020 - Size 6.5,FBALYB Amazon,-14,-15,1,0,1,0
,Merrell J06020 - Size 7,Merrell J06020 - Size 7,Default,36,36,0,0,0,0
,Merrell J06020 - Size 7,Merrell J06020 - Size 7,Default Ridgefield,97,97,0,0,0,144
,Merrell J06020 - Size 7,Merrell J06020 - Size 7,FBALYB Amazon,-27,-28,1,0,1,0
,Merrell J06020 - Size 7.5,Merrell J06020 - Size 7.5,Default Ridgefield,12,12,0,0,0,96
,Merrell J06020 - Size 7.5,Merrell J06020 - Size 7.5,FBALYB Amazon,25,24,1,0,1,0
,Merrell J06020 - Size 8,Merrell J06020 - Size 8,Default Ridgefield,74,74,0,0,0,144
,Merrell J06020 - Size 8,Merrell J06020 - Size 8,FBALYB Amazon,33,30,3,0,3,0
,Merrell J06020 - Size 8.5,Merrell J06020 - Size 8.5,Default,48,48,0,0,0,0
,Merrell J06020 - Size 8.5,Merrell J06020 - Size 8.5,Default Ridgefield,72,72,0,0,0,144
,Merrell J06020 - Size 8.5,Merrell J06020 - Size 8.5,FBALYB Amazon,-2,-6,4,0,4,0
,Merrell J06020 - Size 9,Merrell J06020 - Size 9,Default Ridgefield,12,12,0,0,0,144
,Merrell J06020 - Size 9,Merrell J06020 - Size 9,FBALYB Amazon,-6,-7,1,0,1,0
,Merrell J06020 - Size 9.5,Merrell J06020 - Size 9.5,Default,24,24,0,0,0,0
,Merrell J06020 - Size 9.5,Merrell J06020 - Size 9.5,Default Ridgefield,49,49,0,0,0,96
,Merrell J06020 - Size 9.5,Merrell J06020 - Size 9.5,FBALYB Amazon,1,0,1,0,1,0
,Merrell J06023 - Size 10,Merrell J06023 - Size 10,FBALYB Amazon,171,165,6,0,6,0
,Merrell J06023 - Size 10.5,Merrell J06023 - Size 10.5,FBALYB Amazon,101,100,1,0,1,0
,Merrell J06023 - Size 11,Merrell J06023 - Size 11,Default Ridgefield,105,105,0,0,0,0
,Merrell J06023 - Size 11,Merrell J06023 - Size 11,FBALYB Amazon,67,66,1,0,1,0
,Merrell J06023 - Size 11.5,Merrell J06023 - Size 11.5,FBALYB Amazon,145,144,1,0,1,0
,Merrell J06023 - Size 12,Merrell J06023 - Size 12,FBALYB Amazon,71,70,1,0,1,0
,Merrell J06023 - Size 13,Merrell J06023 - Size 13,Default Ridgefield,2,2,0,0,0,0
,Merrell J06023 - Size 13,Merrell J06023 - Size 13,FBALYB Amazon,-1,-1,0,0,0,0
,Merrell J06023 - Size 14,Merrell J06023 - Size 14,Default Ridgefield,7,7,0,0,0,0
,Merrell J06023 - Size 14,Merrell J06023 - Size 14,FBALYB Amazon,4,4,0,0,0,0
,Merrell J06023 - Size 7.5,Merrell J06023 - Size 7.5,Default Ridgefield,18,18,0,0,0,0
,Merrell J06023 - Size 7.5,Merrell J06023 - Size 7.5,FBALYB Amazon,10,9,1,0,1,0
,Merrell J06023 - Size 8,Merrell J06023 - Size 8,Default Ridgefield,33,33,0,0,0,0
,Merrell J06023 - Size 8,Merrell J06023 - Size 8,FBALYB Amazon,12,12,0,0,0,0
,Merrell J06023 - Size 8.5,Merrell J06023 - Size 8.5,FBALYB Amazon,71,67,4,0,4,0
,Merrell J06023 - Size 9,Merrell J06023 - Size 9,FBALYB Amazon,72,71,1,0,1,0
,Merrell J06023 - Size 9.5,Merrell J06023 - Size 9.5,FBALYB Amazon,87,85,2,0,2,0
,Merrell J06025 - Size 10,Merrell J06025 - Size 10,Default Ridgefield,60,60,0,0,0,120
,Merrell J06025 - Size 10,Merrell J06025 - Size 10,FBALYB Amazon,-16,-18,2,0,2,0
,Merrell J06025 - Size 10.5,Merrell J06025 - Size 10.5,Default Ridgefield,60,60,0,0,0,120
,Merrell J06025 - Size 10.5,Merrell J06025 - Size 10.5,FBALYB Amazon,-26,-26,0,0,0,0
,Merrell J06025 - Size 11,Merrell J06025 - Size 11,Default Ridgefield,60,60,0,0,0,120
,Merrell J06025 - Size 11,Merrell J06025 - Size 11,FBALYB Amazon,-9,-9,0,0,0,0
,Merrell J06025 - Size 11.5,Merrell J06025 - Size 11.5,Default Ridgefield,36,36,0,0,0,72
,Merrell J06025 - Size 11.5,Merrell J06025 - Size 11.5,FBALYB Amazon,-9,-9,0,0,0,0
,Merrell J06025 - Size 12,Merrell J06025 - Size 12,Default Ridgefield,23,23,0,0,0,96
,Merrell J06025 - Size 12,Merrell J06025 - Size 12,FBALYB Amazon,34,33,1,0,1,0
,Merrell J06025 - Size 13,Merrell J06025 - Size 13,Default Ridgefield,36,36,0,0,0,72
,Merrell J06025 - Size 13,Merrell J06025 - Size 13,FBALYB Amazon,-2,-2,0,0,0,0
,Merrell J06025 - Size 14,Merrell J06025 - Size 14,FBALYB Amazon,-4,-4,0,0,0,0
,Merrell J06025 - Size 8,Merrell J06025 - Size 8,Default Ridgefield,12,12,0,0,0,24
,Merrell J06025 - Size 8,Merrell J06025 - Size 8,FBALYB Amazon,-4,-4,0,12,0,0
,Merrell J06025 - Size 8.5,Merrell J06025 - Size 8.5,Default Ridgefield,11,11,0,0,0,48
,Merrell J06025 - Size 8.5,Merrell J06025 - Size 8.5,FBALYB Amazon,24,24,0,0,0,0
,Merrell J06025 - Size 9,Merrell J06025 - Size 9,Default Ridgefield,36,36,0,0,0,72
,Merrell J06025 - Size 9,Merrell J06025 - Size 9,FBALYB Amazon,-10,-10,0,43,0,0
,Merrell J06025 - Size 9.5,Merrell J06025 - Size 9.5,Default Ridgefield,36,36,0,0,0,72
,Merrell J06025 - Size 9.5,Merrell J06025 - Size 9.5,FBALYB Amazon,27,27,0,0,0,0
,Merrell J06028 - Size 10,Merrell J06028 - Size 10,Default,0,0,0,0,0,24
,Merrell J06028 - Size 10,Merrell J06028 - Size 10,Default Ridgefield,17,17,0,0,0,36
,Merrell J06028 - Size 10,Merrell J06028 - Size 10,FBALYB Amazon,-4,-4,0,19,0,0
,Merrell J06028 - Size 10.5,Merrell J06028 - Size 10.5,Default Ridgefield,32,32,0,0,0,24
,Merrell J06028 - Size 10.5,Merrell J06028 - Size 10.5,FBALYB Amazon,6,6,0,0,0,0
,Merrell J06028 - Size 11,Merrell J06028 - Size 11,Default Ridgefield,12,12,0,0,0,12
,Merrell J06028 - Size 11,Merrell J06028 - Size 11,FBALYB Amazon,37,36,1,0,1,0
,Merrell J06028 - Size 6,Merrell J06028 - Size 6,Default,0,0,0,0,0,12
,Merrell J06028 - Size 6,Merrell J06028 - Size 6,Default Ridgefield,24,24,0,0,0,24
,Merrell J06028 - Size 6,Merrell J06028 - Size 6,FBALYB Amazon,2,1,1,0,1,0
,Merrell J06028 - Size 6.5,Merrell J06028 - Size 6.5,Default,0,0,0,0,0,12
,Merrell J06028 - Size 6.5,Merrell J06028 - Size 6.5,Default Ridgefield,36,36,0,0,0,36
,Merrell J06028 - Size 6.5,Merrell J06028 - Size 6.5,FBALYB Amazon,-1,-1,0,0,0,0
,Merrell J06028 - Size 7,Merrell J06028 - Size 7,Default,0,0,0,0,0,36
,Merrell J06028 - Size 7,Merrell J06028 - Size 7,Default Ridgefield,36,36,0,0,0,60
,Merrell J06028 - Size 7,Merrell J06028 - Size 7,FBALYB Amazon,-6,-7,1,24,1,0
,Merrell J06028 - Size 7.5,Merrell J06028 - Size 7.5,Default,0,0,0,0,0,36
,Merrell J06028 - Size 7.5,Merrell J06028 - Size 7.5,Default Ridgefield,25,25,0,0,0,48
,Merrell J06028 - Size 7.5,Merrell J06028 - Size 7.5,FBALYB Amazon,-11,-11,0,23,0,0
,Merrell J06028 - Size 8,Merrell J06028 - Size 8,Default,0,0,0,0,0,60
,Merrell J06028 - Size 8,Merrell J06028 - Size 8,Default Ridgefield,56,56,0,0,0,36
,Merrell J06028 - Size 8,Merrell J06028 - Size 8,FBALYB Amazon,26,23,3,0,3,0
,Merrell J06028 - Size 8.5,Merrell J06028 - Size 8.5,Default,0,0,0,0,0,60
,Merrell J06028 - Size 8.5,Merrell J06028 - Size 8.5,Default Ridgefield,60,60,0,0,0,48
,Merrell J06028 - Size 8.5,Merrell J06028 - Size 8.5,FBALYB Amazon,3,-1,4,0,4,0
,Merrell J06028 - Size 9,Merrell J06028 - Size 9,Default,0,0,0,0,0,48
,Merrell J06028 - Size 9,Merrell J06028 - Size 9,Default Ridgefield,13,13,0,0,0,60
,Merrell J06028 - Size 9,Merrell J06028 - Size 9,FBALYB Amazon,55,54,1,0,1,0
,Merrell J06028 - Size 9.5,Merrell J06028 - Size 9.5,Default,0,0,0,0,0,24
,Merrell J06028 - Size 9.5,Merrell J06028 - Size 9.5,Default Ridgefield,48,48,0,0,0,48
,Merrell J06028 - Size 9.5,Merrell J06028 - Size 9.5,FBALYB Amazon,19,15,4,0,4,0
,Merrell J06029 - Size 10,Merrell J06029 - Size 10,Default,0,0,0,0,0,60
,Merrell J06029 - Size 10,Merrell J06029 - Size 10,Default Ridgefield,0,0,0,0,0,264
,Merrell J06029 - Size 10,Merrell J06029 - Size 10,FBALYB Amazon,154,146,8,1,8,0
,Merrell J06029 - Size 10.5,Merrell J06029 - Size 10.5,Default,0,0,0,0,0,72
,Merrell J06029 - Size 10.5,Merrell J06029 - Size 10.5,Default Ridgefield,15,15,0,0,0,312
,Merrell J06029 - Size 10.5,Merrell J06029 - Size 10.5,FBALYB Amazon,94,82,12,0,12,0
,Merrell J06029 - Size 10.5,Merrell J06029 - Size 10.5,FBALYB Canada,3,3,0,0,0,0
,Merrell J06029 - Size 11,Merrell J06029 - Size 11,Default,0,0,0,0,0,36
,Merrell J06029 - Size 11,Merrell J06029 - Size 11,Default Ridgefield,0,0,0,0,0,300
,Merrell J06029 - Size 11,Merrell J06029 - Size 11,FBALYB Amazon,161,153,8,1,8,0
,Merrell J06029 - Size 11.5,Merrell J06029 - Size 11.5,Default,0,0,0,0,0,10
,Merrell J06029 - Size 11.5,Merrell J06029 - Size 11.5,Default Ridgefield,5,5,0,0,0,216
,Merrell J06029 - Size 11.5,Merrell J06029 - Size 11.5,FBALYB Amazon,135,134,1,3,1,0
,Merrell J06029 - Size 12,Merrell J06029 - Size 12,Default,0,0,0,0,0,48
,Merrell J06029 - Size 12,Merrell J06029 - Size 12,Default Ridgefield,1,1,0,0,0,216
,Merrell J06029 - Size 12,Merrell J06029 - Size 12,FBALYB Amazon,149,136,13,5,13,0
,Merrell J06029 - Size 12,Merrell J06029 - Size 12,FBALYB Canada,2,2,0,0,0,0
,Merrell J06029 - Size 12.5,Merrell J06029 - Size 12.5,FBALYB Amazon,18,18,0,0,0,0
,Merrell J06029 - Size 13,Merrell J06029 - Size 13,Default Ridgefield,0,0,0,0,0,180
,Merrell J06029 - Size 13,Merrell J06029 - Size 13,FBALYB Amazon,133,128,5,0,5,0
,Merrell J06029 - Size 14,Merrell J06029 - Size 14,FBALYB Amazon,-4,-4,0,0,0,0
,Merrell J06029 - Size 7.5,Merrell J06029 - Size 7.5,Default Ridgefield,0,0,0,0,0,36
,Merrell J06029 - Size 7.5,Merrell J06029 - Size 7.5,FBALYB Amazon,23,23,0,0,0,0
,Merrell J06029 - Size 8,Merrell J06029 - Size 8,Default Ridgefield,1,1,0,0,0,60
,Merrell J06029 - Size 8,Merrell J06029 - Size 8,FBALYB Amazon,17,17,0,0,0,0
,Merrell J06029 - Size 8.5,Merrell J06029 - Size 8.5,Default Ridgefield,0,0,0,0,0,132
,Merrell J06029 - Size 8.5,Merrell J06029 - Size 8.5,FBALYB Amazon,56,52,4,2,4,0
,Merrell J06029 - Size 9,Merrell J06029 - Size 9,Default Ridgefield,0,0,0,0,0,168
,Merrell J06029 - Size 9,Merrell J06029 - Size 9,FBALYB Amazon,114,113,1,0,1,0
,Merrell J06029 - Size 9.5,Merrell J06029 - Size 9.5,Default,0,0,0,0,0,48
,Merrell J06029 - Size 9.5,Merrell J06029 - Size 9.5,Default Ridgefield,0,0,0,0,0,216
,Merrell J06029 - Size 9.5,Merrell J06029 - Size 9.5,FBALYB Amazon,161,157,4,0,4,0
,Merrell J06029 - Size 9.5,Merrell J06029 - Size 9.5,FBALYB Canada,5,5,0,0,0,0
,Merrell J06031 - Size 10,Merrell J06031 - Size 10,FBALYB Amazon,167,164,3,0,3,0
,Merrell J06031 - Size 10.5,Merrell J06031 - Size 10.5,Default Ridgefield,5,5,0,0,0,0
,Merrell J06031 - Size 10.5,Merrell J06031 - Size 10.5,FBALYB Amazon,187,186,1,1,1,0
,Merrell J06031 - Size 11,Merrell J06031 - Size 11,FBALYB Amazon,49,48,1,0,1,0
,Merrell J06031 - Size 11.5,Merrell J06031 - Size 11.5,FBALYB Amazon,104,104,0,0,0,0
,Merrell J06031 - Size 12,Merrell J06031 - Size 12,Default Ridgefield,1,1,0,0,0,0
,Merrell J06031 - Size 12,Merrell J06031 - Size 12,FBALYB Amazon,141,141,0,0,0,0
,Merrell J06031 - Size 12.5,Merrell J06031 - Size 12.5,FBALYB Amazon,26,26,0,0,0,0
,Merrell J06031 - Size 13,Merrell J06031 - Size 13,FBALYB Amazon,6,6,0,0,0,0
,Merrell J06031 - Size 7.5,Merrell J06031 - Size 7.5,Default Ridgefield,1,1,0,0,0,0
,Merrell J06031 - Size 7.5,Merrell J06031 - Size 7.5,FBALYB Amazon,26,26,0,0,0,0
,Merrell J06031 - Size 8,Merrell J06031 - Size 8,FBALYB Amazon,34,34,0,0,0,0
,Merrell J06031 - Size 8.5,Merrell J06031 - Size 8.5,Default Ridgefield,4,4,0,0,0,0
,Merrell J06031 - Size 8.5,Merrell J06031 - Size 8.5,FBALYB Amazon,26,26,0,0,0,0
,Merrell J06031 - Size 9,Merrell J06031 - Size 9,FBALYB Amazon,38,31,7,0,7,0
,Merrell J06031 - Size 9.5,Merrell J06031 - Size 9.5,FBALYB Amazon,114,114,0,0,0,0
,Merrell J06031W - Size 10,Merrell J06031W - Size 10,FBALYB Amazon,32,31,1,0,1,0
,Merrell J06031W - Size 10.5,Merrell J06031W - Size 10.5,FBALYB Amazon,-1,-1,0,0,0,0
,Merrell J06031W - Size 11,Merrell J06031W - Size 11,FBALYB Amazon,21,18,3,0,3,0
,Merrell J06031W - Size 11.5,Merrell J06031W - Size 11.5,FBALYB Amazon,22,22,0,0,0,0
,Merrell J06031W - Size 12,Merrell J06031W - Size 12,FBALYB Amazon,10,8,2,0,2,0
,Merrell J06031W - Size 13,Merrell J06031W - Size 13,FBALYB Amazon,-3,-4,1,0,1,0
,Merrell J06031W - Size 7,Merrell J06031W - Size 7,FBALYB Amazon,1,1,0,9,0,0
,Merrell J06031W - Size 7.5,Merrell J06031W - Size 7.5,Default Ridgefield,3,3,0,0,0,0
,Merrell J06031W - Size 7.5,Merrell J06031W - Size 7.5,FBALYB Amazon,5,5,0,0,0,0
,Merrell J06031W - Size 8,Merrell J06031W - Size 8,FBALYB Amazon,16,16,0,0,0,0
,Merrell J06031W - Size 8.5,Merrell J06031W - Size 8.5,FBALYB Amazon,12,11,1,0,1,0
,Merrell J06031W - Size 9,Merrell J06031W - Size 9,FBALYB Amazon,16,16,0,0,0,0
,Merrell J06031W - Size 9.5,Merrell J06031W - Size 9.5,FBALYB Amazon,7,7,0,0,0,0
,Merrell J06037 - Size 10,Merrell J06037 - Size 10,FBALYB Amazon,26,25,1,0,1,0
,Merrell J06037 - Size 10.5,Merrell J06037 - Size 10.5,Default Ridgefield,12,12,0,0,0,0
,Merrell J06037 - Size 10.5,Merrell J06037 - Size 10.5,FBALYB Amazon,25,24,1,0,1,0
,Merrell J06037 - Size 11,Merrell J06037 - Size 11,FBALYB Amazon,38,38,0,0,0,0
,Merrell J06037 - Size 11.5,Merrell J06037 - Size 11.5,FBALYB Amazon,17,17,0,0,0,0
,Merrell J06037 - Size 12,Merrell J06037 - Size 12,FBALYB Amazon,7,5,2,0,2,0
,Merrell J06037 - Size 12.5,Merrell J06037 - Size 12.5,FBALYB Amazon,30,30,0,0,0,0
,Merrell J06037 - Size 13,Merrell J06037 - Size 13,FBALYB Amazon,27,27,0,0,0,0
,Merrell J06037 - Size 8,Merrell J06037 - Size 8,FBALYB Amazon,-1,-1,0,0,0,0
,Merrell J06037 - Size 8.5,Merrell J06037 - Size 8.5,FBALYB Amazon,-2,-2,0,0,0,0
,Merrell J06037 - Size 9,Merrell J06037 - Size 9,FBALYB Amazon,40,40,0,0,0,0
,Merrell J06037 - Size 9.5,Merrell J06037 - Size 9.5,FBALYB Amazon,15,15,0,0,0,0
,Merrell J06039 - Size 10,Merrell J06039 - Size 10,FBALYB Amazon,45,44,1,0,1,0
,Merrell J06039 - Size 10.5,Merrell J06039 - Size 10.5,FBALYB Amazon,33,33,0,0,0,0
,Merrell J06039 - Size 11,Merrell J06039 - Size 11,FBALYB Amazon,27,26,1,0,1,0
,Merrell J06039 - Size 11.5,Merrell J06039 - Size 11.5,Default,6,6,0,0,0,0
,Merrell J06039 - Size 11.5,Merrell J06039 - Size 11.5,FBALYB Amazon,24,24,0,0,0,0
,Merrell J06039 - Size 12,Merrell J06039 - Size 12,FBALYB Amazon,34,33,1,0,1,0
,Merrell J06039 - Size 12.5,Merrell J06039 - Size 12.5,FBALYB Amazon,35,35,0,0,0,0
,Merrell J06039 - Size 13,Merrell J06039 - Size 13,Default,6,6,0,0,0,0
,Merrell J06039 - Size 13,Merrell J06039 - Size 13,FBALYB Amazon,21,21,0,0,0,0
,Merrell J06039 - Size 8,Merrell J06039 - Size 8,FBALYB Amazon,-2,-2,0,0,0,0
,Merrell J06039 - Size 8.5,Merrell J06039 - Size 8.5,FBALYB Amazon,-1,-1,0,0,0,0
,Merrell J06039 - Size 9,Merrell J06039 - Size 9,FBALYB Amazon,-5,-7,2,22,2,0
,Merrell J06039 - Size 9.5,Merrell J06039 - Size 9.5,Default Ridgefield,1,1,0,0,0,0
,Merrell J06039 - Size 9.5,Merrell J06039 - Size 9.5,FBALYB Amazon,3,2,1,23,1,0
,Merrell J06041 - Size 10,Merrell J06041 - Size 10,FBALYB Amazon,41,41,0,0,0,0
,Merrell J06041 - Size 10.5,Merrell J06041 - Size 10.5,FBALYB Amazon,43,43,0,0,0,0
,Merrell J06041 - Size 11,Merrell J06041 - Size 11,FBALYB Amazon,39,39,0,0,0,0
,Merrell J06041 - Size 11.5,Merrell J06041 - Size 11.5,Default Ridgefield,2,2,0,0,0,0
,Merrell J06041 - Size 11.5,Merrell J06041 - Size 11.5,FBALYB Amazon,31,31,0,2,0,0
,Merrell J06041 - Size 12,Merrell J06041 - Size 12,FBALYB Amazon,44,44,0,0,0,0
,Merrell J06041 - Size 12.5,Merrell J06041 - Size 12.5,FBALYB Amazon,34,34,0,0,0,0
,Merrell J06041 - Size 13,Merrell J06041 - Size 13,FBALYB Amazon,30,30,0,0,0,0
,Merrell J06041 - Size 14,Merrell J06041 - Size 14,FBALYB Amazon,-2,-2,0,0,0,0
,Merrell J06041 - Size 8,Merrell J06041 - Size 8,FBALYB Amazon,-3,-3,0,0,0,0
,Merrell J06041 - Size 8.5,Merrell J06041 - Size 8.5,FBALYB Amazon,-5,-5,0,0,0,0
,Merrell J06041 - Size 9,Merrell J06041 - Size 9,Default Ridgefield,2,2,0,0,0,0
,Merrell J06041 - Size 9,Merrell J06041 - Size 9,FBALYB Amazon,17,17,0,16,0,0
,Merrell J06041 - Size 9.5,Merrell J06041 - Size 9.5,FBALYB Amazon,12,12,0,0,0,0
,Merrell J06041W - Size 10,Merrell J06041W - Size 10,FBALYB Amazon,-3,-3,0,0,0,0
,Merrell J06041W - Size 10.5,Merrell J06041W - Size 10.5,FBALYB Amazon,-14,-14,0,10,0,0
,Merrell J06041W - Size 11,Merrell J06041W - Size 11,FBALYB Amazon,-1,-1,0,0,0,0
,Merrell J06041W - Size 11.5,Merrell J06041W - Size 11.5,FBALYB Amazon,-8,-8,0,4,0,0
,Merrell J06041W - Size 12,Merrell J06041W - Size 12,FBALYB Amazon,-2,-2,0,0,0,0
,Merrell J06041W - Size 8,Merrell J06041W - Size 8,Default,5,5,0,0,0,0
,Merrell J06041W - Size 8,Merrell J06041W - Size 8,FBALYB Amazon,-9,-9,0,0,0,0
,Merrell J06041W - Size 8.5,Merrell J06041W - Size 8.5,FBALYB Amazon,-2,-2,0,0,0,0
,Merrell J06041W - Size 9,Merrell J06041W - Size 9,Default Oxford,10,10,0,0,0,0
,Merrell J06041W - Size 9.5,Merrell J06041W - Size 9.5,FBALYB Amazon,-12,-12,0,10,0,0
,Merrell J06045 - Size 10,Merrell J06045 - Size 10,Default Ridgefield,1,1,0,0,0,0
,Merrell J06045 - Size 10,Merrell J06045 - Size 10,FBALYB Amazon,208,206,2,1,2,0
,Merrell J06045 - Size 10.5,Merrell J06045 - Size 10.5,Default Ridgefield,1,1,0,0,0,0
,Merrell J06045 - Size 10.5,Merrell J06045 - Size 10.5,FBALYB Amazon,197,196,1,12,1,0
,Merrell J06045 - Size 11,Merrell J06045 - Size 11,FBALYB Amazon,213,213,0,1,0,0
,Merrell J06045 - Size 11.5,Merrell J06045 - Size 11.5,FBALYB Amazon,153,153,0,0,0,0
,Merrell J06045 - Size 12,Merrell J06045 - Size 12,FBALYB Amazon,162,162,0,1,0,0
,Merrell J06045 - Size 13,Merrell J06045 - Size 13,FBALYB Amazon,156,153,3,0,3,0
,Merrell J06045 - Size 14,Merrell J06045 - Size 14,FBALYB Amazon,-1,-1,0,0,0,0
,Merrell J06045 - Size 7.5,Merrell J06045 - Size 7.5,FBALYB Amazon,21,21,0,0,0,0
,Merrell J06045 - Size 8,Merrell J06045 - Size 8,FBALYB Amazon,35,35,0,0,0,0
,MERRELL J06045- SIZE 8.5,MERRELL J06045- SIZE 8.5 ,FBALYB Amazon,82,81,1,0,1,0
,Merrell J06045 - Size 9,Merrell J06045 - Size 9,FBALYB Amazon,117,115,2,0,2,0
,Merrell J06045 - Size 9.5,Merrell J06045 - Size 9.5,FBALYB Amazon,147,141,6,1,6,0
,Merrell J06049 - Size 10,Merrell J06049 - Size 10,FBALYB Amazon,-4,-4,0,48,0,0
,Merrell J06049 - Size 10.5,Merrell J06049 - Size 10.5,FBALYB Amazon,44,44,0,0,0,0
,Merrell J06049 - Size 11,Merrell J06049 - Size 11,FBALYB Amazon,43,43,0,1,0,0
,Merrell J06049 - Size 11.5,Merrell J06049 - Size 11.5,FBALYB Amazon,34,34,0,12,0,0
,Merrell J06049 - Size 12,Merrell J06049 - Size 12,FBALYB Amazon,32,32,0,1,0,0
,Merrell J06049 - Size 13,Merrell J06049 - Size 13,FBALYB Amazon,36,34,2,0,2,0
,Merrell J06049 - Size 14,Merrell J06049 - Size 14,FBALYB Amazon,-1,-1,0,0,0,0
,Merrell J06049 - Size 7.5,Merrell J06049 - Size 7.5,FBALYB Amazon,-2,-2,0,6,0,0
,Merrell J06049 - Size 8,Merrell J06049 - Size 8,Default Ridgefield,1,1,0,0,0,0
,Merrell J06049 - Size 8,Merrell J06049 - Size 8,FBALYB Amazon,10,10,0,12,0,0
,Merrell J06049 - Size 8.5,Merrell J06049 - Size 8.5,FBALYB Amazon,23,23,0,0,0,0
,Merrell J06049 - Size 9,Merrell J06049 - Size 9,FBALYB Amazon,21,21,0,0,0,0
,Merrell J06049 - Size 9.5,Merrell J06049 - Size 9.5,Default,6,6,0,0,0,0
,Merrell J06049 - Size 9.5,Merrell J06049 - Size 9.5,FBALYB Amazon,3,3,0,27,0,0
,Merrell J0605142 - Size 10.5,Merrell J0605142 - Size 10.5,Default,0,0,0,0,0,240
,Merrell J0605142 - Size 10.5,Merrell J0605142 - Size 10.5,Default Ridgefield,61,61,0,0,0,168
,Merrell J0605142 - Size 10.5,Merrell J0605142 - Size 10.5,FBALYB Amazon,81,73,8,0,8,0
,Merrell J06051 - Size 10,Merrell J06051 - Size 10,Default,0,0,0,0,0,240
,Merrell J06051 - Size 10,Merrell J06051 - Size 10,Default Ridgefield,0,0,0,0,0,168
,Merrell J06051 - Size 10,Merrell J06051 - Size 10,FBALYB Amazon,112,94,18,0,18,0
,Merrell J06051 - Size 11,Merrell J06051 - Size 11,Default,0,0,0,0,0,252
,Merrell J06051 - Size 11,Merrell J06051 - Size 11,Default Ridgefield,0,0,0,0,0,168
,Merrell J06051 - Size 11,Merrell J06051 - Size 11,FBALYB Amazon,93,86,7,13,7,0
,Merrell J06051 - Size 11.5,Merrell J06051 - Size 11.5,Default,0,0,0,0,0,156
,Merrell J06051 - Size 11.5,Merrell J06051 - Size 11.5,Default Ridgefield,2,2,0,0,0,120
,Merrell J06051 - Size 11.5,Merrell J06051 - Size 11.5,FBALYB Amazon,61,57,4,0,4,0
,Merrell J06051 - Size 12,Merrell J06051 - Size 12,Default,0,0,0,0,0,180
,Merrell J06051 - Size 12,Merrell J06051 - Size 12,Default Ridgefield,0,0,0,0,0,132
,Merrell J06051 - Size 12,Merrell J06051 - Size 12,FBALYB Amazon,70,66,4,36,4,0
,Merrell J06051 - Size 12.5,Merrell J06051 - Size 12.5,Default,0,0,0,0,0,12
,Merrell J06051 - Size 13,Merrell J06051 - Size 13,Default,0,0,0,0,0,132
,Merrell J06051 - Size 13,Merrell J06051 - Size 13,Default Ridgefield,120,120,0,0,0,120
,Merrell J06051 - Size 13,Merrell J06051 - Size 13,FBALYB Amazon,103,93,10,12,10,0
,Merrell J06051 - Size 14,Merrell J06051 - Size 14,Default Ridgefield,24,24,0,0,0,0
,Merrell J06051 - Size 14,Merrell J06051 - Size 14,FBALYB Amazon,11,11,0,0,0,0
,Merrell J06051 - Size 7.5,Merrell J06051 - Size 7.5,Default,0,0,0,0,0,24
,Merrell J06051 - Size 7.5,Merrell J06051 - Size 7.5,Default Ridgefield,0,0,0,0,0,12
,Merrell J06051 - Size 7.5,Merrell J06051 - Size 7.5,FBALYB Amazon,12,12,0,0,0,0
,Merrell J06051 - Size 8,Merrell J06051 - Size 8,Default,0,0,0,0,0,60
,Merrell J06051 - Size 8,Merrell J06051 - Size 8,Default Ridgefield,0,0,0,0,0,36
,Merrell J06051 - Size 8,Merrell J06051 - Size 8,FBALYB Amazon,-2,-2,0,12,0,0
,Merrell J06051 - Size 8.5,Merrell J06051 - Size 8.5,Default,0,0,0,0,0,84
,Merrell J06051 - Size 8.5,Merrell J06051 - Size 8.5,Default Ridgefield,0,0,0,0,0,72
,Merrell J06051 - Size 8.5,Merrell J06051 - Size 8.5,FBALYB Amazon,41,38,3,0,3,0
,Merrell J06051 - Size 9,Merrell J06051 - Size 9,Default,0,0,0,0,0,120
,Merrell J06051 - Size 9,Merrell J06051 - Size 9,Default Ridgefield,76,76,0,0,0,96
,Merrell J06051 - Size 9,Merrell J06051 - Size 9,FBALYB Amazon,37,31,6,0,6,0
,Merrell J06051 - Size 9.5,Merrell J06051 - Size 9.5,Default,0,0,0,0,0,168
,Merrell J06051 - Size 9.5,Merrell J06051 - Size 9.5,Default Ridgefield,10,10,0,0,0,120
,Merrell J06051 - Size 9.5,Merrell J06051 - Size 9.5,FBALYB Amazon,30,13,17,0,17,0
,Merrell J06053 - Size 10,Merrell J06053 - Size 10,Default Ridgefield,36,36,0,0,0,312
,Merrell J06053 - Size 10,Merrell J06053 - Size 10,FBALYB Amazon,111,111,0,0,0,0
,Merrell J06053 - Size 10.5,Merrell J06053 - Size 10.5,Default,6,6,0,0,0,0
,Merrell J06053 - Size 10.5,Merrell J06053 - Size 10.5,Default Ridgefield,0,0,0,0,0,312
,Merrell J06053 - Size 10.5,Merrell J06053 - Size 10.5,FBALYB Amazon,137,134,3,0,3,0
,Merrell J06053 - Size 11,Merrell J06053 - Size 11,Default Ridgefield,0,0,0,0,0,312
,Merrell J06053 - Size 11,Merrell J06053 - Size 11,FBALYB Amazon,142,140,2,0,2,0
,Merrell J06053 - Size 11.5,Merrell J06053 - Size 11.5,Default Ridgefield,0,0,0,0,0,216
,Merrell J06053 - Size 11.5,Merrell J06053 - Size 11.5,FBALYB Amazon,100,100,0,0,0,0
,Merrell J06053 - Size 12,Merrell J06053 - Size 12,Default Ridgefield,0,0,0,0,0,240
,Merrell J06053 - Size 12,Merrell J06053 - Size 12,FBALYB Amazon,89,89,0,12,0,0
,Merrell J06053 - Size 13,Merrell J06053 - Size 13,Default Ridgefield,0,0,0,0,0,216
,Merrell J06053 - Size 13,Merrell J06053 - Size 13,FBALYB Amazon,95,95,0,0,0,0
,Merrell J06053 - Size 14,Merrell J06053 - Size 14,FBALYB Amazon,-2,-2,0,0,0,0
,Merrell J06053 - Size 7.5,Merrell J06053 - Size 7.5,Default Ridgefield,0,0,0,0,0,24
,Merrell J06053 - Size 7.5,Merrell J06053 - Size 7.5,FBALYB Amazon,10,8,2,0,2,0
,Merrell J06053 - Size 8,Merrell J06053 - Size 8,Default Ridgefield,0,0,0,0,0,48
,Merrell J06053 - Size 8,Merrell J06053 - Size 8,FBALYB Amazon,22,21,1,0,1,0
,Merrell J06053 - Size 8.5,Merrell J06053 - Size 8.5,Default Ridgefield,0,0,0,0,0,120
,Merrell J06053 - Size 8.5,Merrell J06053 - Size 8.5,FBALYB Amazon,55,53,2,0,2,0
,Merrell J06053 - Size 9,Merrell J06053 - Size 9,Default Ridgefield,24,24,0,0,0,168
,Merrell J06053 - Size 9,Merrell J06053 - Size 9,FBALYB Amazon,54,53,1,0,1,0
,Merrell J06053 - Size 9.5,Merrell J06053 - Size 9.5,Default Ridgefield,12,12,0,0,0,216
,Merrell J06053 - Size 9.5,Merrell J06053 - Size 9.5,FBALYB Amazon,90,90,0,0,0,0
,Merrell J06054 - Size 10,Merrell J06054 - Size 10,Default,0,0,0,0,0,96
,Merrell J06054 - Size 10,Merrell J06054 - Size 10,Default Ridgefield,96,96,0,0,0,96
,Merrell J06054 - Size 10,Merrell J06054 - Size 10,FBALYB Amazon,-38,-38,0,0,0,0
,Merrell J06054 - Size 10.5,Merrell J06054 - Size 10.5,Default,0,0,0,0,0,60
,Merrell J06054 - Size 10.5,Merrell J06054 - Size 10.5,Default Ridgefield,0,0,0,0,0,60
,Merrell J06054 - Size 10.5,Merrell J06054 - Size 10.5,FBALYB Amazon,32,32,0,0,0,0
,Merrell J06054 - Size 11,Merrell J06054 - Size 11,Default,0,0,0,0,0,48
,Merrell J06054 - Size 11,Merrell J06054 - Size 11,Default Ridgefield,0,0,0,0,0,48
,Merrell J06054 - Size 11,Merrell J06054 - Size 11,FBALYB Amazon,27,26,1,0,1,0
,Merrell J06054 - Size 5.5,Merrell J06054 - Size 5.5,Default,0,0,0,0,0,36
,Merrell J06054 - Size 5.5,Merrell J06054 - Size 5.5,Default Ridgefield,0,0,0,0,0,36
,Merrell J06054 - Size 5.5,Merrell J06054 - Size 5.5,FBALYB Amazon,32,32,0,0,0,0
,Merrell J06054 - Size 6,Merrell J06054 - Size 6,Default,0,0,0,0,0,60
,Merrell J06054 - Size 6,Merrell J06054 - Size 6,Default Ridgefield,0,0,0,0,0,60
,Merrell J06054 - Size 6,Merrell J06054 - Size 6,FBALYB Amazon,41,41,0,1,0,0
,Merrell J06054 - Size 6.5,Merrell J06054 - Size 6.5,Default,0,0,0,0,0,96
,Merrell J06054 - Size 6.5,Merrell J06054 - Size 6.5,Default Ridgefield,1,1,0,0,0,96
,Merrell J06054 - Size 6.5,Merrell J06054 - Size 6.5,FBALYB Amazon,65,63,2,0,2,0
,Merrell J06054 - Size 7,Merrell J06054 - Size 7,Default,0,0,0,0,0,180
,Merrell J06054 - Size 7,Merrell J06054 - Size 7,Default Ridgefield,36,36,0,0,0,180
,Merrell J06054 - Size 7,Merrell J06054 - Size 7,FBALYB Amazon,113,112,1,12,1,0
,Merrell J06054 - Size 7.5,Merrell J06054 - Size 7.5,Default,0,0,0,0,0,144
,Merrell J06054 - Size 7.5,Merrell J06054 - Size 7.5,Default Ridgefield,0,0,0,0,0,144
,Merrell J06054 - Size 7.5,Merrell J06054 - Size 7.5,FBALYB Amazon,78,77,1,0,1,0
,Merrell J06054 - Size 8,Merrell J06054 - Size 8,Default,0,0,0,0,0,192
,Merrell J06054 - Size 8,Merrell J06054 - Size 8,Default Ridgefield,0,0,0,0,0,192
,Merrell J06054 - Size 8,Merrell J06054 - Size 8,FBALYB Amazon,101,100,1,37,1,0
,Merrell J06054 - Size 8.5,Merrell J06054 - Size 8.5,Default,0,0,0,0,0,192
,Merrell J06054 - Size 8.5,Merrell J06054 - Size 8.5,Default Ridgefield,0,0,0,0,0,192
,Merrell J06054 - Size 8.5,Merrell J06054 - Size 8.5,FBALYB Amazon,124,121,3,12,3,0
,Merrell J06054 - Size 9,Merrell J06054 - Size 9,Default,0,0,0,0,0,192
,Merrell J06054 - Size 9,Merrell J06054 - Size 9,Default Ridgefield,0,0,0,0,0,192
,Merrell J06054 - Size 9,Merrell J06054 - Size 9,FBALYB Amazon,134,132,2,0,2,0
,Merrell J06054 - Size 9.5,Merrell J06054 - Size 9.5,Default,0,0,0,0,0,144
,Merrell J06054 - Size 9.5,Merrell J06054 - Size 9.5,Default Ridgefield,0,0,0,0,0,144
,Merrell J06054 - Size 9.5,Merrell J06054 - Size 9.5,FBALYB Amazon,119,116,3,10,3,0
,Merrell J06057 - Size 10,Merrell J06057 - Size 10,Default,0,0,0,0,0,13
,Merrell J06057 - Size 10,Merrell J06057 - Size 10,Default Ridgefield,0,0,0,0,0,48
,Merrell J06057 - Size 10,Merrell J06057 - Size 10,FBALYB Amazon,66,66,0,0,0,0
,Merrell J06057 - Size 10.5,Merrell J06057 - Size 10.5,Default Ridgefield,0,0,0,0,0,48
,Merrell J06057 - Size 10.5,Merrell J06057 - Size 10.5,FBALYB Amazon,12,8,4,0,4,0
,Merrell J06057 - Size 11,Merrell J06057 - Size 11,Default Ridgefield,0,0,0,0,0,48
,Merrell J06057 - Size 11,Merrell J06057 - Size 11,FBALYB Amazon,69,66,3,0,3,0
,Merrell J06057 - Size 11.5,Merrell J06057 - Size 11.5,Default Ridgefield,23,23,0,0,0,36
,Merrell J06057 - Size 11.5,Merrell J06057 - Size 11.5,FBALYB Amazon,13,12,1,13,1,0
,Merrell J06057 - Size 12,Merrell J06057 - Size 12,Default Ridgefield,1,1,0,0,0,36
,Merrell J06057 - Size 12,Merrell J06057 - Size 12,FBALYB Amazon,16,15,1,0,1,0
,Merrell J06057 - Size 12.5,Merrell J06057 - Size 12.5,Default Ridgefield,39,39,0,0,0,0
,Merrell J06057 - Size 12.5,Merrell J06057 - Size 12.5,FBALYB Amazon,21,21,0,0,0,0
,Merrell J06057 - Size 13,Merrell J06057 - Size 13,Default Ridgefield,20,20,0,0,0,36
,Merrell J06057 - Size 13,Merrell J06057 - Size 13,FBALYB Amazon,25,23,2,0,2,0
,Merrell J06057 - Size 9,Merrell J06057 - Size 9,Default Ridgefield,0,0,0,0,0,24
,Merrell J06057 - Size 9,Merrell J06057 - Size 9,FBALYB Amazon,31,31,0,0,0,0
,Merrell J06057 - Size 9.5,Merrell J06057 - Size 9.5,Default Ridgefield,1,1,0,0,0,36
,Merrell J06057 - Size 9.5,Merrell J06057 - Size 9.5,FBALYB Amazon,51,51,0,0,0,0
,Merrell J06059 - Size 10,Merrell J06059 - Size 10,Default Ridgefield,0,0,0,0,0,28
,Merrell J06059 - Size 10,Merrell J06059 - Size 10,FBALYB Amazon,-4,-4,0,0,0,0
,Merrell J06059 - Size 10.5,Merrell J06059 - Size 10.5,Default Ridgefield,0,0,0,0,0,28
,Merrell J06059 - Size 10.5,Merrell J06059 - Size 10.5,FBALYB Amazon,-3,-3,0,0,0,0
,Merrell J06059 - Size 11,Merrell J06059 - Size 11,Default Ridgefield,0,0,0,0,0,28
,Merrell J06059 - Size 11,Merrell J06059 - Size 11,FBALYB Amazon,6,6,0,0,0,0
,Merrell J06059 - Size 11.5,Merrell J06059 - Size 11.5,Default Ridgefield,0,0,0,0,0,16
,Merrell J06059 - Size 11.5,Merrell J06059 - Size 11.5,FBALYB Amazon,-3,-3,0,0,0,0
,Merrell J06059 - Size 12,Merrell J06059 - Size 12,Default Ridgefield,0,0,0,0,0,16
,Merrell J06059 - Size 12,Merrell J06059 - Size 12,FBALYB Amazon,-2,-2,0,0,0,0
,Merrell J06059 - Size 13,Merrell J06059 - Size 13,Default Ridgefield,0,0,0,0,0,16
,Merrell J06059 - Size 13,Merrell J06059 - Size 13,FBALYB Amazon,-5,-5,0,0,0,0
,Merrell J06059 - Size 8,Merrell J06059 - Size 8,FBALYB Amazon,-5,-5,0,0,0,0
,Merrell J06059 - Size 8.5,Merrell J06059 - Size 8.5,Default Ridgefield,0,0,0,0,0,16
,Merrell J06059 - Size 8.5,Merrell J06059 - Size 8.5,FBALYB Amazon,-3,-3,0,0,0,0
,Merrell J06059 - Size 9,Merrell J06059 - Size 9,Default Ridgefield,0,0,0,0,0,16
,Merrell J06059 - Size 9,Merrell J06059 - Size 9,FBALYB Amazon,-6,-6,0,0,0,0
,Merrell J06059 - Size 9.5,Merrell J06059 - Size 9.5,Default Ridgefield,0,0,0,0,0,16
,Merrell J06059 - Size 9.5,Merrell J06059 - Size 9.5,FBALYB Amazon,14,14,0,0,0,0
,Merrell J06060 - Size 10,Merrell J06060 - Size 10,Default Ridgefield,18,18,0,0,0,0
,Merrell J06060 - Size 10,Merrell J06060 - Size 10,FBALYB Amazon,14,14,0,0,0,0
,Merrell J06060 - Size 10.5,Merrell J06060 - Size 10.5,FBALYB Amazon,47,47,0,0,0,0
,Merrell J06060 - Size 11,Merrell J06060 - Size 11,FBALYB Amazon,11,11,0,0,0,0
,Merrell J06060 - Size 11.5,Merrell J06060 - Size 11.5,FBALYB Amazon,22,22,0,0,0,0
,Merrell J06060 - Size 12,Merrell J06060 - Size 12,Default Ridgefield,21,21,0,0,0,0
,Merrell J06060 - Size 12,Merrell J06060 - Size 12,FBALYB Amazon,4,4,0,0,0,0
,Merrell J06060 - Size 6.5,Merrell J06060 - Size 6.5,FBALYB Amazon,-2,-2,0,0,0,0
,Merrell J06060 - Size 7,Merrell J06060 - Size 7,FBALYB Amazon,-3,-3,0,0,0,0
,Merrell J06060 - Size 7.5,Merrell J06060 - Size 7.5,FBALYB Amazon,-15,-15,0,3,0,0
,Merrell J06060 - Size 8,Merrell J06060 - Size 8,FBALYB Amazon,-12,-14,2,0,2,0
,Merrell J06060 - Size 8.5,Merrell J06060 - Size 8.5,FBALYB Amazon,13,13,0,0,0,0
,Merrell J06060 - Size 9,Merrell J06060 - Size 9,FBALYB Amazon,9,9,0,0,0,0
,Merrell J06060 - Size 9.5,Merrell J06060 - Size 9.5,FBALYB Amazon,8,8,0,0,0,0
,Merrell J06061 - Size 10,Merrell J06061 - Size 10,Default Ridgefield,0,0,0,0,0,24
,Merrell J06061 - Size 10,Merrell J06061 - Size 10,FBALYB Amazon,-2,-2,0,0,0,0
,Merrell J06061 - Size 10.5,Merrell J06061 - Size 10.5,Default Ridgefield,0,0,0,0,0,24
,Merrell J06061 - Size 10.5,Merrell J06061 - Size 10.5,FBALYB Amazon,-1,-1,0,0,0,0
,Merrell J06061 - Size 11,Merrell J06061 - Size 11,Default Ridgefield,0,0,0,0,0,24
,Merrell J06061 - Size 11,Merrell J06061 - Size 11,FBALYB Amazon,-1,-1,0,0,0,0
,Merrell J06061 - Size 11.5,Merrell J06061 - Size 11.5,Default,6,6,0,0,0,0
,Merrell J06061 - Size 11.5,Merrell J06061 - Size 11.5,Default Ridgefield,0,0,0,0,0,24
,Merrell J06061 - Size 11.5,Merrell J06061 - Size 11.5,FBALYB Amazon,-7,-7,0,0,0,0
,Merrell J06061 - Size 12,Merrell J06061 - Size 12,Default Ridgefield,0,0,0,0,0,24
,Merrell J06061 - Size 12,Merrell J06061 - Size 12,FBALYB Amazon,-7,-7,0,0,0,0
,Merrell J06061 - Size 13,Merrell J06061 - Size 13,Default Ridgefield,0,0,0,0,0,24
,Merrell J06061 - Size 13,Merrell J06061 - Size 13,FBALYB Amazon,-1,-1,0,0,0,0
,Merrell J06061 - Size 14,Merrell J06061 - Size 14,FBALYB Amazon,-1,-1,0,0,0,0
,Merrell J06061 - Size 8,Merrell J06061 - Size 8,Default,6,6,0,0,0,0
,Merrell J06061 - Size 8,Merrell J06061 - Size 8,FBALYB Amazon,-13,-13,0,0,0,0
,Merrell J06061 - Size 8.5,Merrell J06061 - Size 8.5,Default Ridgefield,0,0,0,0,0,12
,Merrell J06061 - Size 8.5,Merrell J06061 - Size 8.5,FBALYB Amazon,-4,-4,0,0,0,0
,Merrell J06061 - Size 9,Merrell J06061 - Size 9,Default Ridgefield,0,0,0,0,0,12
,Merrell J06061 - Size 9,Merrell J06061 - Size 9,FBALYB Amazon,-4,-4,0,0,0,0
,Merrell J06061 - Size 9.5,Merrell J06061 - Size 9.5,Default Ridgefield,0,0,0,0,0,24
,Merrell J06061 - Size 9.5,Merrell J06061 - Size 9.5,FBALYB Amazon,-4,-4,0,0,0,0
,Merrell J06063 - Size 10,Merrell J06063 - Size 10,Default Ridgefield,0,0,0,0,0,36
,Merrell J06063 - Size 10,Merrell J06063 - Size 10,FBALYB Amazon,4,4,0,0,0,0
,Merrell J06063 - Size 10.5,Merrell J06063 - Size 10.5,Default Ridgefield,0,0,0,0,0,36
,Merrell J06063 - Size 10.5,Merrell J06063 - Size 10.5,FBALYB Amazon,-21,-22,1,41,1,0
,Merrell J06063 - Size 11,Merrell J06063 - Size 11,Default,1,1,0,0,0,0
,Merrell J06063 - Size 11,Merrell J06063 - Size 11,Default Ridgefield,0,0,0,0,0,36
,Merrell J06063 - Size 11,Merrell J06063 - Size 11,FBALYB Amazon,-54,-58,4,60,4,0
,Merrell J06063 - Size 11.5,Merrell J06063 - Size 11.5,Default Ridgefield,0,0,0,0,0,24
,Merrell J06063 - Size 11.5,Merrell J06063 - Size 11.5,FBALYB Amazon,5,2,3,16,3,0
,Merrell J06063 - Size 12,Merrell J06063 - Size 12,Default Ridgefield,2,2,0,0,0,24
,Merrell J06063 - Size 12,Merrell J06063 - Size 12,FBALYB Amazon,-5,-6,1,8,1,0
,Merrell J06063 - Size 12.5,Merrell J06063 - Size 12.5,Default Ridgefield,20,20,0,0,0,0
,Merrell J06063 - Size 12.5,Merrell J06063 - Size 12.5,FBALYB Amazon,6,5,1,0,1,0
,Merrell J06063 - Size 13,Merrell J06063 - Size 13,Default Ridgefield,8,8,0,0,0,24
,Merrell J06063 - Size 13,Merrell J06063 - Size 13,FBALYB Amazon,9,8,1,0,1,0
,Merrell J06063 - Size 8,Merrell J06063 - Size 8,Default Ridgefield,0,0,0,0,0,12
,Merrell J06063 - Size 8,Merrell J06063 - Size 8,FBALYB Amazon,-3,-3,0,0,0,0
,Merrell J06063 - Size 8.5,Merrell J06063 - Size 8.5,Default Ridgefield,1,1,0,0,0,12
,Merrell J06063 - Size 8.5,Merrell J06063 - Size 8.5,FBALYB Amazon,7,7,0,0,0,0
,Merrell J06063 - Size 9,Merrell J06063 - Size 9,Default Ridgefield,0,0,0,0,0,24
,Merrell J06063 - Size 9,Merrell J06063 - Size 9,FBALYB Amazon,6,6,0,0,0,0
,Merrell J06063 - Size 9.5,Merrell J06063 - Size 9.5,Default Ridgefield,0,0,0,0,0,24
,Merrell J06063 - Size 9.5,Merrell J06063 - Size 9.5,FBALYB Amazon,9,5,4,0,4,0
,Merrell J06113 - Size 10,Merrell J06113 - Size 10,FBALYB Amazon,-33,-33,0,25,0,0
,Merrell J06113 - Size 10.5,Merrell J06113 - Size 10.5,FBALYB Amazon,-58,-58,0,48,0,0
,Merrell J06113 - Size 11,Merrell J06113 - Size 11,FBALYB Amazon,-38,-38,0,32,0,0
,Merrell J06113 - Size 11.5,Merrell J06113 - Size 11.5,FBALYB Amazon,-30,-30,0,25,0,0
,Merrell J06113 - Size 12,Merrell J06113 - Size 12,FBALYB Amazon,-41,-41,0,34,0,0
,Merrell J06113 - Size 13,Merrell J06113 - Size 13,FBALYB Amazon,-32,-32,0,25,0,0
,Merrell J06113 - Size 7,Merrell J06113 - Size 7,FBALYB Amazon,12,12,0,0,0,0
,Merrell J06113 - Size 7.5,Merrell J06113 - Size 7.5,FBALYB Amazon,-7,-7,0,0,0,0
,Merrell J06113 - Size 8,Merrell J06113 - Size 8,FBALYB Amazon,-14,-14,0,8,0,0
,Merrell J06113 - Size 8.5,Merrell J06113 - Size 8.5,FBALYB Amazon,-4,-4,0,0,0,0
,Merrell J06113 - Size 9,Merrell J06113 - Size 9,FBALYB Amazon,-29,-29,0,25,0,0
,Merrell J06113 - Size 9.5,Merrell J06113 - Size 9.5,FBALYB Amazon,-20,-20,0,15,0,0
,Merrell J066656 - Size 10,Merrell J066656 - Size 10,Default,0,0,0,0,0,5
,Merrell J066656 - Size 10,Merrell J066656 - Size 10,FBALYB Amazon,-29,-29,0,0,0,0
,Merrell J066656 - Size 6,Merrell J066656 - Size 6,FBALYB Amazon,-16,-16,0,2,0,0
,Merrell J066656 - Size 6.5,Merrell J066656 - Size 6.5,FBALYB Amazon,-9,-9,0,1,0,0
,Merrell J066656 - Size 7,Merrell J066656 - Size 7,FBALYB Amazon,-18,-18,0,0,0,0
,Merrell J066656 - Size 7.5,Merrell J066656 - Size 7.5,FBALYB Amazon,-79,-79,0,50,0,0
,Merrell J066656 - Size 8,Merrell J066656 - Size 8,FBALYB Amazon,-27,-27,0,1,0,0
,Merrell J066656 - Size 8.5,Merrell J066656 - Size 8.5,FBALYB Amazon,-103,-103,0,60,0,0
,Merrell J066656 - Size 9,Merrell J066656 - Size 9,FBALYB Amazon,-4,-5,1,36,1,0
,Merrell J066656 - Size 9.5,Merrell J066656 - Size 9.5,FBALYB Amazon,-10,-10,0,0,0,0
,Merrell J08871 - size 10,Merrell J08871 - size 10,Default Ridgefield,96,96,0,0,0,96
,Merrell J08871 - size 10,Merrell J08871 - size 10,FBALYB Amazon,110,110,0,0,0,0
,Merrell J08871 - size 10.5,Merrell J08871 - size 10.5,Default Ridgefield,96,96,0,0,0,96
,Merrell J08871 - size 10.5,Merrell J08871 - size 10.5,FBALYB Amazon,100,97,3,0,3,0
,Merrell J08871 - size 11,Merrell J08871 - size 11,Default Ridgefield,96,96,0,0,0,96
,Merrell J08871 - size 11,Merrell J08871 - size 11,FBALYB Amazon,52,52,0,0,0,0
,Merrell J08871 - size 11.5,Merrell J08871 - size 11.5,Default Ridgefield,72,72,0,0,0,72
,Merrell J08871 - size 11.5,Merrell J08871 - size 11.5,FBALYB Amazon,19,17,2,0,2,0
,Merrell J08871 - size 12,Merrell J08871 - size 12,Default Ridgefield,84,84,0,0,0,84
,Merrell J08871 - size 12,Merrell J08871 - size 12,FBALYB Amazon,89,88,1,0,1,0
,Merrell J08871 - size 12.5,Merrell J08871 - size 12.5,FBALYB Amazon,12,12,0,0,0,0
,Merrell J08871 - size 13,Merrell J08871 - size 13,Default Ridgefield,49,49,0,0,0,72
,Merrell J08871 - size 13,Merrell J08871 - size 13,FBALYB Amazon,-2,-2,0,23,0,0
,Merrell J08871 - size 8,Merrell J08871 - size 8,Default Ridgefield,14,14,0,0,0,24
,Merrell J08871 - size 8,Merrell J08871 - size 8,FBALYB Amazon,20,20,0,10,0,0
,Merrell J08871 - size 8.5,Merrell J08871 - size 8.5,Default Ridgefield,24,24,0,0,0,36
,Merrell J08871 - size 8.5,Merrell J08871 - size 8.5,FBALYB Amazon,-6,-6,0,12,0,0
,Merrell J08871 - size 9,Merrell J08871 - size 9,Default Ridgefield,60,60,0,0,0,60
,Merrell J08871 - size 9,Merrell J08871 - size 9,FBALYB Amazon,46,46,0,0,0,0
,Merrell J08871 - size 9.5,Merrell J08871 - size 9.5,Default Ridgefield,80,80,0,0,0,72
,Merrell J08871 - size 9.5,Merrell J08871 - size 9.5,FBALYB Amazon,15,13,2,19,2,0
,Merrell J15752 - Size 6.5,Merrell J15752 - Size 6.5,FBALYB Amazon,-2,-2,0,0,0,0
,Merrell J15752 - Size 7,Merrell J15752 - Size 7,FBALYB Amazon,3,1,2,0,2,0
,Merrell J15752 - Size 7.5,Merrell J15752 - Size 7.5,FBALYB Amazon,-5,-5,0,0,0,0
,Merrell J15752 - Size 8,Merrell J15752 - Size 8,FBALYB Amazon,3,0,3,0,3,0
,Merrell J15752 - Size 8.5,Merrell J15752 - Size 8.5,FBALYB Amazon,-6,-6,0,0,0,0
,Merrell J15752 - Size 9,Merrell J15752 - Size 9,FBALYB Amazon,-11,-11,0,0,0,0
,Merrell J15752 - Size 9.5,Merrell J15752 - Size 9.5,FBALYB Amazon,-11,-11,0,0,0,0
,Merrell J15845 - Size 10,Merrell J15845 - Size 10,Default,0,-15,15,0,0,0
,Merrell J15845 - Size 10,Merrell J15845 - Size 10,FBALYB Amazon,-6,-6,0,0,0,0
,Merrell J15845 - Size 10.5,Merrell J15845 - Size 10.5,Default,0,-15,15,0,0,0
,Merrell J15845 - Size 11,Merrell J15845 - Size 11,Default,0,-15,15,0,0,0
,Merrell J15845 - Size 11,Merrell J15845 - Size 11,FBALYB Amazon,2,2,0,0,0,0
,Merrell J15845 - Size 11.5,Merrell J15845 - Size 11.5,Default,0,-10,10,0,0,0
,Merrell J15845 - Size 11.5,Merrell J15845 - Size 11.5,FBALYB Amazon,-2,-2,0,0,0,0
,Merrell J15845 - Size 12,Merrell J15845 - Size 12,Default,0,-5,5,0,0,0
,Merrell J15845 - Size 12,Merrell J15845 - Size 12,FBALYB Amazon,0,0,0,5,0,0
,Merrell J15845 - Size 8,Merrell J15845 - Size 8,Default,0,-5,5,0,0,0
,Merrell J15845 - Size 8.5,Merrell J15845 - Size 8.5,Default,0,-9,9,0,0,0
,Merrell J15845 - Size 8.5,Merrell J15845 - Size 8.5,FBALYB Amazon,-3,-3,0,0,0,0
,Merrell J15845 - Size 9,Merrell J15845 - Size 9,Default,0,-10,10,0,0,0
,Merrell J15845 - Size 9.5,Merrell J15845 - Size 9.5,Default,0,-14,14,0,0,0
,Merrell J15845 - Size 9.5,Merrell J15845 - Size 9.5,FBALYB Amazon,-2,-2,0,0,0,0
,Merrell J15845W - Size 10,Merrell J15845W - Size 10,Default,0,-15,15,0,0,0
,Merrell J15845W - Size 10,Merrell J15845W - Size 10,FBALYB Amazon,-1,-1,0,0,0,0
,Merrell J15845W - Size 10.5,Merrell J15845W - Size 10.5,Default,0,-15,15,0,0,0
,Merrell J15845W - Size 10.5,Merrell J15845W - Size 10.5,FBALYB Amazon,-6,-6,0,1,0,0
,Merrell J15845W - Size 11,Merrell J15845W - Size 11,Default,0,-15,15,0,0,0
,Merrell J15845W - Size 11.5,Merrell J15845W - Size 11.5,Default,0,-10,10,0,0,0
,Merrell J15845W - Size 11.5,Merrell J15845W - Size 11.5,FBALYB Amazon,-3,-3,0,1,0,0
,Merrell J15845W - Size 12,Merrell J15845W - Size 12,Default Ridgefield,2,2,0,0,0,0
,Merrell J15845W - Size 12,Merrell J15845W - Size 12,FBALYB Amazon,-4,-4,0,0,0,0
,Merrell J15845W - Size 8,Merrell J15845W - Size 8,Default,0,-5,5,0,0,0
,Merrell J15845W - Size 8,Merrell J15845W - Size 8,FBALYB Amazon,-4,-4,0,0,0,0
,Merrell J15845W - Size 8.5,Merrell J15845W - Size 8.5,Default,0,-10,10,0,0,0
,Merrell J15845W - Size 8.5,Merrell J15845W - Size 8.5,FBALYB Amazon,-6,-6,0,0,0,0
,Merrell J15845W - Size 9,Merrell J15845W - Size 9,Default,0,-10,10,0,0,0
,Merrell J15845W - Size 9,Merrell J15845W - Size 9,FBALYB Amazon,-3,-3,0,1,0,0
,Merrell J15845W - Size 9.5,Merrell J15845W - Size 9.5,Default,0,-15,15,0,0,0
,Merrell J15845W - Size 9.5,Merrell J15845W - Size 9.5,FBALYB Amazon,-5,-5,0,0,0,0
,Merrell J15861W - Size 10,Merrell J15861W - Size 10,Default,0,-11,11,0,0,0
,Merrell J15861W - Size 10,Merrell J15861W - Size 10,FBALYB Amazon,-1,-1,0,0,0,0
,Merrell J15861W - Size 10.5,Merrell J15861W - Size 10.5,Default,0,-12,12,0,0,0
,Merrell J15861W - Size 10.5,Merrell J15861W - Size 10.5,FBALYB Amazon,-5,-5,0,0,0,0
,Merrell J15861W - Size 11,Merrell J15861W - Size 11,Default,0,-12,12,0,0,0
,Merrell J15861W - Size 11,Merrell J15861W - Size 11,FBALYB Amazon,-6,-6,0,0,0,0
,Merrell J15861W - Size 11.5,Merrell J15861W - Size 11.5,Default,0,-11,11,0,0,0
,Merrell J15861W - Size 11.5,Merrell J15861W - Size 11.5,FBALYB Amazon,-6,-6,0,0,0,0
,Merrell J15861W - Size 12,Merrell J15861W - Size 12,FBALYB Amazon,-9,-9,0,0,0,0
,Merrell J15861W - Size 8,Merrell J15861W - Size 8,Default,0,-7,7,0,0,0
,Merrell J15861W - Size 8.5,Merrell J15861W - Size 8.5,Default,0,-11,11,0,0,0
,Merrell J15861W - Size 8.5,Merrell J15861W - Size 8.5,FBALYB Amazon,-1,-1,0,0,0,0
,Merrell J15861W - Size 9,Merrell J15861W - Size 9,Default,0,-12,12,0,0,0
,Merrell J15861W - Size 9,Merrell J15861W - Size 9,FBALYB Amazon,-3,-3,0,0,0,0
,Merrell J15861W - Size 9.5,Merrell J15861W - Size 9.5,Default,0,-12,12,0,0,0
,Merrell J15861W - Size 9.5,Merrell J15861W - Size 9.5,FBALYB Amazon,-7,-7,0,0,0,0
,Merrell J17199 - Size 10,Merrell J17199 - Size 10,Default Ridgefield,28,28,0,0,0,4
,Merrell J17199 - Size 10,Merrell J17199 - Size 10,FBALYB Amazon,14,14,0,0,0,0
,Merrell J17199 - Size 10.5,Merrell J17199 - Size 10.5,Default Ridgefield,28,28,0,0,0,16
,Merrell J17199 - Size 10.5,Merrell J17199 - Size 10.5,FBALYB Amazon,4,2,2,0,2,0
,Merrell J17199 - Size 11,Merrell J17199 - Size 11,Default Ridgefield,28,28,0,0,0,16
,Merrell J17199 - Size 11,Merrell J17199 - Size 11,FBALYB Amazon,8,7,1,0,1,0
,Merrell J17199 - Size 11.5,Merrell J17199 - Size 11.5,Default Ridgefield,16,16,0,0,0,0
,Merrell J17199 - Size 11.5,Merrell J17199 - Size 11.5,FBALYB Amazon,3,1,2,0,2,0
,Merrell J17199 - Size 12,Merrell J17199 - Size 12,FBALYB Amazon,20,20,0,0,0,0
,Merrell J17199 - Size 12.5,Merrell J17199 - Size 12.5,Default Ridgefield,40,40,0,0,0,0
,Merrell J17199 - Size 13,Merrell J17199 - Size 13,FBALYB Amazon,2,0,2,16,2,0
,Merrell J17199 - Size 14,Merrell J17199 - Size 14,FBALYB Amazon,11,11,0,0,0,0
,Merrell J17199 - Size 7.5,Merrell J17199 - Size 7.5,FBALYB Amazon,9,6,3,0,3,0
,Merrell J17199 - Size 8,Merrell J17199 - Size 8,FBALYB Amazon,-2,-2,0,0,0,0
,Merrell J17199 - Size 8.5,Merrell J17199 - Size 8.5,Default Ridgefield,4,4,0,0,0,12
,Merrell J17199 - Size 8.5,Merrell J17199 - Size 8.5,FBALYB Amazon,15,15,0,0,0,0
,Merrell J17199 - Size 9,Merrell J17199 - Size 9,Default Ridgefield,43,43,0,0,0,12
,Merrell J17199 - Size 9,Merrell J17199 - Size 9,FBALYB Amazon,-7,-7,0,0,0,0
,Merrell J17199 - Size 9.5,Merrell J17199 - Size 9.5,Default Ridgefield,4,4,0,0,0,12
,Merrell J17199 - Size 9.5,Merrell J17199 - Size 9.5,FBALYB Amazon,-1,-1,0,12,0,0
,Merrell J19904 - Size 10,Merrell J19904 - Size 10,FBALYB Amazon,-1,-1,0,0,0,0
,Merrell J19904 - Size 11,Merrell J19904 - Size 11,Default,6,6,0,0,0,0
,Merrell J19904 - Size 11,Merrell J19904 - Size 11,FBALYB Amazon,-7,-7,0,0,0,0
,Merrell J19904 - Size 6,Merrell J19904 - Size 6,FBALYB Amazon,-1,-1,0,0,0,0
,Merrell J19904 - Size 6.5,Merrell J19904 - Size 6.5,Default,6,6,0,0,0,0
,Merrell J19904 - Size 6.5,Merrell J19904 - Size 6.5,FBALYB Amazon,-8,-8,0,0,0,0
,Merrell J19904 - Size 7,Merrell J19904 - Size 7,FBALYB Amazon,-6,-6,0,0,0,0
,Merrell J19904 - Size 7.5,Merrell J19904 - Size 7.5,FBALYB Amazon,-9,-9,0,0,0,0
,Merrell J19904 - Size 8,Merrell J19904 - Size 8,FBALYB Amazon,-6,-6,0,0,0,0
,Merrell J19904 - Size 8.5,Merrell J19904 - Size 8.5,FBALYB Amazon,-11,-11,0,0,0,0
,Merrell J19904 - Size 9,Merrell J19904 - Size 9,FBALYB Amazon,-8,-8,0,0,0,0
,Merrell J19904 - Size 9.5,Merrell J19904 - Size 9.5,FBALYB Amazon,-5,-5,0,0,0,0
,Merrell J31275 - Size 10,Merrell J31275 - Size 10,Default Ridgefield,48,48,0,0,0,0
,Merrell J31275 - Size 10,Merrell J31275 - Size 10,FBALYB Amazon,65,65,0,0,0,0
,Merrell J31275 - Size 10.5,Merrell J31275 - Size 10.5,Default Ridgefield,51,51,0,0,0,0
,Merrell J31275 - Size 10.5,Merrell J31275 - Size 10.5,FBALYB Amazon,108,106,2,0,2,0
,Merrell J31275 - Size 11,Merrell J31275 - Size 11,Default Ridgefield,48,48,0,0,0,0
,Merrell J31275 - Size 11,Merrell J31275 - Size 11,FBALYB Amazon,71,70,1,32,1,0
,Merrell J31275 - Size 11.5,Merrell J31275 - Size 11.5,Default Ridgefield,37,37,0,0,0,0
,Merrell J31275 - Size 11.5,Merrell J31275 - Size 11.5,FBALYB Amazon,39,39,0,25,0,0
,Merrell J31275 - Size 12,Merrell J31275 - Size 12,Default Ridgefield,84,84,0,0,0,0
,Merrell J31275 - Size 12,Merrell J31275 - Size 12,FBALYB Amazon,37,34,3,35,3,0
,Merrell J31275 - Size 13,Merrell J31275 - Size 13,Default Ridgefield,52,52,0,0,0,0
,Merrell J31275 - Size 13,Merrell J31275 - Size 13,FBALYB Amazon,46,46,0,25,0,0
,Merrell J31275 - Size 7,Merrell J31275 - Size 7,FBALYB Amazon,30,30,0,0,0,0
,Merrell J31275 - Size 7.5,Merrell J31275 - Size 7.5,FBALYB Amazon,27,27,0,0,0,0
,Merrell J31275 - Size 8,Merrell J31275 - Size 8,Default Ridgefield,12,12,0,0,0,0
,Merrell J31275 - Size 8,Merrell J31275 - Size 8,FBALYB Amazon,31,31,0,0,0,0
,Merrell J31275 - Size 8.5,Merrell J31275 - Size 8.5,Default Ridgefield,24,24,0,0,0,0
,Merrell J31275 - Size 8.5,Merrell J31275 - Size 8.5,FBALYB Amazon,43,43,0,0,0,0
,Merrell J31275 - Size 9,Merrell J31275 - Size 9,Default Ridgefield,12,12,0,0,0,0
,Merrell J31275 - Size 9,Merrell J31275 - Size 9,FBALYB Amazon,33,32,1,25,1,0
,Merrell J31275 - Size 9.5,Merrell J31275 - Size 9.5,Default Ridgefield,12,12,0,0,0,0
,Merrell J31275 - Size 9.5,Merrell J31275 - Size 9.5,FBALYB Amazon,59,58,1,25,1,0
,Merrell J31275 - Size 9.5,Merrell J31275 - Size 9.5,WFS,-2,-2,0,0,0,0
,Merrell J31281 - Size 10,Merrell J31281 - Size 10,Default,0,0,0,0,0,24
,Merrell J31281 - Size 10,Merrell J31281 - Size 10,Default Ridgefield,93,93,0,0,0,0
,Merrell J31281 - Size 10,Merrell J31281 - Size 10,FBALYB Amazon,-35,-35,0,25,0,0
,Merrell J31281 - Size 10.5,Merrell J31281 - Size 10.5,Default,0,0,0,0,0,60
,Merrell J31281 - Size 10.5,Merrell J31281 - Size 10.5,Default Ridgefield,122,122,0,0,0,0
,Merrell J31281 - Size 10.5,Merrell J31281 - Size 10.5,FBALYB Amazon,-77,-77,0,48,0,0
,Merrell J31281 - Size 11,Merrell J31281 - Size 11,Default,0,0,0,0,0,60
,Merrell J31281 - Size 11,Merrell J31281 - Size 11,Default Ridgefield,119,119,0,0,0,0
,Merrell J31281 - Size 11,Merrell J31281 - Size 11,FBALYB Amazon,-14,-14,0,0,0,0
,Merrell J31281 - Size 11.5,Merrell J31281 - Size 11.5,Default,0,0,0,0,0,60
,Merrell J31281 - Size 11.5,Merrell J31281 - Size 11.5,Default Ridgefield,98,98,0,0,0,0
,Merrell J31281 - Size 11.5,Merrell J31281 - Size 11.5,FBALYB Amazon,-40,-40,0,25,0,0
,Merrell J31281 - Size 12,Merrell J31281 - Size 12,Default,0,0,0,0,0,36
,Merrell J31281 - Size 12,Merrell J31281 - Size 12,Default Ridgefield,77,77,0,0,0,0
,Merrell J31281 - Size 12,Merrell J31281 - Size 12,FBALYB Amazon,-13,-13,0,0,0,0
,Merrell J31281 - Size 12.5,Merrell J31281 - Size 12.5,Default,0,0,0,0,0,24
,Merrell J31281 - Size 12.5,Merrell J31281 - Size 12.5,Default Ridgefield,15,15,0,0,0,0
,Merrell J31281 - Size 12.5,Merrell J31281 - Size 12.5,FBALYB Amazon,12,12,0,0,0,0
,Merrell J31281 - Size 13,Merrell J31281 - Size 13,Default,0,0,0,0,0,72
,Merrell J31281 - Size 13,Merrell J31281 - Size 13,Default Ridgefield,49,49,0,0,0,0
,Merrell J31281 - Size 13,Merrell J31281 - Size 13,FBALYB Amazon,163,163,0,25,0,0
,Merrell J31281 - Size 13,Merrell J31281 - Size 13,WFS,-9,-9,0,0,0,0
,Merrell J31281 - Size 14,Merrell J31281 - Size 14,Default,0,0,0,0,0,36
,Merrell J31281 - Size 14,Merrell J31281 - Size 14,Default Ridgefield,21,21,0,0,0,0
,Merrell J31281 - Size 14,Merrell J31281 - Size 14,FBALYB Amazon,-6,-6,0,0,0,0
,Merrell J31281 - Size 7,Merrell J31281 - Size 7,FBALYB Amazon,0,0,0,15,0,0
,Merrell J31281 - Size 7.5,Merrell J31281 - Size 7.5,FBALYB Amazon,8,8,0,0,0,0
,Merrell J31281 - Size 8,Merrell J31281 - Size 8,Default Ridgefield,29,29,0,0,0,0
,Merrell J31281 - Size 8,Merrell J31281 - Size 8,FBALYB Amazon,-5,-5,0,0,0,0
,Merrell J31281 - Size 8.5,Merrell J31281 - Size 8.5,Default Ridgefield,39,39,0,0,0,0
,Merrell J31281 - Size 8.5,Merrell J31281 - Size 8.5,FBALYB Amazon,-5,-5,0,0,0,0
,Merrell J31281 - Size 9,Merrell J31281 - Size 9,Default,0,0,0,0,0,23
,Merrell J31281 - Size 9,Merrell J31281 - Size 9,Default Ridgefield,64,64,0,0,0,0
,Merrell J31281 - Size 9,Merrell J31281 - Size 9,FBALYB Amazon,-33,-33,0,25,0,0
,Merrell J31281 - Size 9.5,Merrell J31281 - Size 9.5,Default,0,0,0,0,0,24
,Merrell J31281 - Size 9.5,Merrell J31281 - Size 9.5,Default Ridgefield,68,68,0,0,0,0
,Merrell J31281 - Size 9.5,Merrell J31281 - Size 9.5,FBALYB Amazon,-40,-40,0,25,0,0
,Merrell J45524 - Size 10,Merrell J45524 - Size 10,FBALYB Amazon,8,8,0,0,0,0
,Merrell J45524 - Size 6.5,Merrell J45524 - Size 6.5,FBALYB Amazon,6,6,0,0,0,0
,Merrell J45524 - Size 7,Merrell J45524 - Size 7,FBALYB Amazon,10,10,0,0,0,0
,Merrell J45524 - Size 7.5,Merrell J45524 - Size 7.5,FBALYB Amazon,-6,-7,1,0,1,0
,Merrell J45524 - Size 8,Merrell J45524 - Size 8,FBALYB Amazon,13,13,0,0,0,0
,Merrell J45524 - Size 9,Merrell J45524 - Size 9,FBALYB Amazon,-2,-2,0,0,0,0
,Merrell J45524 - Size 9.5,Merrell J45524 - Size 9.5,FBALYB Amazon,-3,-3,0,0,0,0
,Merrell J49821 - Size 10,Merrell J49821 - Size 10,FBALYB Amazon,-6,-6,0,0,0,0
,Merrell J49821 - Size 10.5,Merrell J49821 - Size 10.5,FBALYB Amazon,-8,-8,0,0,0,0
,Merrell J49821 - Size 11,Merrell J49821 - Size 11,FBALYB Amazon,-13,-13,0,0,0,0
,Merrell J49821 - Size 11.5,Merrell J49821 - Size 11.5,FBALYB Amazon,-14,-14,0,0,0,0
,Merrell J49821 - Size 12,Merrell J49821 - Size 12,FBALYB Amazon,-5,-5,0,1,0,0
,Merrell J49821 - Size 13,Merrell J49821 - Size 13,FBALYB Amazon,-4,-5,1,0,1,0
,Merrell J49821 - Size 8,Merrell J49821 - Size 8,FBALYB Amazon,-1,-1,0,0,0,0
,Merrell J49821 - Size 8.5,Merrell J49821 - Size 8.5,FBALYB Amazon,10,10,0,0,0,0
,Merrell J49821 - Size 9,Merrell J49821 - Size 9,FBALYB Amazon,-2,-2,0,0,0,0
,Merrell J49821 - Size 9.5,Merrell J49821 - Size 9.5,FBALYB Amazon,-4,-4,0,0,0,0
,Merrell J50395 - Size 10,Merrell J50395 - Size 10,FBALYB Amazon,-9,-9,0,0,0,0
,Merrell J50395 - Size 10.5,Merrell J50395 - Size 10.5,Default,0,-1,1,0,0,0
,Merrell J50395 - Size 10.5,Merrell J50395 - Size 10.5,FBALYB Amazon,-12,-12,0,0,0,0
,Merrell J50395 - Size 11,Merrell J50395 - Size 11,FBALYB Amazon,-8,-8,0,0,0,0
,Merrell J50395 - Size 11.5,Merrell J50395 - Size 11.5,FBALYB Amazon,-5,-5,0,0,0,0
,Merrell J50395 - Size 12,Merrell J50395 - Size 12,FBALYB Amazon,-7,-7,0,0,0,0
,Merrell J50395 - Size 13,Merrell J50395 - Size 13,FBALYB Amazon,-5,-5,0,0,0,0
,Merrell J50395 - Size 14,Merrell J50395 - Size 14,FBALYB Amazon,-1,-1,0,0,0,0
,Merrell J50395 - Size 8,Merrell J50395 - Size 8,FBALYB Amazon,-2,-2,0,0,0,0
,Merrell J50395 - Size 8.5,Merrell J50395 - Size 8.5,FBALYB Amazon,-3,-3,0,0,0,0
,Merrell J50395 - Size 9,Merrell J50395 - Size 9,FBALYB Amazon,-3,-3,0,0,0,0
,Merrell J50403 - Size 10,Merrell J50403 - Size 10,Default,0,0,0,0,0,84
,Merrell J50403 - Size 10,Merrell J50403 - Size 10,Default Ridgefield,0,0,0,0,0,84
,Merrell J50403 - Size 10,Merrell J50403 - Size 10,FBALYB Amazon,75,74,1,0,1,0
,Merrell J50403 - Size 10.5,Merrell J50403 - Size 10.5,Default,0,0,0,0,0,84
,Merrell J50403 - Size 10.5,Merrell J50403 - Size 10.5,Default Ridgefield,0,0,0,0,0,84
,Merrell J50403 - Size 10.5,Merrell J50403 - Size 10.5,FBALYB Amazon,60,59,1,1,1,0
,Merrell J50403 - Size 11,Merrell J50403 - Size 11,Default,0,0,0,0,0,84
,Merrell J50403 - Size 11,Merrell J50403 - Size 11,Default Ridgefield,0,0,0,0,0,84
,Merrell J50403 - Size 11,Merrell J50403 - Size 11,FBALYB Amazon,70,69,1,0,1,0
,Merrell J50403 - Size 11.5,Merrell J50403 - Size 11.5,Default,0,0,0,0,0,60
,Merrell J50403 - Size 11.5,Merrell J50403 - Size 11.5,Default Ridgefield,0,0,0,0,0,60
,Merrell J50403 - Size 11.5,Merrell J50403 - Size 11.5,FBALYB Amazon,53,53,0,0,0,0
,Merrell J50403 - Size 12,Merrell J50403 - Size 12,Default,0,0,0,0,0,60
,Merrell J50403 - Size 12,Merrell J50403 - Size 12,Default Ridgefield,0,0,0,0,0,60
,Merrell J50403 - Size 12,Merrell J50403 - Size 12,FBALYB Amazon,38,38,0,0,0,0
,Merrell J50403 - Size 13,Merrell J50403 - Size 13,Default,6,6,0,0,0,60
,Merrell J50403 - Size 13,Merrell J50403 - Size 13,Default Ridgefield,0,0,0,0,0,60
,Merrell J50403 - Size 13,Merrell J50403 - Size 13,FBALYB Amazon,45,45,0,0,0,0
,Merrell J50403 - Size 14,Merrell J50403 - Size 14,FBALYB Amazon,-3,-3,0,0,0,0
,Merrell J50403 - Size 7.5,Merrell J50403 - Size 7.5,Default,0,0,0,0,0,12
,Merrell J50403 - Size 7.5,Merrell J50403 - Size 7.5,Default Ridgefield,0,0,0,0,0,12
,Merrell J50403 - Size 7.5,Merrell J50403 - Size 7.5,FBALYB Amazon,10,10,0,0,0,0
,Merrell J50403 - Size 8,Merrell J50403 - Size 8,Default,0,0,0,0,0,12
,Merrell J50403 - Size 8,Merrell J50403 - Size 8,Default Ridgefield,0,0,0,0,0,12
,Merrell J50403 - Size 8,Merrell J50403 - Size 8,FBALYB Amazon,5,5,0,0,0,0
,Merrell J50403 - Size 8.5,Merrell J50403 - Size 8.5,Default,0,0,0,0,0,36
,Merrell J50403 - Size 8.5,Merrell J50403 - Size 8.5,Default Ridgefield,0,0,0,0,0,36
,Merrell J50403 - Size 8.5,Merrell J50403 - Size 8.5,FBALYB Amazon,29,29,0,0,0,0
,Merrell J50403 - Size 9,Merrell J50403 - Size 9,Default,0,0,0,0,0,48
,Merrell J50403 - Size 9,Merrell J50403 - Size 9,Default Ridgefield,0,0,0,0,0,48
,Merrell J50403 - Size 9,Merrell J50403 - Size 9,FBALYB Amazon,42,42,0,0,0,0
,Merrell J50403 - Size 9.5,Merrell J50403 - Size 9.5,Default,0,0,0,0,0,60
,Merrell J50403 - Size 9.5,Merrell J50403 - Size 9.5,Default Ridgefield,0,0,0,0,0,60
,Merrell J50403 - Size 9.5,Merrell J50403 - Size 9.5,FBALYB Amazon,49,49,0,0,0,0
,Merrell J52504 - Size 10,Merrell J52504 - Size 10,FBALYB Amazon,-4,-4,0,0,0,0
,Merrell J52504 - Size 11,Merrell J52504 - Size 11,FBALYB Amazon,-5,-5,0,0,0,0
,Merrell J52504 - Size 6.5,Merrell J52504 - Size 6.5,FBALYB Amazon,-4,-4,0,0,0,0
,Merrell J52504 - Size 7,Merrell J52504 - Size 7,FBALYB Amazon,-3,-3,0,0,0,0
,Merrell J52504 - Size 7.5,Merrell J52504 - Size 7.5,FBALYB Amazon,-4,-4,0,0,0,0
,Merrell J52504 - Size 8,Merrell J52504 - Size 8,FBALYB Amazon,-8,-8,0,0,0,0
,Merrell J52504 - Size 8.5,Merrell J52504 - Size 8.5,FBALYB Amazon,-11,-11,0,0,0,0
,Merrell J52504 - Size 9,Merrell J52504 - Size 9,FBALYB Amazon,-6,-6,0,0,0,0
,Merrell J52504 - Size 9.5,Merrell J52504 - Size 9.5,FBALYB Amazon,-3,-3,0,0,0,0
,Merrell J52506 - Size 10,Merrell J52506 - Size 10,FBALYB Amazon,-2,-2,0,0,0,0
,Merrell J52506 - Size 11,Merrell J52506 - Size 11,Default,6,6,0,0,0,0
,Merrell J52506 - Size 11,Merrell J52506 - Size 11,FBALYB Amazon,-13,-13,0,0,0,0
,Merrell J52506 - Size 6,Merrell J52506 - Size 6,FBALYB Amazon,-6,-6,0,0,0,0
,Merrell J52506 - Size 6.5,Merrell J52506 - Size 6.5,FBALYB Amazon,-2,-2,0,0,0,0
,Merrell J52506 - Size 7,Merrell J52506 - Size 7,FBALYB Amazon,-11,-11,0,0,0,0
,Merrell J52506 - Size 7.5,Merrell J52506 - Size 7.5,FBALYB Amazon,-11,-11,0,0,0,0
,Merrell J52506 - Size 8,Merrell J52506 - Size 8,FBALYB Amazon,-14,-14,0,0,0,0
,Merrell J52506 - Size 8.5,Merrell J52506 - Size 8.5,FBALYB Amazon,-12,-12,0,0,0,0
,Merrell J52506 - Size 9,Merrell J52506 - Size 9,FBALYB Amazon,-9,-9,0,0,0,0
,Merrell J52506 - Size 9.5,Merrell J52506 - Size 9.5,FBALYB Amazon,-12,-12,0,0,0,0
,Merrell J559595 - Size 10,Merrell J559595 - Size 10,Default Ridgefield,46,46,0,0,0,0
,Merrell J559595 - Size 10,Merrell J559595 - Size 10,FBALYB Amazon,53,53,0,0,0,0
,Merrell J559595 - Size 10.5,Merrell J559595 - Size 10.5,Default Ridgefield,45,45,0,0,0,0
,Merrell J559595 - Size 10.5,Merrell J559595 - Size 10.5,FBALYB Amazon,22,22,0,0,0,0
,Merrell J559595 - Size 11,Merrell J559595 - Size 11,FBALYB Amazon,9,9,0,0,0,0
,Merrell J559595 - Size 11.5,Merrell J559595 - Size 11.5,FBALYB Amazon,12,12,0,0,0,0
,Merrell J559595 - Size 12,Merrell J559595 - Size 12,Default,0,0,0,0,0,33
,Merrell J559595 - Size 12,Merrell J559595 - Size 12,FBALYB Amazon,13,13,0,0,0,0
,Merrell J559595 - Size 13,Merrell J559595 - Size 13,FBALYB Amazon,-1,-1,0,0,0,0
,Merrell J559595 - Size 8.5,Merrell J559595 - Size 8.5,FBALYB Amazon,32,32,0,0,0,0
,Merrell J559595 - Size 9,Merrell J559595 - Size 9,FBALYB Amazon,6,6,0,0,0,0
,Merrell J559595 - Size 9.5,Merrell J559595 - Size 9.5,Default,0,0,0,0,0,1
,Merrell J559595 - Size 9.5,Merrell J559595 - Size 9.5,FBALYB Amazon,10,10,0,0,0,0
,Merrell J598231 - Size 10,Merrell J598231 - Size 10,FBALYB Amazon,21,20,1,0,1,0
,Merrell J598231 - Size 10.5,Merrell J598231 - Size 10.5,FBALYB Amazon,15,15,0,0,0,0
,Merrell J598231 - Size 11,Merrell J598231 - Size 11,Default Oxford,6,6,0,0,0,0
,Merrell J598231 - Size 11,Merrell J598231 - Size 11,FBALYB Amazon,111,111,0,0,0,0
,Merrell J598231 - Size 11.5,Merrell J598231 - Size 11.5,FBALYB Amazon,27,27,0,0,0,0
,Merrell J598231 - Size 12,Merrell J598231 - Size 12,FBALYB Amazon,-6,-6,0,12,0,0
,Merrell J598231 - Size 13,Merrell J598231 - Size 13,FBALYB Amazon,-9,-9,0,0,0,0
,Merrell J598231 - Size 14,Merrell J598231 - Size 14,Default Ridgefield,30,30,0,0,0,0
,Merrell J598231 - Size 7.5,Merrell J598231 - Size 7.5,FBALYB Amazon,10,10,0,0,0,0
,Merrell J598231 - Size 8,Merrell J598231 - Size 8,Default Ridgefield,3,3,0,0,0,0
,Merrell J598231 - Size 8,Merrell J598231 - Size 8,FBALYB Amazon,8,8,0,0,0,0
,Merrell J598231 - Size 8.5,Merrell J598231 - Size 8.5,Default Oxford,1,1,0,0,0,0
,Merrell J598231 - Size 8.5,Merrell J598231 - Size 8.5,FBALYB Amazon,-8,-8,0,0,0,0
,Merrell J598231 - Size 9,Merrell J598231 - Size 9,FBALYB Amazon,111,111,0,12,0,0
,Merrell J598231 - Size 9.5,Merrell J598231 - Size 9.5,Default Oxford,6,6,0,0,0,0
,Merrell J598231 - Size 9.5,Merrell J598231 - Size 9.5,FBALYB Amazon,15,15,0,0,0,0
,Merrell J598633 - Size 10,Merrell J598633 - Size 10,FBALYB Amazon,-2,-2,0,0,0,0
,Merrell J598633 - Size 10.5,Merrell J598633 - Size 10.5,FBALYB Amazon,-1,-1,0,0,0,0
,Merrell J598633 - Size 11,Merrell J598633 - Size 11,FBALYB Amazon,-3,-3,0,0,0,0
,Merrell J598633 - Size 11.5,Merrell J598633 - Size 11.5,FBALYB Amazon,-3,-3,0,0,0,0
,Merrell J598633 - Size 12,Merrell J598633 - Size 12,Default,1,1,0,0,0,0
,Merrell J598633 - Size 12,Merrell J598633 - Size 12,FBALYB Amazon,-1,-1,0,0,0,0
,Merrell J598633 - Size 8,Merrell J598633 - Size 8,FBALYB Amazon,3,3,0,0,0,0
,Merrell J598633 - Size 8.5,Merrell J598633 - Size 8.5,FBALYB Amazon,8,8,0,0,0,0
,Merrell J598633 - Size 9,Merrell J598633 - Size 9,FBALYB Amazon,-1,-2,1,1,1,0
,Merrell J598633 - Size 9.5,Merrell J598633 - Size 9.5,FBALYB Amazon,7,7,0,0,0,0
,Merrell J60787 - Size 10,Merrell J60787 - Size 10,Default,0,0,0,0,0,96
,Merrell J60787 - Size 10,Merrell J60787 - Size 10,Default Ridgefield,56,56,0,0,0,0
,Merrell J60787 - Size 10,Merrell J60787 - Size 10,FBALYB Amazon,139,128,11,2,11,0
,Merrell J60787 - Size 10.5,Merrell J60787 - Size 10.5,Default,0,0,0,0,0,96
,Merrell J60787 - Size 10.5,Merrell J60787 - Size 10.5,Default Ridgefield,20,20,0,0,0,0
,Merrell J60787 - Size 10.5,Merrell J60787 - Size 10.5,FBALYB Amazon,54,25,29,106,29,0
,Merrell J60787 - Size 11,Merrell J60787 - Size 11,Default,23,23,0,0,0,136
,Merrell J60787 - Size 11,Merrell J60787 - Size 11,Default Ridgefield,43,43,0,0,0,0
,Merrell J60787 - Size 11,Merrell J60787 - Size 11,FBALYB Amazon,76,54,22,73,22,0
,Merrell J60787 - Size 11.5,Merrell J60787 - Size 11.5,Default,0,0,0,0,0,24
,Merrell J60787 - Size 11.5,Merrell J60787 - Size 11.5,Default Ridgefield,2,2,0,0,0,0
,Merrell J60787 - Size 11.5,Merrell J60787 - Size 11.5,FBALYB Amazon,-43,-55,12,11,12,0
,Merrell J60787 - Size 12,Merrell J60787 - Size 12,Default,0,0,0,0,0,72
,Merrell J60787 - Size 12,Merrell J60787 - Size 12,FBALYB Amazon,72,62,10,44,10,0
,Merrell J60787 - Size 13,Merrell J60787 - Size 13,Default,0,0,0,0,0,12
,Merrell J60787 - Size 13,Merrell J60787 - Size 13,Default Ridgefield,52,52,0,0,0,0
,Merrell J60787 - Size 13,Merrell J60787 - Size 13,FBALYB Amazon,97,89,8,1,8,0
,Merrell J60787 - Size 14,Merrell J60787 - Size 14,FBALYB Amazon,49,46,3,0,3,0
,Merrell J60787 - Size 7,Merrell J60787 - Size 7,FBALYB Amazon,-4,-4,0,0,0,0
,Merrell J60787 - Size 7.5,Merrell J60787 - Size 7.5,Default Ridgefield,24,24,0,0,0,0
,Merrell J60787 - Size 7.5,Merrell J60787 - Size 7.5,FBALYB Amazon,60,57,3,0,3,0
,Merrell J60787 - Size 8,Merrell J60787 - Size 8,Default Ridgefield,1,1,0,0,0,0
,Merrell J60787 - Size 8,Merrell J60787 - Size 8,FBALYB Amazon,-76,-77,1,48,1,0
,Merrell J60787 - Size 8.5,Merrell J60787 - Size 8.5,Default,0,0,0,0,0,24
,Merrell J60787 - Size 8.5,Merrell J60787 - Size 8.5,Default Ridgefield,72,72,0,0,0,0
,Merrell J60787 - Size 8.5,Merrell J60787 - Size 8.5,FBALYB Amazon,44,43,1,24,1,0
,Merrell J60787 - Size 9,Merrell J60787 - Size 9,Default,0,0,0,0,0,36
,Merrell J60787 - Size 9,Merrell J60787 - Size 9,FBALYB Amazon,-153,-155,2,119,2,0
,Merrell J60787 - Size 9.5,Merrell J60787 - Size 9.5,Default,0,0,0,0,0,48
,Merrell J60787 - Size 9.5,Merrell J60787 - Size 9.5,FBALYB Amazon,-67,-68,1,1,1,0
,Merrell J60788 - Size 10,Merrell J60788 - Size 10,FBALYB Amazon,-65,-67,2,25,2,0
,Merrell J60788 - Size 10.5,Merrell J60788 - Size 10.5,FBALYB Amazon,1,0,1,0,1,0
,Merrell J60788 - Size 11,Merrell J60788 - Size 11,FBALYB Amazon,-18,-18,0,20,0,0
,Merrell J60788 - Size 11.5,Merrell J60788 - Size 11.5,Default Ridgefield,15,15,0,0,0,0
,Merrell J60788 - Size 11.5,Merrell J60788 - Size 11.5,FBALYB Amazon,5,4,1,0,1,0
,Merrell J60788 - Size 6,Merrell J60788 - Size 6,FBALYB Amazon,-23,-28,5,20,5,0
,Merrell J60788 - Size 6.5,Merrell J60788 - Size 6.5,FBALYB Amazon,-36,-38,2,20,2,0
,Merrell J60788 - Size 7,Merrell J60788 - Size 7,Default,13,13,0,0,0,0
,Merrell J60788 - Size 7,Merrell J60788 - Size 7,Default Ridgefield,1,1,0,0,0,0
,Merrell J60788 - Size 7,Merrell J60788 - Size 7,FBALYB Amazon,-56,-56,0,20,0,0
,Merrell J60788 - Size 7.5,Merrell J60788 - Size 7.5,Default Ridgefield,4,4,0,0,0,0
,Merrell J60788 - Size 7.5,Merrell J60788 - Size 7.5,FBALYB Amazon,-44,-47,3,32,3,0
,Merrell J60788 - Size 8,Merrell J60788 - Size 8,Default Ridgefield,4,4,0,0,0,0
,Merrell J60788 - Size 8,Merrell J60788 - Size 8,FBALYB Amazon,-20,-25,5,16,5,0
,Merrell J60788 - Size 8.5,Merrell J60788 - Size 8.5,FBALYB Amazon,-70,-70,0,7,0,0
,Merrell J60788 - Size 9,Merrell J60788 - Size 9,Default,0,0,0,0,0,4
,Merrell J60788 - Size 9,Merrell J60788 - Size 9,FBALYB Amazon,-60,-61,1,19,1,0
,Merrell J60788 - Size 9.5,Merrell J60788 - Size 9.5,Default Ridgefield,1,1,0,0,0,0
,Merrell J60788 - Size 9.5,Merrell J60788 - Size 9.5,FBALYB Amazon,-57,-57,0,42,0,0
,Merrell J60801 - Size 10,Merrell J60801 - Size 10,FBALYB Amazon,43,42,1,0,1,0
,Merrell J60801 - Size 10.5,Merrell J60801 - Size 10.5,FBALYB Amazon,52,51,1,28,1,0
,Merrell J60801 - Size 10.5,Merrell J60801 - Size 10.5,WFS,-10,-10,0,0,0,0
,Merrell J60801 - Size 11,Merrell J60801 - Size 11,FBALYB Amazon,62,61,1,0,1,0
,Merrell J60801 - Size 11.5,Merrell J60801 - Size 11.5,FBALYB Amazon,-2,-2,0,13,0,0
,Merrell J60801 - Size 12,Merrell J60801 - Size 12,Default,1,1,0,0,0,0
,Merrell J60801 - Size 12,Merrell J60801 - Size 12,FBALYB Amazon,20,19,1,1,1,0
,Merrell J60801 - Size 13,Merrell J60801 - Size 13,FBALYB Amazon,93,93,0,11,0,0
,Merrell J60801 - Size 14,Merrell J60801 - Size 14,FBALYB Amazon,33,32,1,0,1,0
,Merrell J60801 - Size 7,Merrell J60801 - Size 7,Default Ridgefield,16,16,0,0,0,0
,Merrell J60801 - Size 7,Merrell J60801 - Size 7,FBALYB Amazon,3,3,0,0,0,0
,Merrell J60801 - Size 7.5,Merrell J60801 - Size 7.5,FBALYB Amazon,52,52,0,0,0,0
,Merrell J60801 - Size 8,Merrell J60801 - Size 8,FBALYB Amazon,-1,-1,0,4,0,0
,Merrell J60801 - Size 8.5,Merrell J60801 - Size 8.5,Default,23,23,0,0,0,12
,Merrell J60801 - Size 8.5,Merrell J60801 - Size 8.5,Default Ridgefield,0,-3,3,0,0,0
,Merrell J60801 - Size 8.5,Merrell J60801 - Size 8.5,FBALYB Amazon,-9,-9,0,33,0,0
,Merrell J60801 - Size 9,Merrell J60801 - Size 9,Default,28,28,0,0,0,0
,Merrell J60801 - Size 9,Merrell J60801 - Size 9,FBALYB Amazon,39,39,0,1,0,0
,Merrell J60801 - Size 9.5,Merrell J60801 - Size 9.5,Default,0,0,0,0,0,12
,Merrell J60801 - Size 9.5,Merrell J60801 - Size 9.5,Default Ridgefield,60,60,0,0,0,0
,Merrell J60801 - Size 9.5,Merrell J60801 - Size 9.5,FBALYB Amazon,1,1,0,17,0,0
,Merrell J60825 - Size 10,Merrell J60825 - Size 10,Default Ridgefield,345,345,0,0,0,0
,Merrell J60825 - Size 10,Merrell J60825 - Size 10,FBALYB Amazon,58,49,9,0,9,0
,Merrell J60825 - Size 10.5,Merrell J60825 - Size 10.5,Default Ridgefield,272,272,0,0,0,0
,Merrell J60825 - Size 10.5,Merrell J60825 - Size 10.5,FBALYB Amazon,55,49,6,0,6,0
,Merrell J60825 - Size 11,Merrell J60825 - Size 11,Default,0,0,0,0,0,12
,Merrell J60825 - Size 11,Merrell J60825 - Size 11,Default Ridgefield,240,240,0,0,0,0
,Merrell J60825 - Size 11,Merrell J60825 - Size 11,FBALYB Amazon,71,62,9,0,9,0
,Merrell J60825 - Size 11.5,Merrell J60825 - Size 11.5,Default Ridgefield,228,228,0,0,0,0
,Merrell J60825 - Size 11.5,Merrell J60825 - Size 11.5,FBALYB Amazon,14,14,0,0,0,0
,Merrell J60825 - Size 12,Merrell J60825 - Size 12,Default Ridgefield,91,91,0,0,0,0
,Merrell J60825 - Size 12,Merrell J60825 - Size 12,FBALYB Amazon,123,118,5,1,5,0
,Merrell J60825 - Size 13,Merrell J60825 - Size 13,Default Ridgefield,174,174,0,0,0,0
,Merrell J60825 - Size 13,Merrell J60825 - Size 13,FBALYB Amazon,31,28,3,0,3,0
,Merrell J60825 - Size 14,Merrell J60825 - Size 14,FBALYB Amazon,46,45,1,0,1,0
,Merrell J60825 - Size 7,Merrell J60825 - Size 7,FBALYB Amazon,-1,-1,0,0,0,0
,Merrell J60825 - Size 7.5,Merrell J60825 - Size 7.5,Default Ridgefield,12,12,0,0,0,0
,Merrell J60825 - Size 7.5,Merrell J60825 - Size 7.5,FBALYB Amazon,0,-3,3,48,3,0
,Merrell J60825 - Size 8,Merrell J60825 - Size 8,Default,6,6,0,0,0,0
,Merrell J60825 - Size 8,Merrell J60825 - Size 8,Default Ridgefield,62,62,0,0,0,0
,Merrell J60825 - Size 8,Merrell J60825 - Size 8,FBALYB Amazon,-1,-1,0,22,0,0
,Merrell J60825 - Size 8.5,Merrell J60825 - Size 8.5,Default,0,0,0,0,0,4
,Merrell J60825 - Size 8.5,Merrell J60825 - Size 8.5,Default Ridgefield,69,69,0,0,0,0
,Merrell J60825 - Size 8.5,Merrell J60825 - Size 8.5,FBALYB Amazon,53,51,2,1,2,0
,Merrell J60825 - Size 9,Merrell J60825 - Size 9,Default Ridgefield,201,201,0,0,0,0
,Merrell J60825 - Size 9,Merrell J60825 - Size 9,FBALYB Amazon,44,44,0,0,0,0
,Merrell J60825 - Size 9.5,Merrell J60825 - Size 9.5,Default Ridgefield,4,4,0,0,0,0
,Merrell J60825 - Size 9.5,Merrell J60825 - Size 9.5,FBALYB Amazon,133,122,11,0,11,0
,Merrell J60826 - Size 10,Merrell J60826 - Size 10,Default Ridgefield,2,2,0,0,0,0
,Merrell J60826 - Size 10,Merrell J60826 - Size 10,FBALYB Amazon,-63,-66,3,0,3,0
,Merrell J60826 - Size 10.5,Merrell J60826 - Size 10.5,FBALYB Amazon,-12,-13,1,0,1,0
,Merrell J60826 - Size 11,Merrell J60826 - Size 11,FBALYB Amazon,-20,-21,1,0,1,0
,Merrell J60826 - Size 6,Merrell J60826 - Size 6,FBALYB Amazon,-16,-17,1,0,1,0
,Merrell J60826 - Size 6.5,Merrell J60826 - Size 6.5,Default Ridgefield,1,1,0,0,0,0
,Merrell J60826 - Size 6.5,Merrell J60826 - Size 6.5,FBALYB Amazon,-26,-26,0,0,0,0
,Merrell J60826 - Size 7,Merrell J60826 - Size 7,Default Ridgefield,16,16,0,0,0,0
,Merrell J60826 - Size 7,Merrell J60826 - Size 7,FBALYB Amazon,-4,-4,0,1,0,0
,Merrell J60826 - Size 7.5,Merrell J60826 - Size 7.5,Default,0,0,0,0,0,39
,Merrell J60826 - Size 7.5,Merrell J60826 - Size 7.5,Default Ridgefield,72,72,0,0,0,0
,Merrell J60826 - Size 7.5,Merrell J60826 - Size 7.5,FBALYB Amazon,91,90,1,1,1,0
,Merrell J60826 - Size 7.5,Merrell J60826 - Size 7.5,WFS,-2,-2,0,0,0,0
,Merrell J60826 - Size 8,Merrell J60826 - Size 8,FBALYB Amazon,-49,-54,5,0,5,0
,Merrell J60826 - Size 8.5,Merrell J60826 - Size 8.5,FBALYB Amazon,-124,-127,3,0,3,0
,Merrell J60826 - Size 9,Merrell J60826 - Size 9,Default Ridgefield,1,1,0,0,0,0
,Merrell J60826 - Size 9,Merrell J60826 - Size 9,FBALYB Amazon,-94,-99,5,0,5,0
,Merrell J60826 - Size 9.5,Merrell J60826 - Size 9.5,FBALYB Amazon,-80,-82,2,0,2,0
,Merrell J60831 - Size 10,Merrell J60831 - Size 10,Default,0,0,0,0,0,1
,Merrell J60831 - Size 10,Merrell J60831 - Size 10,FBALYB Amazon,-6,-6,0,6,0,0
,Merrell J60831 - Size 10.5,Merrell J60831 - Size 10.5,FBALYB Amazon,-7,-7,0,0,0,0
,Merrell J60831 - Size 11,Merrell J60831 - Size 11,FBALYB Amazon,-3,-3,0,0,0,0
,Merrell J60831 - Size 11.5,Merrell J60831 - Size 11.5,FBALYB Amazon,-1,-1,0,0,0,0
,Merrell J60831 - Size 12,Merrell J60831 - Size 12,FBALYB Amazon,-14,-14,0,1,0,0
,Merrell J60831 - Size 13,Merrell J60831 - Size 13,FBALYB Amazon,-8,-8,0,3,0,0
,Merrell J60831 - Size 8.5,Merrell J60831 - Size 8.5,FBALYB Amazon,-4,-4,0,0,0,0
,Merrell J60831 - Size 9,Merrell J60831 - Size 9,FBALYB Amazon,-4,-4,0,0,0,0
,Merrell J60831 - Size 9.5,Merrell J60831 - Size 9.5,Default,0,0,0,0,0,10
,Merrell J60831 - Size 9.5,Merrell J60831 - Size 9.5,FBALYB Amazon,-8,-8,0,0,0,0
,Merrell J63787W - Size 10,Merrell J63787W - Size 10,Default Ridgefield,1,1,0,0,0,0
,Merrell J63787W - Size 10,Merrell J63787W - Size 10,FBALYB Amazon,22,21,1,0,1,0
,Merrell J63787W - Size 10.5,Merrell J63787W - Size 10.5,Default Ridgefield,12,12,0,0,0,0
,Merrell J63787W - Size 10.5,Merrell J63787W - Size 10.5,FBALYB Amazon,25,23,2,0,2,0
,Merrell J63787W - Size 11,Merrell J63787W - Size 11,Default Ridgefield,20,20,0,0,0,0
,Merrell J63787W - Size 11,Merrell J63787W - Size 11,FBALYB Amazon,-16,-19,3,0,3,0
,Merrell J63787W - Size 11.5,Merrell J63787W - Size 11.5,Default Ridgefield,24,24,0,0,0,0
,Merrell J63787W - Size 11.5,Merrell J63787W - Size 11.5,FBALYB Amazon,7,0,7,0,7,0
,Merrell J63787W - Size 12,Merrell J63787W - Size 12,Default Ridgefield,8,8,0,0,0,0
,Merrell J63787W - Size 12,Merrell J63787W - Size 12,FBALYB Amazon,-3,-3,0,0,0,0
,Merrell J63787W - Size 13,Merrell J63787W - Size 13,Default Ridgefield,25,25,0,0,0,0
,Merrell J63787W - Size 13,Merrell J63787W - Size 13,FBALYB Amazon,6,0,6,0,6,0
,Merrell J63787W - Size 8,Merrell J63787W - Size 8,Default Ridgefield,14,14,0,0,0,0
,Merrell J63787W - Size 8,Merrell J63787W - Size 8,FBALYB Amazon,6,5,1,0,1,0
,Merrell J63787W - Size 8.5,Merrell J63787W - Size 8.5,Default Ridgefield,12,12,0,0,0,0
,Merrell J63787W - Size 8.5,Merrell J63787W - Size 8.5,FBALYB Amazon,-8,-10,2,0,2,0
,Merrell J63787W - Size 9,Merrell J63787W - Size 9,Default Ridgefield,28,28,0,0,0,0
,Merrell J63787W - Size 9,Merrell J63787W - Size 9,FBALYB Amazon,-2,-2,0,0,0,0
,Merrell J63787W - Size 9.5,Merrell J63787W - Size 9.5,FBALYB Amazon,18,11,7,0,7,0
,Merrell J63811W - Size 10,Merrell J63811W - Size 10,FBALYB Amazon,24,23,1,0,1,0
,Merrell J63811W - Size 10.5,Merrell J63811W - Size 10.5,FBALYB Amazon,21,21,0,0,0,0
,Merrell J63811W - Size 11,Merrell J63811W - Size 11,FBALYB Amazon,13,12,1,0,1,0
,Merrell J63811W - Size 11.5,Merrell J63811W - Size 11.5,FBALYB Amazon,70,69,1,0,1,0
,Merrell J63811W - Size 12,Merrell J63811W - Size 12,FBALYB Amazon,35,35,0,1,0,0
,Merrell J63811W - Size 13,Merrell J63811W - Size 13,FBALYB Amazon,4,2,2,0,2,0
,Merrell J63811W - Size 8,Merrell J63811W - Size 8,Default Ridgefield,17,17,0,0,0,0
,Merrell J63811W - Size 8,Merrell J63811W - Size 8,FBALYB Amazon,15,15,0,0,0,0
,Merrell J63811W - Size 8.5,Merrell J63811W - Size 8.5,Default Ridgefield,17,17,0,0,0,0
,Merrell J63811W - Size 8.5,Merrell J63811W - Size 8.5,FBALYB Amazon,8,8,0,0,0,0
,Merrell J63811W - Size 9,Merrell J63811W - Size 9,FBALYB Amazon,-1,-2,1,0,1,0
,Merrell J63811W - Size 9.5,Merrell J63811W - Size 9.5,Default Ridgefield,28,28,0,0,0,0
,Merrell J63811W - Size 9.5,Merrell J63811W - Size 9.5,FBALYB Amazon,-6,-6,0,0,0,0
,Merrell J63815W - Size 10,Merrell J63815W - Size 10,FBALYB Amazon,17,16,1,0,1,0
,Merrell J63815W - Size 10.5,Merrell J63815W - Size 10.5,FBALYB Amazon,3,-1,4,0,4,0
,Merrell J63815W - Size 11,Merrell J63815W - Size 11,Default Ridgefield,73,73,0,0,0,0
,Merrell J63815W - Size 11,Merrell J63815W - Size 11,FBALYB Amazon,16,8,8,0,8,0
,Merrell J63815W - Size 11.5,Merrell J63815W - Size 11.5,FBALYB Amazon,15,12,3,0,3,0
,Merrell J63815W - Size 12,Merrell J63815W - Size 12,FBALYB Amazon,-2,-2,0,0,0,0
,Merrell J63815W - Size 13,Merrell J63815W - Size 13,FBALYB Amazon,-3,-3,0,0,0,0
,Merrell J63815W - Size 8,Merrell J63815W - Size 8,Default Ridgefield,19,19,0,0,0,0
,Merrell J63815W - Size 8,Merrell J63815W - Size 8,FBALYB Amazon,3,1,2,0,2,0
,Merrell J63815W - Size 8.5,Merrell J63815W - Size 8.5,FBALYB Amazon,-8,-8,0,0,0,0
,Merrell J63815W - Size 9,Merrell J63815W - Size 9,Default Ridgefield,7,7,0,0,0,0
,Merrell J63815W - Size 9,Merrell J63815W - Size 9,FBALYB Amazon,5,5,0,1,0,0
,Merrell J63815W - Size 9.5,Merrell J63815W - Size 9.5,Default,15,15,0,0,0,0
,Merrell J63815W - Size 9.5,Merrell J63815W - Size 9.5,Default Ridgefield,2,2,0,0,0,0
,Merrell J63815W - Size 9.5,Merrell J63815W - Size 9.5,FBALYB Amazon,4,1,3,0,3,0
,Merrell J63829 - Size 10,Merrell J63829 - Size 10,Default Ridgefield,60,60,0,0,0,72
,Merrell J63829 - Size 10,Merrell J63829 - Size 10,FBALYB Amazon,-14,-14,0,0,0,0
,Merrell J63829 - Size 10.5,Merrell J63829 - Size 10.5,Default Ridgefield,72,72,0,0,0,72
,Merrell J63829 - Size 10.5,Merrell J63829 - Size 10.5,FBALYB Amazon,-6,-6,0,0,0,0
,Merrell J63829 - Size 11,Merrell J63829 - Size 11,Default Ridgefield,72,72,0,0,0,72
,Merrell J63829 - Size 11,Merrell J63829 - Size 11,FBALYB Amazon,-11,-11,0,0,0,0
,Merrell J63829 - Size 11.5,Merrell J63829 - Size 11.5,Default Ridgefield,48,48,0,0,0,48
,Merrell J63829 - Size 11.5,Merrell J63829 - Size 11.5,FBALYB Amazon,-7,-7,0,0,0,0
,Merrell J63829 - Size 12,Merrell J63829 - Size 12,Default Ridgefield,60,60,0,0,0,48
,Merrell J63829 - Size 12,Merrell J63829 - Size 12,FBALYB Amazon,-5,-5,0,1,0,0
,Merrell J63829 - Size 13,Merrell J63829 - Size 13,Default Ridgefield,48,48,0,0,0,48
,Merrell J63829 - Size 13,Merrell J63829 - Size 13,FBALYB Amazon,-1,-1,0,0,0,0
,Merrell J63829 - Size 7.5,Merrell J63829 - Size 7.5,Default Ridgefield,12,12,0,0,0,12
,Merrell J63829 - Size 8,Merrell J63829 - Size 8,Default Ridgefield,12,12,0,0,0,12
,Merrell J63829 - Size 8,Merrell J63829 - Size 8,FBALYB Amazon,-10,-10,0,0,0,0
,Merrell J63829 - Size 8.5,Merrell J63829 - Size 8.5,Default Ridgefield,24,24,0,0,0,24
,Merrell J63829 - Size 8.5,Merrell J63829 - Size 8.5,FBALYB Amazon,-3,-3,0,0,0,0
,Merrell J63829 - Size 9,Merrell J63829 - Size 9,Default Ridgefield,36,36,0,0,0,36
,Merrell J63829 - Size 9,Merrell J63829 - Size 9,FBALYB Amazon,-10,-10,0,0,0,0
,Merrell J63829 - Size 9.5,Merrell J63829 - Size 9.5,Default Ridgefield,48,48,0,0,0,48
,Merrell J63829 - Size 9.5,Merrell J63829 - Size 9.5,FBALYB Amazon,-3,-3,0,0,0,0
,Merrell J65685 - Size 10,Merrell J65685 - Size 10,Default Ridgefield,194,194,0,0,0,0
,Merrell J65685 - Size 10,Merrell J65685 - Size 10,FBALYB Amazon,-13,-13,0,0,0,0
,Merrell J65685 - Size 10.5,Merrell J65685 - Size 10.5,Default Ridgefield,160,160,0,0,0,0
,Merrell J65685 - Size 10.5,Merrell J65685 - Size 10.5,FBALYB Amazon,7,1,6,4,6,0
,Merrell J65685 - Size 11,Merrell J65685 - Size 11,Default Ridgefield,36,36,0,0,0,0
,Merrell J65685 - Size 11,Merrell J65685 - Size 11,FBALYB Amazon,84,79,5,33,5,0
,Merrell J65685 - Size 11.5,Merrell J65685 - Size 11.5,Default Ridgefield,69,69,0,0,0,0
,Merrell J65685 - Size 11.5,Merrell J65685 - Size 11.5,FBALYB Amazon,36,33,3,0,3,0
,Merrell J65685 - Size 12,Merrell J65685 - Size 12,Default Ridgefield,74,74,0,0,0,0
,Merrell J65685 - Size 12,Merrell J65685 - Size 12,FBALYB Amazon,23,19,4,17,4,0
,Merrell J65685 - Size 12.5,Merrell J65685 - Size 12.5,Default Ridgefield,28,28,0,0,0,0
,Merrell J65685 - Size 12.5,Merrell J65685 - Size 12.5,FBALYB Amazon,16,16,0,0,0,0
,Merrell J65685 - Size 13,Merrell J65685 - Size 13,Default Ridgefield,65,65,0,0,0,0
,Merrell J65685 - Size 13,Merrell J65685 - Size 13,FBALYB Amazon,40,34,6,0,6,0
,Merrell J65685 - Size 14,Merrell J65685 - Size 14,Default Ridgefield,7,7,0,0,0,0
,Merrell J65685 - Size 14,Merrell J65685 - Size 14,FBALYB Amazon,11,10,1,0,1,0
,Merrell J65685 - Size 7,Merrell J65685 - Size 7,Default Ridgefield,12,12,0,0,0,0
,Merrell J65685 - Size 7,Merrell J65685 - Size 7,FBALYB Amazon,18,18,0,0,0,0
,Merrell J65685 - Size 7.5,Merrell J65685 - Size 7.5,Default Ridgefield,12,12,0,0,0,0
,Merrell J65685 - Size 7.5,Merrell J65685 - Size 7.5,FBALYB Amazon,38,38,0,0,0,0
,Merrell J65685 - Size 8,Merrell J65685 - Size 8,Default Ridgefield,12,12,0,0,0,0
,Merrell J65685 - Size 8,Merrell J65685 - Size 8,FBALYB Amazon,18,16,2,0,2,0
,Merrell J65685 - Size 8.5,Merrell J65685 - Size 8.5,Default Ridgefield,24,24,0,0,0,0
,Merrell J65685 - Size 8.5,Merrell J65685 - Size 8.5,FBALYB Amazon,9,6,3,0,3,0
,Merrell J65685 - Size 9,Merrell J65685 - Size 9,Default Ridgefield,16,16,0,0,0,0
,Merrell J65685 - Size 9,Merrell J65685 - Size 9,FBALYB Amazon,27,23,4,15,4,0
,Merrell J65685 - Size 9.5,Merrell J65685 - Size 9.5,Default Ridgefield,130,130,0,0,0,0
,Merrell J65685 - Size 9.5,Merrell J65685 - Size 9.5,FBALYB Amazon,-3,-6,3,16,3,0
,Merrell J71443 - Size 10,Merrell J71443 - Size 10,FBALYB Amazon,25,23,2,0,2,0
,Merrell J71443 - Size 10.5,Merrell J71443 - Size 10.5,Default Ridgefield,60,60,0,0,0,0
,Merrell J71443 - Size 10.5,Merrell J71443 - Size 10.5,FBALYB Amazon,22,20,2,0,2,0
,Merrell J71443 - Size 11,Merrell J71443 - Size 11,Default Ridgefield,36,36,0,0,0,0
,Merrell J71443 - Size 11,Merrell J71443 - Size 11,FBALYB Amazon,10,10,0,0,0,0
,Merrell J71443 - Size 11.5,Merrell J71443 - Size 11.5,Default Ridgefield,8,8,0,0,0,0
,Merrell J71443 - Size 11.5,Merrell J71443 - Size 11.5,FBALYB Amazon,11,11,0,0,0,0
,Merrell J71443 - Size 12,Merrell J71443 - Size 12,Default Ridgefield,13,13,0,0,0,0
,Merrell J71443 - Size 12,Merrell J71443 - Size 12,FBALYB Amazon,22,22,0,0,0,0
,Merrell J71443 - Size 12.5,Merrell J71443 - Size 12.5,FBALYB Amazon,-2,-2,0,0,0,0
,Merrell J71443 - Size 13,Merrell J71443 - Size 13,Default Ridgefield,48,48,0,0,0,0
,Merrell J71443 - Size 13,Merrell J71443 - Size 13,FBALYB Amazon,16,16,0,0,0,0
,Merrell J71443 - Size 14,Merrell J71443 - Size 14,Default Ridgefield,0,-1,1,0,0,0
,Merrell J71443 - Size 14,Merrell J71443 - Size 14,FBALYB Amazon,4,4,0,0,0,0
,Merrell J71443 - Size 7,Merrell J71443 - Size 7,FBALYB Amazon,8,8,0,0,0,0
,Merrell J71443 - Size 7.5,Merrell J71443 - Size 7.5,FBALYB Amazon,16,16,0,0,0,0
,Merrell J71443 - Size 8,Merrell J71443 - Size 8,Default Ridgefield,12,12,0,0,0,0
,Merrell J71443 - Size 8,Merrell J71443 - Size 8,FBALYB Amazon,-11,-11,0,0,0,0
,Merrell J71443 - Size 8.5,Merrell J71443 - Size 8.5,FBALYB Amazon,9,4,5,0,5,0
,Merrell J71443 - Size 9,Merrell J71443 - Size 9,FBALYB Amazon,-3,-3,0,0,0,0
,Merrell J71443 - Size 9.5,Merrell J71443 - Size 9.5,Default Ridgefield,32,32,0,0,0,0
,Merrell J71443 - Size 9.5,Merrell J71443 - Size 9.5,FBALYB Amazon,-3,-4,1,0,1,0
,Merrell J71447 - Size 10,Merrell J71447 - Size 10,Default Ridgefield,54,54,0,0,0,24
,Merrell J71447 - Size 10,Merrell J71447 - Size 10,FBALYB Amazon,-1,-1,0,0,0,0
,Merrell J71447 - Size 10.5,Merrell J71447 - Size 10.5,Default Ridgefield,40,40,0,0,0,12
,Merrell J71447 - Size 10.5,Merrell J71447 - Size 10.5,FBALYB Amazon,-1,-3,2,0,2,0
,Merrell J71447 - Size 11,Merrell J71447 - Size 11,Default Ridgefield,26,26,0,0,0,24
,Merrell J71447 - Size 11,Merrell J71447 - Size 11,FBALYB Amazon,-1,-1,0,0,0,0
,Merrell J71447 - Size 11.5,Merrell J71447 - Size 11.5,Default Ridgefield,0,0,0,0,0,12
,Merrell J71447 - Size 11.5,Merrell J71447 - Size 11.5,FBALYB Amazon,48,48,0,0,0,0
,Merrell J71447 - Size 12,Merrell J71447 - Size 12,Default Ridgefield,40,40,0,0,0,12
,Merrell J71447 - Size 12,Merrell J71447 - Size 12,FBALYB Amazon,2,-2,4,0,4,0
,Merrell J71447 - Size 12.5,Merrell J71447 - Size 12.5,Default Ridgefield,1,1,0,0,0,0
,Merrell J71447 - Size 12.5,Merrell J71447 - Size 12.5,FBALYB Amazon,11,11,0,0,0,0
,Merrell J71447 - Size 13,Merrell J71447 - Size 13,Default Ridgefield,16,16,0,0,0,12
,Merrell J71447 - Size 14,Merrell J71447 - Size 14,Default Ridgefield,4,4,0,0,0,0
,Merrell J71447 - Size 14,Merrell J71447 - Size 14,FBALYB Amazon,1,0,1,0,1,0
,Merrell J71447 - Size 7,Merrell J71447 - Size 7,FBALYB Amazon,3,3,0,0,0,0
,Merrell J71447 - Size 7.5,Merrell J71447 - Size 7.5,Default Ridgefield,11,11,0,0,0,0
,Merrell J71447 - Size 7.5,Merrell J71447 - Size 7.5,FBALYB Amazon,4,4,0,0,0,0
,Merrell J71447 - Size 8,Merrell J71447 - Size 8,FBALYB Amazon,-1,-1,0,0,0,0
,Merrell J71447 - Size 8.5,Merrell J71447 - Size 8.5,Default Ridgefield,48,48,0,0,0,16
,Merrell J71447 - Size 8.5,Merrell J71447 - Size 8.5,FBALYB Amazon,9,9,0,0,0,0
,Merrell J71447 - Size 9,Merrell J71447 - Size 9,Default Ridgefield,36,36,0,0,0,16
,Merrell J71447 - Size 9,Merrell J71447 - Size 9,FBALYB Amazon,7,7,0,16,0,0
,Merrell J71447 - Size 9.5,Merrell J71447 - Size 9.5,Default Ridgefield,58,58,0,0,0,4
,Merrell J71447 - Size 9.5,Merrell J71447 - Size 9.5,FBALYB Amazon,6,6,0,0,0,0
,Merrell J73703 - Size 10,Merrell J73703 - Size 10,Default Ridgefield,34,34,0,0,0,0
,Merrell J73703 - Size 10,Merrell J73703 - Size 10,FBALYB Amazon,69,69,0,0,0,0
,Merrell J73703 - Size 10.5,Merrell J73703 - Size 10.5,Default Ridgefield,27,27,0,0,0,0
,Merrell J73703 - Size 10.5,Merrell J73703 - Size 10.5,FBALYB Amazon,61,61,0,1,0,0
,Merrell J73703 - Size 10.5,Merrell J73703 - Size 10.5,FBALYB Canada,3,3,0,0,0,0
,Merrell J73703 - Size 11,Merrell J73703 - Size 11,Default Ridgefield,11,11,0,0,0,0
,Merrell J73703 - Size 11,Merrell J73703 - Size 11,FBALYB Amazon,29,29,0,0,0,0
,Merrell J73703 - Size 11.5,Merrell J73703 - Size 11.5,Default Ridgefield,13,13,0,0,0,0
,Merrell J73703 - Size 11.5,Merrell J73703 - Size 11.5,FBALYB Amazon,109,108,1,0,1,0
,Merrell J73703 - Size 12,Merrell J73703 - Size 12,Default,0,0,0,0,0,1
,Merrell J73703 - Size 12,Merrell J73703 - Size 12,FBALYB Amazon,21,17,4,0,4,0
,Merrell J73703 - Size 13,Merrell J73703 - Size 13,FBALYB Amazon,11,11,0,1,0,0
,Merrell J73703 - Size 7.5,Merrell J73703 - Size 7.5,FBALYB Amazon,9,9,0,0,0,0
,Merrell J73703 - Size 8,Merrell J73703 - Size 8,FBALYB Amazon,13,13,0,0,0,0
,Merrell J73703 - Size 8.5,Merrell J73703 - Size 8.5,FBALYB Amazon,55,55,0,0,0,0
,Merrell J73703 - Size 9,Merrell J73703 - Size 9,FBALYB Amazon,50,50,0,0,0,0
,Merrell J73703 - Size 9.5,Merrell J73703 - Size 9.5,FBALYB Amazon,14,14,0,0,0,0
,Merrell J77375 - Size 10,Merrell J77375 - Size 10,Default,0,0,0,0,0,1
,Merrell J77375 - Size 10,Merrell J77375 - Size 10,Default Ridgefield,48,48,0,0,0,0
,Merrell J77375 - Size 10,Merrell J77375 - Size 10,FBALYB Amazon,38,38,0,0,0,0
,Merrell J77375 - Size 10.5,Merrell J77375 - Size 10.5,Default Ridgefield,48,48,0,0,0,0
,Merrell J77375 - Size 10.5,Merrell J77375 - Size 10.5,FBALYB Amazon,5,4,1,33,1,0
,Merrell J77375 - Size 11,Merrell J77375 - Size 11,Default Ridgefield,48,48,0,0,0,0
,Merrell J77375 - Size 11,Merrell J77375 - Size 11,FBALYB Amazon,36,35,1,0,1,0
,Merrell J77375 - Size 11.5,Merrell J77375 - Size 11.5,Default Ridgefield,36,36,0,0,0,0
,Merrell J77375 - Size 11.5,Merrell J77375 - Size 11.5,FBALYB Amazon,27,27,0,1,0,0
,Merrell J77375 - Size 12,Merrell J77375 - Size 12,Default Ridgefield,24,24,0,0,0,0
,Merrell J77375 - Size 12,Merrell J77375 - Size 12,FBALYB Amazon,35,35,0,1,0,0
,Merrell J77375 - Size 13,Merrell J77375 - Size 13,Default Ridgefield,36,36,0,0,0,0
,Merrell J77375 - Size 13,Merrell J77375 - Size 13,FBALYB Amazon,52,52,0,0,0,0
,Merrell J77375 - Size 7,Merrell J77375 - Size 7,FBALYB Amazon,1,1,0,0,0,0
,Merrell J77375 - Size 7.5,Merrell J77375 - Size 7.5,FBALYB Amazon,-2,-2,0,0,0,0
,Merrell J77375 - Size 8,Merrell J77375 - Size 8,Default Ridgefield,12,12,0,0,0,0
,Merrell J77375 - Size 8,Merrell J77375 - Size 8,FBALYB Amazon,10,10,0,0,0,0
,Merrell J77375 - Size 8.5,Merrell J77375 - Size 8.5,Default Ridgefield,24,24,0,0,0,0
,Merrell J77375 - Size 8.5,Merrell J77375 - Size 8.5,FBALYB Amazon,11,11,0,1,0,0
,Merrell J77375 - Size 9,Merrell J77375 - Size 9,Default Ridgefield,24,24,0,0,0,0
,Merrell J77375 - Size 9,Merrell J77375 - Size 9,FBALYB Amazon,14,14,0,0,0,0
,Merrell J77375 - Size 9.5,Merrell J77375 - Size 9.5,Default Ridgefield,36,36,0,0,0,0
,Merrell J77375 - Size 9.5,Merrell J77375 - Size 9.5,FBALYB Amazon,28,28,0,0,0,0
,Merrell J77413 - Size 10,Merrell J77413 - Size 10,FBALYB Amazon,-31,-31,0,25,0,0
,Merrell J77413 - Size 10.5,Merrell J77413 - Size 10.5,FBALYB Amazon,-9,-9,0,0,0,0
,Merrell J77413 - Size 11,Merrell J77413 - Size 11,FBALYB Amazon,-39,-39,0,32,0,0
,Merrell J77413 - Size 11.5,Merrell J77413 - Size 11.5,FBALYB Amazon,-7,-7,0,0,0,0
,Merrell J77413 - Size 12,Merrell J77413 - Size 12,FBALYB Amazon,-5,-5,0,0,0,0
,Merrell J77413 - Size 13,Merrell J77413 - Size 13,FBALYB Amazon,-29,-29,0,25,0,0
,Merrell J77413 - Size 7,Merrell J77413 - Size 7,FBALYB Amazon,13,13,0,15,0,0
,Merrell J77413 - Size 7.5,Merrell J77413 - Size 7.5,FBALYB Amazon,-14,-14,0,14,0,0
,Merrell J77413 - Size 8,Merrell J77413 - Size 8,FBALYB Amazon,-16,-16,0,15,0,0
,Merrell J77413 - Size 8.5,Merrell J77413 - Size 8.5,FBALYB Amazon,-20,-20,0,15,0,0
,Merrell J77413 - Size 9,Merrell J77413 - Size 9,FBALYB Amazon,-11,-11,0,0,0,0
,Merrell J77413 - Size 9.5,Merrell J77413 - Size 9.5,FBALYB Amazon,-28,-28,0,25,0,0
,Merrell J84987 - Size 10,Merrell J84987 - Size 10,Default Ridgefield,28,28,0,0,0,28
,Merrell J84987 - Size 10,Merrell J84987 - Size 10,FBALYB Amazon,14,14,0,0,0,0
,Merrell J84987 - Size 10.5,Merrell J84987 - Size 10.5,Default Ridgefield,28,28,0,0,0,28
,Merrell J84987 - Size 10.5,Merrell J84987 - Size 10.5,FBALYB Amazon,15,13,2,0,2,0
,Merrell J84987 - Size 11,Merrell J84987 - Size 11,Default Ridgefield,28,28,0,0,0,28
,Merrell J84987 - Size 11,Merrell J84987 - Size 11,FBALYB Amazon,28,28,0,0,0,0
,Merrell J84987 - Size 11.5,Merrell J84987 - Size 11.5,Default Ridgefield,43,43,0,0,0,16
,Merrell J84987 - Size 12,Merrell J84987 - Size 12,Default Ridgefield,16,16,0,0,0,16
,Merrell J84987 - Size 12,Merrell J84987 - Size 12,FBALYB Amazon,22,22,0,0,0,0
,Merrell J84987 - Size 12.5,Merrell J84987 - Size 12.5,Default Ridgefield,32,32,0,0,0,0
,Merrell J84987 - Size 13,Merrell J84987 - Size 13,Default Ridgefield,16,16,0,0,0,16
,Merrell J84987 - Size 13,Merrell J84987 - Size 13,FBALYB Amazon,8,8,0,0,0,0
,Merrell J84987 - Size 14,Merrell J84987 - Size 14,Default Ridgefield,14,14,0,0,0,0
,Merrell J84987 - Size 7.5,Merrell J84987 - Size 7.5,Default Ridgefield,16,16,0,0,0,0
,Merrell J84987 - Size 7.5,Merrell J84987 - Size 7.5,FBALYB Amazon,7,7,0,0,0,0
,Merrell J84987 - Size 8,Merrell J84987 - Size 8,Default Ridgefield,1,1,0,0,0,0
,Merrell J84987 - Size 8,Merrell J84987 - Size 8,FBALYB Amazon,8,8,0,0,0,0
,Merrell J84987 - Size 8.5,Merrell J84987 - Size 8.5,Default Ridgefield,16,16,0,0,0,16
,Merrell J84987 - Size 8.5,Merrell J84987 - Size 8.5,FBALYB Amazon,16,16,0,0,0,0
,Merrell J84987 - Size 9,Merrell J84987 - Size 9,Default Ridgefield,16,16,0,0,0,16
,Merrell J84987 - Size 9,Merrell J84987 - Size 9,FBALYB Amazon,8,7,1,0,1,0
,Merrell J84987 - Size 9.5,Merrell J84987 - Size 9.5,Default Ridgefield,16,16,0,0,0,16
,Merrell J84987 - Size 9.5,Merrell J84987 - Size 9.5,FBALYB Amazon,15,15,0,0,0,0
,Merrell J91825 - Size 10,Merrell J91825 - Size 10,Default Ridgefield,7,7,0,0,0,26
,Merrell J91825 - Size 10,Merrell J91825 - Size 10,FBALYB Amazon,9,9,0,0,0,0
,Merrell J91825 - Size 10.5,Merrell J91825 - Size 10.5,Default Ridgefield,13,13,0,0,0,26
,Merrell J91825 - Size 10.5,Merrell J91825 - Size 10.5,FBALYB Amazon,-90,-90,0,65,0,0
,Merrell J91825 - Size 11,Merrell J91825 - Size 11,Default Ridgefield,12,12,0,0,0,26
,Merrell J91825 - Size 11,Merrell J91825 - Size 11,FBALYB Amazon,-54,-56,2,38,2,0
,Merrell J91825 - Size 11.5,Merrell J91825 - Size 11.5,Default Ridgefield,6,6,0,0,0,14
,Merrell J91825 - Size 11.5,Merrell J91825 - Size 11.5,FBALYB Amazon,-26,-28,2,0,2,0
,Merrell J91825 - Size 12,Merrell J91825 - Size 12,Default Ridgefield,26,26,0,0,0,26
,Merrell J91825 - Size 12,Merrell J91825 - Size 12,FBALYB Amazon,-21,-21,0,0,0,0
,Merrell J91825 - Size 12.5,Merrell J91825 - Size 12.5,Default Ridgefield,16,16,0,0,0,0
,Merrell J91825 - Size 12.5,Merrell J91825 - Size 12.5,FBALYB Canada,5,5,0,0,0,0
,Merrell J91825 - Size 13,Merrell J91825 - Size 13,Default Ridgefield,12,12,0,0,0,14
,Merrell J91825 - Size 13,Merrell J91825 - Size 13,FBALYB Amazon,-12,-12,0,0,0,0
,Merrell J91825 - Size 14,Merrell J91825 - Size 14,FBALYB Amazon,-1,-1,0,0,0,0
,Merrell J91825 - Size 7.5,Merrell J91825 - Size 7.5,FBALYB Amazon,5,5,0,0,0,0
,Merrell J91825 - Size 8,Merrell J91825 - Size 8,FBALYB Amazon,-1,-1,0,0,0,0
,Merrell J91825 - Size 8.5,Merrell J91825 - Size 8.5,Default Ridgefield,16,16,0,0,0,16
,Merrell J91825 - Size 8.5,Merrell J91825 - Size 8.5,FBALYB Amazon,-5,-6,1,0,1,0
,Merrell J91825 - Size 9,Merrell J91825 - Size 9,Default Ridgefield,8,8,0,0,0,16
,Merrell J91825 - Size 9,Merrell J91825 - Size 9,FBALYB Amazon,-14,-14,0,8,0,0
,Merrell J91825 - Size 9.5,Merrell J91825 - Size 9.5,Default Ridgefield,14,14,0,0,0,16
,Merrell J91825 - Size 9.5,Merrell J91825 - Size 9.5,FBALYB Amazon,-17,-17,0,0,0,0
,Merrell J91829 - Size 10,Merrell J91829 - Size 10,FBALYB Amazon,-9,-9,0,0,0,0
,Merrell J91829 - Size 10,Merrell J91829 - Size 10,FBALYB Canada,2,2,0,0,0,0
,Merrell J91829 - Size 10.5,Merrell J91829 - Size 10.5,Default Ridgefield,0,-4,4,0,0,0
,Merrell J91829 - Size 10.5,Merrell J91829 - Size 10.5,FBALYB Amazon,1,1,0,0,0,0
,Merrell J91829 - Size 10.5,Merrell J91829 - Size 10.5,FBALYB Canada,2,2,0,0,0,0
,Merrell J91829 - Size 11,Merrell J91829 - Size 11,FBALYB Canada,3,3,0,0,0,0
,Merrell J91829 - Size 11.5,Merrell J91829 - Size 11.5,Default Ridgefield,5,5,0,0,0,0
,Merrell J91829 - Size 11.5,Merrell J91829 - Size 11.5,FBALYB Canada,5,5,0,0,0,0
,Merrell J91829 - Size 12,Merrell J91829 - Size 12,Default,0,0,0,0,0,1
,Merrell J91829 - Size 12,Merrell J91829 - Size 12,FBALYB Amazon,-6,-6,0,0,0,0
,Merrell J91829 - Size 13,Merrell J91829 - Size 13,FBALYB Amazon,-2,-2,0,0,0,0
,Merrell J91829 - Size 8.5,Merrell J91829 - Size 8.5,FBALYB Amazon,-4,-4,0,0,0,0
,Merrell J91829 - Size 9,Merrell J91829 - Size 9,FBALYB Amazon,-6,-6,0,0,0,0
,Merrell J91829 - Size 9,Merrell J91829 - Size 9,FBALYB Canada,4,4,0,0,0,0
,Merrell J91829 - Size 9.5,Merrell J91829 - Size 9.5,FBALYB Amazon,1,0,1,0,1,0
,Merrell J91829 - Size 9.5,Merrell J91829 - Size 9.5,FBALYB Canada,4,4,0,0,0,0
,Merrell J91833 - Size 10,Merrell J91833 - Size 10,Default Ridgefield,48,48,0,0,0,72
,Merrell J91833 - Size 10,Merrell J91833 - Size 10,FBALYB Amazon,52,51,1,0,1,0
,Merrell J91833 - Size 10.5,Merrell J91833 - Size 10.5,Default Ridgefield,72,72,0,0,0,72
,Merrell J91833 - Size 10.5,Merrell J91833 - Size 10.5,FBALYB Amazon,-5,-5,0,0,0,0
,Merrell J91833 - Size 11,Merrell J91833 - Size 11,Default Ridgefield,24,24,0,0,0,72
,Merrell J91833 - Size 11,Merrell J91833 - Size 11,FBALYB Amazon,8,2,6,60,6,0
,Merrell J91833 - Size 11.5,Merrell J91833 - Size 11.5,Default Ridgefield,36,36,0,0,0,48
,Merrell J91833 - Size 11.5,Merrell J91833 - Size 11.5,FBALYB Amazon,11,9,2,0,2,0
,Merrell J91833 - Size 12,Merrell J91833 - Size 12,Default Ridgefield,63,63,0,0,0,60
,Merrell J91833 - Size 12,Merrell J91833 - Size 12,FBALYB Amazon,3,2,1,0,1,0
,Merrell J91833 - Size 12.5,Merrell J91833 - Size 12.5,Default Ridgefield,13,13,0,0,0,0
,Merrell J91833 - Size 12.5,Merrell J91833 - Size 12.5,FBALYB Amazon,27,27,0,0,0,0
,Merrell J91833 - Size 13,Merrell J91833 - Size 13,Default Ridgefield,48,48,0,0,0,48
,Merrell J91833 - Size 13,Merrell J91833 - Size 13,FBALYB Amazon,1,-1,2,0,2,0
,Merrell J91833 - Size 14,Merrell J91833 - Size 14,FBALYB Amazon,4,4,0,0,0,0
,Merrell J91833 - Size 7.5,Merrell J91833 - Size 7.5,Default Ridgefield,12,12,0,0,0,12
,Merrell J91833 - Size 7.5,Merrell J91833 - Size 7.5,FBALYB Amazon,14,13,1,0,1,0
,Merrell J91833 - Size 8,Merrell J91833 - Size 8,Default Ridgefield,19,19,0,0,0,12
,Merrell J91833 - Size 8,Merrell J91833 - Size 8,FBALYB Amazon,-5,-5,0,0,0,0
,Merrell J91833 - Size 8.5,Merrell J91833 - Size 8.5,Default Ridgefield,41,41,0,0,0,24
,Merrell J91833 - Size 8.5,Merrell J91833 - Size 8.5,FBALYB Amazon,45,43,2,1,2,0
,Merrell J91833 - Size 9,Merrell J91833 - Size 9,Default Ridgefield,57,57,0,0,0,48
,Merrell J91833 - Size 9,Merrell J91833 - Size 9,FBALYB Amazon,64,62,2,0,2,0
,Merrell J91833 - Size 9.5,Merrell J91833 - Size 9.5,Default Ridgefield,36,36,0,0,0,48
,Merrell J91833 - Size 9.5,Merrell J91833 - Size 9.5,FBALYB Amazon,-10,-13,3,12,3,0
,Merrell J91833W - Size 10,Merrell J91833W - Size 10,FBALYB Amazon,-5,-5,0,0,0,0
,Merrell J91833W - Size 10.5,Merrell J91833W - Size 10.5,FBALYB Amazon,-2,-2,0,0,0,0
,Merrell J91833W - Size 11.5,Merrell J91833W - Size 11.5,FBALYB Amazon,-1,-1,0,0,0,0
,Merrell J91833W - Size 12,Merrell J91833W - Size 12,FBALYB Amazon,-2,-2,0,0,0,0
,Merrell J91833W - Size 8,Merrell J91833W - Size 8,FBALYB Amazon,-3,-3,0,0,0,0
,Merrell J91833W - Size 8.5,Merrell J91833W - Size 8.5,FBALYB Amazon,-2,-2,0,0,0,0
,Merrell J91833W - Size 9,Merrell J91833W - Size 9,FBALYB Amazon,-5,-5,0,0,0,0
,Merrell J91833W - Size 9.5,Merrell J91833W - Size 9.5,FBALYB Amazon,-2,-2,0,0,0,0
,Merrell J91837 - Size 10,Merrell J91837 - Size 10,FBALYB Amazon,-14,-16,2,0,2,0
,Merrell J91837 - Size 10.5,Merrell J91837 - Size 10.5,Default Ridgefield,6,6,0,0,0,0
,Merrell J91837 - Size 10.5,Merrell J91837 - Size 10.5,FBALYB Amazon,-2,-8,6,0,6,0
,Merrell J91837 - Size 11,Merrell J91837 - Size 11,FBALYB Amazon,40,35,5,0,5,0
,Merrell J91837 - Size 11.5,Merrell J91837 - Size 11.5,FBALYB Amazon,-8,-8,0,0,0,0
,Merrell J91837 - Size 12,Merrell J91837 - Size 12,Default Ridgefield,36,36,0,0,0,0
,Merrell J91837 - Size 12,Merrell J91837 - Size 12,FBALYB Amazon,-9,-10,1,12,1,0
,Merrell J91837 - Size 12.5,Merrell J91837 - Size 12.5,FBALYB Amazon,23,23,0,0,0,0
,Merrell J91837 - Size 13,Merrell J91837 - Size 13,Default Ridgefield,30,30,0,0,0,0
,Merrell J91837 - Size 13,Merrell J91837 - Size 13,FBALYB Amazon,13,12,1,8,1,0
,Merrell J91837 - Size 14,Merrell J91837 - Size 14,FBALYB Amazon,17,16,1,0,1,0
,Merrell J91837 - Size 7.5,Merrell J91837 - Size 7.5,FBALYB Amazon,6,6,0,0,0,0
,Merrell J91837 - Size 8,Merrell J91837 - Size 8,FBALYB Amazon,-1,-1,0,0,0,0
,Merrell J91837 - Size 8.5,Merrell J91837 - Size 8.5,FBALYB Amazon,2,2,0,0,0,0
,Merrell J91837 - Size 9,Merrell J91837 - Size 9,FBALYB Amazon,-5,-5,0,0,0,0
,Merrell J91837 - Size 9.5,Merrell J91837 - Size 9.5,FBALYB Amazon,36,32,4,0,4,0
,Merrell J91837W - Size 10.5,Merrell J91837W - Size 10.5,FBALYB Amazon,-3,-3,0,0,0,0
,Merrell J91837W - Size 11,Merrell J91837W - Size 11,FBALYB Amazon,-5,-5,0,0,0,0
,Merrell J91837W - Size 11.5,Merrell J91837W - Size 11.5,FBALYB Amazon,-1,-1,0,0,0,0
,Merrell J91837W - Size 8.5,Merrell J91837W - Size 8.5,FBALYB Amazon,-2,-2,0,0,0,0
,Merrell J91837W - Size 9,Merrell J91837W - Size 9,FBALYB Amazon,-1,-1,0,0,0,0
,Merrell J92025 - Size 10,Merrell J92025 - Size 10,Default Ridgefield,0,0,0,0,0,36
,Merrell J92025 - Size 10,Merrell J92025 - Size 10,FBALYB Amazon,27,27,0,0,0,0
,Merrell J92025 - Size 10.5,Merrell J92025 - Size 10.5,Default Ridgefield,36,36,0,0,0,36
,Merrell J92025 - Size 10.5,Merrell J92025 - Size 10.5,FBALYB Amazon,-2,-3,1,0,1,0
,Merrell J92025 - Size 11,Merrell J92025 - Size 11,Default Ridgefield,0,0,0,0,0,36
,Merrell J92025 - Size 11,Merrell J92025 - Size 11,FBALYB Amazon,29,27,2,0,2,0
,Merrell J92025 - Size 11.5,Merrell J92025 - Size 11.5,Default Ridgefield,0,0,0,0,0,24
,Merrell J92025 - Size 11.5,Merrell J92025 - Size 11.5,FBALYB Amazon,21,21,0,0,0,0
,Merrell J92025 - Size 12,Merrell J92025 - Size 12,Default Ridgefield,0,0,0,0,0,24
,Merrell J92025 - Size 12,Merrell J92025 - Size 12,FBALYB Amazon,20,20,0,0,0,0
,Merrell J92025 - Size 13,Merrell J92025 - Size 13,Default Ridgefield,0,0,0,0,0,24
,Merrell J92025 - Size 13,Merrell J92025 - Size 13,FBALYB Amazon,20,20,0,0,0,0
,Merrell J92025 - Size 8.5,Merrell J92025 - Size 8.5,Default Ridgefield,12,12,0,0,0,12
,Merrell J92025 - Size 8.5,Merrell J92025 - Size 8.5,FBALYB Amazon,-2,-2,0,0,0,0
,Merrell J92025 - Size 9,Merrell J92025 - Size 9,Default Ridgefield,0,0,0,0,0,24
,Merrell J92025 - Size 9,Merrell J92025 - Size 9,FBALYB Amazon,23,23,0,0,0,0
,Merrell J92025 - Size 9.5,Merrell J92025 - Size 9.5,Default Ridgefield,24,24,0,0,0,24
,Merrell J92025 - Size 9.5,Merrell J92025 - Size 9.5,FBALYB Amazon,-5,-5,0,0,0,0
,Merrell J92027 - Size 10,Merrell J92027 - Size 10,FBALYB Amazon,-10,-10,0,0,0,0
,Merrell J92027 - Size 10.5,Merrell J92027 - Size 10.5,FBALYB Amazon,-2,-2,0,0,0,0
,Merrell J92027 - Size 11,Merrell J92027 - Size 11,FBALYB Amazon,-10,-10,0,0,0,0
,Merrell J92027 - Size 11.5,Merrell J92027 - Size 11.5,FBALYB Amazon,-3,-3,0,0,0,0
,Merrell J92027 - Size 12,Merrell J92027 - Size 12,FBALYB Amazon,-6,-6,0,0,0,0
,Merrell J92027 - Size 13,Merrell J92027 - Size 13,FBALYB Amazon,-3,-3,0,0,0,0
,Merrell J92027 - Size 8,Merrell J92027 - Size 8,FBALYB Amazon,-1,-1,0,0,0,0
,Merrell J92027 - Size 9,Merrell J92027 - Size 9,FBALYB Amazon,-2,-2,0,0,0,0
,Merrell J92027 - Size 9.5,Merrell J92027 - Size 9.5,FBALYB Amazon,-4,-4,0,0,0,0
,MERRELL J99677 - SIZE 10,MERRELL J99677 - SIZE 10,Default,0,0,0,0,0,48
,MERRELL J99677 - SIZE 10.5,MERRELL J99677 - SIZE 10.5,Default,0,0,0,0,0,48
,MERRELL J99677 - SIZE 11,MERRELL J99677 - SIZE 11,Default,0,0,0,0,0,48
,MERRELL J99677 - SIZE 11.5,MERRELL J99677 - SIZE 11.5,Default,0,0,0,0,0,36
,MERRELL J99677 - SIZE 12,MERRELL J99677 - SIZE 12,Default,0,0,0,0,0,48
,MERRELL J99677 - SIZE 12.5,MERRELL J99677 - SIZE 12.5,Default,0,0,0,0,0,36
,MERRELL J99677 - SIZE 13,MERRELL J99677 - SIZE 13,Default,0,0,0,0,0,36
,MERRELL J99677 - SIZE 9,MERRELL J99677 - SIZE 9,Default,0,0,0,0,0,24
,MERRELL J99677 - SIZE 9.5,MERRELL J99677 - SIZE 9.5,Default,0,0,0,0,0,35
,Merrell Men ACCENTOR 2 VENT WP BOULDER J84925 Size 10,Merrell Men ACCENTOR 2 VENT WP BOULDER J84925 Size 10,Default Ridgefield,54,54,0,0,0,0
,Merrell Men ACCENTOR 2 VENT WP BOULDER J84925 Size 10.5,Merrell Men ACCENTOR 2 VENT WP BOULDER J84925 Size 10.5,Default Ridgefield,56,56,0,0,0,0
,Merrell Men ACCENTOR 2 VENT WP BOULDER J84925 Size 11,Merrell Men ACCENTOR 2 VENT WP BOULDER J84925 Size 11,Default Ridgefield,56,56,0,0,0,0
,Merrell Men ACCENTOR 2 VENT WP BOULDER J84925 Size 11.5,Merrell Men ACCENTOR 2 VENT WP BOULDER J84925 Size 11.5,Default Ridgefield,32,32,0,0,0,0
,Merrell Men ACCENTOR 2 VENT WP BOULDER J84925 Size 12,Merrell Men ACCENTOR 2 VENT WP BOULDER J84925 Size 12,Default Ridgefield,32,32,0,0,0,0
,Merrell Men ACCENTOR 2 VENT WP BOULDER J84925 Size 13,Merrell Men ACCENTOR 2 VENT WP BOULDER J84925 Size 13,Default Ridgefield,32,32,0,0,0,0
,Merrell Men ACCENTOR 2 VENT WP BOULDER J84925 Size 8.5,Merrell Men ACCENTOR 2 VENT WP BOULDER J84925 Size 8.5,Default Ridgefield,32,32,0,0,0,0
,Merrell Men ACCENTOR 2 VENT WP BOULDER J84925 Size 9,Merrell Men ACCENTOR 2 VENT WP BOULDER J84925 Size 9,Default Ridgefield,36,36,0,0,0,0
,Merrell Men ACCENTOR 2 VENT WP BOULDER J84925 Size 9.5,Merrell Men ACCENTOR 2 VENT WP BOULDER J84925 Size 9.5,Default Ridgefield,28,28,0,0,0,0
,Merrell Men  ACCENTOR 2 VENT WP GRANITE J84951 Size 10,Merrell Men  ACCENTOR 2 VENT WP GRANITE J84951 Size 10,Default Ridgefield,28,28,0,0,0,0
,Merrell Men  ACCENTOR 2 VENT WP GRANITE J84951 Size 10,Merrell Men  ACCENTOR 2 VENT WP GRANITE J84951 Size 10,FBALYB Amazon,28,28,0,0,0,0
,Merrell Men  ACCENTOR 2 VENT WP GRANITE J84951 Size 10.5,Merrell Men  ACCENTOR 2 VENT WP GRANITE J84951 Size 10.5,Default Ridgefield,28,28,0,0,0,0
,Merrell Men  ACCENTOR 2 VENT WP GRANITE J84951 Size 10.5,Merrell Men  ACCENTOR 2 VENT WP GRANITE J84951 Size 10.5,FBALYB Amazon,28,28,0,0,0,0
,Merrell Men  ACCENTOR 2 VENT WP GRANITE J84951 Size 11,Merrell Men  ACCENTOR 2 VENT WP GRANITE J84951 Size 11,Default Ridgefield,12,12,0,0,0,0
,Merrell Men  ACCENTOR 2 VENT WP GRANITE J84951 Size 11,Merrell Men  ACCENTOR 2 VENT WP GRANITE J84951 Size 11,FBALYB Amazon,44,44,0,0,0,0
,Merrell Men  ACCENTOR 2 VENT WP GRANITE J84951 Size 11.5,Merrell Men  ACCENTOR 2 VENT WP GRANITE J84951 Size 11.5,Default Ridgefield,20,20,0,0,0,0
,Merrell Men  ACCENTOR 2 VENT WP GRANITE J84951 Size 11.5,Merrell Men  ACCENTOR 2 VENT WP GRANITE J84951 Size 11.5,FBALYB Amazon,12,12,0,0,0,0
,Merrell Men  ACCENTOR 2 VENT WP GRANITE J84951 Size 12,Merrell Men  ACCENTOR 2 VENT WP GRANITE J84951 Size 12,FBALYB Amazon,32,32,0,0,0,0
,Merrell Men  ACCENTOR 2 VENT WP GRANITE J84951 Size 13,Merrell Men  ACCENTOR 2 VENT WP GRANITE J84951 Size 13,Default Ridgefield,16,16,0,0,0,0
,Merrell Men  ACCENTOR 2 VENT WP GRANITE J84951 Size 13,Merrell Men  ACCENTOR 2 VENT WP GRANITE J84951 Size 13,FBALYB Amazon,16,16,0,0,0,0
,Merrell Men  ACCENTOR 2 VENT WP GRANITE J84951 Size 8.5,Merrell Men  ACCENTOR 2 VENT WP GRANITE J84951 Size 8.5,Default Ridgefield,28,28,0,0,0,0
,Merrell Men  ACCENTOR 2 VENT WP GRANITE J84951 Size 8.5,Merrell Men  ACCENTOR 2 VENT WP GRANITE J84951 Size 8.5,FBALYB Amazon,4,4,0,0,0,0
,Merrell Men  ACCENTOR 2 VENT WP GRANITE J84951 Size 9,Merrell Men  ACCENTOR 2 VENT WP GRANITE J84951 Size 9,Default Ridgefield,8,8,0,0,0,0
,Merrell Men  ACCENTOR 2 VENT WP GRANITE J84951 Size 9,Merrell Men  ACCENTOR 2 VENT WP GRANITE J84951 Size 9,FBALYB Amazon,24,24,0,0,0,0
,Merrell Men  ACCENTOR 2 VENT WP GRANITE J84951 Size 9.5,Merrell Men  ACCENTOR 2 VENT WP GRANITE J84951 Size 9.5,Default Ridgefield,16,16,0,0,0,0
,Merrell Men  ACCENTOR 2 VENT WP GRANITE J84951 Size 9.5,Merrell Men  ACCENTOR 2 VENT WP GRANITE J84951 Size 9.5,FBALYB Amazon,16,16,0,0,0,0
,Merrell Men ALVERSTONE CASTLEROCK J48529 Size 10,Merrell Men ALVERSTONE CASTLEROCK J48529 Size 10,Default Ridgefield,24,24,0,0,0,0
,Merrell Men ALVERSTONE CASTLEROCK J48529 Size 10,Merrell Men ALVERSTONE CASTLEROCK J48529 Size 10,FBALYB Amazon,21,21,0,0,0,0
,Merrell Men ALVERSTONE CASTLEROCK J48529 Size 10.5,Merrell Men ALVERSTONE CASTLEROCK J48529 Size 10.5,Default Ridgefield,24,24,0,0,0,0
,Merrell Men ALVERSTONE CASTLEROCK J48529 Size 10.5,Merrell Men ALVERSTONE CASTLEROCK J48529 Size 10.5,FBALYB Amazon,17,17,0,0,0,0
,Merrell Men ALVERSTONE CASTLEROCK J48529 Size 11,Merrell Men ALVERSTONE CASTLEROCK J48529 Size 11,Default Ridgefield,24,24,0,0,0,0
,Merrell Men ALVERSTONE CASTLEROCK J48529 Size 11,Merrell Men ALVERSTONE CASTLEROCK J48529 Size 11,FBALYB Amazon,21,21,0,0,0,0
,Merrell Men ALVERSTONE CASTLEROCK J48529 Size 11.5,Merrell Men ALVERSTONE CASTLEROCK J48529 Size 11.5,Default Ridgefield,24,24,0,0,0,0
,Merrell Men ALVERSTONE CASTLEROCK J48529 Size 11.5,Merrell Men ALVERSTONE CASTLEROCK J48529 Size 11.5,FBALYB Amazon,21,20,1,0,1,0
,Merrell Men ALVERSTONE CASTLEROCK J48529 Size 12,Merrell Men ALVERSTONE CASTLEROCK J48529 Size 12,Default Ridgefield,24,24,0,0,0,0
,Merrell Men ALVERSTONE CASTLEROCK J48529 Size 12,Merrell Men ALVERSTONE CASTLEROCK J48529 Size 12,FBALYB Amazon,21,21,0,0,0,0
,Merrell Men ALVERSTONE CASTLEROCK J48529 Size 13,Merrell Men ALVERSTONE CASTLEROCK J48529 Size 13,Default Ridgefield,24,24,0,0,0,0
,Merrell Men ALVERSTONE CASTLEROCK J48529 Size 13,Merrell Men ALVERSTONE CASTLEROCK J48529 Size 13,FBALYB Amazon,20,20,0,0,0,0
,Merrell Men ALVERSTONE CASTLEROCK J48529 Size 8.5,Merrell Men ALVERSTONE CASTLEROCK J48529 Size 8.5,Default Ridgefield,12,12,0,0,0,0
,Merrell Men ALVERSTONE CASTLEROCK J48529 Size 8.5,Merrell Men ALVERSTONE CASTLEROCK J48529 Size 8.5,FBALYB Amazon,11,11,0,0,0,0
,Merrell Men ALVERSTONE CASTLEROCK J48529 Size 9,Merrell Men ALVERSTONE CASTLEROCK J48529 Size 9,Default Ridgefield,12,12,0,0,0,0
,Merrell Men ALVERSTONE CASTLEROCK J48529 Size 9,Merrell Men ALVERSTONE CASTLEROCK J48529 Size 9,FBALYB Amazon,10,10,0,0,0,0
,Merrell Men ALVERSTONE CASTLEROCK J48529 Size 9.5,Merrell Men ALVERSTONE CASTLEROCK J48529 Size 9.5,Default Ridgefield,24,24,0,0,0,0
,Merrell Men ALVERSTONE CASTLEROCK J48529 Size 9.5,Merrell Men ALVERSTONE CASTLEROCK J48529 Size 9.5,FBALYB Amazon,20,20,0,0,0,0
,MERRELL MENS J033035 ALVERSTONE Boulder SIZE 10,MERRELL MENS J033035 ALVERSTONE Boulder SIZE 10,Default Ridgefield,24,24,0,0,0,0
,MERRELL MENS J033035 ALVERSTONE Boulder SIZE 10,MERRELL MENS J033035 ALVERSTONE Boulder SIZE 10,FBALYB Amazon,14,14,0,0,0,0
,MERRELL MENS J033035 ALVERSTONE Boulder SIZE 10.5,MERRELL MENS J033035 ALVERSTONE Boulder SIZE 10.5,Default Ridgefield,1,1,0,0,0,0
,MERRELL MENS J033035 ALVERSTONE Boulder SIZE 10.5,MERRELL MENS J033035 ALVERSTONE Boulder SIZE 10.5,FBALYB Amazon,41,37,4,0,4,0
,MERRELL MENS J033035 ALVERSTONE Boulder SIZE 11,MERRELL MENS J033035 ALVERSTONE Boulder SIZE 11,FBALYB Amazon,38,38,0,0,0,0
,MERRELL MENS J033035 ALVERSTONE Boulder SIZE 11.5,MERRELL MENS J033035 ALVERSTONE Boulder SIZE 11.5,Default Ridgefield,11,11,0,0,0,0
,MERRELL MENS J033035 ALVERSTONE Boulder SIZE 11.5,MERRELL MENS J033035 ALVERSTONE Boulder SIZE 11.5,FBALYB Amazon,17,17,0,0,0,0
,MERRELL MENS J033035 ALVERSTONE Boulder SIZE 12,MERRELL MENS J033035 ALVERSTONE Boulder SIZE 12,Default Ridgefield,12,12,0,0,0,0
,MERRELL MENS J033035 ALVERSTONE Boulder SIZE 12,MERRELL MENS J033035 ALVERSTONE Boulder SIZE 12,FBALYB Amazon,32,32,0,0,0,0
,MERRELL MENS J033035 ALVERSTONE Boulder SIZE 12.5,MERRELL MENS J033035 ALVERSTONE Boulder SIZE 12.5,Default Ridgefield,34,34,0,0,0,0
,MERRELL MENS J033035 ALVERSTONE Boulder SIZE 13,MERRELL MENS J033035 ALVERSTONE Boulder SIZE 13,FBALYB Amazon,33,33,0,0,0,0
,MERRELL MENS J033035 ALVERSTONE Boulder SIZE 9,MERRELL MENS J033035 ALVERSTONE Boulder SIZE 9,FBALYB Amazon,20,20,0,0,0,0
,MERRELL MENS J033035 ALVERSTONE Boulder SIZE 9.5,MERRELL MENS J033035 ALVERSTONE Boulder SIZE 9.5,FBALYB Amazon,31,30,1,0,1,0
,MERRELL MENS J036221 ALVERSTONE Charcoal SIZE 10,MERRELL MENS J036221 ALVERSTONE Charcoal SIZE 10,Default Ridgefield,46,46,0,0,0,0
,MERRELL MENS J036221 ALVERSTONE Charcoal SIZE 10.5,MERRELL MENS J036221 ALVERSTONE Charcoal SIZE 10.5,Default Ridgefield,46,46,0,0,0,0
,MERRELL MENS J036221 ALVERSTONE Charcoal SIZE 11,MERRELL MENS J036221 ALVERSTONE Charcoal SIZE 11,Default Ridgefield,46,46,0,0,0,0
,MERRELL MENS J036221 ALVERSTONE Charcoal SIZE 11.5,MERRELL MENS J036221 ALVERSTONE Charcoal SIZE 11.5,Default Ridgefield,34,34,0,0,0,0
,MERRELL MENS J036221 ALVERSTONE Charcoal SIZE 12,MERRELL MENS J036221 ALVERSTONE Charcoal SIZE 12,Default Ridgefield,46,46,0,0,0,0
,MERRELL MENS J036221 ALVERSTONE Charcoal SIZE 13,MERRELL MENS J036221 ALVERSTONE Charcoal SIZE 13,Default Ridgefield,35,35,0,0,0,0
,MERRELL MENS J036221 ALVERSTONE Charcoal SIZE 9,MERRELL MENS J036221 ALVERSTONE Charcoal SIZE 9,Default Ridgefield,22,22,0,0,0,0
,MERRELL MENS J036221 ALVERSTONE Charcoal SIZE 9.5,MERRELL MENS J036221 ALVERSTONE Charcoal SIZE 9.5,Default Ridgefield,34,34,0,0,0,0
,Merrell MENS J589903W ALVERSTONE WP Earth Black SIZE 10,Merrell MENS J589903W ALVERSTONE WP Earth Black SIZE 10,Default Ridgefield,48,48,0,0,0,0
,Merrell MENS J589903W ALVERSTONE WP Earth Black SIZE 10.5,Merrell MENS J589903W ALVERSTONE WP Earth Black SIZE 10.5,Default Ridgefield,48,48,0,0,0,0
,Merrell MENS J589903W ALVERSTONE WP Earth Black SIZE 11,Merrell MENS J589903W ALVERSTONE WP Earth Black SIZE 11,Default Ridgefield,48,48,0,0,0,0
,Merrell MENS J589903W ALVERSTONE WP Earth Black SIZE 11.5,Merrell MENS J589903W ALVERSTONE WP Earth Black SIZE 11.5,Default Ridgefield,36,36,0,0,0,0
,Merrell MENS J589903W ALVERSTONE WP Earth Black SIZE 12,Merrell MENS J589903W ALVERSTONE WP Earth Black SIZE 12,Default Ridgefield,48,48,0,0,0,0
,Merrell MENS J589903W ALVERSTONE WP Earth Black SIZE 12.5,Merrell MENS J589903W ALVERSTONE WP Earth Black SIZE 12.5,Default Ridgefield,36,36,0,0,0,0
,Merrell MENS J589903W ALVERSTONE WP Earth Black SIZE 13,Merrell MENS J589903W ALVERSTONE WP Earth Black SIZE 13,Default Ridgefield,36,36,0,0,0,0
,Merrell MENS J589903W ALVERSTONE WP Earth Black SIZE 9,Merrell MENS J589903W ALVERSTONE WP Earth Black SIZE 9,Default Ridgefield,24,24,0,0,0,0
,Merrell MENS J589903W ALVERSTONE WP Earth Black SIZE 9.5,Merrell MENS J589903W ALVERSTONE WP Earth Black SIZE 9.5,Default Ridgefield,36,36,0,0,0,0
,Merrell Women ALVERSTONE BRINDLE J52862 Size 10,Merrell Women ALVERSTONE BRINDLE J52862 Size 10,Default Ridgefield,16,16,0,0,0,0
,Merrell Women ALVERSTONE BRINDLE J52862 Size 10,Merrell Women ALVERSTONE BRINDLE J52862 Size 10,FBALYB Amazon,15,15,0,0,0,0
,Merrell Women ALVERSTONE BRINDLE J52862 Size 6.5,Merrell Women ALVERSTONE BRINDLE J52862 Size 6.5,Default Ridgefield,18,18,0,0,0,0
,Merrell Women ALVERSTONE BRINDLE J52862 Size 6.5,Merrell Women ALVERSTONE BRINDLE J52862 Size 6.5,FBALYB Amazon,16,15,1,0,1,0
,Merrell Women ALVERSTONE BRINDLE J52862 Size 7,Merrell Women ALVERSTONE BRINDLE J52862 Size 7,Default Ridgefield,30,30,0,0,0,0
,Merrell Women ALVERSTONE BRINDLE J52862 Size 7,Merrell Women ALVERSTONE BRINDLE J52862 Size 7,FBALYB Amazon,28,28,0,0,0,0
,Merrell Women ALVERSTONE BRINDLE J52862 Size 7.5,Merrell Women ALVERSTONE BRINDLE J52862 Size 7.5,Default Ridgefield,28,28,0,0,0,0
,Merrell Women ALVERSTONE BRINDLE J52862 Size 7.5,Merrell Women ALVERSTONE BRINDLE J52862 Size 7.5,FBALYB Amazon,28,27,1,0,1,0
,Merrell Women ALVERSTONE BRINDLE J52862 Size 8,Merrell Women ALVERSTONE BRINDLE J52862 Size 8,Default Ridgefield,28,28,0,0,0,0
,Merrell Women ALVERSTONE BRINDLE J52862 Size 8,Merrell Women ALVERSTONE BRINDLE J52862 Size 8,FBALYB Amazon,21,21,0,0,0,0
,Merrell Women ALVERSTONE BRINDLE J52862 Size 8.5,Merrell Women ALVERSTONE BRINDLE J52862 Size 8.5,Default Ridgefield,28,28,0,0,0,0
,Merrell Women ALVERSTONE BRINDLE J52862 Size 8.5,Merrell Women ALVERSTONE BRINDLE J52862 Size 8.5,FBALYB Amazon,25,25,0,0,0,0
,Merrell Women ALVERSTONE BRINDLE J52862 Size 9,Merrell Women ALVERSTONE BRINDLE J52862 Size 9,Default Ridgefield,16,16,0,0,0,0
,Merrell Women ALVERSTONE BRINDLE J52862 Size 9,Merrell Women ALVERSTONE BRINDLE J52862 Size 9,FBALYB Amazon,16,16,0,0,0,0
,Merrell Women ALVERSTONE BRINDLE J52862 Size 9.5,Merrell Women ALVERSTONE BRINDLE J52862 Size 9.5,Default Ridgefield,16,16,0,0,0,0
,Merrell Women ALVERSTONE BRINDLE J52862 Size 9.5,Merrell Women ALVERSTONE BRINDLE J52862 Size 9.5,FBALYB Amazon,16,16,0,0,0,0
,MERRELL Women ALVERSTONE J034612 STORM SIZE 10,MERRELL Women ALVERSTONE J034612 STORM SIZE 10,Default Ridgefield,16,16,0,0,0,0
,MERRELL Women ALVERSTONE J034612 STORM SIZE 10,MERRELL Women ALVERSTONE J034612 STORM SIZE 10,FBALYB Amazon,13,13,0,0,0,0
,MERRELL Women ALVERSTONE J034612 STORM SIZE 6.5,MERRELL Women ALVERSTONE J034612 STORM SIZE 6.5,Default Ridgefield,36,36,0,0,0,0
,MERRELL Women ALVERSTONE J034612 STORM SIZE 7,MERRELL Women ALVERSTONE J034612 STORM SIZE 7,Default Ridgefield,30,30,0,0,0,0
,MERRELL Women ALVERSTONE J034612 STORM SIZE 7,MERRELL Women ALVERSTONE J034612 STORM SIZE 7,FBALYB Amazon,22,21,1,0,1,0
,MERRELL Women ALVERSTONE J034612 STORM SIZE 7.5,MERRELL Women ALVERSTONE J034612 STORM SIZE 7.5,Default Ridgefield,28,28,0,0,0,0
,MERRELL Women ALVERSTONE J034612 STORM SIZE 7.5,MERRELL Women ALVERSTONE J034612 STORM SIZE 7.5,FBALYB Amazon,13,12,1,0,1,0
,MERRELL Women ALVERSTONE J034612 STORM SIZE 8,MERRELL Women ALVERSTONE J034612 STORM SIZE 8,Default Ridgefield,28,28,0,0,0,0
,MERRELL Women ALVERSTONE J034612 STORM SIZE 8,MERRELL Women ALVERSTONE J034612 STORM SIZE 8,FBALYB Amazon,10,10,0,0,0,0
,MERRELL Women ALVERSTONE J034612 STORM SIZE 8.5,MERRELL Women ALVERSTONE J034612 STORM SIZE 8.5,Default Ridgefield,28,28,0,0,0,0
,MERRELL Women ALVERSTONE J034612 STORM SIZE 8.5,MERRELL Women ALVERSTONE J034612 STORM SIZE 8.5,FBALYB Amazon,12,11,1,0,1,0
,MERRELL Women ALVERSTONE J034612 STORM SIZE 9,MERRELL Women ALVERSTONE J034612 STORM SIZE 9,Default Ridgefield,32,32,0,0,0,0
,MERRELL Women ALVERSTONE J034612 STORM SIZE 9.5,MERRELL Women ALVERSTONE J034612 STORM SIZE 9.5,Default Ridgefield,16,16,0,0,0,0
,MERRELL Women ALVERSTONE J034612 STORM SIZE 9.5,MERRELL Women ALVERSTONE J034612 STORM SIZE 9.5,FBALYB Amazon,10,10,0,0,0,0
,MERRELL Women  ALVERSTONE WP STORM J034620 Size 10,MERRELL Women  ALVERSTONE WP STORM J034620 Size 10,Default Ridgefield,4,4,0,0,0,0
,MERRELL Women  ALVERSTONE WP STORM J034620 Size 10,MERRELL Women  ALVERSTONE WP STORM J034620 Size 10,FBALYB Amazon,11,10,1,0,1,0
,MERRELL Women  ALVERSTONE WP STORM J034620 Size 6.5,MERRELL Women  ALVERSTONE WP STORM J034620 Size 6.5,Default Ridgefield,18,18,0,0,0,0
,MERRELL Women  ALVERSTONE WP STORM J034620 Size 6.5,MERRELL Women  ALVERSTONE WP STORM J034620 Size 6.5,FBALYB Amazon,5,4,1,0,1,0
,MERRELL Women  ALVERSTONE WP STORM J034620 Size 7,MERRELL Women  ALVERSTONE WP STORM J034620 Size 7,Default Ridgefield,30,30,0,0,0,0
,MERRELL Women  ALVERSTONE WP STORM J034620 Size 7,MERRELL Women  ALVERSTONE WP STORM J034620 Size 7,FBALYB Amazon,24,24,0,0,0,0
,MERRELL Women  ALVERSTONE WP STORM J034620 Size 7.5,MERRELL Women  ALVERSTONE WP STORM J034620 Size 7.5,Default Ridgefield,28,28,0,0,0,0
,MERRELL Women  ALVERSTONE WP STORM J034620 Size 7.5,MERRELL Women  ALVERSTONE WP STORM J034620 Size 7.5,FBALYB Amazon,9,9,0,0,0,0
,MERRELL Women  ALVERSTONE WP STORM J034620 Size 8,MERRELL Women  ALVERSTONE WP STORM J034620 Size 8,Default Ridgefield,60,60,0,0,0,0
,MERRELL Women  ALVERSTONE WP STORM J034620 Size 8.5,MERRELL Women  ALVERSTONE WP STORM J034620 Size 8.5,Default Ridgefield,28,28,0,0,0,0
,MERRELL Women  ALVERSTONE WP STORM J034620 Size 8.5,MERRELL Women  ALVERSTONE WP STORM J034620 Size 8.5,FBALYB Amazon,10,8,2,0,2,0
,MERRELL Women  ALVERSTONE WP STORM J034620 Size 9,MERRELL Women  ALVERSTONE WP STORM J034620 Size 9,Default Ridgefield,16,16,0,0,0,0
,MERRELL Women  ALVERSTONE WP STORM J034620 Size 9,MERRELL Women  ALVERSTONE WP STORM J034620 Size 9,FBALYB Amazon,1,-2,3,0,3,0
,MERRELL Women  ALVERSTONE WP STORM J034620 Size 9.5,MERRELL Women  ALVERSTONE WP STORM J034620 Size 9.5,Default Ridgefield,16,16,0,0,0,0
,MERRELL Women  ALVERSTONE WP STORM J034620 Size 9.5,MERRELL Women  ALVERSTONE WP STORM J034620 Size 9.5,FBALYB Amazon,6,6,0,0,0,0
,Merrell Women TREMBLANT PULL ON POLAR WP BLACK Size 10,Merrell Women TREMBLANT PULL ON POLAR WP BLACK Size 10,Default Ridgefield,10,10,0,0,0,0
,Merrell Women TREMBLANT PULL ON POLAR WP BLACK Size 6.5,Merrell Women TREMBLANT PULL ON POLAR WP BLACK Size 6.5,Default Ridgefield,15,15,0,0,0,0
,Merrell Women TREMBLANT PULL ON POLAR WP BLACK Size 7,Merrell Women TREMBLANT PULL ON POLAR WP BLACK Size 7,FBALYB Amazon,28,28,0,0,0,0
,Merrell Women TREMBLANT PULL ON POLAR WP BLACK Size 7.5,Merrell Women TREMBLANT PULL ON POLAR WP BLACK Size 7.5,Default Ridgefield,35,35,0,0,0,0
,Merrell Women TREMBLANT PULL ON POLAR WP BLACK Size 8,Merrell Women TREMBLANT PULL ON POLAR WP BLACK Size 8,Default Ridgefield,39,39,0,0,0,0
,Merrell Women TREMBLANT PULL ON POLAR WP BLACK Size 8.5,Merrell Women TREMBLANT PULL ON POLAR WP BLACK Size 8.5,FBALYB Amazon,32,32,0,0,0,0
,Merrell Women TREMBLANT PULL ON POLAR WP BLACK Size 9,Merrell Women TREMBLANT PULL ON POLAR WP BLACK Size 9,FBALYB Amazon,20,20,0,0,0,0
,Merrell Women TREMBLANT PULL ON POLAR WP BLACK Size 9.5,Merrell Women TREMBLANT PULL ON POLAR WP BLACK Size 9.5,Default Ridgefield,19,19,0,0,0,0
,Merrell Women TREMBLANT PULL ON POLAR WP MERRELL OAK Size 10,Merrell Women TREMBLANT PULL ON POLAR WP MERRELL OAK Size 10,Default Ridgefield,5,5,0,0,0,0
,Merrell Women TREMBLANT PULL ON POLAR WP MERRELL OAK Size 6,Merrell Women TREMBLANT PULL ON POLAR WP MERRELL OAK Size 6,Default Ridgefield,0,-2,2,0,0,0
,Merrell Women TREMBLANT PULL ON POLAR WP MERRELL OAK Size 6,Merrell Women TREMBLANT PULL ON POLAR WP MERRELL OAK Size 6,FBALYB Amazon,4,4,0,0,0,0
,Merrell Women TREMBLANT PULL ON POLAR WP MERRELL OAK Size 6.5,Merrell Women TREMBLANT PULL ON POLAR WP MERRELL OAK Size 6.5,Default Ridgefield,15,15,0,0,0,0
,Merrell Women TREMBLANT PULL ON POLAR WP MERRELL OAK Size 7,Merrell Women TREMBLANT PULL ON POLAR WP MERRELL OAK Size 7,FBALYB Amazon,36,36,0,0,0,0
,Merrell Women TREMBLANT PULL ON POLAR WP MERRELL OAK Size 7.5,Merrell Women TREMBLANT PULL ON POLAR WP MERRELL OAK Size 7.5,FBALYB Amazon,44,44,0,0,0,0
,Merrell Women TREMBLANT PULL ON POLAR WP MERRELL OAK Size 8,Merrell Women TREMBLANT PULL ON POLAR WP MERRELL OAK Size 8,Default Ridgefield,60,60,0,0,0,0
,Merrell Women TREMBLANT PULL ON POLAR WP MERRELL OAK Size 8.5,Merrell Women TREMBLANT PULL ON POLAR WP MERRELL OAK Size 8.5,Default Ridgefield,50,50,0,0,0,0
,Merrell Women TREMBLANT PULL ON POLAR WP MERRELL OAK Size 9,Merrell Women TREMBLANT PULL ON POLAR WP MERRELL OAK Size 9,FBALYB Amazon,32,32,0,0,0,0
,Merrell Women TREMBLANT PULL ON POLAR WP MERRELL OAK Size 9.5,Merrell Women TREMBLANT PULL ON POLAR WP MERRELL OAK Size 9.5,FBALYB Amazon,19,19,0,0,0,0
,Merrell Women YOKOTA 2 BOULDER J78636 Size 10,Merrell Women YOKOTA 2 BOULDER J78636 Size 10,Default Ridgefield,24,24,0,0,0,0
,Merrell Women YOKOTA 2 BOULDER J78636 Size 10,Merrell Women YOKOTA 2 BOULDER J78636 Size 10,FBALYB Amazon,18,18,0,0,0,0
,Merrell Women YOKOTA 2 BOULDER J78636 Size 10.5,Merrell Women YOKOTA 2 BOULDER J78636 Size 10.5,Default Ridgefield,12,12,0,0,0,0
,Merrell Women YOKOTA 2 BOULDER J78636 Size 10.5,Merrell Women YOKOTA 2 BOULDER J78636 Size 10.5,FBALYB Amazon,12,12,0,0,0,0
,Merrell Women YOKOTA 2 BOULDER J78636 Size 11,Merrell Women YOKOTA 2 BOULDER J78636 Size 11,Default Ridgefield,12,12,0,0,0,0
,Merrell Women YOKOTA 2 BOULDER J78636 Size 11,Merrell Women YOKOTA 2 BOULDER J78636 Size 11,FBALYB Amazon,5,5,0,0,0,0
,Merrell Women YOKOTA 2 BOULDER J78636 Size 5.5,Merrell Women YOKOTA 2 BOULDER J78636 Size 5.5,Default Ridgefield,12,12,0,0,0,0
,Merrell Women YOKOTA 2 BOULDER J78636 Size 5.5,Merrell Women YOKOTA 2 BOULDER J78636 Size 5.5,FBALYB Amazon,10,10,0,0,0,0
,Merrell Women YOKOTA 2 BOULDER J78636 Size 6,Merrell Women YOKOTA 2 BOULDER J78636 Size 6,Default Ridgefield,12,12,0,0,0,0
,Merrell Women YOKOTA 2 BOULDER J78636 Size 6,Merrell Women YOKOTA 2 BOULDER J78636 Size 6,FBALYB Amazon,3,3,0,0,0,0
,Merrell Women YOKOTA 2 BOULDER J78636 Size 6.5,Merrell Women YOKOTA 2 BOULDER J78636 Size 6.5,Default Ridgefield,24,24,0,0,0,0
,Merrell Women YOKOTA 2 BOULDER J78636 Size 6.5,Merrell Women YOKOTA 2 BOULDER J78636 Size 6.5,FBALYB Amazon,12,12,0,0,0,0
,Merrell Women YOKOTA 2 BOULDER J78636 Size 7,Merrell Women YOKOTA 2 BOULDER J78636 Size 7,Default Ridgefield,48,48,0,0,0,0
,Merrell Women YOKOTA 2 BOULDER J78636 Size 7,Merrell Women YOKOTA 2 BOULDER J78636 Size 7,FBALYB Amazon,30,30,0,0,0,0
,Merrell Women YOKOTA 2 BOULDER J78636 Size 7.5,Merrell Women YOKOTA 2 BOULDER J78636 Size 7.5,Default Ridgefield,36,36,0,0,0,0
,Merrell Women YOKOTA 2 BOULDER J78636 Size 7.5,Merrell Women YOKOTA 2 BOULDER J78636 Size 7.5,FBALYB Amazon,29,27,2,0,2,0
,Merrell Women YOKOTA 2 BOULDER J78636 Size 8,Merrell Women YOKOTA 2 BOULDER J78636 Size 8,Default Ridgefield,48,48,0,0,0,0
,Merrell Women YOKOTA 2 BOULDER J78636 Size 8,Merrell Women YOKOTA 2 BOULDER J78636 Size 8,FBALYB Amazon,26,26,0,0,0,0
,Merrell Women YOKOTA 2 BOULDER J78636 Size 8.5,Merrell Women YOKOTA 2 BOULDER J78636 Size 8.5,Default Ridgefield,48,48,0,0,0,0
,Merrell Women YOKOTA 2 BOULDER J78636 Size 8.5,Merrell Women YOKOTA 2 BOULDER J78636 Size 8.5,FBALYB Amazon,27,25,2,0,2,0
,Merrell Women YOKOTA 2 BOULDER J78636 Size 9,Merrell Women YOKOTA 2 BOULDER J78636 Size 9,Default Ridgefield,48,48,0,0,0,0
,Merrell Women YOKOTA 2 BOULDER J78636 Size 9,Merrell Women YOKOTA 2 BOULDER J78636 Size 9,FBALYB Amazon,32,32,0,0,0,0
,Merrell Women YOKOTA 2 BOULDER J78636 Size 9.5,Merrell Women YOKOTA 2 BOULDER J78636 Size 9.5,Default Ridgefield,36,36,0,0,0,0
,Merrell Women YOKOTA 2 BOULDER J78636 Size 9.5,Merrell Women YOKOTA 2 BOULDER J78636 Size 9.5,FBALYB Amazon,15,15,0,0,0,0
,Merrell Women YOKOTA 2 BRINDLE J78638 Size 10,Merrell Women YOKOTA 2 BRINDLE J78638 Size 10,Default Ridgefield,36,36,0,0,0,0
,Merrell Women YOKOTA 2 BRINDLE J78638 Size 10,Merrell Women YOKOTA 2 BRINDLE J78638 Size 10,FBALYB Amazon,30,30,0,0,0,0
,Merrell Women YOKOTA 2 BRINDLE J78638 Size 10.5,Merrell Women YOKOTA 2 BRINDLE J78638 Size 10.5,Default Ridgefield,12,12,0,0,0,0
,Merrell Women YOKOTA 2 BRINDLE J78638 Size 10.5,Merrell Women YOKOTA 2 BRINDLE J78638 Size 10.5,FBALYB Amazon,7,6,1,0,1,0
,Merrell Women YOKOTA 2 BRINDLE J78638 Size 11,Merrell Women YOKOTA 2 BRINDLE J78638 Size 11,Default Ridgefield,12,12,0,0,0,0
,Merrell Women YOKOTA 2 BRINDLE J78638 Size 11,Merrell Women YOKOTA 2 BRINDLE J78638 Size 11,FBALYB Amazon,10,10,0,0,0,0
,Merrell Women YOKOTA 2 BRINDLE J78638 Size 5.5,Merrell Women YOKOTA 2 BRINDLE J78638 Size 5.5,Default Ridgefield,12,12,0,0,0,0
,Merrell Women YOKOTA 2 BRINDLE J78638 Size 5.5,Merrell Women YOKOTA 2 BRINDLE J78638 Size 5.5,FBALYB Amazon,10,10,0,0,0,0
,Merrell Women YOKOTA 2 BRINDLE J78638 Size 6,Merrell Women YOKOTA 2 BRINDLE J78638 Size 6,Default Ridgefield,24,24,0,0,0,0
,Merrell Women YOKOTA 2 BRINDLE J78638 Size 6,Merrell Women YOKOTA 2 BRINDLE J78638 Size 6,FBALYB Amazon,20,20,0,0,0,0
,Merrell Women YOKOTA 2 BRINDLE J78638 Size 6.5,Merrell Women YOKOTA 2 BRINDLE J78638 Size 6.5,Default Ridgefield,36,31,5,0,0,0
,Merrell Women YOKOTA 2 BRINDLE J78638 Size 6.5,Merrell Women YOKOTA 2 BRINDLE J78638 Size 6.5,FBALYB Amazon,35,35,0,0,0,0
,Merrell Women YOKOTA 2 BRINDLE J78638 Size 7,Merrell Women YOKOTA 2 BRINDLE J78638 Size 7,Default Ridgefield,60,60,0,0,0,0
,Merrell Women YOKOTA 2 BRINDLE J78638 Size 7,Merrell Women YOKOTA 2 BRINDLE J78638 Size 7,FBALYB Amazon,50,50,0,0,0,0
,Merrell Women YOKOTA 2 BRINDLE J78638 Size 7.5,Merrell Women YOKOTA 2 BRINDLE J78638 Size 7.5,Default Ridgefield,48,48,0,0,0,0
,Merrell Women YOKOTA 2 BRINDLE J78638 Size 7.5,Merrell Women YOKOTA 2 BRINDLE J78638 Size 7.5,FBALYB Amazon,40,40,0,0,0,0
,Merrell Women YOKOTA 2 BRINDLE J78638 Size 8,Merrell Women YOKOTA 2 BRINDLE J78638 Size 8,Default Ridgefield,60,60,0,0,0,0
,Merrell Women YOKOTA 2 BRINDLE J78638 Size 8,Merrell Women YOKOTA 2 BRINDLE J78638 Size 8,FBALYB Amazon,51,51,0,0,0,0
,Merrell Women YOKOTA 2 BRINDLE J78638 Size 8.5,Merrell Women YOKOTA 2 BRINDLE J78638 Size 8.5,Default Ridgefield,60,60,0,0,0,0
,Merrell Women YOKOTA 2 BRINDLE J78638 Size 8.5,Merrell Women YOKOTA 2 BRINDLE J78638 Size 8.5,FBALYB Amazon,53,53,0,0,0,0
,Merrell Women YOKOTA 2 BRINDLE J78638 Size 9,Merrell Women YOKOTA 2 BRINDLE J78638 Size 9,Default Ridgefield,60,60,0,0,0,0
,Merrell Women YOKOTA 2 BRINDLE J78638 Size 9,Merrell Women YOKOTA 2 BRINDLE J78638 Size 9,FBALYB Amazon,55,55,0,0,0,0
,Merrell Women YOKOTA 2 BRINDLE J78638 Size 9.5,Merrell Women YOKOTA 2 BRINDLE J78638 Size 9.5,Default Ridgefield,48,48,0,0,0,0
,Merrell Women YOKOTA 2 BRINDLE J78638 Size 9.5,Merrell Women YOKOTA 2 BRINDLE J78638 Size 9.5,FBALYB Amazon,42,42,0,0,0,0
,Merrell Women YOKOTA 2 GRANITE J85904 Size 10,Merrell Women YOKOTA 2 GRANITE J85904 Size 10,Default Ridgefield,12,12,0,0,0,0
,Merrell Women YOKOTA 2 GRANITE J85904 Size 10,Merrell Women YOKOTA 2 GRANITE J85904 Size 10,FBALYB Amazon,3,2,1,0,1,0
,Merrell Women YOKOTA 2 GRANITE J85904 Size 6.5,Merrell Women YOKOTA 2 GRANITE J85904 Size 6.5,Default Ridgefield,24,24,0,0,0,0
,Merrell Women YOKOTA 2 GRANITE J85904 Size 6.5,Merrell Women YOKOTA 2 GRANITE J85904 Size 6.5,FBALYB Amazon,8,8,0,0,0,0
,Merrell Women YOKOTA 2 GRANITE J85904 Size 7,Merrell Women YOKOTA 2 GRANITE J85904 Size 7,Default Ridgefield,24,24,0,0,0,0
,Merrell Women YOKOTA 2 GRANITE J85904 Size 7,Merrell Women YOKOTA 2 GRANITE J85904 Size 7,FBALYB Amazon,10,10,0,0,0,0
,Merrell Women YOKOTA 2 GRANITE J85904 Size 7.5,Merrell Women YOKOTA 2 GRANITE J85904 Size 7.5,Default Ridgefield,24,24,0,0,0,0
,Merrell Women YOKOTA 2 GRANITE J85904 Size 7.5,Merrell Women YOKOTA 2 GRANITE J85904 Size 7.5,FBALYB Amazon,1,1,0,0,0,0
,Merrell Women YOKOTA 2 GRANITE J85904 Size 8,Merrell Women YOKOTA 2 GRANITE J85904 Size 8,Default Ridgefield,12,12,0,0,0,0
,Merrell Women YOKOTA 2 GRANITE J85904 Size 8,Merrell Women YOKOTA 2 GRANITE J85904 Size 8,FBALYB Amazon,19,17,2,0,2,0
,Merrell Women YOKOTA 2 GRANITE J85904 Size 8.5,Merrell Women YOKOTA 2 GRANITE J85904 Size 8.5,Default Ridgefield,4,4,0,0,0,0
,Merrell Women YOKOTA 2 GRANITE J85904 Size 8.5,Merrell Women YOKOTA 2 GRANITE J85904 Size 8.5,FBALYB Amazon,24,20,4,0,4,0
,Merrell Women YOKOTA 2 GRANITE J85904 Size 9,Merrell Women YOKOTA 2 GRANITE J85904 Size 9,Default Ridgefield,12,12,0,0,0,0
,Merrell Women YOKOTA 2 GRANITE J85904 Size 9,Merrell Women YOKOTA 2 GRANITE J85904 Size 9,FBALYB Amazon,0,-1,1,0,1,0
,Merrell Women YOKOTA 2 GRANITE J85904 Size 9.5,Merrell Women YOKOTA 2 GRANITE J85904 Size 9.5,Default Ridgefield,24,24,0,0,0,0
,Merrell Women YOKOTA 2 GRANITE J85904 Size 9.5,Merrell Women YOKOTA 2 GRANITE J85904 Size 9.5,FBALYB Amazon,1,1,0,0,0,0
,Merrick Fresh Kiss Coconut Medium Dog 10oz,Merrick Fresh Kiss Coconut Medium Dog 18ct,FBALYB Amazon,30,30,0,0,0,0
,Merrick Fresh Kiss Coconut Small Dog 25ct,Merrick Fresh Kiss Coconut Small Dog 25ct,FBALYB Amazon,2,2,0,0,0,0
,Merrick Fresh Kiss Coconut X-Small 78ct,Merrick Fresh Kiss Coconut X-Small 78ct,FBALYB Amazon,1,1,0,0,0,0
,Merrick Fresh Kiss Coconut X-Small Dog 40ct,Merrick Fresh Kiss Coconut X-Small Dog 40ct,FBALYB Amazon,27,27,0,0,0,0
,Merrick Fresh Kisses Coconut X‑Small 10oz,Merrick Fresh Kisses Coconut + Botanical Oils X‑Small ‑ 10oz,FBALYB Amazon,1,1,0,0,0,0
,Merrick Fresh Kisses Mint Strips Extra Small 78 ct,Merrick Fresh Kisses Double-Brush Mint Breath Strips Extra Small Grain-Free Dental Dog Treats 78 ct,FBALYB Amazon,5,5,0,0,0,0
,Merrick Fresh Kisses Mint Strips Extra Small Dog,Merrick Fresh Kisses Double-Brush Mint Breath Strips Extra Small Grain-Free Dental Dog Treats,FBALYB Amazon,1,1,0,0,0,0
,Merrick Fresh Kiss Mint for Medium Dogs 6oz,Merrick Fresh Kiss Mint for Medium Dogs 6oz,FBALYB Amazon,8,8,0,0,0,0
,Merrick Fresh Kiss Mint for Small Dogs 5.5oz,Merrick Fresh Kiss Mint for Small Dogs 5.5oz,Default,0,0,0,0,0,6
,Merrick Fresh Kiss Mint for Small Dogs 5.5oz,Merrick Fresh Kiss Mint for Small Dogs 5.5oz,FBALYB Amazon,39,39,0,0,0,0
,Merrick Fresh Kiss Mint Large Dog 12ct,Merrick Fresh Kiss Mint Large Dog 12ct,Default,0,0,0,0,0,4
,Merrick Fresh Kiss Mint Large Dog 12ct,Merrick Fresh Kiss Mint Large Dog 12ct,FBALYB Amazon,-1,-1,0,0,0,0
,Merrick Fresh Kiss Mint Large Dog 16ct,Merrick Fresh Kiss Mint Large Dog 16ct,FBALYB Amazon,54,54,0,0,0,0
,Merrick Fresh Kiss Mint Large Dog 7ct,Merrick Fresh Kiss Mint Large Dog 7ct,Default,0,0,0,0,0,20
,Merrick Fresh Kiss Mint Large Dog 7ct,Merrick Fresh Kiss Mint Large Dog 7ct,FBALYB Amazon,70,70,0,0,0,0
,Merrick Fresh Kiss Mint Medium Dog 18ct,Merrick Fresh Kiss Mint Medium Dog 18ct,FBALYB Amazon,84,84,0,0,0,0
,Merrick Fresh Kiss Mint Small Dog 36ct,Merrick Fresh Kiss Mint Small Dog 36ct,FBALYB Amazon,-3,-3,0,0,0,0
,Merrick Fresh Kiss Mint X-Small Dog 33ct,Merrick Fresh Kiss Mint X-Small Dog 33ct,FBALYB Amazon,2,2,0,0,0,0
,Merrick Pet Treats Fresh Kisses Coco Large 6.5oz,Merrick Pet Treats Fresh Kisses Coco Large 6.5oz,FBALYB Amazon,213,213,0,0,0,0
,Merrick Purrfect Bistro Beef Pate 3oz,Merrick Purrfect Bistro Beef Pate 3oz,Default Ridgefield,1030,1030,0,0,0,0
,Merrick Purrfect Bistro Grain Free Chicken 3oz,Merrick Purrfect Bistro Grain Free Chicken 3oz,Default Ridgefield,24,24,0,0,0,0
,Merrick Purrfect Bistro Salmon Pate 3oz,Merrick Purrfect Bistro Salmon Pate 3oz,Default Ridgefield,22,22,0,0,0,0
,Merrick Purrfect Bistro Salmon Pate 3oz 24pk,Merrick Purrfect Bistro Salmon Pate 3oz 24pk,FBALYB Amazon,13,13,0,0,0,0
,Merrick Purrfect Bistro Tuna Pate 3oz,Merrick Purrfect Bistro Tuna Pate 3oz,Default Ridgefield,0,-3600,3600,0,0,0
,Merrick Purrfect Bistro Tuna Pate 3oz 24pk,Merrick Purrfect Bistro Tuna Pate 3oz 24pk,FBALYB Amazon,54,54,0,0,0,0
,Merrick Purrfect Bistro Turkey Pate 3oz,Merrick Purrfect Bistro Turkey Pate 3oz,Default Ridgefield,24,24,0,0,0,0
,Merrick Purrfect Bistro Turkey Pate 3oz 24pk,Merrick Purrfect Bistro Turkey Pate 3oz 24pk,FBALYB Amazon,55,55,0,0,0,0
,Metal Toothpaste Squeezer,Metal Toothpaste Squeezer,FBALYB Amazon,1,1,0,0,0,0
,Metal Toothpaste Squeezer 2ct,Metal Toothpaste Squeezer 2ct,FBALYB Amazon,-1,-1,0,0,0,0
,Metamucil Orange 2x130tsp,Metamucil Orange 2x130tsp,Default,0,0,0,0,0,8
,Metamucil Orange Powder 2 pk,Metamucil Orange Powder 2 pk,FBALYB Amazon,2,2,0,0,0,0
,"Method All-Purpose Cleaner with Refill, 96 oz.","Method All-Purpose Surface Cleaner with Refill, 96 oz. Pink Grapefruit",FBALYB Amazon,5,5,0,0,0,0
,Mh 11 Oz smooth bold,"Maxwell House Smooth Bold Ground Coffee, 11.5 Ounce",FBALYB Amazon,7,7,0,0,0,0
,Mh 25.6 breakfast blend light mh,"Maxwell House Ground Coffee, Breakfast Blend, 25.6 Ounce",FBALYB Amazon,-1,-1,0,0,0,0
,Mh 29.3 the original roast medium,"Maxwell House Decaf Ground Coffee Canister, Original Roast, 29.3 Ounce",FBALYB Amazon,-2,-3,1,0,1,0
,Mh 30 .6 master blend light,"Maxwell House Coffee, Master Blend, 30.6-Ounce",FBALYB Amazon,20,20,0,0,0,0
,Mh 30 Oz the original roast mediun,"Maxwell House Coffee, Original, 30.6-Ounce",FBALYB Amazon,1,1,0,0,0,0
,Microbe-Lift PL Bacteria for Ponds,Microbe-Lift PL Beneficial Bacteria for Ponds,FBALYB Amazon,-2,-2,0,49,0,0
,Microsoft Surface Dock,Microsoft Surface Dock,FBALYB Amazon,-13,-13,0,12,0,0
,Midwest Homes 20o0 snapyz bowl 2pack,Midwest Homes 20o0 snapyz bowl 2pack,FBALYB Amazon,1,1,0,0,0,0
,Midwest Snapy Fit Stainless Steel Pet Food Dish 2 qt,Midwest Snapy Fit Stainless Steel Pet Food Dish 2 qt,Default Ridgefield,61,61,0,0,0,0
,Mikasa 20 pc Rockford Flatware,Mikasa 20 pc Rockford Flatware,FBALYB Amazon,-7,-7,0,1,0,0
,Mikasa bravo 6 piece set,Mikasa Bravo 6 Piece Serving Set in Stainless Steel,FBALYB Amazon,2,2,0,0,0,0
,Mikasa Cheers Wine Glasses 6ct,Mikasa Cheers Wine Glasses 6ct,FBALYB Amazon,-9,-9,0,2,0,0
,Mike and Ike 54,"Mike and Ike Chewy Assorted Fruit Flavored Candies, 54 Ounce",FBALYB Amazon,34,34,0,1,0,0
,MILKBONE 37 OZ  CHEWY TREATS,MILKBONE 37 OZ  CHEWY TREATS,FBALYB Amazon,506,506,0,5,0,0
,Milk Bone Brushing Chews Large 2 Pack,Milk Bone Brushing Chews Large 2 Pack,FBALYB Amazon,1,1,0,2,0,0
,Milk Bone Brushing Chew Small 46 ct 2pk,Milk Bone Brushing Chew Small 46 ct 2pk,FBALYB Amazon,0,-1,1,0,1,0
,Milk-Bone Senior Dog Biscuits 2pk,Milk-Bone Senior Dog Biscuits 2pk,FBALYB Amazon,1,1,0,0,0,0
,Milk-Bone Soft & Chewy 37 oz.,"Milk-Bone Soft & Chewy Beef Recipe Dog Snacks, 37 oz.",Default,0,-1344,1344,0,0,0
,Milk-Bone Soft & Chewy 37 oz.,"Milk-Bone Soft & Chewy Beef Recipe Dog Snacks, 37 oz.",FBALYB Amazon,220,220,0,19,0,0
,Milk-Bone Soft & Chewy 37 oz. 2 pk,Milk-Bone Soft & Chewy 37 oz. 2 pk,FBALYB Amazon,-581,-581,0,580,0,0
,"MINI CROOKED RIVER, AXIS, STUD","MINI CROOKED RIVER, AXIS, STUD",Default Ridgefield,20,20,0,0,0,0
,"MINI CROOKED RIVER, AXIS, STUD","MINI CROOKED RIVER, AXIS, STUD",FBALYB Amazon,-16,-16,0,0,0,0
,Mini M.U.L.E. 50 oz Baton Rouge/ Flames,Mini M.U.L.E. 50 oz Baton Rouge/ Flames,Default Ridgefield,838,838,0,0,0,0
,Mini M.U.L.E. 50 oz Baton Rouge/ Flames,Mini M.U.L.E. 50 oz Baton Rouge/ Flames,FBALYB Amazon,-4,-4,0,0,0,0
,Mini M.U.L.E. 50 oz Black/Flames,Mini M.U.L.E. 50 oz Black/Flames,Default Ridgefield,718,718,0,0,0,0
,Mini M.U.L.E. 50 oz Black/Flames,Mini M.U.L.E. 50 oz Black/Flames,FBALYB Amazon,-11,-11,0,2,0,0
,Minisuit Selfie Stick Pro with Built-In,Minisuit Selfie Stick Pro with Built-In Remote for Apple & Android - Black,FBALYB Amazon,1,1,0,0,0,0
,"Minute Whole Grain Brown Rice, 8 ct","Minute Whole Grain Brown Rice, 8 ct",FBALYB Amazon,-5,-5,0,5,0,0
,"Miracle Care R‑7 Ear Powder, Step 1, 12grams","Miracle Care R‑7 Ear Powder, Step 1, 12grams",FBALYB Amazon,4,4,0,0,0,0
,MLP Pinkie Pie and Gummy Snap,My Little Pony Pinkie Pie & Gummy Snap Doll Set Rainbow ,Default Ridgefield,1,1,0,0,0,0
,MLP Twilight and Spike,My Little Pony Equestria Girls Twilight and Spike,Default Ridgefield,5,5,0,0,0,0
,MN-SRWT-SUWR,Ozark Trail Vacuum Insulated Stainless Steel 30 Ounce Tumbler,FBALYB Amazon,-1,-1,0,0,0,0
,Moccamaster KBT 10-Cup Coffee Brewer,"Moccamaster KBT 10-Cup Coffee Brewer with Thermal Carafe, Polished Silver",Default,0,0,0,0,0,6
,Money on Honey Wildflower Honey Caramel - 14 oz,Money on Honey Wildflower Honey Caramel - 14 oz,Default,0,0,0,0,0,12
,Money on Honey Wildflower Honey Caramel - 14 oz,Money on Honey Wildflower Honey Caramel - 14 oz,FBALYB Amazon,1,1,0,0,0,0
,Monopoly Fortnite,Monopoly Fortnite,Default Ridgefield,1703,1703,0,0,0,0
,Monopoly Fortnite,Monopoly Fortnite,FBALYB Amazon,280,231,49,3,49,0
,Monopoly Jr Sofia The First,Hasbro A8850 Monopoly Jr Sofia The First,FBALYB Amazon,12,12,0,0,0,0
,"Monster Fish Medley by Aqueon,3.8 oz","Monster Fish Medley by Aqueon,3.8 oz",FBALYB Amazon,-39,-39,0,40,0,0
,Moritz Icy Square chocolate 1Kg,Moritz Icy Square chocolate 1Kg,Default Ridgefield,16,16,0,0,0,0
,Moritz Icy Square chocolate 1Kg,Moritz Icy Square chocolate 1Kg,FBALYB Amazon,27,27,0,0,0,0
,Moritz Icy Square chocolate 1Kg,Moritz Icy Square chocolate 1Kg,WFS,-14,-14,0,0,0,0
,Moritz Icy Squares 2 Pack,Moritz Icy Squares 2 Pack,FBALYB Amazon,149,149,0,0,0,0
,"Morton Coarse Kosher Salt, 3 lbs.","Morton Coarse Kosher Salt, 3 lbs.",FBALYB Amazon,-40,-40,0,55,0,0
,Mott's Applesauce 36pk,Mott's Applesauce 36pk,FBALYB Amazon,75,75,0,14,0,0
,Mott's Organic Applesauce 36 pack,"Mott's Organic Applesauce ‑ 36 pack, 3.9 fl oz cups",Default,0,0,0,0,0,3
,Mott's Organic Applesauce 36 pack,"Mott's Organic Applesauce ‑ 36 pack, 3.9 fl oz cups",FBALYB Amazon,-4,-4,0,0,0,0
,"Mott's Organic Applesauce Pouches, 24 ct","Mott's Organic Applesauce Pouches, 24 ct./3.2 oz.",FBALYB Amazon,29,29,0,40,0,0
,Mouse in Pouch Electronic Action Toy,Mouse in Pouch Electronic Action Toy,Default,0,0,0,0,0,20
,Mr Clean All-Purpose Cleaner 5.2 L,Mr Clean All-Purpose Cleaner 5.2 L,Default,0,-51,51,0,0,0
,Mr Clean All-Purpose Cleaner 5.2 L,Mr Clean All-Purpose Cleaner 5.2 L,Default Ridgefield,23,23,0,0,0,0
,Mr Clean All-Purpose Cleaner 5.2 L,Mr Clean All-Purpose Cleaner 5.2 L,FBALYB Amazon,-113,-172,59,410,59,0
,Mr Clean All-Purpose Cleaner 5.2 L,Mr Clean All-Purpose Cleaner 5.2 L,FBALYB Canada,3,3,0,1,0,0
,Mr. Clean Magic Eraser,Mr. Clean Magic Eraser 10CT,FBALYB Amazon,-4,-4,0,0,0,0
,Mr Clean Magic Eraser Pads Variety Pack 11ct,Mr Clean Magic Eraser Pads Variety Pack 11ct,FBALYB Amazon,-1,-1,0,0,0,0
,MR CLEAN WITH  FEBREZE 175 OZ,MR CLEAN WITH  FEBREZE 175 OZ,Default Ridgefield,77,77,0,0,0,0
,MR CLEAN WITH  FEBREZE 175 OZ,MR CLEAN WITH  FEBREZE 175 OZ,FBALYB Amazon,17,17,0,1,0,0
,Mr. Freeze Jumbo Ice Pop 150 ml 70 ct,Mr. Freeze Jumbo Ice Pop 150 ml 70 ct,Default Oxford,3,3,0,0,0,0
,Mr. Freeze Jumbo Ice Pop 150 ml 70 ct,Mr. Freeze Jumbo Ice Pop 150 ml 70 ct,FBALYB Amazon,5,5,0,12,0,0
,Mr. Potato Head Marvel,Mr. Potato Head Marvel Spider‑Man vs. Iron Man,Default,0,0,0,0,0,2
,Mrs. Dash Original Seasoning 21oz 2pk,Mrs. Dash Original Seasoning 21oz 2pk,FBALYB Amazon,-2,-2,0,0,0,0
,"Mrs. Dash Original Seasoning Blend, 21 oz","Mrs. Dash Original Seasoning Blend, 21 oz",FBALYB Amazon,-1,-1,0,0,0,0
,MULTI-ACTIVE CORRECTION CREAM GEL 50 ml,MULTI-ACTIVE CORRECTION CREAM GEL 50 ml,Default Ridgefield,60,60,0,0,0,0
,MULTI-ACTIVE CORRECTION CREAM GEL 50 ml,MULTI-ACTIVE CORRECTION CREAM GEL 50 ml,FBALYB Amazon,22,22,0,0,0,0
,"Multipet Plush Dog Toy, Lambchop","Multipet Plush Dog Toy, Lambchop ",FBALYB Amazon,-3,-3,0,0,0,0
,"Multipet Plush Dog Toy, Lambchop 3pk","Multipet Plush Dog Toy, Lambchop 3pk",Default,0,-1,1,0,0,0
,"Multipet Plush Dog Toy, Lambchop 3pk","Multipet Plush Dog Toy, Lambchop 3pk",FBALYB Amazon,8,8,0,0,0,0
,Muse Masterpiece 3oz 12pk Bundle,Muse Masterpiece 3oz 12pk Bundle,FBALYB Amazon,2,0,2,0,2,0
,Musher's Paw Protection Wax 1lb,Musher's Paw Protection Wax 1lb,FBALYB Amazon,3,3,0,0,0,0
,My anywhere,Logitech Wireless Anywhere Mouse MX for PC and Mac,FBALYB Amazon,-1,-1,0,0,0,0
,My Little Pony Fluttershy,My Little Pony Friendship Is Magic Fluttershy Figure,FBALYB Amazon,-1,-1,0,1,0,0
,My Little Pony Princess Assorted-E5892,My Little Pony Princess Assorted-E5892,Default,2,-222,224,0,0,0
,My Little Pony Princess Assorted-E5892,My Little Pony Princess Assorted-E5892,Default Ridgefield,32,32,0,0,0,0
,MY LITTLE PONY PRINCESS CELESTIA,MY LITTLE PONY PRINCESS CELESTIA,Default,0,-32,32,0,0,0
,MY LITTLE PONY PRINCESS CELESTIA,MY LITTLE PONY PRINCESS CELESTIA,Default Ridgefield,249,247,2,0,0,0
,MY LITTLE PONY PRINCESS CELESTIA,MY LITTLE PONY PRINCESS CELESTIA,FBALYB Amazon,-23,-23,0,19,0,0
,MY LITTLE PONY PRINCESS LUNA,MY LITTLE PONY PRINCESS LUNA,Default Ridgefield,2,2,0,0,0,0
,MY LITTLE PONY PRINCESS LUNA,MY LITTLE PONY PRINCESS LUNA,FBALYB Amazon,11,2,9,2,9,0
,Nabisco Fig Newtons 24Ct Packs,Nabisco Fig Newtons 24‑2 Ct Packs,FBALYB Amazon,50,50,0,0,0,0
,Nabisco Lorna Doones 30ct,Nabisco Lorna Doones 30ct,Default,0,-1,1,0,0,278
,Nabisco Lorna Doones 30ct,Nabisco Lorna Doones 30ct,FBALYB Amazon,653,652,1,95,1,0
,Nabisco Lorna Doones 30ct 4pk,Nabisco Lorna Doones 30ct 4pk,FBALYB Amazon,110,110,0,0,0,0
,#NAME?,"Arlo Security System - 1 Wire-Free HD Camera, Indoor/Outdoor, Night Vision (V...",Default,0,0,0,0,0,1
,Native - Jefferson Adult Jiffy Black/Shell White Shoe 11100100-1105 US Size M3 W5,Native - Jefferson Adult Jiffy Black/Shell White Shoe 11100100-1105 US Size M3 W5,Default Ridgefield,26,26,0,0,0,0
,native - jefferson adult jiffy black/shell white shoe 11100100-1105 us size m4 w6,native - jefferson adult jiffy black/shell white shoe 11100100-1105 us size m4 w6,Default Ridgefield,98,98,0,0,0,0
,Native - Jefferson Adult Jiffy Black/Shell White Shoe 11100100-1105 US Size M5 W7,Native - Jefferson Adult Jiffy Black/Shell White Shoe 11100100-1105 US Size M5 W7,Default Ridgefield,164,164,0,0,0,0
,Native - Jefferson Adult Jiffy Black/Shell White Shoe 11100100-1105 US Size M6 W8,Native - Jefferson Adult Jiffy Black/Shell White Shoe 11100100-1105 US Size M6 W8,Default Ridgefield,177,177,0,0,0,0
,Native - Jefferson Adult Jiffy Black/Shell White Shoe 11100100-1105 US Size M6 W8,Native - Jefferson Adult Jiffy Black/Shell White Shoe 11100100-1105 US Size M6 W8,FBALYB Amazon,50,50,0,0,0,0
,Native - Jefferson Adult Jiffy Black/Shell White Shoe 11100100-1105 US Size M7 W9,Native - Jefferson Adult Jiffy Black/Shell White Shoe 11100100-1105 US Size M7 W9,Default Ridgefield,104,104,0,0,0,0
,Native - Jefferson Adult Jiffy Black/Shell White Shoe 11100100-1105 US Size M7 W9,Native - Jefferson Adult Jiffy Black/Shell White Shoe 11100100-1105 US Size M7 W9,FBALYB Amazon,36,36,0,1,0,0
,Native - Jefferson Adult Jiffy Black/Shell White Shoe 11100100-1105 US Size M8 W10,Native - Jefferson Adult Jiffy Black/Shell White Shoe 11100100-1105 US Size M8 W10,Default Ridgefield,34,34,0,0,0,0
,Native - Jefferson Adult Jiffy Black/Shell White Shoe 11100100-1105 US Size M8 W10,Native - Jefferson Adult Jiffy Black/Shell White Shoe 11100100-1105 US Size M8 W10,FBALYB Amazon,42,42,0,1,0,0
,Native - Jefferson Adult Jiffy Black/Shell White Shoe 11100100-1105 US Size M9 W11,Native - Jefferson Adult Jiffy Black/Shell White Shoe 11100100-1105 US Size M9 W11,Default Ridgefield,58,58,0,0,0,0
,Native - Jefferson Adult Jiffy Black/Shell White Shoe 11100100-1105 US Size M9 W11,Native - Jefferson Adult Jiffy Black/Shell White Shoe 11100100-1105 US Size M9 W11,FBALYB Amazon,46,45,1,3,1,0
,Native - Jefferson Adult Pigeon Grey/Shell White Shoe 11100100-1501 US Size M10 W12,Native - Jefferson Adult Pigeon Grey/Shell White Shoe 11100100-1501 US Size M10 W12,Default Ridgefield,13,13,0,0,0,0
,Native - Jefferson Adult Pigeon Grey/Shell White Shoe 11100100-1501 US Size M11 W13,Native - Jefferson Adult Pigeon Grey/Shell White Shoe 11100100-1501 US Size M11 W13,FBALYB Amazon,-2,-2,0,1,0,0
,Native - Jefferson Adult Pigeon Grey/Shell White Shoe 11100100-1501 US Size M3 W5,Native - Jefferson Adult Pigeon Grey/Shell White Shoe 11100100-1501 US Size M3 W5,Default Ridgefield,26,26,0,0,0,0
,Native - Jefferson Adult Pigeon Grey/Shell White Shoe 11100100-1501 US Size M4 W6,Native - Jefferson Adult Pigeon Grey/Shell White Shoe 11100100-1501 US Size M4 W6,FBALYB Amazon,65,64,1,0,1,0
,Native - Jefferson Adult Pigeon Grey/Shell White Shoe 11100100-1501 US Size M5 W7,Native - Jefferson Adult Pigeon Grey/Shell White Shoe 11100100-1501 US Size M5 W7,Default Ridgefield,97,97,0,0,0,0
,Native - Jefferson Adult Pigeon Grey/Shell White Shoe 11100100-1501 US Size M5 W7,Native - Jefferson Adult Pigeon Grey/Shell White Shoe 11100100-1501 US Size M5 W7,FBALYB Amazon,50,50,0,0,0,0
,Native - Jefferson Adult Pigeon Grey/Shell White Shoe 11100100-1501 US Size M6 W8,Native - Jefferson Adult Pigeon Grey/Shell White Shoe 11100100-1501 US Size M6 W8,Default Ridgefield,149,149,0,0,0,0
,Native - Jefferson Adult Pigeon Grey/Shell White Shoe 11100100-1501 US Size M6 W8,Native - Jefferson Adult Pigeon Grey/Shell White Shoe 11100100-1501 US Size M6 W8,FBALYB Amazon,41,40,1,0,1,0
,Native - Jefferson Adult Pigeon Grey/Shell White Shoe 11100100-1501 US Size M7 W9,Native - Jefferson Adult Pigeon Grey/Shell White Shoe 11100100-1501 US Size M7 W9,Default Ridgefield,91,91,0,0,0,0
,Native - Jefferson Adult Pigeon Grey/Shell White Shoe 11100100-1501 US Size M7 W9,Native - Jefferson Adult Pigeon Grey/Shell White Shoe 11100100-1501 US Size M7 W9,FBALYB Amazon,50,50,0,0,0,0
,Native - Jefferson Adult Pigeon Grey/Shell White Shoe 11100100-1501 US Size M8 W10,Native - Jefferson Adult Pigeon Grey/Shell White Shoe 11100100-1501 US Size M8 W10,Default Ridgefield,109,109,0,0,0,0
,Native - Jefferson Adult Pigeon Grey/Shell White Shoe 11100100-1501 US Size M9 W11,Native - Jefferson Adult Pigeon Grey/Shell White Shoe 11100100-1501 US Size M9 W11,Default Ridgefield,108,108,0,0,0,0
,Native - Jefferson Adult Pigeon Grey/Shell White Shoe 11100100-1501 US Size M9 W11,Native - Jefferson Adult Pigeon Grey/Shell White Shoe 11100100-1501 US Size M9 W11,FBALYB Amazon,1,1,0,0,0,0
,Native - Jefferson Adult Regatta Blue/Shell White Shoe 11100100-4201 US Size M11 W13,Native - Jefferson Adult Regatta Blue/Shell White Shoe 11100100-4201 US Size M11 W13,FBALYB Amazon,-1,-1,0,0,0,0
,Native - Jefferson Adult Regatta Blue/Shell White Shoe 11100100-4201 US Size M3 W5,Native - Jefferson Adult Regatta Blue/Shell White Shoe 11100100-4201 US Size M3 W5,FBALYB Amazon,23,23,0,0,0,0
,Native - Jefferson Adult Regatta Blue/Shell White Shoe 11100100-4201 US Size M4 W6,Native - Jefferson Adult Regatta Blue/Shell White Shoe 11100100-4201 US Size M4 W6,FBALYB Amazon,31,31,0,0,0,0
,Native - Jefferson Adult Regatta Blue/Shell White Shoe 11100100-4201 US Size M5 W7,Native - Jefferson Adult Regatta Blue/Shell White Shoe 11100100-4201 US Size M5 W7,Default Ridgefield,97,97,0,0,0,0
,Native - Jefferson Adult Regatta Blue/Shell White Shoe 11100100-4201 US Size M6 W8,Native - Jefferson Adult Regatta Blue/Shell White Shoe 11100100-4201 US Size M6 W8,Default Ridgefield,118,118,0,0,0,0
,Native - Jefferson Adult Regatta Blue/Shell White Shoe 11100100-4201 US Size M7 W9,Native - Jefferson Adult Regatta Blue/Shell White Shoe 11100100-4201 US Size M7 W9,FBALYB Amazon,64,64,0,0,0,0
,Native - Jefferson Adult Regatta Blue/Shell White Shoe 11100100-4201 US Size M8 W10,Native - Jefferson Adult Regatta Blue/Shell White Shoe 11100100-4201 US Size M8 W10,FBALYB Amazon,29,29,0,0,0,0
,Native - Jefferson Adult Regatta Blue/Shell White Shoe 11100100-4201 US Size M9 W11,Native - Jefferson Adult Regatta Blue/Shell White Shoe 11100100-4201 US Size M9 W11,Default Ridgefield,58,58,0,0,0,0
,Native - Jefferson Adult Regatta Blue/Shell White Shoe 11100100-4201 US Size M9 W11,Native - Jefferson Adult Regatta Blue/Shell White Shoe 11100100-4201 US Size M9 W11,FBALYB Amazon,1,0,1,0,1,0
,Native - Jefferson Adult Shell White/Shell White Shoe 11100100-1999 US Size M11 W13,Native - Jefferson Adult Shell White/Shell White Shoe 11100100-1999 US Size M11 W13,Default Ridgefield,1,1,0,0,0,0
,Native - Jefferson Adult Shell White/Shell White Shoe 11100100-1999 US Size M3 W5,Native - Jefferson Adult Shell White/Shell White Shoe 11100100-1999 US Size M3 W5,Default Ridgefield,26,26,0,0,0,0
,Native - Jefferson Adult Shell White/Shell White Shoe 11100100-1999 US Size M4 W6,Native - Jefferson Adult Shell White/Shell White Shoe 11100100-1999 US Size M4 W6,FBALYB Amazon,68,66,2,0,2,0
,Native - Jefferson Adult Shell White/Shell White Shoe 11100100-1999 US Size M5 W7,Native - Jefferson Adult Shell White/Shell White Shoe 11100100-1999 US Size M5 W7,Default Ridgefield,100,100,0,0,0,0
,Native - Jefferson Adult Shell White/Shell White Shoe 11100100-1999 US Size M5 W7,Native - Jefferson Adult Shell White/Shell White Shoe 11100100-1999 US Size M5 W7,FBALYB Amazon,49,49,0,0,0,0
,Native - Jefferson Adult Shell White/Shell White Shoe 11100100-1999 US Size M6 W8,Native - Jefferson Adult Shell White/Shell White Shoe 11100100-1999 US Size M6 W8,Default Ridgefield,140,140,0,0,0,0
,Native - Jefferson Adult Shell White/Shell White Shoe 11100100-1999 US Size M6 W8,Native - Jefferson Adult Shell White/Shell White Shoe 11100100-1999 US Size M6 W8,FBALYB Amazon,48,48,0,0,0,0
,Native - Jefferson Adult Shell White/Shell White Shoe 11100100-1999 US Size M7 W9,Native - Jefferson Adult Shell White/Shell White Shoe 11100100-1999 US Size M7 W9,Default Ridgefield,90,90,0,0,0,0
,Native - Jefferson Adult Shell White/Shell White Shoe 11100100-1999 US Size M7 W9,Native - Jefferson Adult Shell White/Shell White Shoe 11100100-1999 US Size M7 W9,FBALYB Amazon,46,46,0,0,0,0
,Native - Jefferson Adult Shell White/Shell White Shoe 11100100-1999 US Size M8 W10,Native - Jefferson Adult Shell White/Shell White Shoe 11100100-1999 US Size M8 W10,Default Ridgefield,34,34,0,0,0,0
,Native - Jefferson Adult Shell White/Shell White Shoe 11100100-1999 US Size M8 W10,Native - Jefferson Adult Shell White/Shell White Shoe 11100100-1999 US Size M8 W10,FBALYB Amazon,45,44,1,0,1,0
,Native - Jefferson Adult Shell White/Shell White Shoe 11100100-1999 US Size M9 W11,Native - Jefferson Adult Shell White/Shell White Shoe 11100100-1999 US Size M9 W11,Default Ridgefield,85,85,0,0,0,0
,Native - Jefferson Adult Shell White/Shell White Shoe 11100100-1999 US Size M9 W11,Native - Jefferson Adult Shell White/Shell White Shoe 11100100-1999 US Size M9 W11,FBALYB Amazon,-1,-2,1,0,1,0
,Native Jefferson Bling Child Milk Pink Bling/Shell White US Size: C4,Native Jefferson Bling Child Milk Pink Bling/Shell White US Size: C4,FBALYB Amazon,-32,-32,0,0,0,0
,Native Jefferson Bling Child Milk Pink Bling/Shell White US Size: C5,Native Jefferson Bling Child Milk Pink Bling/Shell White US Size: C5,FBALYB Amazon,-32,-32,0,0,0,0
,Native Jefferson Bling Child Shoe Eva Metal Bling/Shell White US Size: C10 - Child,Native Jefferson Bling Child Shoe Eva Metal Bling/Shell White US Size: C10 - Child,Default Ridgefield,5,5,0,0,0,0
,Native Jefferson Bling Child Shoe Eva Metal Bling/Shell White US Size: C10 - Child,Native Jefferson Bling Child Shoe Eva Metal Bling/Shell White US Size: C10 - Child,FBALYB Amazon,-7,-7,0,0,0,0
,Native Jefferson Bling Child Shoe Eva Metal Bling/Shell White US Size: C4 - Child,Native Jefferson Bling Child Shoe Eva Metal Bling/Shell White US Size: C4 - Child,FBALYB Amazon,-19,-19,0,0,0,0
,Native Jefferson Bling Child Shoe Eva Metal Bling/Shell White US Size: C5 - Child,Native Jefferson Bling Child Shoe Eva Metal Bling/Shell White US Size: C5 - Child,Default Ridgefield,1,1,0,0,0,0
,Native Jefferson Bling Child Shoe Eva Metal Bling/Shell White US Size: C5 - Child,Native Jefferson Bling Child Shoe Eva Metal Bling/Shell White US Size: C5 - Child,FBALYB Amazon,-16,-16,0,0,0,0
,Native Jefferson Bling Child Shoe Eva Metal Bling/Shell White US Size: C6 - Child,Native Jefferson Bling Child Shoe Eva Metal Bling/Shell White US Size: C6 - Child,FBALYB Amazon,-25,-25,0,0,0,0
,Native Jefferson Bling Child Shoe Eva Metal Bling/Shell White US Size: C7 - Child,Native Jefferson Bling Child Shoe Eva Metal Bling/Shell White US Size: C7 - Child,FBALYB Amazon,-11,-11,0,0,0,0
,Native Jefferson Bling Child Shoe Eva Metal Bling/Shell White US Size: C8 - Child,Native Jefferson Bling Child Shoe Eva Metal Bling/Shell White US Size: C8 - Child,FBALYB Amazon,-11,-11,0,0,0,0
,Native Jefferson Bling Child Shoe Eva Metal Bling/Shell White US Size: C9 - Child,Native Jefferson Bling Child Shoe Eva Metal Bling/Shell White US Size: C9 - Child,FBALYB Amazon,-11,-11,0,0,0,0
,Native Jefferson Bling Child Shoe Eva Milk Pink Bling/Shell White US Size: C10 - Child,Native Jefferson Bling Child Shoe Eva Milk Pink Bling/Shell White US Size: C10 - Child,Default Ridgefield,372,372,0,0,0,0
,Native Jefferson Bling Child Shoe Eva Milk Pink Bling/Shell White US Size: C10 - Child,Native Jefferson Bling Child Shoe Eva Milk Pink Bling/Shell White US Size: C10 - Child,FBALYB Amazon,-40,-40,0,1,0,0
,Native Jefferson Bling Child Shoe Eva Milk Pink Bling/Shell White US Size: C11 - Child,Native Jefferson Bling Child Shoe Eva Milk Pink Bling/Shell White US Size: C11 - Child,FBALYB Amazon,-1,-1,0,0,0,0
,Native Jefferson Bling Child Shoe Eva Milk Pink Bling/Shell White US Size: C12 - Child,Native Jefferson Bling Child Shoe Eva Milk Pink Bling/Shell White US Size: C12 - Child,FBALYB Amazon,0,-2,2,0,2,0
,Native Jefferson Bling Child Shoe Eva Milk Pink Bling/Shell White US Size: C13 - Child,Native Jefferson Bling Child Shoe Eva Milk Pink Bling/Shell White US Size: C13 - Child,FBALYB Amazon,-2,-3,1,0,1,0
,Native Jefferson Bling Child Shoe Eva Milk Pink Bling/Shell White US Size: C6 - Child,Native Jefferson Bling Child Shoe Eva Milk Pink Bling/Shell White US Size: C6 - Child,Default Ridgefield,55,55,0,0,0,0
,Native Jefferson Bling Child Shoe Eva Milk Pink Bling/Shell White US Size: C6 - Child,Native Jefferson Bling Child Shoe Eva Milk Pink Bling/Shell White US Size: C6 - Child,FBALYB Amazon,-30,-30,0,0,0,0
,Native Jefferson Bling Child Shoe Eva Milk Pink Bling/Shell White US Size: C7 - Child,Native Jefferson Bling Child Shoe Eva Milk Pink Bling/Shell White US Size: C7 - Child,Default Ridgefield,135,135,0,0,0,0
,Native Jefferson Bling Child Shoe Eva Milk Pink Bling/Shell White US Size: C7 - Child,Native Jefferson Bling Child Shoe Eva Milk Pink Bling/Shell White US Size: C7 - Child,FBALYB Amazon,26,26,0,0,0,0
,Native Jefferson Bling Child Shoe Eva Milk Pink Bling/Shell White US Size: C8 - Child,Native Jefferson Bling Child Shoe Eva Milk Pink Bling/Shell White US Size: C8 - Child,Default Ridgefield,233,233,0,0,0,0
,Native Jefferson Bling Child Shoe Eva Milk Pink Bling/Shell White US Size: C8 - Child,Native Jefferson Bling Child Shoe Eva Milk Pink Bling/Shell White US Size: C8 - Child,FBALYB Amazon,63,62,1,0,1,0
,Native Jefferson Bling Child Shoe Eva Milk Pink Bling/Shell White US Size: C9 - Child,Native Jefferson Bling Child Shoe Eva Milk Pink Bling/Shell White US Size: C9 - Child,Default Ridgefield,428,428,0,0,0,0
,Native Jefferson Bling Child Shoe Eva Milk Pink Bling/Shell White US Size: C9 - Child,Native Jefferson Bling Child Shoe Eva Milk Pink Bling/Shell White US Size: C9 - Child,FBALYB Amazon,49,48,1,0,1,0
,Native Jefferson Bling Junior Metal Bling/Shell White US Size: J1,Native Jefferson Bling Junior Metal Bling/Shell White US Size: J1,FBALYB Amazon,-12,-12,0,0,0,0
,Native Jefferson Bling Junior Metal Bling/Shell White US Size: J2,Native Jefferson Bling Junior Metal Bling/Shell White US Size: J2,FBALYB Amazon,-17,-17,0,1,0,0
,Native Jefferson Bling Junior Metal Bling/Shell White US Size: J3,Native Jefferson Bling Junior Metal Bling/Shell White US Size: J3,FBALYB Amazon,-14,-14,0,0,0,0
,Native Jefferson Bling Junior Metal Bling/Shell White US Size: J4,Native Jefferson Bling Junior Metal Bling/Shell White US Size: J4,FBALYB Amazon,-9,-9,0,0,0,0
,Native Jefferson Bling Junior Metal Bling/Shell White US Size: J5,Native Jefferson Bling Junior Metal Bling/Shell White US Size: J5,FBALYB Amazon,-21,-21,0,0,0,0
,Native Jefferson Bling Junior Metal Bling/Shell White US Size: J6,Native Jefferson Bling Junior Metal Bling/Shell White US Size: J6,FBALYB Amazon,-8,-10,2,0,2,0
,Native Jefferson Bling Junior Milk Pink Bling/Shell White US Size: J1,Native Jefferson Bling Junior Milk Pink Bling/Shell White US Size: J1,FBALYB Amazon,-10,-10,0,0,0,0
,Native Jefferson Bling Junior Milk Pink Bling/Shell White US Size: J2,Native Jefferson Bling Junior Milk Pink Bling/Shell White US Size: J2,FBALYB Amazon,-12,-12,0,0,0,0
,Native Jefferson Bling Junior Milk Pink Bling/Shell White US Size: J3,Native Jefferson Bling Junior Milk Pink Bling/Shell White US Size: J3,FBALYB Amazon,-14,-14,0,0,0,0
,Native Jefferson Bling Junior Milk Pink Bling/Shell White US Size: J4,Native Jefferson Bling Junior Milk Pink Bling/Shell White US Size: J4,FBALYB Amazon,-15,-15,0,0,0,0
,Native Jefferson Bling Junior Milk Pink Bling/Shell White US Size: J5,Native Jefferson Bling Junior Milk Pink Bling/Shell White US Size: J5,FBALYB Amazon,-11,-11,0,1,0,0
,Native Jefferson Bling Junior Milk Pink Bling/Shell White US Size: J6,Native Jefferson Bling Junior Milk Pink Bling/Shell White US Size: J6,FBALYB Amazon,-9,-9,0,0,0,0
,Native Jefferson Bling Youth Metal Bling/Shell White US Size: C11,Native Jefferson Bling Youth Metal Bling/Shell White US Size: C11,FBALYB Amazon,-12,-12,0,0,0,0
,Native Jefferson Bling Youth Metal Bling/Shell White US Size: C12,Native Jefferson Bling Youth Metal Bling/Shell White US Size: C12,FBALYB Amazon,-23,-23,0,0,0,0
,Native Jefferson Bling Youth Metal Bling/Shell White US Size: C13,Native Jefferson Bling Youth Metal Bling/Shell White US Size: C13,Default Ridgefield,1,1,0,0,0,0
,Native Jefferson Bling Youth Metal Bling/Shell White US Size: C13,Native Jefferson Bling Youth Metal Bling/Shell White US Size: C13,FBALYB Amazon,-18,-18,0,0,0,0
,Native Jefferson Bling Youth Milk Pink Bling/Shell White US Size: C11,Native Jefferson Bling Youth Milk Pink Bling/Shell White US Size: C11,FBALYB Amazon,-10,-10,0,0,0,0
,Native Jefferson Bling Youth Milk Pink Bling/Shell White US Size: C12,Native Jefferson Bling Youth Milk Pink Bling/Shell White US Size: C12,FBALYB Amazon,-8,-8,0,0,0,0
,Native Jefferson Bling Youth Milk Pink Bling/Shell White US Size: C13,Native Jefferson Bling Youth Milk Pink Bling/Shell White US Size: C13,FBALYB Amazon,-17,-17,0,0,0,0
,Native Jefferson Child Shell White/Shell White US Size: C10,Native Jefferson Child Shell White/Shell White US Size: C10,FBALYB Amazon,-18,-18,0,1,0,0
,Native Jefferson Child Shell White/Shell White US Size: C4,Native Jefferson Child Shell White/Shell White US Size: C4,FBALYB Amazon,-32,-33,1,0,1,0
,Native Jefferson Child Shell White/Shell White US Size: C5,Native Jefferson Child Shell White/Shell White US Size: C5,Default Ridgefield,1,1,0,0,0,0
,Native Jefferson Child Shell White/Shell White US Size: C5,Native Jefferson Child Shell White/Shell White US Size: C5,FBALYB Amazon,-26,-27,1,0,1,0
,Native Jefferson Child Shell White/Shell White US Size: C6,Native Jefferson Child Shell White/Shell White US Size: C6,FBALYB Amazon,-22,-22,0,1,0,0
,Native Jefferson Child Shell White/Shell White US Size: C9,Native Jefferson Child Shell White/Shell White US Size: C9,Default Ridgefield,0,-11,11,0,0,0
,Native Jefferson Child Shell White/Shell White US Size: C9,Native Jefferson Child Shell White/Shell White US Size: C9,FBALYB Amazon,-24,-24,0,0,0,0
,Native Jefferson Child Shoe Eva Crayon Yellow/Shell White US Size: C10 - Child,Native Jefferson Child Shoe Eva Crayon Yellow/Shell White US Size: C10 - Child,Default Ridgefield,1,1,0,0,0,0
,Native Jefferson Child Shoe Eva Crayon Yellow/Shell White US Size: C10 - Child,Native Jefferson Child Shoe Eva Crayon Yellow/Shell White US Size: C10 - Child,FBALYB Amazon,25,22,3,0,3,0
,Native Jefferson Child Shoe Eva Crayon Yellow/Shell White US Size: C4 - Child,Native Jefferson Child Shoe Eva Crayon Yellow/Shell White US Size: C4 - Child,Default Ridgefield,48,48,0,0,0,0
,Native Jefferson Child Shoe Eva Crayon Yellow/Shell White US Size: C4 - Child,Native Jefferson Child Shoe Eva Crayon Yellow/Shell White US Size: C4 - Child,FBALYB Amazon,-9,-10,1,0,1,0
,Native Jefferson Child Shoe Eva Crayon Yellow/Shell White US Size: C5 - Child,Native Jefferson Child Shoe Eva Crayon Yellow/Shell White US Size: C5 - Child,Default Ridgefield,48,48,0,0,0,0
,Native Jefferson Child Shoe Eva Crayon Yellow/Shell White US Size: C5 - Child,Native Jefferson Child Shoe Eva Crayon Yellow/Shell White US Size: C5 - Child,FBALYB Amazon,-24,-25,1,0,1,0
,Native Jefferson Child Shoe Eva Crayon Yellow/Shell White US Size: C6 - Child,Native Jefferson Child Shoe Eva Crayon Yellow/Shell White US Size: C6 - Child,FBALYB Amazon,45,45,0,0,0,0
,Native Jefferson Child Shoe Eva Crayon Yellow/Shell White US Size: C7 - Child,Native Jefferson Child Shoe Eva Crayon Yellow/Shell White US Size: C7 - Child,Default Ridgefield,119,119,0,0,0,0
,Native Jefferson Child Shoe Eva Crayon Yellow/Shell White US Size: C7 - Child,Native Jefferson Child Shoe Eva Crayon Yellow/Shell White US Size: C7 - Child,FBALYB Amazon,-7,-7,0,0,0,0
,Native Jefferson Child Shoe Eva Crayon Yellow/Shell White US Size: C8 - Child,Native Jefferson Child Shoe Eva Crayon Yellow/Shell White US Size: C8 - Child,Default Ridgefield,93,93,0,0,0,0
,Native Jefferson Child Shoe Eva Crayon Yellow/Shell White US Size: C8 - Child,Native Jefferson Child Shoe Eva Crayon Yellow/Shell White US Size: C8 - Child,FBALYB Amazon,23,19,4,0,4,0
,Native Jefferson Child Shoe Eva Crayon Yellow/Shell White US Size: C9 - Child,Native Jefferson Child Shoe Eva Crayon Yellow/Shell White US Size: C9 - Child,FBALYB Amazon,22,22,0,0,0,0
,Native Jefferson Child Shoe Eva Grasshopper Green/Shell White US Size: C10 - Child,Native Jefferson Child Shoe Eva Grasshopper Green/Shell White US Size: C10 - Child,Default Ridgefield,1,1,0,0,0,0
,Native Jefferson Child Shoe Eva Grasshopper Green/Shell White US Size: C10 - Child,Native Jefferson Child Shoe Eva Grasshopper Green/Shell White US Size: C10 - Child,FBALYB Amazon,35,35,0,0,0,0
,Native Jefferson Child Shoe Eva Grasshopper Green/Shell White US Size: C4 - Child,Native Jefferson Child Shoe Eva Grasshopper Green/Shell White US Size: C4 - Child,FBALYB Amazon,62,62,0,0,0,0
,Native Jefferson Child Shoe Eva Grasshopper Green/Shell White US Size: C5 - Child,Native Jefferson Child Shoe Eva Grasshopper Green/Shell White US Size: C5 - Child,FBALYB Amazon,9,8,1,0,1,0
,Native Jefferson Child Shoe Eva Grasshopper Green/Shell White US Size: C6 - Child,Native Jefferson Child Shoe Eva Grasshopper Green/Shell White US Size: C6 - Child,FBALYB Amazon,43,42,1,0,1,0
,Native Jefferson Child Shoe Eva Grasshopper Green/Shell White US Size: C7 - Child,Native Jefferson Child Shoe Eva Grasshopper Green/Shell White US Size: C7 - Child,FBALYB Amazon,2,2,0,0,0,0
,Native Jefferson Child Shoe Eva Grasshopper Green/Shell White US Size: C8 - Child,Native Jefferson Child Shoe Eva Grasshopper Green/Shell White US Size: C8 - Child,FBALYB Amazon,-2,-2,0,0,0,0
,Native Jefferson Child Shoe Eva Grasshopper Green/Shell White US Size: C9 - Child,Native Jefferson Child Shoe Eva Grasshopper Green/Shell White US Size: C9 - Child,FBALYB Amazon,21,21,0,0,0,0
,Native Jefferson Child Shoe Eva Hollywood Pink/Shell White US Size:C10 - Child,Native Jefferson Child Shoe Eva Hollywood Pink/Shell White US Size:C10 - Child,Default Ridgefield,144,144,0,0,0,0
,Native Jefferson Child Shoe Eva Hollywood Pink/Shell White US Size:C10 - Child,Native Jefferson Child Shoe Eva Hollywood Pink/Shell White US Size:C10 - Child,FBALYB Amazon,-27,-27,0,0,0,0
,Native Jefferson Child Shoe Eva Hollywood Pink/Shell White US Size: C4 - Child,Native Jefferson Child Shoe Eva Hollywood Pink/Shell White US Size: C4 - Child,Default Ridgefield,46,46,0,0,0,0
,Native Jefferson Child Shoe Eva Hollywood Pink/Shell White US Size: C4 - Child,Native Jefferson Child Shoe Eva Hollywood Pink/Shell White US Size: C4 - Child,FBALYB Amazon,-15,-15,0,11,0,0
,Native Jefferson Child Shoe Eva Hollywood Pink/Shell White US Size: C5 - Child,Native Jefferson Child Shoe Eva Hollywood Pink/Shell White US Size: C5 - Child,Default Ridgefield,118,118,0,0,0,0
,Native Jefferson Child Shoe Eva Hollywood Pink/Shell White US Size: C5 - Child,Native Jefferson Child Shoe Eva Hollywood Pink/Shell White US Size: C5 - Child,FBALYB Amazon,18,17,1,0,1,0
,Native Jefferson Child Shoe Eva Hollywood Pink/Shell White US Size: C6 - Child,Native Jefferson Child Shoe Eva Hollywood Pink/Shell White US Size: C6 - Child,Default Ridgefield,215,215,0,0,0,0
,Native Jefferson Child Shoe Eva Hollywood Pink/Shell White US Size: C6 - Child,Native Jefferson Child Shoe Eva Hollywood Pink/Shell White US Size: C6 - Child,FBALYB Amazon,-43,-43,0,0,0,0
,Native Jefferson Child Shoe Eva Hollywood Pink/Shell White US Size: C7 - Child,Native Jefferson Child Shoe Eva Hollywood Pink/Shell White US Size: C7 - Child,Default Ridgefield,357,357,0,0,0,0
,Native Jefferson Child Shoe Eva Hollywood Pink/Shell White US Size: C7 - Child,Native Jefferson Child Shoe Eva Hollywood Pink/Shell White US Size: C7 - Child,FBALYB Amazon,-38,-38,0,0,0,0
,Native Jefferson Child Shoe Eva Hollywood Pink/Shell White US Size: C8 - Child,Native Jefferson Child Shoe Eva Hollywood Pink/Shell White US Size: C8 - Child,Default Ridgefield,360,360,0,0,0,0
,Native Jefferson Child Shoe Eva Hollywood Pink/Shell White US Size: C8 - Child,Native Jefferson Child Shoe Eva Hollywood Pink/Shell White US Size: C8 - Child,FBALYB Amazon,-7,-8,1,0,1,0
,Native Jefferson Child Shoe Eva Hollywood Pink/Shell White US Size: C9 - Child,Native Jefferson Child Shoe Eva Hollywood Pink/Shell White US Size: C9 - Child,Default Ridgefield,119,119,0,0,0,0
,Native Jefferson Child Shoe Eva Hollywood Pink/Shell White US Size: C9 - Child,Native Jefferson Child Shoe Eva Hollywood Pink/Shell White US Size: C9 - Child,FBALYB Amazon,42,42,0,0,0,0
,Native Jefferson Child Shoe Eva Jiffy Black/Shell White US Size: C10 - Child,Native Jefferson Child Shoe Eva Jiffy Black/Shell White US Size: C10 - Child,Default Ridgefield,46,46,0,0,0,0
,Native Jefferson Child Shoe Eva Jiffy Black/Shell White US Size: C10 - Child,Native Jefferson Child Shoe Eva Jiffy Black/Shell White US Size: C10 - Child,FBALYB Amazon,31,31,0,1,0,0
,Native Jefferson Child Shoe Eva Jiffy Black/Shell White US Size: C4 - Child,Native Jefferson Child Shoe Eva Jiffy Black/Shell White US Size: C4 - Child,Default Ridgefield,22,22,0,0,0,0
,Native Jefferson Child Shoe Eva Jiffy Black/Shell White US Size: C4 - Child,Native Jefferson Child Shoe Eva Jiffy Black/Shell White US Size: C4 - Child,FBALYB Amazon,-5,-6,1,0,1,0
,Native Jefferson Child Shoe Eva Jiffy Black/Shell White US Size: C5 - Child,Native Jefferson Child Shoe Eva Jiffy Black/Shell White US Size: C5 - Child,Default Ridgefield,60,60,0,0,0,0
,Native Jefferson Child Shoe Eva Jiffy Black/Shell White US Size: C5 - Child,Native Jefferson Child Shoe Eva Jiffy Black/Shell White US Size: C5 - Child,FBALYB Amazon,-5,-7,2,0,2,0
,Native Jefferson Child Shoe Eva Jiffy Black/Shell White US Size: C6 - Child,Native Jefferson Child Shoe Eva Jiffy Black/Shell White US Size: C6 - Child,Default Ridgefield,93,93,0,0,0,0
,Native Jefferson Child Shoe Eva Jiffy Black/Shell White US Size: C6 - Child,Native Jefferson Child Shoe Eva Jiffy Black/Shell White US Size: C6 - Child,FBALYB Amazon,9,7,2,0,2,0
,Native Jefferson Child Shoe Eva Jiffy Black/Shell White US Size: C7 - Child,Native Jefferson Child Shoe Eva Jiffy Black/Shell White US Size: C7 - Child,Default Ridgefield,186,186,0,0,0,0
,Native Jefferson Child Shoe Eva Jiffy Black/Shell White US Size: C7 - Child,Native Jefferson Child Shoe Eva Jiffy Black/Shell White US Size: C7 - Child,FBALYB Amazon,-32,-32,0,1,0,0
,Native Jefferson Child Shoe Eva Jiffy Black/Shell White US Size: C8 - Child,Native Jefferson Child Shoe Eva Jiffy Black/Shell White US Size: C8 - Child,Default Ridgefield,190,190,0,0,0,0
,Native Jefferson Child Shoe Eva Jiffy Black/Shell White US Size: C8 - Child,Native Jefferson Child Shoe Eva Jiffy Black/Shell White US Size: C8 - Child,FBALYB Amazon,5,4,1,0,1,0
,Native Jefferson Child Shoe Eva Jiffy Black/Shell White US Size: C9 - Child,Native Jefferson Child Shoe Eva Jiffy Black/Shell White US Size: C9 - Child,Default Ridgefield,41,41,0,0,0,0
,Native Jefferson Child Shoe Eva Jiffy Black/Shell White US Size: C9 - Child,Native Jefferson Child Shoe Eva Jiffy Black/Shell White US Size: C9 - Child,FBALYB Amazon,30,30,0,0,0,0
,Native Jefferson Child Shoe Eva Milk Pink/Shell White US Size: C10 - Child,Native Jefferson Child Shoe Eva Milk Pink/Shell White US Size: C10 - Child,FBALYB Amazon,53,52,1,0,1,0
,Native Jefferson Child Shoe Eva Milk Pink/Shell White US Size: C4 - Child,Native Jefferson Child Shoe Eva Milk Pink/Shell White US Size: C4 - Child,Default Ridgefield,28,28,0,0,0,0
,Native Jefferson Child Shoe Eva Milk Pink/Shell White US Size: C4 - Child,Native Jefferson Child Shoe Eva Milk Pink/Shell White US Size: C4 - Child,FBALYB Amazon,61,61,0,0,0,0
,Native Jefferson Child Shoe Eva Milk Pink/Shell White US Size: C5 - Child,Native Jefferson Child Shoe Eva Milk Pink/Shell White US Size: C5 - Child,Default Ridgefield,7,7,0,0,0,0
,Native Jefferson Child Shoe Eva Milk Pink/Shell White US Size: C5 - Child,Native Jefferson Child Shoe Eva Milk Pink/Shell White US Size: C5 - Child,FBALYB Amazon,31,29,2,0,2,0
,Native Jefferson Child Shoe Eva Milk Pink/Shell White US Size: C6 - Child,Native Jefferson Child Shoe Eva Milk Pink/Shell White US Size: C6 - Child,Default Ridgefield,72,72,0,0,0,0
,Native Jefferson Child Shoe Eva Milk Pink/Shell White US Size: C6 - Child,Native Jefferson Child Shoe Eva Milk Pink/Shell White US Size: C6 - Child,FBALYB Amazon,-20,-20,0,0,0,0
,Native Jefferson Child Shoe Eva Milk Pink/Shell White US Size: C7 - Child,Native Jefferson Child Shoe Eva Milk Pink/Shell White US Size: C7 - Child,Default Ridgefield,119,119,0,0,0,0
,Native Jefferson Child Shoe Eva Milk Pink/Shell White US Size: C7 - Child,Native Jefferson Child Shoe Eva Milk Pink/Shell White US Size: C7 - Child,FBALYB Amazon,-14,-14,0,0,0,0
,Native Jefferson Child Shoe Eva Milk Pink/Shell White US Size: C8 - Child,Native Jefferson Child Shoe Eva Milk Pink/Shell White US Size: C8 - Child,Default Ridgefield,106,106,0,0,0,0
,Native Jefferson Child Shoe Eva Milk Pink/Shell White US Size: C8 - Child,Native Jefferson Child Shoe Eva Milk Pink/Shell White US Size: C8 - Child,FBALYB Amazon,-25,-25,0,0,0,0
,Native Jefferson Child Shoe Eva Milk Pink/Shell White US Size: C9 - Child,Native Jefferson Child Shoe Eva Milk Pink/Shell White US Size: C9 - Child,Default Ridgefield,61,61,0,0,0,0
,Native Jefferson Child Shoe Eva Milk Pink/Shell White US Size: C9 - Child,Native Jefferson Child Shoe Eva Milk Pink/Shell White US Size: C9 - Child,FBALYB Amazon,-17,-17,0,0,0,0
,Native Jefferson Child Shoe Eva Pigeon Gray/Shell White US Size:C10 - Child,Native Jefferson Child Shoe Eva Pigeon Gray/Shell White US Size:C10 - Child,Default Ridgefield,90,90,0,0,0,0
,Native Jefferson Child Shoe Eva Pigeon Gray/Shell White US Size:C10 - Child,Native Jefferson Child Shoe Eva Pigeon Gray/Shell White US Size:C10 - Child,FBALYB Amazon,59,59,0,0,0,0
,Native Jefferson Child Shoe Eva Pigeon Gray/Shell White US Size:C4 - Child,Native Jefferson Child Shoe Eva Pigeon Gray/Shell White US Size:C4 - Child,FBALYB Amazon,36,34,2,0,2,0
,Native Jefferson Child Shoe Eva Pigeon Gray/Shell White US Size:C5 - Child,Native Jefferson Child Shoe Eva Pigeon Gray/Shell White US Size:C5 - Child,FBALYB Amazon,-36,-36,0,0,0,0
,Native Jefferson Child Shoe Eva Pigeon Gray/Shell White US Size: C6 - Child,Native Jefferson Child Shoe Eva Pigeon Gray/Shell White US Size: C6 - Child,Default Ridgefield,238,238,0,0,0,0
,Native Jefferson Child Shoe Eva Pigeon Gray/Shell White US Size: C6 - Child,Native Jefferson Child Shoe Eva Pigeon Gray/Shell White US Size: C6 - Child,FBALYB Amazon,-37,-38,1,0,1,0
,Native Jefferson Child Shoe Eva Pigeon Gray/Shell White US Size: C7 - Child,Native Jefferson Child Shoe Eva Pigeon Gray/Shell White US Size: C7 - Child,FBALYB Amazon,-11,-14,3,0,3,0
,Native Jefferson Child Shoe Eva Pigeon Gray/Shell White US Size: C8 - Child,Native Jefferson Child Shoe Eva Pigeon Gray/Shell White US Size: C8 - Child,Default Ridgefield,403,403,0,0,0,0
,Native Jefferson Child Shoe Eva Pigeon Gray/Shell White US Size: C8 - Child,Native Jefferson Child Shoe Eva Pigeon Gray/Shell White US Size: C8 - Child,FBALYB Amazon,10,3,7,2,7,0
,Native Jefferson Child Shoe Eva Pigeon Gray/Shell White US Size: C9 - Child,Native Jefferson Child Shoe Eva Pigeon Gray/Shell White US Size: C9 - Child,Default Ridgefield,116,116,0,0,0,0
,Native Jefferson Child Shoe Eva Pigeon Gray/Shell White US Size: C9 - Child,Native Jefferson Child Shoe Eva Pigeon Gray/Shell White US Size: C9 - Child,FBALYB Amazon,42,39,3,0,3,0
,Native Jefferson Child Shoe Eva Pigeon Grey/ Shell White Grey US Size: C13,Native Jefferson Child Shoe Eva Pigeon Grey/ Shell White Grey US Size: C13,Default Ridgefield,166,166,0,0,0,0
,Native Jefferson Child Shoe Eva Pigeon Grey/ Shell White Grey US Size: C13,Native Jefferson Child Shoe Eva Pigeon Grey/ Shell White Grey US Size: C13,FBALYB Amazon,93,93,0,1,0,0
,Native Jefferson Child Shoe Eva Pigeon Grey/ Shell White Grey US Size: C4,Native Jefferson Child Shoe Eva Pigeon Grey/ Shell White Grey US Size: C4,Default Ridgefield,144,144,0,0,0,0
,Native Jefferson Child Shoe Eva Pigeon Grey/ Shell White Grey US Size: C5,Native Jefferson Child Shoe Eva Pigeon Grey/ Shell White Grey US Size: C5,Default Ridgefield,216,216,0,0,0,0
,Native Jefferson Child Shoe Eva Pigeon Grey/ Shell White Grey US Size: C7,Native Jefferson Child Shoe Eva Pigeon Grey/ Shell White Grey US Size: C7,Default Ridgefield,479,479,0,0,0,0
,Native Jefferson Child Shoe Eva Regatta Blue/Shell White US Size: C10 - Child,Native Jefferson Child Shoe Eva Regatta Blue/Shell White US Size: C10 - Child,FBALYB Amazon,56,49,7,0,7,0
,Native Jefferson Child Shoe Eva Regatta Blue/Shell White US Size: C4 - Child,Native Jefferson Child Shoe Eva Regatta Blue/Shell White US Size: C4 - Child,FBALYB Amazon,63,61,2,0,2,0
,Native Jefferson Child Shoe Eva Regatta Blue/Shell White US Size: C5 - Child,Native Jefferson Child Shoe Eva Regatta Blue/Shell White US Size: C5 - Child,FBALYB Amazon,30,24,6,0,6,0
,Native Jefferson Child Shoe Eva Regatta Blue/Shell White US Size: C6 - Child,Native Jefferson Child Shoe Eva Regatta Blue/Shell White US Size: C6 - Child,Default Ridgefield,1,1,0,0,0,0
,Native Jefferson Child Shoe Eva Regatta Blue/Shell White US Size: C6 - Child,Native Jefferson Child Shoe Eva Regatta Blue/Shell White US Size: C6 - Child,FBALYB Amazon,73,62,11,0,11,0
,Native Jefferson Child Shoe Eva Regatta Blue/Shell White US Size: C7 - Child,Native Jefferson Child Shoe Eva Regatta Blue/Shell White US Size: C7 - Child,Default Ridgefield,1,1,0,0,0,0
,Native Jefferson Child Shoe Eva Regatta Blue/Shell White US Size: C7 - Child,Native Jefferson Child Shoe Eva Regatta Blue/Shell White US Size: C7 - Child,FBALYB Amazon,224,214,10,0,10,0
,Native Jefferson Child Shoe Eva Regatta Blue/Shell White US Size: C8 - Child,Native Jefferson Child Shoe Eva Regatta Blue/Shell White US Size: C8 - Child,FBALYB Amazon,206,194,12,3,12,0
,Native Jefferson Child Shoe Eva Regatta Blue/Shell White US Size: C9 - Child,Native Jefferson Child Shoe Eva Regatta Blue/Shell White US Size: C9 - Child,Default Ridgefield,1,1,0,0,0,0
,Native Jefferson Child Shoe Eva Regatta Blue/Shell White US Size: C9 - Child,Native Jefferson Child Shoe Eva Regatta Blue/Shell White US Size: C9 - Child,FBALYB Amazon,50,48,2,0,2,0
,Native Jefferson Child Shoe Eva Shell White/Shell White US Size: C7 - Child,Native Jefferson Child Shoe Eva Shell White/Shell White US Size: C7 - Child,FBALYB Amazon,54,52,2,2,2,0
,Native Jefferson Child Shoe Eva Shell White/Shell White US Size: C8 - Child,Native Jefferson Child Shoe Eva Shell White/Shell White US Size: C8 - Child,Default Ridgefield,10,10,0,0,0,0
,Native Jefferson Child Shoe Eva Shell White/Shell White US Size: C8 - Child,Native Jefferson Child Shoe Eva Shell White/Shell White US Size: C8 - Child,FBALYB Amazon,35,35,0,0,0,0
,Native Jefferson Child Shoe Eva Torch Red/Shell White US Size: C10 - Child,Native Jefferson Child Shoe Eva Torch Red/Shell White US Size: C10 - Child,FBALYB Amazon,38,37,1,0,1,0
,Native Jefferson Child Shoe Eva Torch Red/Shell White US Size: C4 - Child,Native Jefferson Child Shoe Eva Torch Red/Shell White US Size: C4 - Child,Default Ridgefield,9,9,0,0,0,0
,Native Jefferson Child Shoe Eva Torch Red/Shell White US Size: C4 - Child,Native Jefferson Child Shoe Eva Torch Red/Shell White US Size: C4 - Child,FBALYB Amazon,44,44,0,0,0,0
,Native Jefferson Child Shoe Eva Torch Red/Shell White US Size: C5 - Child,Native Jefferson Child Shoe Eva Torch Red/Shell White US Size: C5 - Child,FBALYB Amazon,39,35,4,0,4,0
,Native Jefferson Child Shoe Eva Torch Red/Shell White US Size: C6 - Child,Native Jefferson Child Shoe Eva Torch Red/Shell White US Size: C6 - Child,FBALYB Amazon,123,123,0,0,0,0
,Native Jefferson Child Shoe Eva Torch Red/Shell White US Size: C7 - Child,Native Jefferson Child Shoe Eva Torch Red/Shell White US Size: C7 - Child,FBALYB Amazon,158,158,0,0,0,0
,Native Jefferson Child Shoe Eva Torch Red/Shell White US Size: C8 - Child,Native Jefferson Child Shoe Eva Torch Red/Shell White US Size: C8 - Child,FBALYB Amazon,167,163,4,0,4,0
,Native Jefferson Child Shoe Eva Torch Red/Shell White US Size: C9 - Child,Native Jefferson Child Shoe Eva Torch Red/Shell White US Size: C9 - Child,Default Ridgefield,1,1,0,0,0,0
,Native Jefferson Child Shoe Eva Torch Red/Shell White US Size: C9 - Child,Native Jefferson Child Shoe Eva Torch Red/Shell White US Size: C9 - Child,FBALYB Amazon,48,48,0,0,0,0
,Native Jefferson Iridescent Child Lavender Purple/Shell White/Galaxy US Size: C4,Native Jefferson Iridescent Child Lavender Purple/Shell White/Galaxy US Size: C4,FBALYB Amazon,58,58,0,0,0,0
,Native Jefferson Iridescent Child Lavender Purple/Shell White/Galaxy US Size: C6,Native Jefferson Iridescent Child Lavender Purple/Shell White/Galaxy US Size: C6,FBALYB Amazon,16,16,0,0,0,0
,Native Jefferson Iridescent Child Shoe Eva Lavender Purple/Shell White/Galaxy US Size: C10 - Child,Native Jefferson Iridescent Child Shoe Eva Lavender Purple/Shell White/Galaxy US Size: C10 - Child,FBALYB Amazon,14,14,0,0,0,0
,Native Jefferson Iridescent Child Shoe Eva Lavender Purple/Shell White/Galaxy US Size: C5 - Child,Native Jefferson Iridescent Child Shoe Eva Lavender Purple/Shell White/Galaxy US Size: C5 - Child,FBALYB Amazon,58,58,0,0,0,0
,Native Jefferson Iridescent Child Shoe Eva Lavender Purple/Shell White/Galaxy US Size: C7 - Child,Native Jefferson Iridescent Child Shoe Eva Lavender Purple/Shell White/Galaxy US Size: C7 - Child,FBALYB Amazon,-9,-9,0,0,0,0
,Native Jefferson Iridescent Child Shoe Eva Lavender Purple/Shell White/Galaxy US Size: C8 - Child,Native Jefferson Iridescent Child Shoe Eva Lavender Purple/Shell White/Galaxy US Size: C8 - Child,FBALYB Amazon,-15,-15,0,0,0,0
,Native Jefferson Iridescent Child Shoe Eva Lavender Purple/Shell White/Galaxy US Size: C9 - Child,Native Jefferson Iridescent Child Shoe Eva Lavender Purple/Shell White/Galaxy US Size: C9 - Child,FBALYB Amazon,26,26,0,0,0,0
,Native Jefferson Iridescent Junior Lavender Purple/Shell White/Galaxy US Size: J1,Native Jefferson Iridescent Junior Lavender Purple/Shell White/Galaxy US Size: J1,FBALYB Amazon,1,1,0,0,0,0
,Native Jefferson Iridescent Junior Lavender Purple/Shell White/Galaxy US Size: J2,Native Jefferson Iridescent Junior Lavender Purple/Shell White/Galaxy US Size: J2,FBALYB Amazon,15,15,0,0,0,0
,Native Jefferson Iridescent Junior Lavender Purple/Shell White/Galaxy US Size: J3,Native Jefferson Iridescent Junior Lavender Purple/Shell White/Galaxy US Size: J3,FBALYB Amazon,19,19,0,0,0,0
,Native Jefferson Iridescent Youth Lavender Purple/Shell White/Galaxy US Size: C13,Native Jefferson Iridescent Youth Lavender Purple/Shell White/Galaxy US Size: C13,FBALYB Amazon,31,31,0,0,0,0
,Native Jefferson Iridescent Youth Shoe Lavender Purple/Shell White/Galaxy US Size: C11 - Youth,Native Jefferson Iridescent Youth Shoe Lavender Purple/Shell White/Galaxy US Size: C11 - Youth,FBALYB Amazon,46,46,0,0,0,0
,Native Jefferson Iridescent Youth Shoe Lavender Purple/Shell White/Galaxy US Size: C12 - Youth,Native Jefferson Iridescent Youth Shoe Lavender Purple/Shell White/Galaxy US Size: C12 - Youth,Default Ridgefield,9,9,0,0,0,0
,Native Jefferson Iridescent Youth Shoe Lavender Purple/Shell White/Galaxy US Size: C12 - Youth,Native Jefferson Iridescent Youth Shoe Lavender Purple/Shell White/Galaxy US Size: C12 - Youth,FBALYB Amazon,37,37,0,0,0,0
,Native Jefferson Junior Crayon Yellow/Shell White US Size: J3,Native Jefferson Junior Crayon Yellow/Shell White US Size: J3,FBALYB Amazon,-9,-9,0,0,0,0
,Native Jefferson Junior Crayon Yellow/Shell White US Size: J4,Native Jefferson Junior Crayon Yellow/Shell White US Size: J4,FBALYB Amazon,-12,-12,0,0,0,0
,Native Jefferson Junior Crayon Yellow/Shell White US Size: J5,Native Jefferson Junior Crayon Yellow/Shell White US Size: J5,FBALYB Amazon,27,27,0,0,0,0
,Native Jefferson Junior Grasshopper Green/Shell White US Size: J3,Native Jefferson Junior Grasshopper Green/Shell White US Size: J3,FBALYB Amazon,-10,-10,0,1,0,0
,Native Jefferson Junior Grasshopper Green/Shell White US Size: J4,Native Jefferson Junior Grasshopper Green/Shell White US Size: J4,FBALYB Amazon,-12,-12,0,0,0,0
,Native Jefferson Junior Grasshopper Green/Shell White US Size: J5,Native Jefferson Junior Grasshopper Green/Shell White US Size: J5,FBALYB Amazon,-7,-7,0,0,0,0
,Native Jefferson Junior Hollywood Pink/Shell White US Size: J4,Native Jefferson Junior Hollywood Pink/Shell White US Size: J4,FBALYB Amazon,-20,-20,0,0,0,0
,Native Jefferson Junior Jiffy Black/Shell White US Size: J4,Native Jefferson Junior Jiffy Black/Shell White US Size: J4,FBALYB Amazon,-21,-23,2,0,2,0
,Native Jefferson Junior Milk Pink/Shell White US Size: J1,Native Jefferson Junior Milk Pink/Shell White US Size: J1,FBALYB Amazon,-24,-24,0,0,0,0
,Native Jefferson Junior Milk Pink/Shell White US Size: J2,Native Jefferson Junior Milk Pink/Shell White US Size: J2,FBALYB Amazon,-7,-7,0,0,0,0
,Native Jefferson Junior Milk Pink/Shell White US Size: J4,Native Jefferson Junior Milk Pink/Shell White US Size: J4,FBALYB Amazon,-11,-11,0,0,0,0
,Native Jefferson Junior Milk Pink/Shell White US Size: J5,Native Jefferson Junior Milk Pink/Shell White US Size: J5,FBALYB Amazon,30,30,0,0,0,0
,Native Jefferson Junior Milk Pink/Shell White US Size: J6,Native Jefferson Junior Milk Pink/Shell White US Size: J6,FBALYB Amazon,49,49,0,0,0,0
,Native Jefferson Junior Pigeon Gray/Shell White US Size: J4,Native Jefferson Junior Pigeon Gray/Shell White US Size: J4,FBALYB Amazon,-21,-22,1,0,1,0
,Native Jefferson Junior Pigeon Gray/Shell White US Size: J6,Native Jefferson Junior Pigeon Gray/Shell White US Size: J6,FBALYB Amazon,-19,-21,2,0,2,0
,Native Jefferson Junior Regatta Blue/Shell White US Size: J4,Native Jefferson Junior Regatta Blue/Shell White US Size: J4,FBALYB Amazon,-26,-26,0,0,0,0
,Native Jefferson Junior Regatta Blue/Shell White US Size: J6,Native Jefferson Junior Regatta Blue/Shell White US Size: J6,FBALYB Amazon,-33,-34,1,0,1,0
,Native Jefferson Junior Shell White/Shell White US Size: J1,Native Jefferson Junior Shell White/Shell White US Size: J1,Default Ridgefield,26,26,0,0,0,0
,Native Jefferson Junior Shell White/Shell White US Size: J1,Native Jefferson Junior Shell White/Shell White US Size: J1,FBALYB Amazon,-14,-14,0,0,0,0
,Native Jefferson Junior Shell White/Shell White US Size: J2,Native Jefferson Junior Shell White/Shell White US Size: J2,Default Ridgefield,26,26,0,0,0,0
,Native Jefferson Junior Shell White/Shell White US Size: J2,Native Jefferson Junior Shell White/Shell White US Size: J2,FBALYB Amazon,-17,-17,0,0,0,0
,Native Jefferson Junior Shell White/Shell White US Size: J3,Native Jefferson Junior Shell White/Shell White US Size: J3,Default Ridgefield,26,26,0,0,0,0
,Native Jefferson Junior Shell White/Shell White US Size: J3,Native Jefferson Junior Shell White/Shell White US Size: J3,FBALYB Amazon,-12,-12,0,0,0,0
,Native Jefferson Junior Shell White/Shell White US Size: J4,Native Jefferson Junior Shell White/Shell White US Size: J4,FBALYB Amazon,-24,-24,0,0,0,0
,Native Jefferson Junior Shell White/Shell White US Size: J6,Native Jefferson Junior Shell White/Shell White US Size: J6,FBALYB Amazon,1,1,0,0,0,0
,Native Jefferson Junior Shoe Eva Crayon Yellow/Shell White US Size: J1 - Junior,Native Jefferson Junior Shoe Eva Crayon Yellow/Shell White US Size: J1 - Junior,Default Ridgefield,15,15,0,0,0,0
,Native Jefferson Junior Shoe Eva Crayon Yellow/Shell White US Size: J1 - Junior,Native Jefferson Junior Shoe Eva Crayon Yellow/Shell White US Size: J1 - Junior,FBALYB Amazon,-19,-19,0,0,0,0
,Native Jefferson Junior Shoe Eva Crayon Yellow/Shell White US Size: J2 - Junior,Native Jefferson Junior Shoe Eva Crayon Yellow/Shell White US Size: J2 - Junior,Default Ridgefield,24,24,0,0,0,0
,Native Jefferson Junior Shoe Eva Crayon Yellow/Shell White US Size: J2 - Junior,Native Jefferson Junior Shoe Eva Crayon Yellow/Shell White US Size: J2 - Junior,FBALYB Amazon,-4,-4,0,0,0,0
,Native Jefferson Junior Shoe Eva Crayon Yellow/Shell White US Size: J6 - Junior,Native Jefferson Junior Shoe Eva Crayon Yellow/Shell White US Size: J6 - Junior,Default Ridgefield,24,24,0,0,0,0
,Native Jefferson Junior Shoe Eva Crayon Yellow/Shell White US Size: J6 - Junior,Native Jefferson Junior Shoe Eva Crayon Yellow/Shell White US Size: J6 - Junior,FBALYB Amazon,42,42,0,0,0,0
,Native Jefferson Junior Shoe Eva Grasshopper Green/Shell White US Size: J1 - Junior,Native Jefferson Junior Shoe Eva Grasshopper Green/Shell White US Size: J1 - Junior,FBALYB Amazon,-12,-12,0,0,0,0
,Native Jefferson Junior Shoe Eva Grasshopper Green/Shell White US Size: J2 - Junior,Native Jefferson Junior Shoe Eva Grasshopper Green/Shell White US Size: J2 - Junior,FBALYB Amazon,-13,-13,0,0,0,0
,Native Jefferson Junior Shoe Eva Grasshopper Green/Shell White US Size: J6 - Junior,Native Jefferson Junior Shoe Eva Grasshopper Green/Shell White US Size: J6 - Junior,FBALYB Amazon,-11,-11,0,0,0,0
,Native Jefferson Junior Shoe Eva Hollywood Pink/Shell White US Size: J1 - Junior,Native Jefferson Junior Shoe Eva Hollywood Pink/Shell White US Size: J1 - Junior,Default Ridgefield,47,47,0,0,0,0
,Native Jefferson Junior Shoe Eva Hollywood Pink/Shell White US Size: J1 - Junior,Native Jefferson Junior Shoe Eva Hollywood Pink/Shell White US Size: J1 - Junior,FBALYB Amazon,-29,-29,0,0,0,0
,Native Jefferson Junior Shoe Eva Hollywood Pink/Shell White US Size: J2 - Junior,Native Jefferson Junior Shoe Eva Hollywood Pink/Shell White US Size: J2 - Junior,Default Ridgefield,71,71,0,0,0,0
,Native Jefferson Junior Shoe Eva Hollywood Pink/Shell White US Size: J2 - Junior,Native Jefferson Junior Shoe Eva Hollywood Pink/Shell White US Size: J2 - Junior,FBALYB Amazon,-15,-15,0,0,0,0
,Native Jefferson Junior Shoe Eva Hollywood Pink/Shell White US Size: J3 - Junior,Native Jefferson Junior Shoe Eva Hollywood Pink/Shell White US Size: J3 - Junior,Default Ridgefield,22,22,0,0,0,0
,Native Jefferson Junior Shoe Eva Hollywood Pink/Shell White US Size: J3 - Junior,Native Jefferson Junior Shoe Eva Hollywood Pink/Shell White US Size: J3 - Junior,FBALYB Amazon,-14,-14,0,0,0,0
,Native Jefferson Junior Shoe Eva Hollywood Pink/Shell White US Size: J5 - Junior,Native Jefferson Junior Shoe Eva Hollywood Pink/Shell White US Size: J5 - Junior,Default Ridgefield,24,24,0,0,0,0
,Native Jefferson Junior Shoe Eva Hollywood Pink/Shell White US Size: J5 - Junior,Native Jefferson Junior Shoe Eva Hollywood Pink/Shell White US Size: J5 - Junior,FBALYB Amazon,-20,-20,0,0,0,0
,Native Jefferson Junior Shoe Eva Hollywood Pink/Shell White US Size: J6 - Junior,Native Jefferson Junior Shoe Eva Hollywood Pink/Shell White US Size: J6 - Junior,Default Ridgefield,72,72,0,0,0,0
,Native Jefferson Junior Shoe Eva Hollywood Pink/Shell White US Size: J6 - Junior,Native Jefferson Junior Shoe Eva Hollywood Pink/Shell White US Size: J6 - Junior,FBALYB Amazon,17,17,0,0,0,0
,Native Jefferson Junior Shoe Eva Jiffy Black/Shell White US Size: J1 - Junior,Native Jefferson Junior Shoe Eva Jiffy Black/Shell White US Size: J1 - Junior,Default Ridgefield,33,33,0,0,0,0
,Native Jefferson Junior Shoe Eva Jiffy Black/Shell White US Size: J1 - Junior,Native Jefferson Junior Shoe Eva Jiffy Black/Shell White US Size: J1 - Junior,FBALYB Amazon,-22,-22,0,0,0,0
,Native Jefferson Junior Shoe Eva Jiffy Black/Shell White US Size: J2 - Junior,Native Jefferson Junior Shoe Eva Jiffy Black/Shell White US Size: J2 - Junior,Default Ridgefield,69,69,0,0,0,0
,Native Jefferson Junior Shoe Eva Jiffy Black/Shell White US Size: J2 - Junior,Native Jefferson Junior Shoe Eva Jiffy Black/Shell White US Size: J2 - Junior,FBALYB Amazon,-19,-19,0,0,0,0
,Native Jefferson Junior Shoe Eva Jiffy Black/Shell White US Size: J3 - Junior,Native Jefferson Junior Shoe Eva Jiffy Black/Shell White US Size: J3 - Junior,Default Ridgefield,51,51,0,0,0,0
,Native Jefferson Junior Shoe Eva Jiffy Black/Shell White US Size: J3 - Junior,Native Jefferson Junior Shoe Eva Jiffy Black/Shell White US Size: J3 - Junior,FBALYB Amazon,-16,-16,0,0,0,0
,Native Jefferson Junior Shoe Eva Jiffy Black/Shell White US Size: J5 - Junior,Native Jefferson Junior Shoe Eva Jiffy Black/Shell White US Size: J5 - Junior,Default Ridgefield,3,3,0,0,0,0
,Native Jefferson Junior Shoe Eva Jiffy Black/Shell White US Size: J5 - Junior,Native Jefferson Junior Shoe Eva Jiffy Black/Shell White US Size: J5 - Junior,FBALYB Amazon,-33,-34,1,0,1,0
,Native Jefferson Junior Shoe Eva Jiffy Black/Shell White US Size: J6 - Junior,Native Jefferson Junior Shoe Eva Jiffy Black/Shell White US Size: J6 - Junior,FBALYB Amazon,14,14,0,0,0,0
,Native Jefferson Junior Shoe Eva Pigeon Gray/Shell White US Size: J1 - Junior,Native Jefferson Junior Shoe Eva Pigeon Gray/Shell White US Size: J1 - Junior,Default Ridgefield,92,92,0,0,0,0
,Native Jefferson Junior Shoe Eva Pigeon Gray/Shell White US Size: J1 - Junior,Native Jefferson Junior Shoe Eva Pigeon Gray/Shell White US Size: J1 - Junior,FBALYB Amazon,-69,-69,0,1,0,0
,Native Jefferson Junior Shoe Eva Pigeon Gray/Shell White US Size: J2 - Junior,Native Jefferson Junior Shoe Eva Pigeon Gray/Shell White US Size: J2 - Junior,Default Ridgefield,124,124,0,0,0,0
,Native Jefferson Junior Shoe Eva Pigeon Gray/Shell White US Size: J2 - Junior,Native Jefferson Junior Shoe Eva Pigeon Gray/Shell White US Size: J2 - Junior,FBALYB Amazon,-17,-17,0,0,0,0
,Native Jefferson Junior Shoe Eva Pigeon Gray/Shell White US Size: J3 - Junior,Native Jefferson Junior Shoe Eva Pigeon Gray/Shell White US Size: J3 - Junior,FBALYB Amazon,66,66,0,0,0,0
,Native Jefferson Junior Shoe Eva Pigeon Gray/Shell White US Size: J5 - Junior,Native Jefferson Junior Shoe Eva Pigeon Gray/Shell White US Size: J5 - Junior,FBALYB Amazon,18,17,1,0,1,0
,Native Jefferson Junior Shoe Eva Regatta Blue/Shell White US Size: J1 - Junior,Native Jefferson Junior Shoe Eva Regatta Blue/Shell White US Size: J1 - Junior,Default Ridgefield,107,107,0,0,0,0
,Native Jefferson Junior Shoe Eva Regatta Blue/Shell White US Size: J1 - Junior,Native Jefferson Junior Shoe Eva Regatta Blue/Shell White US Size: J1 - Junior,FBALYB Amazon,-29,-29,0,0,0,0
,Native Jefferson Junior Shoe Eva Regatta Blue/Shell White US Size: J2 - Junior,Native Jefferson Junior Shoe Eva Regatta Blue/Shell White US Size: J2 - Junior,Default Ridgefield,128,128,0,0,0,0
,Native Jefferson Junior Shoe Eva Regatta Blue/Shell White US Size: J2 - Junior,Native Jefferson Junior Shoe Eva Regatta Blue/Shell White US Size: J2 - Junior,FBALYB Amazon,-21,-21,0,0,0,0
,Native Jefferson Junior Shoe Eva Regatta Blue/Shell White US Size: J3 - Junior,Native Jefferson Junior Shoe Eva Regatta Blue/Shell White US Size: J3 - Junior,Default Ridgefield,82,82,0,0,0,0
,Native Jefferson Junior Shoe Eva Regatta Blue/Shell White US Size: J3 - Junior,Native Jefferson Junior Shoe Eva Regatta Blue/Shell White US Size: J3 - Junior,FBALYB Amazon,-19,-19,0,0,0,0
,Native Jefferson Junior Shoe Eva Regatta Blue/Shell White US Size: J5 - Junior,Native Jefferson Junior Shoe Eva Regatta Blue/Shell White US Size: J5 - Junior,FBALYB Amazon,-8,-10,2,0,2,0
,Native Jefferson Junior Shoe Eva Shell White/Shell White US Size: J5 - Junior,Native Jefferson Junior Shoe Eva Shell White/Shell White US Size: J5 - Junior,FBALYB Amazon,-20,-20,0,0,0,0
,Native Jefferson Junior Shoe Eva Torch Red/Shell White US Size: J1 - Junior,Native Jefferson Junior Shoe Eva Torch Red/Shell White US Size: J1 - Junior,Default Ridgefield,24,24,0,0,0,0
,Native Jefferson Junior Shoe Eva Torch Red/Shell White US Size: J1 - Junior,Native Jefferson Junior Shoe Eva Torch Red/Shell White US Size: J1 - Junior,FBALYB Amazon,-35,-35,0,0,0,0
,Native Jefferson Junior Shoe Eva Torch Red/Shell White US Size: J2 - Junior,Native Jefferson Junior Shoe Eva Torch Red/Shell White US Size: J2 - Junior,Default Ridgefield,48,48,0,0,0,0
,Native Jefferson Junior Shoe Eva Torch Red/Shell White US Size: J2 - Junior,Native Jefferson Junior Shoe Eva Torch Red/Shell White US Size: J2 - Junior,FBALYB Amazon,-21,-21,0,0,0,0
,Native Jefferson Junior Shoe Eva Torch Red/Shell White US Size: J3 - Junior,Native Jefferson Junior Shoe Eva Torch Red/Shell White US Size: J3 - Junior,Default Ridgefield,24,24,0,0,0,0
,Native Jefferson Junior Shoe Eva Torch Red/Shell White US Size: J3 - Junior,Native Jefferson Junior Shoe Eva Torch Red/Shell White US Size: J3 - Junior,FBALYB Amazon,-23,-23,0,0,0,0
,Native Jefferson Junior Shoe Eva Torch Red/Shell White US Size: J5 - Junior,Native Jefferson Junior Shoe Eva Torch Red/Shell White US Size: J5 - Junior,Default Ridgefield,24,24,0,0,0,0
,Native Jefferson Junior Shoe Eva Torch Red/Shell White US Size: J5 - Junior,Native Jefferson Junior Shoe Eva Torch Red/Shell White US Size: J5 - Junior,FBALYB Amazon,-18,-18,0,0,0,0
,Native Jefferson Junior Shoe Eva Torch Red/Shell White US Size: J6 - Junior,Native Jefferson Junior Shoe Eva Torch Red/Shell White US Size: J6 - Junior,Default Ridgefield,48,48,0,0,0,0
,Native Jefferson Junior Shoe Eva Torch Red/Shell White US Size: J6 - Junior,Native Jefferson Junior Shoe Eva Torch Red/Shell White US Size: J6 - Junior,FBALYB Amazon,8,8,0,0,0,0
,Native Jefferson Junior Torch Red/Shell White US Size: J4,Native Jefferson Junior Torch Red/Shell White US Size: J4,FBALYB Amazon,-14,-14,0,0,0,0
,Native Jefferson Youth Crayon Yellow/Shell White US Size: C13,Native Jefferson Youth Crayon Yellow/Shell White US Size: C13,FBALYB Amazon,-14,-14,0,0,0,0
,Native Jefferson Youth Grasshopper Green/Shell White US Size: C11,Native Jefferson Youth Grasshopper Green/Shell White US Size: C11,FBALYB Amazon,-13,-16,3,0,3,0
,Native Jefferson Youth Hollywood Pink/Shell White US Size: C11,Native Jefferson Youth Hollywood Pink/Shell White US Size: C11,Default Ridgefield,2,2,0,0,0,0
,Native Jefferson Youth Hollywood Pink/Shell White US Size: C11,Native Jefferson Youth Hollywood Pink/Shell White US Size: C11,FBALYB Amazon,212,212,0,0,0,0
,Native Jefferson Youth Hollywood Pink/Shell White US Size: C13,Native Jefferson Youth Hollywood Pink/Shell White US Size: C13,Default Ridgefield,6,6,0,0,0,0
,Native Jefferson Youth Hollywood Pink/Shell White US Size: C13,Native Jefferson Youth Hollywood Pink/Shell White US Size: C13,FBALYB Amazon,-16,-16,0,0,0,0
,Native Jefferson Youth Jiffy Black/Shell White US Size: C13,Native Jefferson Youth Jiffy Black/Shell White US Size: C13,FBALYB Amazon,-22,-23,1,0,1,0
,Native Jefferson Youth Milk Pink/Shell White US Size: C11,Native Jefferson Youth Milk Pink/Shell White US Size: C11,Default Ridgefield,18,18,0,0,0,0
,Native Jefferson Youth Milk Pink/Shell White US Size: C11,Native Jefferson Youth Milk Pink/Shell White US Size: C11,FBALYB Amazon,52,52,0,0,0,0
,Native Jefferson Youth Milk Pink/Shell White US Size: C12,Native Jefferson Youth Milk Pink/Shell White US Size: C12,Default Ridgefield,1,1,0,0,0,0
,Native Jefferson Youth Milk Pink/Shell White US Size: C12,Native Jefferson Youth Milk Pink/Shell White US Size: C12,FBALYB Amazon,75,75,0,0,0,0
,Native Jefferson Youth Pigeon Gray/Shell White US Size: C11,Native Jefferson Youth Pigeon Gray/Shell White US Size: C11,FBALYB Amazon,-29,-29,0,0,0,0
,Native Jefferson Youth Pigeon Gray/Shell White US Size: C12,Native Jefferson Youth Pigeon Gray/Shell White US Size: C12,FBALYB Amazon,-44,-44,0,1,0,0
,Native Jefferson Youth Shell White/Shell White US Size: C11,Native Jefferson Youth Shell White/Shell White US Size: C11,FBALYB Amazon,-28,-28,0,1,0,0
,Native Jefferson Youth Shell White/Shell White US Size: C12,Native Jefferson Youth Shell White/Shell White US Size: C12,FBALYB Amazon,-14,-14,0,1,0,0
,Native Jefferson Youth Shell White/Shell White US Size: C13,Native Jefferson Youth Shell White/Shell White US Size: C13,FBALYB Amazon,-34,-35,1,0,1,0
,Native Jefferson Youth Shoe Crayon Yellow/Shell White US Size: C11 - Youth,Native Jefferson Youth Shoe Crayon Yellow/Shell White US Size: C11 - Youth,FBALYB Amazon,80,80,0,0,0,0
,Native Jefferson Youth Shoe Crayon Yellow/Shell White US Size: C12 - Youth,Native Jefferson Youth Shoe Crayon Yellow/Shell White US Size: C12 - Youth,FBALYB Amazon,39,37,2,0,2,0
,Native Jefferson Youth Shoe Grasshopper Green/Shell White US Size: C12 - Youth,Native Jefferson Youth Shoe Grasshopper Green/Shell White US Size: C12 - Youth,FBALYB Amazon,-16,-16,0,0,0,0
,Native Jefferson Youth Shoe Grasshopper Green/Shell White US Size: C13 - Youth,Native Jefferson Youth Shoe Grasshopper Green/Shell White US Size: C13 - Youth,FBALYB Amazon,-18,-18,0,0,0,0
,Native Jefferson Youth Shoe Hollywood Pink/Shell White US Size: C12 - Youth,Native Jefferson Youth Shoe Hollywood Pink/Shell White US Size: C12 - Youth,Default Ridgefield,11,11,0,0,0,0
,Native Jefferson Youth Shoe Hollywood Pink/Shell White US Size: C12 - Youth,Native Jefferson Youth Shoe Hollywood Pink/Shell White US Size: C12 - Youth,FBALYB Amazon,131,130,1,0,1,0
,Native Jefferson Youth Shoe Jiffy Black/Shell White US Size: C11 - Youth,Native Jefferson Youth Shoe Jiffy Black/Shell White US Size: C11 - Youth,FBALYB Amazon,139,139,0,0,0,0
,Native Jefferson Youth Shoe Jiffy Black/Shell White US Size: C12 - Youth,Native Jefferson Youth Shoe Jiffy Black/Shell White US Size: C12 - Youth,Default Ridgefield,84,84,0,0,0,0
,Native Jefferson Youth Shoe Jiffy Black/Shell White US Size: C12 - Youth,Native Jefferson Youth Shoe Jiffy Black/Shell White US Size: C12 - Youth,FBALYB Amazon,-24,-24,0,0,0,0
,Native Jefferson Youth Shoe Milk Pink/Shell White US Size: C13 - Youth,Native Jefferson Youth Shoe Milk Pink/Shell White US Size: C13 - Youth,Default Ridgefield,1,1,0,0,0,0
,Native Jefferson Youth Shoe Milk Pink/Shell White US Size: C13 - Youth,Native Jefferson Youth Shoe Milk Pink/Shell White US Size: C13 - Youth,FBALYB Amazon,36,34,2,1,2,0
,Native Jefferson Youth Shoe Pigeon Gray/Shell White US Size: C13 - Youth,Native Jefferson Youth Shoe Pigeon Gray/Shell White US Size: C13 - Youth,Default Ridgefield,1,1,0,0,0,0
,Native Jefferson Youth Shoe Pigeon Gray/Shell White US Size: C13 - Youth,Native Jefferson Youth Shoe Pigeon Gray/Shell White US Size: C13 - Youth,FBALYB Amazon,-55,-55,0,0,0,0
,Native Jefferson Youth Shoe Regatta Blue/Shell White US Size: C11 - Youth,Native Jefferson Youth Shoe Regatta Blue/Shell White US Size: C11 - Youth,FBALYB Amazon,152,149,3,0,3,0
,Native Jefferson Youth Shoe Regatta Blue/Shell White US Size: C12 - Youth,Native Jefferson Youth Shoe Regatta Blue/Shell White US Size: C12 - Youth,FBALYB Amazon,91,88,3,6,3,0
,Native Jefferson Youth Shoe Regatta Blue/Shell White US Size: C13 - Youth,Native Jefferson Youth Shoe Regatta Blue/Shell White US Size: C13 - Youth,Default Ridgefield,147,147,0,0,0,0
,Native Jefferson Youth Shoe Regatta Blue/Shell White US Size: C13 - Youth,Native Jefferson Youth Shoe Regatta Blue/Shell White US Size: C13 - Youth,FBALYB Amazon,-15,-17,2,7,2,0
,Native Jefferson Youth Shoe Torch Red/Shell White US Size: C11 - Youth,Native Jefferson Youth Shoe Torch Red/Shell White US Size: C11 - Youth,Default Ridgefield,2,2,0,0,0,0
,Native Jefferson Youth Shoe Torch Red/Shell White US Size: C11 - Youth,Native Jefferson Youth Shoe Torch Red/Shell White US Size: C11 - Youth,FBALYB Amazon,157,157,0,0,0,0
,Native Jefferson Youth Shoe Torch Red/Shell White US Size: C13 - Youth,Native Jefferson Youth Shoe Torch Red/Shell White US Size: C13 - Youth,FBALYB Amazon,75,74,1,0,1,0
,Native Jefferson Youth Torch Red/Shell White US Size: C12,Native Jefferson Youth Torch Red/Shell White US Size: C12,Default Ridgefield,1,1,0,0,0,0
,Native Jefferson Youth Torch Red/Shell White US Size: C12,Native Jefferson Youth Torch Red/Shell White US Size: C12,FBALYB Amazon,53,53,0,0,0,0
,Natrol Alpha Lipoic Acid Capsules 600mg 30 Count 3pk,Natrol Alpha Lipoic Acid Capsules 600mg 30 Count 3pk,FBALYB Amazon,-1,-1,0,0,0,0
,Natrol BioBeads Probiotic 90ct,Natrol BioBeads Probiotic 90ct,FBALYB Amazon,4,4,0,2,0,0
,Natrol Biotin 5000 mcg 250ct,Natrol Biotin 5000 mcg 250ct,FBALYB Amazon,-33,-33,0,32,0,0
,Natrol Biotin 5000 mcg 250ct 2pack,Natrol Biotin 5000 mcg 250ct 2pack,FBALYB Amazon,1,1,0,0,0,0
,Natrol CetylPure 120ct,Natrol CetylPure 120ct,FBALYB Amazon,-13,-13,0,11,0,0
,Natrol Melatonin 5mg 250ct 2pack,Natrol Melatonin 5mg 250ct 2pack,FBALYB Amazon,-1,-1,0,0,0,0
,Natural Balance Brown Rice & Lamb 14oz 2pk,Natural Balance Brown Rice & Lamb 14oz 2pk,FBALYB Amazon,-3,-3,0,0,0,0
,Natural Balance Brown Rice & Lamb 8oz 2pk,Natural Balance Brown Rice & Lamb 8oz 2pk,FBALYB Amazon,52,52,0,0,0,0
,Natural Balance Lamb/BRice 13oz,Natural Balance Lamb/BRice 13oz,Default,0,0,0,0,0,24
,Natural Balance Potato & Duck 28oz 2pk,Natural Balance Potato & Duck 28oz 2pk,FBALYB Amazon,-5,-5,0,6,0,0
,Natural Balance Potato & Duck 8oz,Natural Balance Potato & Duck 8oz,FBALYB Amazon,60,60,0,0,0,0
,Natural Balance Potato & Duck 8oz 2pk,Natural Balance Potato & Duck 8oz 2pk,FBALYB Amazon,32,32,0,0,0,0
,Natural Balance Sweet Potato & Bison 14oz,Natural Balance Sweet Potato & Bison 14oz ,Default,0,0,0,0,0,9
,Natural Balance Sweet Potato & Bison 14oz 2pk,Natural Balance Sweet Potato & Bison 14oz 2pk,FBALYB Amazon,-2,-2,0,0,0,0
,Natural Balance Sweet Potato & Chicken 14oz 2pk,Natural Balance Sweet Potato & Chicken 14oz 2pk,FBALYB Amazon,1,1,0,0,0,0
,Natural Balance Sweet Potato & Chicken 8oz 2pk,Natural Balance Sweet Potato & Chicken 8oz 2pk,Default,-4,-4,0,0,0,0
,Natural Balance Sweet Potato & Chicken 8oz 2pk,Natural Balance Sweet Potato & Chicken 8oz 2pk,FBALYB Amazon,-1,-1,0,0,0,0
,Natural Balance Sweet Potato & Fish 14oz 2pk,Natural Balance Sweet Potato & Fish 14oz 2pk,Default,-55,-55,0,0,0,0
,Natural Balance Sweet Potato & Fish 14oz 2pk,Natural Balance Sweet Potato & Fish 14oz 2pk,FBALYB Amazon,3,3,0,0,0,0
,Natural Balance Sweet Potato & Fish 8oz 2pk,Natural Balance Sweet Potato & Fish 8oz 2pk,FBALYB Amazon,6,6,0,0,0,0
,Natural Balance Sweet Potato & Venison 14oz,Natural Balance Sweet Potato & Venison 14oz ,Default,0,0,0,0,0,96
,Natural Balance Sweet Potato & Venison 14oz 2pk,Natural Balance Sweet Potato & Venison 14oz 2pk,FBALYB Amazon,2,2,0,0,0,0
,Natural Balance Sweet Potato & Venison 8oz 2pk,Natural Balance Sweet Potato & Venison 8oz 2pk,Default,-5,-5,0,0,0,0
,Natural Balance Variety 8oz 3pk,"Natural Balance Variety 8oz 3pk (Bison, Duck, Chicken)",FBALYB Amazon,3,3,0,0,0,0
,Natural Chemistry Flea/Tick Shampoo 16oz,Natural Chemistry Flea/Tick Shampoo 16oz,FBALYB Amazon,-1,-1,0,0,0,0
,Natural Chemistry Flea/Tick Spray 24oz,Natural Chemistry Flea/Tick Spray 24oz,FBALYB Amazon,14,14,0,0,0,0
,Natural Chemistry Habitat Cleaner Deodorizer 1gal,Natural Chemistry Habitat Cleaner Deodorizer 1gal,FBALYB Amazon,13,13,0,0,0,0
,Natural Chemistry Healthy Habitat Cleaner 24oz,Natural Chemistry Healthy Habitat Cleaner 24oz,Default,0,0,0,0,0,6
,Natural Chemistry Healthy Habitat Cleaner 24oz,Natural Chemistry Healthy Habitat Cleaner 24oz,FBALYB Amazon,8,8,0,0,0,0
,Natural Flea/Tick Oatmeal Shampoo 16oz,Natural Flea/Tick Oatmeal Shampoo 16oz,FBALYB Amazon,-1,-1,0,0,0,0
,Natural Forest Tortoise Food 60Oz,Natural Forest Tortoise Food 60Oz,Default,0,0,0,0,0,10
,Natural Forest Tortoise Food 60Oz,Natural Forest Tortoise Food 60Oz,FBALYB Amazon,0,0,0,6,0,0
,Natural Henna Cream Dark Brown 6pk,Natural Henna Cream Dark Brown 6pk,FBALYB Amazon,4,4,0,0,0,0
,Nature Bounty Hair Skin Nails 150,Nature Bounty Hair Skin Nails 150,FBALYB Amazon,-2,-2,0,0,0,0
,Nature Bounty Hair Skin Nails 230 Gummies,Nature Bounty Hair Skin Nails 230 Gummies,Default,0,0,0,0,0,18
,Nature Bounty Hair Skin Nails 230 Gummies,Nature Bounty Hair Skin Nails 230 Gummies,FBALYB Amazon,-5,-5,0,0,0,0
,Nature Bounty Hair Skin Nails 230 Gummies 2pk,Nature Bounty Hair Skin Nails 230 Gummies 2pk,FBALYB Amazon,1,1,0,0,0,0
,Nature Bounty Hair Skin Nails 250,Nature Bounty Hair Skin Nails 250 ,FBALYB Amazon,0,-2,2,0,2,0
,Nature Made B12 400ct,Nature Made B12 400ct,FBALYB Amazon,-13,-23,10,0,10,0
,"Nature Made Balanced CoQ10, 90 ct.","Nature Made Balanced CoQ10, 90 ct.",FBALYB Amazon,-2,-2,0,1,0,0
,Nature Made Biotin 5000 250ct,Nature Made Biotin 5000 250ct,FBALYB Amazon,-1,-4,3,0,3,0
,Nature Made Burpless Fish Oil 1200mg,Nature Made Burpless Fish Oil 1200mg ,FBALYB Amazon,-5,-5,0,1,0,0
,Nature Made Calcium 750mg+D+K 300ct,Nature Made Calcium 750mg+D+K 300ct,Avrami - Ebay,36,36,0,0,0,0
,Nature Made Calcium 750mg+D+K 300ct,Nature Made Calcium 750mg+D+K 300ct,FBALYB Amazon,197,195,2,0,2,0
,Nature Made Calcium 750mg+D+K 300ct,Nature Made Calcium 750mg+D+K 300ct,WFS,-48,-48,0,0,0,0
,Nature Made CholestOff 240caplets,Nature Made CholestOff 240caplets,FBALYB Amazon,-8,-35,27,0,27,0
,Nature Made CholestOff 240caplets 2pk,Nature Made CholestOff 240caplets 2pk,FBALYB Amazon,-16,-17,1,0,1,0
,Nature Made CholestOff Plus 200softgels,Nature Made CholestOff Plus 200softgels,FBALYB Amazon,80,80,0,0,0,0
,Nature Made CholestOff Plus 200softgels 2pk,Nature Made CholestOff Plus 200softgels 2pk,FBALYB Amazon,60,59,1,0,1,0
,Nature Made CoQ10 140 2pk,Nature Made CoQ10 140 2pk,FBALYB Amazon,-4,-4,0,0,0,0
,Nature Made CoQ10 140ct,Nature Made CoQ10 140ct,Default,0,0,0,0,0,120
,Nature Made CoQ10 150 Gummies,Nature Made CoQ10 150 Gummies,FBALYB Amazon,155,155,0,0,0,0
,Nature Made Cranberry 180ct,Nature Made Cranberry 180ct,FBALYB Amazon,9,9,0,0,0,0
,Nature Made Diabetes Health Pack 60,Nature Made Diabetes Health Pack 60,FBALYB Amazon,184,184,0,0,0,0
,Nature Made Diabetes Health Pack 60 2pk,Nature Made Diabetes Health Pack 60 2pk,FBALYB Amazon,-123,-123,0,0,0,0
,Nature Made Fish Oil 200ct,Nature Made Fish Oil 200ct,Default,0,0,0,0,0,355
,Nature Made Fish Oil 200ct,Nature Made Fish Oil 200ct,FBALYB Amazon,-9,-9,0,2,0,0
,Nature Made Fish Oil 200ct 2pk,Nature Made Fish Oil 200ct 2pk,FBALYB Amazon,1,1,0,1,0,0
,"Nature Made Flaxseed Oil 1400 mg., 300 Softgels","Nature Made Flaxseed Oil 1400 mg., 300 Softgels",FBALYB Amazon,140,139,1,14,1,0
,"Nature Made Hair, Skin and Nails 220 ct.","Nature Made Hair, Skin and Nails 220 ct.",FBALYB Amazon,-7,-10,3,11,3,0
,Nature Made Hair/Skin/Nails Gummy 250 ct,Nature Made Hair/Skin/Nails Gummy 250 ct,FBALYB Amazon,-2,-2,0,1,0,0
,"Nature Made Iron 65 mg Tablets, 365 Ct","Nature Made Iron 65 mg Tablets, 365 Ct",Default,1,1,0,0,0,0
,"Nature Made Iron 65 mg Tablets, 365 Ct","Nature Made Iron 65 mg Tablets, 365 Ct",FBALYB Amazon,-20,-20,0,0,0,0
,Nature Made Magnesium 150 3pk,Nature Made Magnesium 150 3pk,FBALYB Amazon,-54,-54,0,54,0,0
,Nature Made Magnesium 150 Softgels 2pk,Nature Made Magnesium 150 Softgels 2pk,FBALYB Amazon,480,479,1,23,1,0
,Nature Made Melatonin 250ct,Nature Made Melatonin 250ct,FBALYB Amazon,-17,-24,7,0,7,0
,Nature Made Multi for Her 300ct,Nature Made Multi for Her 300ct,Default,0,-8,8,0,0,0
,Nature Made Multi for Her 300ct,Nature Made Multi for Her 300ct,FBALYB Amazon,110,109,1,40,1,0
,Nature Made Multi for Her 300ct,Nature Made Multi for Her 300ct,WFS,-3,-3,0,0,0,0
,"Nature Made Multi For Him Tablets, 300 ct.","Nature Made Multi For Him Tablets, 300 ct.",Avrami - Ebay,70,70,0,0,0,0
,"Nature Made Multi For Him Tablets, 300 ct.","Nature Made Multi For Him Tablets, 300 ct.",Default,0,-660,660,0,0,0
,"Nature Made Multi For Him Tablets, 300 ct.","Nature Made Multi For Him Tablets, 300 ct.",Default Ridgefield,31,23,8,0,0,0
,"Nature Made Multi For Him Tablets, 300 ct.","Nature Made Multi For Him Tablets, 300 ct.",FBALYB Amazon,390,390,0,1,0,0
,"Nature Made Multi For Him Tablets, 300 ct.","Nature Made Multi For Him Tablets, 300 ct.",WFS,-222,-222,0,0,0,0
,Nature Made Omega 3 Fish Oil 130ct,Nature Made Omega 3 Fish Oil 130ct,Avrami - Ebay,50,50,0,0,0,0
,Nature Made Omega 3 Fish Oil 130ct,Nature Made Omega 3 Fish Oil 130ct,Default Ridgefield,50,50,0,0,0,0
,Nature Made Omega 3 Fish Oil 130ct,Nature Made Omega 3 Fish Oil 130ct,FBALYB Amazon,-65,-98,33,282,33,0
,Nature Made Omega 3 Fish Oil 130ct,Nature Made Omega 3 Fish Oil 130ct,WFS,-195,-195,0,0,0,0
,NatureMade Omega-3 Xtra Absorb 80,NatureMade Omega-3 Xtra Absorb 80,FBALYB Amazon,2,2,0,0,0,0
,Nature Made Prenatal DHA,Nature Made Prenatal DHA,FBALYB Amazon,-24,-24,0,0,0,0
,Nature Made Probiotic 90ct,Nature Made Probiotic 90ct,FBALYB Amazon,-10,-10,0,11,0,0
,Nature Made Sam-e 60 2Pack,Nature Made Sam-e 60 2Pack,FBALYB Amazon,-1,-1,0,0,0,0
,Nature Made Super B‑Complex 460 ct,"Nature Made Super B‑Complex, Tablets ‑ 460 count",FBALYB Amazon,130,130,0,46,0,0
,Nature Made Super B‑Complex 460 ct 2pk,Nature Made Super B‑Complex 460 ct 2pk,FBALYB Amazon,216,216,0,0,0,0
,Nature Made Super C Immune 200ct,Nature Made Super C Immune 200ct,Default Oxford,0,-1,1,0,0,0
,Nature Made Super C Immune 200ct,Nature Made Super C Immune 200ct,Default Ridgefield,0,-282,282,0,0,0
,Nature Made Super C Immune 200ct,Nature Made Super C Immune 200ct,FBALYB Amazon,-2,-2,0,1,0,0
,NATURE MADE TRIPLE FLEX 170CT,NATURE MADE TRIPLE FLEX 170CT,Default Ridgefield,0,-179,179,0,179,0
,Nature Made TripleFlex 200ct,Nature Made TripleFlex 200ct,Default,1,1,0,0,0,0
,Nature Made TripleFlex 200ct,Nature Made TripleFlex 200ct,FBALYB Amazon,-1,-1,0,0,0,0
,Nature Made Vitamin C 1000mg 365ct,Nature Made Vitamin C 1000mg 365ct,FBALYB Amazon,465,465,0,0,0,0
,Nature Made Vitamin C 1000mg 365ct,Nature Made Vitamin C 1000mg 365ct,WFS,54,54,0,0,0,0
,"Nature Made Vitamin C Adult Gummies, 200 ct.","Nature Made Vitamin C Adult Gummies, 200 ct.",Default,0,-97,97,0,0,0
,"Nature Made Vitamin C Adult Gummies, 200 ct.","Nature Made Vitamin C Adult Gummies, 200 ct.",FBALYB Amazon,-3,-4,1,2,1,0
,Nature Made Vitamin D3 300ct,Nature Made Vitamin D3 300ct,FBALYB Amazon,521,514,7,1,7,0
,Nature Made Vitamin D3 320 ct.,Nature Made Vitamin D3 320 ct.,Default,0,-198,198,0,0,0
,Nature Made Vitamin D3 320 ct.,Nature Made Vitamin D3 320 ct.,Default Ridgefield,0,-405,405,0,0,0
,Nature Made Vitamin D3 320 ct.,Nature Made Vitamin D3 320 ct.,FBALYB Amazon,-42,-84,42,10,42,0
,Nature Made Vitamin D-3 5000IU 220 Count Softgels,Nature Made Vitamin D-3 5000IU 220 Count Softgels,FBALYB Amazon,1,-4,5,0,5,0
,Nature Made Vitamin D3 600 softgels,Nature Made Vitamin D3 600 softgels,Default Ridgefield,-7,-7,0,0,0,0
,Nature Made Vitamin D3 600 softgels,Nature Made Vitamin D3 600 softgels,FBALYB Amazon,176,172,4,0,4,0
,Nature Made Vitamin D3 650CT,Nature Made Vitamin D3 650CT,FBALYB Amazon,-7,-7,0,0,0,0
,Nature Made Vitamin D3 650CT 2pk,Nature Made Vitamin D3 650CT 2pk,FBALYB Amazon,80,80,0,57,0,0
,Nature Made Vitamin D3 Adult Gummies,Nature Made Vitamin D3 Adult Gummies ‑ 275 Gummies,FBALYB Amazon,170,169,1,0,1,0
,Nature Made Water Vitamin E 350 ct,Nature Made Water Vitamin E 350 ct,Default,1,1,0,0,0,0
,Nature Made Water Vitamin E 350 ct,Nature Made Water Vitamin E 350 ct,FBALYB Amazon,-6,-6,0,2,0,0
,Nature's Bounty Cranberry 120ct,Nature's Bounty Cranberry 120ct,Default,0,0,0,0,0,20
,Nature's Bounty Fish Oil 130 Softgels 2pk,Nature's Bounty Fish Oil 130 Softgels 2pk,FBALYB Amazon,-2,-2,0,0,0,0
,Natures Bounty Fish Oil 2400 mg 2pk,Natures Bounty Fish Oil 2400 mg 2pk,FBALYB Amazon,28,28,0,0,0,0
,Nature's Bounty Liquid B Complex 2oz,Nature's Bounty Liquid B Complex 2oz,FBALYB Amazon,5,5,0,0,0,0
,Nature's Bounty Liquid B Complex 2oz 4PK,Nature's Bounty Liquid B Complex 2oz 4PK,FBALYB Amazon,-2,-2,0,0,0,0
,"Nature's Bounty Ultra Probiotic 10, 140ct","Nature's Bounty Ultra Probiotic 10, 140ct",Default,0,0,0,0,0,15
,"Nature's Bounty Ultra Probiotic 10, 140ct","Nature's Bounty Ultra Probiotic 10, 140ct",FBALYB Amazon,-2,-2,0,0,0,0
,Nature's Bounty Vitamin B-12,Nature's Bounty Quick Dissolve Fast Acting 2500 mcg Vitamin B-12 Methylcobalamin Natural Cherry Flavor (300 tablets),FBALYB Amazon,-4,-4,0,0,0,0
,Nature's Bounty Vitamin B-12 2pk,Nature's Bounty Vitamin B-12 2pk,FBALYB Amazon,-1,-1,0,0,0,0
,Nature's Miracle Advanced Dog Stain 128oz,Nature's Miracle Advanced Dog Stain 128oz,FBALYB Amazon,51,51,0,26,0,0
,"Nature's Miracle Calming Spray, 8oz","Nature's Miracle Just For Cats Calming Spray, 8‑oz bottle",Default,0,-100,100,0,0,0
,"Nature's Miracle Calming Spray, 8oz","Nature's Miracle Just For Cats Calming Spray, 8‑oz bottle",FBALYB Amazon,295,295,0,0,0,0
,Nature's Miracle Cats Advanced Stain 128oz,Nature's Miracle Cats Advanced Stain 128oz,FBALYB Amazon,-6,-6,0,3,0,0
,Nature's Miracle Cat Stain & Odor Remover 128oz,Nature's Miracle Cat Stain & Odor Remover 128oz,Default Ridgefield,2,2,0,0,0,0
,Nature's Miracle Cat Stain & Odor Remover 128oz,Nature's Miracle Cat Stain & Odor Remover 128oz,FBALYB Amazon,4,4,0,0,0,0
,Nature's Miracle Charcoal Filter 2ct,Nature's Miracle Charcoal Filter 2ct,FBALYB Amazon,2,2,0,0,0,0
,Nature's Miracle Charcoal Filter 2ct 3pk,Nature's Miracle Charcoal Filter 2ct 3pk,FBALYB Amazon,-1,-1,0,0,0,0
,Nature's Miracle Dog Stain & Odor Remover 128oz,Nature's Miracle Dog Stain & Odor Remover 128oz,FBALYB Amazon,-5,-5,0,7,0,0
,Nature's Miracle Dog Stain & Odor Remover 24oz 2pk,Nature's Miracle Dog Stain & Odor Remover 24oz 2pk,FBALYB Amazon,15,15,0,0,0,0
,Nature's Miracle Dog Urine Accushot 1.3gal,Nature's Miracle Dog Urine Accushot 1.3gal,FBALYB Amazon,9,9,0,0,0,0
,Nature's Miracle Hard Floor Cleaner 24oz 2pk,Nature's Miracle Hard Floor Cleaner 24oz 2pk,FBALYB Amazon,-1,-1,0,0,0,0
,Nature's Miracle Just for Cats Litter Box Odor Destroyer Powder - 20 oz,Nature's Miracle Just for Cats Litter Box Odor Destroyer Powder - 20 oz,Default Ridgefield,18,18,0,0,0,0
,Nature's Miracle No More Marking 24oz,Nature's Miracle No More Marking 24oz,FBALYB Amazon,1,1,0,0,0,0
,Nature's Miracle Pick-Up Refill Bags,Nature's Miracle Pick-Up Refill Bags,FBALYB Amazon,-36,-36,0,0,0,0
,Nature's Miracle Pick-Up Refill Bags 2pk,Nature's Miracle Pick-Up Refill Bags 2pk,FBALYB Amazon,1,1,0,0,0,0
,Nature's Miracle Stain Remover,Nature's Miracle Stain and Odor Remover 170oz,FBALYB Amazon,-1,-1,0,0,0,0
,Nature's Miracle Urine Destroyer 128oz,Nature's Miracle Urine Destroyer 128oz,FBALYB Amazon,3,3,0,0,0,0
,Nature's Truth Cherry Extract 1200mg 90ct 2pk,Nature's Truth Cherry Extract 1200mg 90ct 2pk,FBALYB Amazon,1,1,0,0,0,0
,Nature's Truth Fish Oil 1200mg 120ct 3pk,Nature's Truth Fish Oil 1200mg 120ct 3pk,FBALYB Amazon,45,45,0,0,0,0
,Nature's Way Joint Movement Glucosamine 33 servings,Nature's Way Joint Movement Glucosamine 33 servings,Avrami - Ebay,1,1,0,0,0,0
,Nature's Way Joint Movement Glucosamine 33 servings,Nature's Way Joint Movement Glucosamine 33 servings,Default,0,-288,288,0,0,0
,Nature's Way Joint Movement Glucosamine 33 servings,Nature's Way Joint Movement Glucosamine 33 servings,Default Oxford,80,80,0,0,0,0
,Nature's Way Joint Movement Glucosamine 33 servings,Nature's Way Joint Movement Glucosamine 33 servings,Default Ridgefield,201,9,192,0,0,0
,Nature's Way Joint Movement Glucosamine 33 servings,Nature's Way Joint Movement Glucosamine 33 servings,FBALYB Amazon,101,88,13,0,13,0
,Nature's Way Joint Movement Glucosamine 33 servings,Nature's Way Joint Movement Glucosamine 33 servings,WFS,356,356,0,0,0,0
,Nature's Way Joint Movement Glucosamine 33 servings 2PK,Nature's Way Joint Movement Glucosamine 33 servings 2PK,FBALYB Amazon,0,0,0,361,0,0
,Nature Valley H & O 49ct,Nature Valley Honey & Oat Granola Bars 49 CT,FBALYB Amazon,8,8,0,0,0,0
,Nature Valley Peanut,Nature's Valley Sweet and Salty Granola Bars Peanut ,FBALYB Amazon,1,1,0,0,0,0
,Nature Valley Sweet/Salty 36 bars,"Nature Valley Sweet/Salty 36 bars (8 d.choc nut, 10 almond, 18 peanut)",Default,0,0,0,0,0,50
,Nature Valley Sweet/Salty 36 bars,"Nature Valley Sweet/Salty 36 bars (8 d.choc nut, 10 almond, 18 peanut)",FBALYB Amazon,255,254,1,10,1,0
,Nature Valley Sweet&Salty 48ct,"Nature Valley Sweet & Salty Nut Granola Bar, Almond, 1.2 oz (48 Bars)",Default,0,0,0,0,0,5
,Nature Valley Sweet&Salty 48ct,"Nature Valley Sweet & Salty Nut Granola Bar, Almond, 1.2 oz (48 Bars)",FBALYB Amazon,1,1,0,0,0,0
,Nautica Polo Large 1BWKC8107,Nautica Polo Large 1BWKC8107,FBASKCK Amazon,50,50,0,0,0,0
,Nautica Polo Large 1BWKC8117,Nautica Polo Large 1BWKC8117,Default,0,0,0,0,0,2
,Nautica Polo Large 1BWKC8117,Nautica Polo Large 1BWKC8117,FBASKCK Amazon,35,35,0,0,0,0
,Nautica Polo Large 4TNKC8117,Nautica Polo Large 4TNKC8117,Default,0,0,0,0,0,1
,Nautica Polo Large 4TNKC8117,Nautica Polo Large 4TNKC8117,FBASKCK Amazon,60,60,0,0,0,0
,Nautica Polo Medium 1BWKC8107,Nautica Polo Medium 1BWKC8107,FBASKCK Amazon,35,35,0,0,0,0
,Nautica Polo Medium 1BWKC8117,Nautica Polo Medium 1BWKC8117,FBASKCK Amazon,33,33,0,0,0,0
,Nautica Polo Medium 4TNKC8117,Nautica Polo Medium 4TNKC8117,FBASKCK Amazon,46,46,0,0,0,0
,Nautica Polo X-Large 1BWKC8107,Nautica Polo X-Large 1BWKC8107,FBASKCK Amazon,30,30,0,0,0,0
,Nautica Polo X-Large 1BWKC8117,Nautica Polo X-Large 1BWKC8117,Default,0,0,0,0,0,1
,Nautica Polo X-Large 1BWKC8117,Nautica Polo X-Large 1BWKC8117,FBASKCK Amazon,22,22,0,0,0,0
,Nautica Polo X-Large 4TNKC8117,Nautica Polo X-Large 4TNKC8117,FBASKCK Amazon,23,23,0,0,0,0
,Nautica Polo X Large 6NRKC8107,Nautica Polo X Large 6NRKC8107,Default,0,0,0,0,0,1
,Nautica Polo XX-Large 1BWKC8117,Nautica Polo XX-Large 1BWKC8117,FBASKCK Amazon,9,9,0,0,0,0
,Nautica Polo XX-Large 4TNKC8117,Nautica Polo XX-Large 4TNKC8117,FBASKCK Amazon,10,10,0,0,0,0
,"Nautica T-Shirt Crew Neck Stretch Super Soft Cotton BLACK 3 PACK, S","Nautica T-Shirt Crew Neck Stretch Super Soft Cotton BLACK 3 PACK, S",Default Ridgefield,11,11,0,0,0,0
,"Nautica T-Shirt Crew Neck Stretch Super Soft Cotton White 3 PACK, L","Nautica T-Shirt Crew Neck Stretch Super Soft Cotton White 3 PACK, L",Default Ridgefield,17,17,0,0,0,0
,"Nautica T-Shirt Crew Neck Stretch Super Soft Cotton White 3 PACK, S","Nautica T-Shirt Crew Neck Stretch Super Soft Cotton White 3 PACK, S",Default Ridgefield,25,25,0,0,0,0
,"Nautica T-Shirt Tagless Crew Neck Stretch Super Soft Cotton BLACK 3 PACK, M","Nautica T-Shirt Tagless Crew Neck Stretch Super Soft Cotton BLACK 3 PACK, M",Default Ridgefield,59,59,0,0,0,0
,"Nautica T-Shirt Tagless Crew Neck Stretch Super Soft Cotton White 3 PACK, M","Nautica T-Shirt Tagless Crew Neck Stretch Super Soft Cotton White 3 PACK, M",Default Ridgefield,108,108,0,0,0,0
,Navy Go walk Slip on 7,Navy Go walk Slip on 7,FBALYB Amazon,0,0,0,1,0,0
,Navy Go walk Slip on 7.5,Navy Go walk Slip on 7.5,FBALYB Amazon,1,0,1,0,1,0
,Navy Go walk Slip on 8,Navy Go walk Slip on 8,FBALYB Amazon,0,0,0,2,0,0
,Navy Go walk Slip on 8.5,Navy Go walk Slip on 8.5,FBALYB Amazon,-1,-1,0,0,0,0
,Neato Botvac D505 Pet & Allergy Robotic Vacuum,Neato Botvac D505 Pet & Allergy Robotic Vacuum,FBALYB Amazon,11,11,0,0,0,0
,Neato Botvac Robotic Vacuum,Neato Botvac D303 Pet & Allergy Robotic Vacuum,FBALYB Amazon,25,25,0,0,0,0
,Neato Robotics - Botvac - Black,Neato Robotics - Botvac Connected App-Controlled Self-Charging Robot Vacuum - Black,Default,0,0,0,0,0,1
,Neato Robotics - Botvac - Black,Neato Robotics - Botvac Connected App-Controlled Self-Charging Robot Vacuum - Black,FBALYB Amazon,-1,-1,0,0,0,0
,NeilMed Sinus Rinse,NeilMed Sinus Rinse,Default Ridgefield,30,-984,1014,0,0,0
,Neil Med Sinus Rinse 200 ct + 1 Bottle,Neil Med Sinus Rinse 200 ct + 1 Bottle,Avrami - Ebay,180,180,0,0,0,0
,Neil Med Sinus Rinse 200 ct + 1 Bottle,Neil Med Sinus Rinse 200 ct + 1 Bottle,Default Oxford,192,192,0,0,0,0
,Neil Med Sinus Rinse 200 ct + 1 Bottle,Neil Med Sinus Rinse 200 ct + 1 Bottle,FBALYB Amazon,241,239,2,0,2,0
,NeoCell Clgn SChews FP 2000mg 2PK,NeoCell Clgn SChews FP 2000mg 2PK,FBALYB Amazon,28,26,2,0,2,0
,NeoCell Super Collagen + C 360ct,NeoCell Super Collagen + C 360ct,FBALYB Amazon,305,305,0,1,0,0
,Neosporin Ointment Variety Pack,Neosporin First Aid Antibiotic Ointment Variety Pack,Default,0,0,0,0,0,2
,Neosporin Ointment Variety Pack,Neosporin First Aid Antibiotic Ointment Variety Pack,FBALYB Amazon,-8,-8,0,2,0,0
,Neptune's Harvest Fish/Seaweed 36oz,Neptune's Harvest Fish And Seaweed Fertilizer Blend - Blue Label - 36 Oz,FBALYB Amazon,3,3,0,0,0,0
,Nerf Laser OPS Alphapoint E2280EU40,Nerf Laser OPS Alphapoint E2280EU40,FBALYB Amazon,-22,-22,0,0,0,0
,Nerf Modulus Shadow ICS 6 Blaster,Nerf Modulus Shadow ICS 6 Blaster,Default Ridgefield,2516,2516,0,0,0,0
,Nerf Modulus Shadow ICS 6 Blaster,Nerf Modulus Shadow ICS 6 Blaster,FBALYB Amazon,77,61,16,14,16,0
,Nerf N‑Strike Elite,Nerf N‑Strike Elite RayvenFire Blaster,Default,0,0,0,0,0,10
,Nerf N-Strike Elite Disruptor,Nerf N-Strike Elite Disruptor,Default,0,0,0,0,0,46
,Nerf N-Strike Elite Disruptor,Nerf N-Strike Elite Disruptor,Default Ridgefield,2,-18,20,0,0,0
,Nerf N-Strike Elite Disruptor,Nerf N-Strike Elite Disruptor,FBALYB Amazon,6,0,6,0,6,0
,Nerf N‑Strike Elite SurgeFire,Nerf N‑Strike Elite SurgeFire Includes 45 Elite Darts,Default,0,-1,1,0,0,3
,Nerf Zombie Strike Deco Darts,,FBALYB Amazon,-180,-183,3,6,3,0
,Nerf Zombie Strike Outbreaker Bow,Nerf Zombie Strike Outbreaker Bow,Default,0,-200,200,0,0,0
,Nerf Zombie Strike Outbreaker Bow,Nerf Zombie Strike Outbreaker Bow,FBALYB Amazon,-16,-16,0,0,0,0
,Nescafe 8's Cappuccino 3 pk,Nescafe 8's Cappuccino 3 pk,FBALYB Amazon,18,15,3,1,3,0
,Nescafe Dolce Gusto Americano 16 caps,Nescafe Dolce Gusto Americano 16 caps,Default Ridgefield,4324,4324,0,0,0,0
,Nescafe Dolce Gusto Americano 16 caps,Nescafe Dolce Gusto Americano 16 caps,FBALYB Amazon,129,129,0,0,0,0
,Nescafe Dolce Gusto Americano 16 caps 3pk,Nescafe Dolce Gusto Americano 16 caps 3pk,FBALYB Amazon,515,487,28,20,28,0
,Nescafe Dolce Gusto Americano 16 caps 3pk,Nescafe Dolce Gusto Americano 16 caps 3pk,FBALYB Canada,0,0,0,50,0,0
,Nescafe Dolce Gusto Americano Intenso Coffee Pods 16 Caps,Nescafe Dolce Gusto Americano Intenso Coffee Pods 16 Caps,Default,0,0,0,0,0,261
,Nescafe Dolce Gusto Americano Intenso Coffee Pods 16 Caps,Nescafe Dolce Gusto Americano Intenso Coffee Pods 16 Caps,FBALYB Amazon,114,114,0,0,0,0
,Nescafe Dolce Gusto Americano Intenso Coffee Pods 16 Caps 3pk,Nescafe Dolce Gusto Americano Intenso Coffee Pods 16 Caps 3pk,FBALYB Amazon,115,86,29,140,29,0
,Nescafé Dolce Gusto Nesquik 3pk 48ct,Nescafé Dolce Gusto Nesquik 3pk 48ct,FBAAP Amazon,0,-144,144,0,0,0
,Nescafé Dolce Gusto Nesquik 3pk 48ct,Nescafé Dolce Gusto Nesquik 3pk 48ct,FBALYB Amazon,35,34,1,0,1,0
,Nescafe Dolce Gusto Skinny Cappuccino 16 caps,Nescafe Dolce Gusto Skinny Cappuccino 16 caps,Default Ridgefield,4464,4464,0,0,0,0
,Nescafe Dolce Gusto Skinny Cappuccino 16 caps 3PK,Nescafe Dolce Gusto Skinny Cappuccino 16 caps 3PK,FBALYB Amazon,400,396,4,85,4,0
,Nescafe Dolce Gusto Skinny Cappuccino 16 caps 3PK,Nescafe Dolce Gusto Skinny Cappuccino 16 caps 3PK,FBALYB Canada,-1,-1,0,50,0,0
,Nescafe Espresso 100g,Nescafe Espresso 100g,Avrami - Ebay,17,17,0,0,0,0
,Nescafe Espresso 100g,Nescafe Espresso 100g,FBALYB Amazon,192,191,1,0,1,0
,Nescafe Espresso 100g,Nescafe Espresso 100g,WFS,-26,-26,0,0,0,0
,Nescafe Espresso 3.50oz 3pack,Nescafe Espresso 3.50oz 3pack,FBALYB Amazon,3,-9,12,1,12,0
,Nescafe Espresso Coffee 2 Jars 3.5oz,Nescafe Espresso Coffee 2 Jars 3.5oz,FBALYB Amazon,4,-3,7,0,7,0
,Nescafe Gold Blend 100g,Nescafe Gold Blend 100g,Default,0,-864,864,0,0,0
,Nescafe Gold Blend Coffee 200g,Nescafe Gold Blend Coffee 200g,FBALYB Amazon,21,11,10,4,10,0
,Nescafe Gold Cappuccino 6pk,Nescafe Gold Cappuccino 6pk,FBALYB Amazon,2,2,0,0,0,0
,Nescafe Gold Cappuccino Unsweetened 8's 3pk,Nescafe Gold Cappuccino Unsweetened 8's 3pk,FBALYB Amazon,-7,-8,1,8,1,0
,Nescafe Gold Unsweetened packets 113.6g,Nescafe Gold Unsweetened packets 113.6g,Default Ridgefield,3,3,0,0,0,0
,Nescafe Instant Coffee Gold 100g 2pk,Nescafe Instant Coffee Gold 100g 2pk,FBALYB Amazon,-146,-146,0,159,0,0
,"Nescafe Taster's Choice, 12 oz - 3 Pack","Nescafe Taster's Choice, 12 oz - 3 Pack",FBALYB Amazon,-2,-2,0,1,0,0
,"Nescafe Taster's Choice, 12 oz - 6 Pack","Nescafe Taster's Choice, 12 oz - 6 Pack",FBALYB Amazon,3,3,0,0,0,0
,Nest Cam Indoor Security Camera,Nest Cam Indoor security camera,Default,0,0,0,0,0,1
,Nest Cam Outdoor Security Camera,Nest Cam Outdoor Security Camera,Default,0,0,0,0,0,1
,Nest Cam Outdoor Security Camera,Nest Cam Outdoor Security Camera,FBAAP Amazon,-1,-1,0,0,0,0
,Nestle After 8 mints 30 Mints 3pk,Nestle After 8 mints 30 Mints 3pk,FBALYB Amazon,50,50,0,0,0,0
,"Nestle After Eight, Dark Mint Thins 32oz Chocolate","Nestle After Eight, Dark Mint Thins 32oz Chocolate",FBALYB Amazon,-48,-48,0,0,0,0
,Nestle Carnation Hot Chocolate  40,Nestle Carnation Hot Chocolate  40 ,FBALYB Amazon,93,93,0,0,0,0
,Nestle Materna Prenatal 140ct,Nestle Materna Prenatal 140ct,Default,1,1,0,0,0,0
,Nestle Materna Prenatal 140ct,Nestle Materna Prenatal 140ct,FBALYB Amazon,-2,-2,0,0,0,0
,Nestle Pearsons Coffee Nips Box 4oz 12pk,Nestle Coffee Nips Box 4oz 12pk,FBALYB Amazon,-6,-6,0,6,0,0
,Neutrogena GrapefruitCleansing Wipes 2pk,Neutrogena GrapefruitCleansing Wipes 2pk,Default,0,-1,1,0,0,0
,Neutrogena GrapefruitCleansing Wipes 2pk,Neutrogena GrapefruitCleansing Wipes 2pk,FBALYB Amazon,-13,-32,19,1,19,0
,Neutrogena Grapefruit CleansingWipes 4pk,Neutrogena Grapefruit CleansingWipes 4pk,FBALYB Amazon,3,2,1,3,1,0
,Neutrogena Hydroboost 3oz 50 Spf,Neutrogena Hydroboost 3oz 50 Spf,Default Ridgefield,13,13,0,0,0,0
,Neutrogena Hydroboost 3oz 50 Spf,Neutrogena Hydroboost 3oz 50 Spf,FBALYB Amazon,1,1,0,1,0,0
,Neutrogena Hydroboost 3oz 50 Spf,Neutrogena Hydroboost 3oz 50 Spf,FBALYB Canada,1,1,0,0,0,0
,Neutrogena Hydroboost 3oz 50 Spf 2PK,Neutrogena Hydroboost 3oz 50 Spf 2PK,FBALYB Amazon,-2,-2,0,0,0,0
,Neutrogena Hydro Boost Cleanser Wipes (25 ct),Neutrogena Hydro Boost Cleanser Wipes (25 ct),Default Ridgefield,418,418,0,0,0,0
,Neutrogena HydroBoost CleanserWipes 3pk,Neutrogena HydroBoost CleanserWipes 3pk,Default,0,-144,144,0,0,0
,Neutrogena HydroBoost CleanserWipes 3pk,Neutrogena HydroBoost CleanserWipes 3pk,FBALYB Amazon,4,4,0,0,0,0
,Neutrogena Hydro Boost Gel Cream Hyaluronic Acid 47ml 2 Count,Neutrogena Hydro Boost Gel Cream Hyaluronic Acid 47ml 2 Count,Default Ridgefield,216,216,0,0,0,0
,Neutrogena Hydro Boost Gel Cream Hyaluronic Acid 47ml 2 Count,Neutrogena Hydro Boost Gel Cream Hyaluronic Acid 47ml 2 Count,FBALYB Amazon,57,57,0,0,0,0
,Neutrogena Makeup Remover Towelettes,Neutrogena Makeup Remover Towelettes,Default Ridgefield,260,260,0,0,0,0
,Neutrogena Makeup Remover Towelettes,Neutrogena Makeup Remover Towelettes,FBALYB Amazon,1,1,0,0,0,0
,Neutrogena Makeup Remover Wipes 132ct,Neutrogena Makeup Remover Wipes 132ct,Default Ridgefield,24,24,0,0,0,0
,Neutrogena Makeup Remover Wipes 25ct,Neutrogena Makeup Remover Wipes 25ct,Default Ridgefield,66,66,0,0,0,0
,Neutrogena Makeup Remover Wipes 25ct 4PK,Neutrogena Makeup Remover Wipes 25ct 4PK,FBALYB Amazon,94,89,5,34,5,0
,Neutrogena Makeup Remover Wipes 25ct 6 PK,Neutrogena Makeup Remover Wipes 25ct 6 PK,FBALYB Amazon,23,15,8,15,8,0
,Neutrogena Makeup Remover Wipes 25ct 8 PK,Neutrogena Makeup Remover Wipes 25ct 8 PK,Default,11,11,0,0,0,0
,Neutrogena Makeup Remover Wipes 25ct 8 PK,Neutrogena Makeup Remover Wipes 25ct 8 PK,FBALYB Amazon,-36,-37,1,10,1,0
,Neutrogena Make Up Remover Wipes 5pk,Neutrogena Make Up Remover Wipes 5pk,FBALYB Amazon,-126,-127,1,135,1,0
,Neutrogena Pink Grapefruit Wipes 6pk,Neutrogena Pink Grapefruit Wipes 6pk,FBALYB Amazon,15,15,0,17,0,0
,Neutrogena Rainbath 40 Oz 3pk,Neutrogena Rainbath 40 Oz 3pk,FBALYB Amazon,-1,-1,0,0,0,0
,Neutrogena Rainbath Bonus w/7ct Wipe Pallet,Neutrogena Rainbath Bonus w/7ct Wipe Pallet,FBALYB Amazon,-520,-520,0,520,0,0
,Neutrogena Rainbath refreshing 40 oz 2pk,Neutrogena Rainbath refreshing 40 oz 2pk,FBALYB Amazon,-2,-2,0,0,0,0
,Neutrogena Rainbath Variety 3pk,Neutrogena Rainbath Variety 3pk,FBALYB Amazon,-6,-6,0,0,0,0
,Neutrogena Travel pack 7ct,Neutrogena Travel pack 7ct ,Default,0,-4500,4500,0,0,0
,Neutrogena Travel pack 7ct,Neutrogena Travel pack 7ct ,Default Ridgefield,231,231,0,0,0,0
,Neutrogena Visibly Clear Pink Grapefruit Medicated Wipes,Neutrogena Visibly Clear Pink Grapefruit Medicated Wipes,Default,0,-648,648,0,0,0
,Neutrogena Visibly Clear Pink Grapefruit Medicated Wipes,Neutrogena Visibly Clear Pink Grapefruit Medicated Wipes,Default Ridgefield,58,58,0,0,0,0
,Neutrogena Visibly Clear Pink Grapefruit Medicated Wipes 3pk,Neutrogena Visibly Clear Pink Grapefruit Medicated Wipes 3pk,FBALYB Amazon,3,3,0,7,0,0
,New Balance Men L3000BK5 Fresh Foam 3000v5 Black/White Size 10,New Balance Men L3000BK5 Fresh Foam 3000v5 Black/White Size 10,FBALYB Amazon,17,17,0,0,0,0
,New Balance Men L3000BK5 Fresh Foam 3000v5 Black/White Size 10.5,New Balance Men L3000BK5 Fresh Foam 3000v5 Black/White Size 10.5,FBALYB Amazon,-8,-8,0,0,0,0
,New Balance Men L3000BK5 Fresh Foam 3000v5 Black/White Size 11,New Balance Men L3000BK5 Fresh Foam 3000v5 Black/White Size 11,FBALYB Amazon,-5,-6,1,0,1,0
,New Balance Men L3000BK5 Fresh Foam 3000v5 Black/White Size 11.5,New Balance Men L3000BK5 Fresh Foam 3000v5 Black/White Size 11.5,FBALYB Amazon,9,8,1,0,1,0
,New Balance Men L3000BK5 Fresh Foam 3000v5 Black/White Size 12,New Balance Men L3000BK5 Fresh Foam 3000v5 Black/White Size 12,FBALYB Amazon,12,12,0,0,0,0
,New Balance Men L3000BK5 Fresh Foam 3000v5 Black/White Size 13,New Balance Men L3000BK5 Fresh Foam 3000v5 Black/White Size 13,FBALYB Amazon,11,11,0,0,0,0
,New Balance Men L3000BK5 Fresh Foam 3000v5 Black/White Size 8.5,New Balance Men L3000BK5 Fresh Foam 3000v5 Black/White Size 8.5,Default Ridgefield,15,15,0,0,0,0
,New Balance Men L3000BK5 Fresh Foam 3000v5 Black/White Size 9,New Balance Men L3000BK5 Fresh Foam 3000v5 Black/White Size 9,Default Ridgefield,2,2,0,0,0,0
,New Balance Men L3000BK5 Fresh Foam 3000v5 Black/White Size 9,New Balance Men L3000BK5 Fresh Foam 3000v5 Black/White Size 9,FBALYB Amazon,-1,-1,0,0,0,0
,New Balance Men L3000BK5 Fresh Foam 3000v5 Black/White Size 9.5,New Balance Men L3000BK5 Fresh Foam 3000v5 Black/White Size 9.5,FBALYB Amazon,5,5,0,0,0,0
,New Balance Men L3000MW5 Fresh Foam 3000v5 Maroon/White Size 10,New Balance Men L3000MW5 Fresh Foam 3000v5 Maroon/White Size 10,FBALYB Amazon,40,40,0,0,0,0
,New Balance Men L3000MW5 Fresh Foam 3000v5 Maroon/White Size 10.5,New Balance Men L3000MW5 Fresh Foam 3000v5 Maroon/White Size 10.5,FBALYB Amazon,40,40,0,0,0,0
,New Balance Men L3000MW5 Fresh Foam 3000v5 Maroon/White Size 11,New Balance Men L3000MW5 Fresh Foam 3000v5 Maroon/White Size 11,FBALYB Amazon,38,38,0,0,0,0
,New Balance Men L3000MW5 Fresh Foam 3000v5 Maroon/White Size 11.5,New Balance Men L3000MW5 Fresh Foam 3000v5 Maroon/White Size 11.5,FBALYB Amazon,24,24,0,0,0,0
,New Balance Men L3000MW5 Fresh Foam 3000v5 Maroon/White Size 12,New Balance Men L3000MW5 Fresh Foam 3000v5 Maroon/White Size 12,FBALYB Amazon,19,19,0,0,0,0
,New Balance Men L3000MW5 Fresh Foam 3000v5 Maroon/White Size 13,New Balance Men L3000MW5 Fresh Foam 3000v5 Maroon/White Size 13,FBALYB Amazon,5,5,0,0,0,0
,New Balance Men L3000MW5 Fresh Foam 3000v5 Maroon/White Size 8.5,New Balance Men L3000MW5 Fresh Foam 3000v5 Maroon/White Size 8.5,FBALYB Amazon,15,15,0,0,0,0
,New Balance Men L3000MW5 Fresh Foam 3000v5 Maroon/White Size 9,New Balance Men L3000MW5 Fresh Foam 3000v5 Maroon/White Size 9,FBALYB Amazon,15,15,0,0,0,0
,New Balance Men L3000MW5 Fresh Foam 3000v5 Maroon/White Size 9.5,New Balance Men L3000MW5 Fresh Foam 3000v5 Maroon/White Size 9.5,FBALYB Amazon,28,28,0,0,0,0
,New Balance Men L3000OA5 Fresh Foam 3000v5 White/Green Size 10,New Balance Men L3000OA5 Fresh Foam 3000v5 White/Green Size 10,FBALYB Amazon,33,32,1,0,1,0
,New Balance Men L3000OA5 Fresh Foam 3000v5 White/Green Size 10.5,New Balance Men L3000OA5 Fresh Foam 3000v5 White/Green Size 10.5,FBALYB Amazon,26,26,0,0,0,0
,New Balance Men L3000OA5 Fresh Foam 3000v5 White/Green Size 11,New Balance Men L3000OA5 Fresh Foam 3000v5 White/Green Size 11,FBALYB Amazon,21,21,0,0,0,0
,New Balance Men L3000OA5 Fresh Foam 3000v5 White/Green Size 11.5,New Balance Men L3000OA5 Fresh Foam 3000v5 White/Green Size 11.5,FBALYB Amazon,18,18,0,0,0,0
,New Balance Men L3000OA5 Fresh Foam 3000v5 White/Green Size 12,New Balance Men L3000OA5 Fresh Foam 3000v5 White/Green Size 12,FBALYB Amazon,15,14,1,0,1,0
,New Balance Men L3000OA5 Fresh Foam 3000v5 White/Green Size 13,New Balance Men L3000OA5 Fresh Foam 3000v5 White/Green Size 13,FBALYB Amazon,20,20,0,0,0,0
,New Balance Men L3000OA5 Fresh Foam 3000v5 White/Green Size 8.5,New Balance Men L3000OA5 Fresh Foam 3000v5 White/Green Size 8.5,FBALYB Amazon,4,4,0,0,0,0
,New Balance Men L3000OA5 Fresh Foam 3000v5 White/Green Size 9,New Balance Men L3000OA5 Fresh Foam 3000v5 White/Green Size 9,FBALYB Amazon,10,10,0,0,0,0
,New Balance Men L3000OA5 Fresh Foam 3000v5 White/Green Size 9.5,New Balance Men L3000OA5 Fresh Foam 3000v5 White/Green Size 9.5,FBALYB Amazon,24,24,0,0,0,0
,New Balance Men L3000SD5 Fresh Foam 3000v5 Team Carolina/White Size 10,New Balance Men L3000SD5 Fresh Foam 3000v5 Team Carolina/White Size 10,FBALYB Amazon,10,10,0,0,0,0
,New Balance Men L3000SD5 Fresh Foam 3000v5 Team Carolina/White Size 10.5,New Balance Men L3000SD5 Fresh Foam 3000v5 Team Carolina/White Size 10.5,FBALYB Amazon,10,9,1,0,1,0
,New Balance Men L3000SD5 Fresh Foam 3000v5 Team Carolina/White Size 11,New Balance Men L3000SD5 Fresh Foam 3000v5 Team Carolina/White Size 11,FBALYB Amazon,-2,-2,0,0,0,0
,New Balance Men L3000SD5 Fresh Foam 3000v5 Team Carolina/White Size 8.5,New Balance Men L3000SD5 Fresh Foam 3000v5 Team Carolina/White Size 8.5,FBALYB Amazon,10,9,1,0,1,0
,New Balance Men L3000SD5 Fresh Foam 3000v5 Team Carolina/White Size 9,New Balance Men L3000SD5 Fresh Foam 3000v5 Team Carolina/White Size 9,FBALYB Amazon,-1,-1,0,0,0,0
,New Balance Men L3000SD5 Fresh Foam 3000v5 Team Carolina/White Size 9.5,New Balance Men L3000SD5 Fresh Foam 3000v5 Team Carolina/White Size 9.5,FBALYB Amazon,18,18,0,0,0,0
,New Balance Men L3000TB5 Fresh Foam 3000v5 Royal Blue/White Size 10,New Balance Men L3000TB5 Fresh Foam 3000v5 Royal Blue/White Size 10,FBALYB Amazon,23,23,0,0,0,0
,New Balance Men L3000TB5 Fresh Foam 3000v5 Royal Blue/White Size 10.5,New Balance Men L3000TB5 Fresh Foam 3000v5 Royal Blue/White Size 10.5,FBALYB Amazon,24,23,1,0,1,0
,New Balance Men L3000TB5 Fresh Foam 3000v5 Royal Blue/White Size 11,New Balance Men L3000TB5 Fresh Foam 3000v5 Royal Blue/White Size 11,FBALYB Amazon,20,20,0,0,0,0
,New Balance Men L3000TB5 Fresh Foam 3000v5 Royal Blue/White Size 11.5,New Balance Men L3000TB5 Fresh Foam 3000v5 Royal Blue/White Size 11.5,FBALYB Amazon,14,14,0,0,0,0
,New Balance Men L3000TB5 Fresh Foam 3000v5 Royal Blue/White Size 12,New Balance Men L3000TB5 Fresh Foam 3000v5 Royal Blue/White Size 12,FBALYB Amazon,13,13,0,0,0,0
,New Balance Men L3000TB5 Fresh Foam 3000v5 Royal Blue/White Size 13,New Balance Men L3000TB5 Fresh Foam 3000v5 Royal Blue/White Size 13,FBALYB Amazon,23,23,0,0,0,0
,New Balance Men L3000TB5 Fresh Foam 3000v5 Royal Blue/White Size 8.5,New Balance Men L3000TB5 Fresh Foam 3000v5 Royal Blue/White Size 8.5,FBALYB Amazon,5,4,1,0,1,0
,New Balance Men L3000TB5 Fresh Foam 3000v5 Royal Blue/White Size 9,New Balance Men L3000TB5 Fresh Foam 3000v5 Royal Blue/White Size 9,FBALYB Amazon,5,5,0,0,0,0
,New Balance Men L3000TB5 Fresh Foam 3000v5 Royal Blue/White Size 9.5,New Balance Men L3000TB5 Fresh Foam 3000v5 Royal Blue/White Size 9.5,FBALYB Amazon,10,10,0,0,0,0
,New Balance Men L3000TO5 Fresh Foam 3000v5 Orange/White Size 10,New Balance Men L3000TO5 Fresh Foam 3000v5 Orange/White Size 10,FBALYB Amazon,40,40,0,0,0,0
,New Balance Men L3000TO5 Fresh Foam 3000v5 Orange/White Size 10.5,New Balance Men L3000TO5 Fresh Foam 3000v5 Orange/White Size 10.5,FBALYB Amazon,40,40,0,0,0,0
,New Balance Men L3000TO5 Fresh Foam 3000v5 Orange/White Size 11,New Balance Men L3000TO5 Fresh Foam 3000v5 Orange/White Size 11,FBALYB Amazon,39,39,0,0,0,0
,New Balance Men L3000TO5 Fresh Foam 3000v5 Orange/White Size 11.5,New Balance Men L3000TO5 Fresh Foam 3000v5 Orange/White Size 11.5,FBALYB Amazon,25,25,0,0,0,0
,New Balance Men L3000TO5 Fresh Foam 3000v5 Orange/White Size 12,New Balance Men L3000TO5 Fresh Foam 3000v5 Orange/White Size 12,Default Ridgefield,2,2,0,0,0,0
,New Balance Men L3000TO5 Fresh Foam 3000v5 Orange/White Size 12,New Balance Men L3000TO5 Fresh Foam 3000v5 Orange/White Size 12,FBALYB Amazon,25,25,0,0,0,0
,New Balance Men L3000TO5 Fresh Foam 3000v5 Orange/White Size 13,New Balance Men L3000TO5 Fresh Foam 3000v5 Orange/White Size 13,FBALYB Amazon,24,24,0,0,0,0
,New Balance Men L3000TO5 Fresh Foam 3000v5 Orange/White Size 8.5,New Balance Men L3000TO5 Fresh Foam 3000v5 Orange/White Size 8.5,Default Ridgefield,2,2,0,0,0,0
,New Balance Men L3000TO5 Fresh Foam 3000v5 Orange/White Size 8.5,New Balance Men L3000TO5 Fresh Foam 3000v5 Orange/White Size 8.5,FBALYB Amazon,12,12,0,0,0,0
,New Balance Men L3000TO5 Fresh Foam 3000v5 Orange/White Size 9,New Balance Men L3000TO5 Fresh Foam 3000v5 Orange/White Size 9,FBALYB Amazon,15,15,0,0,0,0
,New Balance Men L3000TO5 Fresh Foam 3000v5 Orange/White Size 9.5,New Balance Men L3000TO5 Fresh Foam 3000v5 Orange/White Size 9.5,FBALYB Amazon,23,23,0,0,0,0
,New Balance Men L3000WP5 Fresh Foam 3000v5 White/Purple Size 10,New Balance Men L3000WP5 Fresh Foam 3000v5 White/Purple Size 10,FBALYB Amazon,40,40,0,0,0,0
,New Balance Men L3000WP5 Fresh Foam 3000v5 White/Purple Size 10.5,New Balance Men L3000WP5 Fresh Foam 3000v5 White/Purple Size 10.5,FBALYB Amazon,38,38,0,0,0,0
,New Balance Men L3000WP5 Fresh Foam 3000v5 White/Purple Size 11,New Balance Men L3000WP5 Fresh Foam 3000v5 White/Purple Size 11,FBALYB Amazon,38,38,0,0,0,0
,New Balance Men L3000WP5 Fresh Foam 3000v5 White/Purple Size 11.5,New Balance Men L3000WP5 Fresh Foam 3000v5 White/Purple Size 11.5,FBALYB Amazon,25,25,0,0,0,0
,New Balance Men L3000WP5 Fresh Foam 3000v5 White/Purple Size 12,New Balance Men L3000WP5 Fresh Foam 3000v5 White/Purple Size 12,FBALYB Amazon,22,22,0,0,0,0
,New Balance Men L3000WP5 Fresh Foam 3000v5 White/Purple Size 13,New Balance Men L3000WP5 Fresh Foam 3000v5 White/Purple Size 13,FBALYB Amazon,20,20,0,0,0,0
,New Balance Men L3000WP5 Fresh Foam 3000v5 White/Purple Size 8.5,New Balance Men L3000WP5 Fresh Foam 3000v5 White/Purple Size 8.5,FBALYB Amazon,14,14,0,0,0,0
,New Balance Men L3000WP5 Fresh Foam 3000v5 White/Purple Size 9,New Balance Men L3000WP5 Fresh Foam 3000v5 White/Purple Size 9,FBALYB Amazon,14,14,0,0,0,0
,New Balance Men L3000WP5 Fresh Foam 3000v5 White/Purple Size 9.5,New Balance Men L3000WP5 Fresh Foam 3000v5 White/Purple Size 9.5,FBALYB Amazon,25,25,0,0,0,0
,New Balance Men's CM997HDL Sneaker-White/Navy/Yellow Size 10,New Balance Men's CM997HDL Sneaker-White/Navy/Yellow Size 10,FBALYB Amazon,4,4,0,0,0,0
,New Balance Men's CM997HDL Sneaker-White/Navy/Yellow Size 10.5,New Balance Men's CM997HDL Sneaker-White/Navy/Yellow Size 10.5,FBALYB Amazon,13,13,0,0,0,0
,New Balance Men's CM997HDL Sneaker-White/Navy/Yellow Size 11.5,New Balance Men's CM997HDL Sneaker-White/Navy/Yellow Size 11.5,FBALYB Amazon,6,6,0,0,0,0
,New Balance Men's CM997HDL Sneaker-White/Navy/Yellow Size 12.5,New Balance Men's CM997HDL Sneaker-White/Navy/Yellow Size 12.5,Default Ridgefield,3,3,0,0,0,0
,New Balance Men's CM997HDL Sneaker-White/Navy/Yellow Size 13,New Balance Men's CM997HDL Sneaker-White/Navy/Yellow Size 13,FBALYB Amazon,2,2,0,0,0,0
,New Balance Men's CM997HDL Sneaker-White/Navy/Yellow Size 6.5,New Balance Men's CM997HDL Sneaker-White/Navy/Yellow Size 6.5,FBALYB Amazon,4,4,0,0,0,0
,New Balance Men's CM997HDL Sneaker-White/Navy/Yellow Size 7.5,New Balance Men's CM997HDL Sneaker-White/Navy/Yellow Size 7.5,FBALYB Amazon,3,3,0,0,0,0
,New Balance Men's CM997HDL Sneaker-White/Navy/Yellow Size 8.5,New Balance Men's CM997HDL Sneaker-White/Navy/Yellow Size 8.5,FBALYB Amazon,15,15,0,0,0,0
,New Balance Men's CM997HDL Sneaker-White/Navy/Yellow Size 9.5,New Balance Men's CM997HDL Sneaker-White/Navy/Yellow Size 9.5,FBALYB Amazon,18,18,0,0,0,0
,New Balance Men's CM997HDQ Sneaker-Eclipse/Rancloud Size 10,New Balance Men's CM997HDQ Sneaker-Eclipse/Rancloud Size 10,FBALYB Amazon,-7,-7,0,0,0,0
,New Balance Men's CM997HDQ Sneaker-Eclipse/Rancloud Size 11,New Balance Men's CM997HDQ Sneaker-Eclipse/Rancloud Size 11,FBALYB Amazon,-1,-1,0,0,0,0
,New Balance Men's CM997HDQ Sneaker-Eclipse/Rancloud Size 11.5,New Balance Men's CM997HDQ Sneaker-Eclipse/Rancloud Size 11.5,FBALYB Amazon,-6,-6,0,0,0,0
,New Balance Men's CM997HDQ Sneaker-Eclipse/Rancloud Size 12,New Balance Men's CM997HDQ Sneaker-Eclipse/Rancloud Size 12,FBALYB Amazon,-1,-1,0,0,0,0
,New Balance Men's CM997HDQ Sneaker-Eclipse/Rancloud Size 13,New Balance Men's CM997HDQ Sneaker-Eclipse/Rancloud Size 13,FBALYB Amazon,-1,-1,0,0,0,0
,New Balance Men's CM997HDQ Sneaker-Eclipse/Rancloud Size 8,New Balance Men's CM997HDQ Sneaker-Eclipse/Rancloud Size 8,Default Ridgefield,1,1,0,0,0,0
,New Balance Men's CM997HDQ Sneaker-Eclipse/Rancloud Size 8,New Balance Men's CM997HDQ Sneaker-Eclipse/Rancloud Size 8,FBALYB Amazon,-4,-4,0,0,0,0
,New Balance Men's CM997HDQ Sneaker-Eclipse/Rancloud Size 8.5,New Balance Men's CM997HDQ Sneaker-Eclipse/Rancloud Size 8.5,Default,0,0,0,0,0,1
,New Balance Men's CM997HDQ Sneaker-Eclipse/Rancloud Size 8.5,New Balance Men's CM997HDQ Sneaker-Eclipse/Rancloud Size 8.5,FBALYB Amazon,-1,-1,0,0,0,0
,New Balance Men's CM997HDQ Sneaker-Eclipse/Rancloud Size 9.5,New Balance Men's CM997HDQ Sneaker-Eclipse/Rancloud Size 9.5,FBALYB Amazon,-2,-2,0,0,0,0
,New Balance Men's CM997HDR Sneaker-Black/Raincloud Size 10,New Balance Men's CM997HDR Sneaker-Black/Raincloud Size 10,FBALYB Amazon,-4,-4,0,0,0,0
,New Balance Men's CM997HDR Sneaker-Black/Raincloud Size 11,New Balance Men's CM997HDR Sneaker-Black/Raincloud Size 11,Default Ridgefield,1,1,0,0,0,0
,New Balance Men's CM997HDR Sneaker-Black/Raincloud Size 11,New Balance Men's CM997HDR Sneaker-Black/Raincloud Size 11,FBALYB Amazon,-3,-3,0,0,0,0
,New Balance Men's CM997HDR Sneaker-Black/Raincloud Size 12,New Balance Men's CM997HDR Sneaker-Black/Raincloud Size 12,FBALYB Amazon,-1,-1,0,0,0,0
,New Balance Men's CM997HDR Sneaker-Black/Raincloud Size 13,New Balance Men's CM997HDR Sneaker-Black/Raincloud Size 13,Default,0,0,0,0,0,2
,New Balance Men's CM997HDR Sneaker-Black/Raincloud Size 13,New Balance Men's CM997HDR Sneaker-Black/Raincloud Size 13,FBALYB Amazon,-4,-4,0,0,0,0
,New Balance Men's CM997HDR Sneaker-Black/Raincloud Size 8,New Balance Men's CM997HDR Sneaker-Black/Raincloud Size 8,FBALYB Amazon,7,7,0,0,0,0
,New Balance Men's CM997HDR Sneaker-Black/Raincloud Size 8.5,New Balance Men's CM997HDR Sneaker-Black/Raincloud Size 8.5,FBALYB Amazon,-4,-4,0,0,0,0
,New Balance Men's CM997HDR Sneaker-Black/Raincloud Size 9,New Balance Men's CM997HDR Sneaker-Black/Raincloud Size 9,Default,0,0,0,0,0,1
,New Balance Men's CM997HDR Sneaker-Black/Raincloud Size 9,New Balance Men's CM997HDR Sneaker-Black/Raincloud Size 9,FBALYB Amazon,-1,-1,0,0,0,0
,New Balance Men's CM997HDR Sneaker-Black/Raincloud Size 9.5,New Balance Men's CM997HDR Sneaker-Black/Raincloud Size 9.5,Default,0,0,0,0,0,1
,New Balance Men's CM997HDR Sneaker-Black/Raincloud Size 9.5,New Balance Men's CM997HDR Sneaker-Black/Raincloud Size 9.5,FBALYB Amazon,-6,-6,0,0,0,0
,New Balance Men's CM997HDW Sneaker-White Size 10,New Balance Men's CM997HDW Sneaker-White Size 10,Default,0,0,0,0,0,1
,New Balance Men's CM997HDW Sneaker-White Size 10,New Balance Men's CM997HDW Sneaker-White Size 10,Default Ridgefield,11,11,0,0,0,0
,New Balance Men's CM997HDW Sneaker-White Size 10.5,New Balance Men's CM997HDW Sneaker-White Size 10.5,Default,0,0,0,0,0,7
,New Balance Men's CM997HDW Sneaker-White Size 10.5,New Balance Men's CM997HDW Sneaker-White Size 10.5,Default Ridgefield,12,12,0,0,0,0
,New Balance Men's CM997HDW Sneaker-White Size 11,New Balance Men's CM997HDW Sneaker-White Size 11,Default,0,0,0,0,0,2
,New Balance Men's CM997HDW Sneaker-White Size 11.5,New Balance Men's CM997HDW Sneaker-White Size 11.5,Default Ridgefield,22,22,0,0,0,0
,New Balance Men's CM997HDW Sneaker-White Size 12,New Balance Men's CM997HDW Sneaker-White Size 12,Default,0,0,0,0,0,1
,New Balance Men's CM997HDW Sneaker-White Size 12,New Balance Men's CM997HDW Sneaker-White Size 12,Default Ridgefield,12,12,0,0,0,0
,New Balance Men's CM997HDW Sneaker-White Size 12.5,New Balance Men's CM997HDW Sneaker-White Size 12.5,Default Ridgefield,17,17,0,0,0,0
,New Balance Men's CM997HDW Sneaker-White Size 13,New Balance Men's CM997HDW Sneaker-White Size 13,Default Ridgefield,23,23,0,0,0,0
,New Balance Men's CM997HDW Sneaker-White Size 6.5,New Balance Men's CM997HDW Sneaker-White Size 6.5,Default Ridgefield,6,6,0,0,0,0
,New Balance Men's CM997HDW Sneaker-White Size 7.5,New Balance Men's CM997HDW Sneaker-White Size 7.5,FBALYB Amazon,2,1,1,0,1,0
,New Balance Men's CM997HDW Sneaker-White Size 8,New Balance Men's CM997HDW Sneaker-White Size 8,Default Ridgefield,6,6,0,0,0,0
,New Balance Men's CM997HDW Sneaker-White Size 8.5,New Balance Men's CM997HDW Sneaker-White Size 8.5,FBALYB Amazon,8,8,0,0,0,0
,New Balance Men's CM997HDW Sneaker-White Size 9.5,New Balance Men's CM997HDW Sneaker-White Size 9.5,FBALYB Amazon,20,20,0,1,0,0
,New Balance Men's CM997HZH Sneaker-Nimbus Cloud Size 10,New Balance Men's CM997HZH Sneaker-Nimbus Cloud Size 10,FBALYB Amazon,-2,-2,0,0,0,0
,New Balance Men's CM997HZH Sneaker-Nimbus Cloud Size 10.5,New Balance Men's CM997HZH Sneaker-Nimbus Cloud Size 10.5,FBALYB Amazon,-2,-2,0,0,0,0
,New Balance Men's CM997HZH Sneaker-Nimbus Cloud Size 11,New Balance Men's CM997HZH Sneaker-Nimbus Cloud Size 11,Default,0,0,0,0,0,2
,New Balance Men's CM997HZH Sneaker-Nimbus Cloud Size 11,New Balance Men's CM997HZH Sneaker-Nimbus Cloud Size 11,FBALYB Amazon,-1,-1,0,0,0,0
,New Balance Men's CM997HZH Sneaker-Nimbus Cloud Size 11.5,New Balance Men's CM997HZH Sneaker-Nimbus Cloud Size 11.5,FBALYB Amazon,0,0,0,1,0,0
,New Balance Men's CM997HZH Sneaker-Nimbus Cloud Size 7.5,New Balance Men's CM997HZH Sneaker-Nimbus Cloud Size 7.5,FBALYB Amazon,1,1,0,0,0,0
,New Balance Men's CM997HZH Sneaker-Nimbus Cloud Size 8.5,New Balance Men's CM997HZH Sneaker-Nimbus Cloud Size 8.5,FBALYB Amazon,11,11,0,0,0,0
,New Balance Men's CM997HZH Sneaker-Nimbus Cloud Size 9,New Balance Men's CM997HZH Sneaker-Nimbus Cloud Size 9,FBALYB Amazon,-1,-1,0,0,0,0
,New Balance Men's CM997HZH Sneaker-Nimbus Cloud Size 9.5,New Balance Men's CM997HZH Sneaker-Nimbus Cloud Size 9.5,FBALYB Amazon,-4,-4,0,1,0,0
,New Balance Men's CM997HZJ Sneaker-White/Blue/Red Size 10,New Balance Men's CM997HZJ Sneaker-White/Blue/Red Size 10,FBALYB Amazon,7,7,0,0,0,0
,New Balance Men's CM997HZJ Sneaker-White/Blue/Red Size 10.5,New Balance Men's CM997HZJ Sneaker-White/Blue/Red Size 10.5,Default Ridgefield,3,3,0,0,0,0
,New Balance Men's CM997HZJ Sneaker-White/Blue/Red Size 10.5,New Balance Men's CM997HZJ Sneaker-White/Blue/Red Size 10.5,FBALYB Amazon,1,1,0,4,0,0
,New Balance Men's CM997HZJ Sneaker-White/Blue/Red Size 11,New Balance Men's CM997HZJ Sneaker-White/Blue/Red Size 11,FBALYB Amazon,-1,-1,0,0,0,0
,New Balance Men's CM997HZJ Sneaker-White/Blue/Red Size 11.5,New Balance Men's CM997HZJ Sneaker-White/Blue/Red Size 11.5,FBALYB Amazon,1,1,0,0,0,0
,New Balance Men's CM997HZJ Sneaker-White/Blue/Red Size 12.5,New Balance Men's CM997HZJ Sneaker-White/Blue/Red Size 12.5,Default Ridgefield,3,3,0,0,0,0
,New Balance Men's CM997HZJ Sneaker-White/Blue/Red Size 13,New Balance Men's CM997HZJ Sneaker-White/Blue/Red Size 13,FBALYB Amazon,2,1,1,0,1,0
,New Balance Men's CM997HZJ Sneaker-White/Blue/Red Size 7.5,New Balance Men's CM997HZJ Sneaker-White/Blue/Red Size 7.5,FBALYB Amazon,1,1,0,0,0,0
,New Balance Men's CM997HZJ Sneaker-White/Blue/Red Size 8,New Balance Men's CM997HZJ Sneaker-White/Blue/Red Size 8,FBALYB Amazon,7,7,0,0,0,0
,New Balance Men's CM997HZJ Sneaker-White/Blue/Red Size 8.5,New Balance Men's CM997HZJ Sneaker-White/Blue/Red Size 8.5,Default,0,0,0,0,0,1
,New Balance Men's CM997HZJ Sneaker-White/Blue/Red Size 8.5,New Balance Men's CM997HZJ Sneaker-White/Blue/Red Size 8.5,FBALYB Amazon,11,11,0,0,0,0
,New Balance Men's CM997HZJ Sneaker-White/Blue/Red Size 9.5,New Balance Men's CM997HZJ Sneaker-White/Blue/Red Size 9.5,FBALYB Amazon,12,11,1,0,1,0
,New Balance Men's CM997HZK Sneaker-Black/Verdite Size 10,New Balance Men's CM997HZK Sneaker-Black/Verdite Size 10,Default Ridgefield,25,25,0,0,0,0
,New Balance Men's CM997HZK Sneaker-Black/Verdite Size 10,New Balance Men's CM997HZK Sneaker-Black/Verdite Size 10,FBALYB Amazon,26,26,0,0,0,0
,New Balance Men's CM997HZK Sneaker-Black/Verdite Size 11,New Balance Men's CM997HZK Sneaker-Black/Verdite Size 11,FBALYB Amazon,-2,-2,0,0,0,0
,New Balance Men's CM997HZK Sneaker-Black/Verdite Size 8,New Balance Men's CM997HZK Sneaker-Black/Verdite Size 8,FBALYB Amazon,6,6,0,0,0,0
,New Balance Men's CM997HZK Sneaker-Black/Verdite Size 8.5,New Balance Men's CM997HZK Sneaker-Black/Verdite Size 8.5,Default Ridgefield,35,35,0,0,0,0
,New Balance Men's CM997HZK Sneaker-Black/Verdite Size 8.5,New Balance Men's CM997HZK Sneaker-Black/Verdite Size 8.5,FBALYB Amazon,36,36,0,0,0,0
,New Balance Men's CM997HZK Sneaker-Black/Verdite Size 9.5,New Balance Men's CM997HZK Sneaker-Black/Verdite Size 9.5,Default Ridgefield,1,1,0,0,0,0
,New Balance Men's CM997HZK Sneaker-Black/Verdite Size 9.5,New Balance Men's CM997HZK Sneaker-Black/Verdite Size 9.5,FBALYB Amazon,71,71,0,0,0,0
,New Balance Men's L3000BO5 Fresh Foam 3000v5 Black/Orange Size 10,New Balance Men's L3000BO5 Fresh Foam 3000v5 Black/Orange Size 10,FBALYB Amazon,32,32,0,0,0,0
,New Balance Men's L3000BO5 Fresh Foam 3000v5 Black/Orange Size 10.5,New Balance Men's L3000BO5 Fresh Foam 3000v5 Black/Orange Size 10.5,FBALYB Amazon,39,39,0,0,0,0
,New Balance Men's L3000BO5 Fresh Foam 3000v5 Black/Orange Size 11,New Balance Men's L3000BO5 Fresh Foam 3000v5 Black/Orange Size 11,FBALYB Amazon,37,37,0,0,0,0
,New Balance Men's L3000BO5 Fresh Foam 3000v5 Black/Orange Size 11.5,New Balance Men's L3000BO5 Fresh Foam 3000v5 Black/Orange Size 11.5,FBALYB Amazon,23,23,0,0,0,0
,New Balance Men's L3000BO5 Fresh Foam 3000v5 Black/Orange Size 12,New Balance Men's L3000BO5 Fresh Foam 3000v5 Black/Orange Size 12,FBALYB Amazon,25,25,0,0,0,0
,New Balance Men's L3000BO5 Fresh Foam 3000v5 Black/Orange Size 13,New Balance Men's L3000BO5 Fresh Foam 3000v5 Black/Orange Size 13,FBALYB Amazon,25,25,0,0,0,0
,New Balance Men's L3000BO5 Fresh Foam 3000v5 Black/Orange Size 8.5,New Balance Men's L3000BO5 Fresh Foam 3000v5 Black/Orange Size 8.5,FBALYB Amazon,11,11,0,0,0,0
,New Balance Men's L3000BO5 Fresh Foam 3000v5 Black/Orange Size 9,New Balance Men's L3000BO5 Fresh Foam 3000v5 Black/Orange Size 9,FBALYB Amazon,14,14,0,0,0,0
,New Balance Men's L3000BO5 Fresh Foam 3000v5 Black/Orange Size 9.5,New Balance Men's L3000BO5 Fresh Foam 3000v5 Black/Orange Size 9.5,FBALYB Amazon,25,25,0,0,0,0
,New Balance Men's L3000BY5 Fresh Foam 3000v5 Black/Yellow Size 10,New Balance Men's L3000BY5 Fresh Foam 3000v5 Black/Yellow Size 10,FBALYB Amazon,21,21,0,0,0,0
,New Balance Men's L3000BY5 Fresh Foam 3000v5 Black/Yellow Size 10.5,New Balance Men's L3000BY5 Fresh Foam 3000v5 Black/Yellow Size 10.5,FBALYB Amazon,16,16,0,0,0,0
,New Balance Men's L3000BY5 Fresh Foam 3000v5 Black/Yellow Size 11,New Balance Men's L3000BY5 Fresh Foam 3000v5 Black/Yellow Size 11,FBALYB Amazon,24,24,0,0,0,0
,New Balance Men's L3000BY5 Fresh Foam 3000v5 Black/Yellow Size 11.5,New Balance Men's L3000BY5 Fresh Foam 3000v5 Black/Yellow Size 11.5,FBALYB Amazon,4,4,0,0,0,0
,New Balance Men's L3000BY5 Fresh Foam 3000v5 Black/Yellow Size 12,New Balance Men's L3000BY5 Fresh Foam 3000v5 Black/Yellow Size 12,FBALYB Amazon,22,22,0,0,0,0
,New Balance Men's L3000BY5 Fresh Foam 3000v5 Black/Yellow Size 13,New Balance Men's L3000BY5 Fresh Foam 3000v5 Black/Yellow Size 13,FBALYB Amazon,8,8,0,0,0,0
,New Balance Men's L3000BY5 Fresh Foam 3000v5 Black/Yellow Size 8.5,New Balance Men's L3000BY5 Fresh Foam 3000v5 Black/Yellow Size 8.5,FBALYB Amazon,13,13,0,0,0,0
,New Balance Men's L3000BY5 Fresh Foam 3000v5 Black/Yellow Size 9,New Balance Men's L3000BY5 Fresh Foam 3000v5 Black/Yellow Size 9,FBALYB Amazon,14,14,0,0,0,0
,New Balance Men's L3000BY5 Fresh Foam 3000v5 Black/Yellow Size 9.5,New Balance Men's L3000BY5 Fresh Foam 3000v5 Black/Yellow Size 9.5,FBALYB Amazon,27,27,0,0,0,0
,New Balance Men's M1500GNW Sneaker-Grey Size 10.5,New Balance Men's M1500GNW Sneaker-Grey Size 10.5,FBALYB Amazon,0,0,0,1,0,0
,New Balance Men's M1500GNW Sneaker-Grey Size 11,New Balance Men's M1500GNW Sneaker-Grey Size 11,Default,0,0,0,0,0,1
,New Balance Men's M1500GNW Sneaker-Grey Size 11,New Balance Men's M1500GNW Sneaker-Grey Size 11,FBALYB Amazon,-1,-1,0,0,0,0
,New Balance Men's M1500GNW Sneaker-Grey Size 12,New Balance Men's M1500GNW Sneaker-Grey Size 12,FBALYB Amazon,-1,-1,0,0,0,0
,New Balance Men's M1500GNW Sneaker-Grey Size 8,New Balance Men's M1500GNW Sneaker-Grey Size 8,FBALYB Amazon,8,8,0,0,0,0
,New Balance Men's M490LB7 Sneaker-Black/Castlerock Size 10.5,New Balance Men's M490LB7 Sneaker-Black/Castlerock Size 10.5,FBALYB Amazon,-1,-1,0,0,0,0
,New Balance Men's M490LB7 Sneaker-Black/Castlerock Size 11.5,New Balance Men's M490LB7 Sneaker-Black/Castlerock Size 11.5,FBALYB Amazon,-4,-4,0,0,0,0
,New Balance Men's M490LB7 Sneaker-Black/Castlerock Size 12,New Balance Men's M490LB7 Sneaker-Black/Castlerock Size 12,FBALYB Amazon,-1,-1,0,0,0,0
,New Balance Men's M490LB7 Sneaker-Black/Castlerock Size 7.5,New Balance Men's M490LB7 Sneaker-Black/Castlerock Size 7.5,FBALYB Amazon,3,3,0,0,0,0
,New Balance Men's M490LB7 Sneaker-Black/Castlerock Size 8.5,New Balance Men's M490LB7 Sneaker-Black/Castlerock Size 8.5,Default,0,0,0,0,0,1
,New Balance Men's M490LB7 Sneaker-Black/Castlerock Size 8.5,New Balance Men's M490LB7 Sneaker-Black/Castlerock Size 8.5,FBALYB Amazon,14,14,0,0,0,0
,New Balance Men's M490LB7 Sneaker-Black/Castlerock Size 9.5,New Balance Men's M490LB7 Sneaker-Black/Castlerock Size 9.5,FBALYB Amazon,1,1,0,0,0,0
,New Balance Men's M490LN7 Sneaker-Marblehead/Black/Grey Size 10.5,New Balance Men's M490LN7 Sneaker-Marblehead/Black/Grey Size 10.5,FBALYB Amazon,-2,-2,0,0,0,0
,New Balance Men's M490LN7 Sneaker-Marblehead/Black/Grey Size 7.5,New Balance Men's M490LN7 Sneaker-Marblehead/Black/Grey Size 7.5,FBALYB Amazon,6,6,0,0,0,0
,New Balance Men's M490LN7 Sneaker-Marblehead/Black/Grey Size 8.5,New Balance Men's M490LN7 Sneaker-Marblehead/Black/Grey Size 8.5,FBALYB Amazon,13,13,0,0,0,0
,New Balance Men's M490LN7 Sneaker-Marblehead/Black/Grey Size 9.5,New Balance Men's M490LN7 Sneaker-Marblehead/Black/Grey Size 9.5,FBALYB Amazon,8,8,0,0,0,0
,New Balance Men's M490LV7 Sneaker-Royal Blue Size 11.5,New Balance Men's M490LV7 Sneaker-Royal Blue Size 11.5,FBALYB Amazon,4,4,0,0,0,0
,New Balance Men's M490LV7 Sneaker-Royal Blue Size 12,New Balance Men's M490LV7 Sneaker-Royal Blue Size 12,FBALYB Amazon,2,2,0,0,0,0
,New Balance Men's M490LV7 Sneaker-Royal Blue Size 7.5,New Balance Men's M490LV7 Sneaker-Royal Blue Size 7.5,Default,0,0,0,0,0,1
,New Balance Men's M490LV7 Sneaker-Royal Blue Size 7.5,New Balance Men's M490LV7 Sneaker-Royal Blue Size 7.5,FBALYB Amazon,3,3,0,0,0,0
,New Balance Men's M490LV7 Sneaker-Royal Blue Size 8.5,New Balance Men's M490LV7 Sneaker-Royal Blue Size 8.5,FBALYB Amazon,-1,-1,0,0,0,0
,New Balance Men's M490LV7 Sneaker-Royal Blue Size 9.5,New Balance Men's M490LV7 Sneaker-Royal Blue Size 9.5,FBALYB Amazon,4,4,0,0,0,0
,New Balance Men's M520CN5 Sneaker-Navy/Blue Size 10.5,New Balance Men's M520CN5 Sneaker-Navy/Blue Size 10.5,FBALYB Amazon,-2,-2,0,0,0,0
,New Balance Men's M520CN5 Sneaker-Navy/Blue Size 11.5,New Balance Men's M520CN5 Sneaker-Navy/Blue Size 11.5,FBALYB Amazon,-2,-2,0,0,0,0
,New Balance Men's M520CN5 Sneaker-Navy/Blue Size 7,New Balance Men's M520CN5 Sneaker-Navy/Blue Size 7,FBALYB Amazon,-2,-2,0,0,0,0
,New Balance Men's M520CN5 Sneaker-Navy/Blue Size 7.5,New Balance Men's M520CN5 Sneaker-Navy/Blue Size 7.5,FBALYB Amazon,-3,-3,0,0,0,0
,New Balance Men's M520CN5 Sneaker-Navy/Blue Size 8.5,New Balance Men's M520CN5 Sneaker-Navy/Blue Size 8.5,FBALYB Amazon,-5,-5,0,0,0,0
,New Balance Men's M520CN5 Sneaker-Navy/Blue Size 9.5,New Balance Men's M520CN5 Sneaker-Navy/Blue Size 9.5,FBALYB Amazon,-4,-4,0,0,0,0
,New Balance Men's M520CR5 Sneaker-Black/Sulfur Size 10.5,New Balance Men's M520CR5 Sneaker-Black/Sulfur Size 10.5,FBALYB Amazon,-2,-2,0,0,0,0
,New Balance Men's M520CR5 Sneaker-Black/Sulfur Size 7.5,New Balance Men's M520CR5 Sneaker-Black/Sulfur Size 7.5,FBALYB Amazon,-6,-7,1,0,1,0
,New Balance Men's M520CR5 Sneaker-Black/Sulfur Size 8.5,New Balance Men's M520CR5 Sneaker-Black/Sulfur Size 8.5,Default,0,0,0,0,0,1
,New Balance Men's M520CR5 Sneaker-Black/Sulfur Size 8.5,New Balance Men's M520CR5 Sneaker-Black/Sulfur Size 8.5,FBALYB Amazon,-4,-4,0,0,0,0
,New Balance Men's M520CR5 Sneaker-Black/Sulfur Size 9.5,New Balance Men's M520CR5 Sneaker-Black/Sulfur Size 9.5,FBALYB Amazon,-1,-1,0,0,0,0
,New Balance Men's M520CV5 Sneaker-Grey/Blue Size 10.5,New Balance Men's M520CV5 Sneaker-Grey/Blue Size 10.5,FBALYB Amazon,-1,-1,0,0,0,0
,New Balance Men's M520CV5 Sneaker-Grey/Blue Size 12,New Balance Men's M520CV5 Sneaker-Grey/Blue Size 12,FBALYB Amazon,-1,-1,0,0,0,0
,New Balance Men's M520CV5 Sneaker-Grey/Blue Size 8.5,New Balance Men's M520CV5 Sneaker-Grey/Blue Size 8.5,FBALYB Amazon,-2,-2,0,1,0,0
,New Balance Men's M520CV5 Sneaker-Grey/Blue Size 9.5,New Balance Men's M520CV5 Sneaker-Grey/Blue Size 9.5,FBALYB Amazon,-1,-1,0,0,0,0
,New Balance Men's M870BW5 Sneaker-Black/White Size 7.5,New Balance Men's M870BW5 Sneaker-Black/White Size 7.5,FBALYB Amazon,-2,-2,0,0,0,0
,New Balance Men's M870GY5 Sneaker-Gunmetal/Pigment Size 11.5,New Balance Men's M870GY5 Sneaker-Gunmetal/Pigment Size 11.5,Default,0,0,0,0,0,1
,New Balance Men's M870GY5 Sneaker-Gunmetal/Pigment Size 12.5,New Balance Men's M870GY5 Sneaker-Gunmetal/Pigment Size 12.5,FBALYB Amazon,-2,-2,0,0,0,0
,New Balance Men's M870GY5 Sneaker-Gunmetal/Pigment Size 13,New Balance Men's M870GY5 Sneaker-Gunmetal/Pigment Size 13,FBALYB Amazon,-2,-2,0,0,0,0
,New Balance Men's M870GY5 Sneaker-Gunmetal/Pigment Size 7,New Balance Men's M870GY5 Sneaker-Gunmetal/Pigment Size 7,FBALYB Amazon,-1,-1,0,0,0,0
,New Balance Men's M870GY5 Sneaker-Gunmetal/Pigment Size 7.5,New Balance Men's M870GY5 Sneaker-Gunmetal/Pigment Size 7.5,FBALYB Amazon,-2,-2,0,0,0,0
,New Balance Men's M870GY5 Sneaker-Gunmetal/Pigment Size 8.5,New Balance Men's M870GY5 Sneaker-Gunmetal/Pigment Size 8.5,Default,0,0,0,0,0,1
,New Balance Men's M870GY5 Sneaker-Gunmetal/Pigment Size 9.5,New Balance Men's M870GY5 Sneaker-Gunmetal/Pigment Size 9.5,FBALYB Amazon,-1,-1,0,0,0,0
,New Balance Men's MDRNRP1 Sneaker-Pigment Eclipse Size 10.5,New Balance Men's MDRNRP1 Sneaker-Pigment Eclipse Size 10.5,FBALYB Amazon,-2,-2,0,0,0,0
,New Balance Men's MDRNRP1 Sneaker-Pigment Eclipse Size 12,New Balance Men's MDRNRP1 Sneaker-Pigment Eclipse Size 12,FBALYB Amazon,-2,-2,0,0,0,0
,New Balance Men's MDRNRP1 Sneaker-Pigment Eclipse Size 7.5,New Balance Men's MDRNRP1 Sneaker-Pigment Eclipse Size 7.5,FBALYB Amazon,1,1,0,0,0,0
,New Balance Men's MDRNRP1 Sneaker-Pigment Eclipse Size 8.5,New Balance Men's MDRNRP1 Sneaker-Pigment Eclipse Size 8.5,Default,0,0,0,0,0,3
,New Balance Men's MDRNRP1 Sneaker-Pigment Eclipse Size 8.5,New Balance Men's MDRNRP1 Sneaker-Pigment Eclipse Size 8.5,Default Ridgefield,9,9,0,0,0,0
,New Balance Men's MDRNRP1 Sneaker-Pigment Eclipse Size 9.5,New Balance Men's MDRNRP1 Sneaker-Pigment Eclipse Size 9.5,FBALYB Amazon,1,0,1,0,1,0
,New Balance Men's ML574EGB Sneaker-Burgundy (512)  Size 10,New Balance Men's ML574EGB Sneaker-Burgundy (512)  Size 10,FBALYB Amazon,-3,-3,0,0,0,0
,New Balance Men's ML574EGB Sneaker-Burgundy (512)  Size 10.5,New Balance Men's ML574EGB Sneaker-Burgundy (512)  Size 10.5,Default Ridgefield,3,3,0,0,0,0
,New Balance Men's ML574EGB Sneaker-Burgundy (512)  Size 10.5,New Balance Men's ML574EGB Sneaker-Burgundy (512)  Size 10.5,FBALYB Amazon,-1,-1,0,0,0,0
,New Balance Men's ML574EGB Sneaker-Burgundy (512)  Size 7.5,New Balance Men's ML574EGB Sneaker-Burgundy (512)  Size 7.5,FBALYB Amazon,-5,-5,0,0,0,0
,New Balance Men's ML574EGB Sneaker-Burgundy (512)  Size 8,New Balance Men's ML574EGB Sneaker-Burgundy (512)  Size 8,FBALYB Amazon,-4,-4,0,0,0,0
,New Balance Men's ML574EGB Sneaker-Burgundy (512)  Size 8.5,New Balance Men's ML574EGB Sneaker-Burgundy (512)  Size 8.5,FBALYB Amazon,9,9,0,0,0,0
,New Balance Men's ML574EGB Sneaker-Burgundy (512)  Size 9,New Balance Men's ML574EGB Sneaker-Burgundy (512)  Size 9,Default Oxford,33,33,0,0,0,0
,New Balance Men's ML574EGB Sneaker-Burgundy (512)  Size 9,New Balance Men's ML574EGB Sneaker-Burgundy (512)  Size 9,FBALYB Amazon,-42,-42,0,0,0,0
,New Balance Men's ML574EGB Sneaker-Burgundy (512)  Size 9.5,New Balance Men's ML574EGB Sneaker-Burgundy (512)  Size 9.5,FBALYB Amazon,-3,-3,0,0,0,0
,New Balance Men's ML574EGG Sneaker-Grey (030) Size 10,New Balance Men's ML574EGG Sneaker-Grey (030) Size 10,Default,12,12,0,0,0,0
,New Balance Men's ML574EGG Sneaker-Grey (030) Size 10,New Balance Men's ML574EGG Sneaker-Grey (030) Size 10,FBALYB Amazon,-12,-12,0,0,0,0
,New Balance Men's ML574EGG Sneaker-Grey (030) Size 10.5,New Balance Men's ML574EGG Sneaker-Grey (030) Size 10.5,Default,3,3,0,0,0,0
,New Balance Men's ML574EGG Sneaker-Grey (030) Size 10.5,New Balance Men's ML574EGG Sneaker-Grey (030) Size 10.5,FBALYB Amazon,-8,-8,0,0,0,0
,New Balance Men's ML574EGG Sneaker-Grey (030) Size 11,New Balance Men's ML574EGG Sneaker-Grey (030) Size 11,Default Ridgefield,3,3,0,0,0,0
,New Balance Men's ML574EGG Sneaker-Grey (030) Size 11,New Balance Men's ML574EGG Sneaker-Grey (030) Size 11,FBALYB Amazon,-2,-2,0,0,0,0
,New Balance Men's ML574EGG Sneaker-Grey (030) Size 11.5,New Balance Men's ML574EGG Sneaker-Grey (030) Size 11.5,FBALYB Amazon,-1,-1,0,0,0,0
,New Balance Men's ML574EGG Sneaker-Grey (030) Size 7.5,New Balance Men's ML574EGG Sneaker-Grey (030) Size 7.5,FBALYB Amazon,19,18,1,0,1,0
,New Balance Men's ML574EGG Sneaker-Grey (030) Size 8,New Balance Men's ML574EGG Sneaker-Grey (030) Size 8,FBALYB Amazon,22,21,1,0,1,0
,New Balance Men's ML574EGG Sneaker-Grey (030) Size 8.5,New Balance Men's ML574EGG Sneaker-Grey (030) Size 8.5,FBALYB Amazon,57,54,3,1,3,0
,New Balance Men's ML574EGG Sneaker-Grey (030) Size 9,New Balance Men's ML574EGG Sneaker-Grey (030) Size 9,Default Ridgefield,2,2,0,0,0,0
,New Balance Men's ML574EGG Sneaker-Grey (030) Size 9,New Balance Men's ML574EGG Sneaker-Grey (030) Size 9,FBALYB Amazon,-16,-16,0,0,0,0
,New Balance Men's ML574EGG Sneaker-Grey (030) Size 9.5,New Balance Men's ML574EGG Sneaker-Grey (030) Size 9.5,FBALYB Amazon,-13,-13,0,0,0,0
,New Balance Men's ML574EGK  Sneaker-Black  (001) Size 10,New Balance Men's ML574EGK  Sneaker-Black  (001) Size 10,FBALYB Amazon,-9,-9,0,0,0,0
,New Balance Men's ML574EGK  Sneaker-Black  (001) Size 10.5,New Balance Men's ML574EGK  Sneaker-Black  (001) Size 10.5,FBALYB Amazon,-3,-3,0,0,0,0
,New Balance Men's ML574EGK  Sneaker-Black  (001) Size 11,New Balance Men's ML574EGK  Sneaker-Black  (001) Size 11,FBALYB Amazon,-2,-2,0,0,0,0
,New Balance Men's ML574EGK Sneaker-Black (001) Size 11.5,New Balance Men's ML574EGK Sneaker-Black (001) Size 11.5,FBALYB Amazon,0,-1,1,0,1,0
,New Balance Men's ML574EGK Sneaker-Black (001) Size 12,New Balance Men's ML574EGK Sneaker-Black (001) Size 12,FBALYB Amazon,-1,-1,0,0,0,0
,New Balance Men's ML574EGK Sneaker-Black (001) Size 13,New Balance Men's ML574EGK Sneaker-Black (001) Size 13,FBALYB Amazon,-1,-1,0,0,0,0
,New Balance Men's ML574EGK  Sneaker-Black  (001) Size 7.5,New Balance Men's ML574EGK  Sneaker-Black  (001) Size 7.5,FBALYB Amazon,21,21,0,0,0,0
,New Balance Men's ML574EGK  Sneaker-Black  (001) Size 8,New Balance Men's ML574EGK  Sneaker-Black  (001) Size 8,FBALYB Amazon,64,60,4,0,4,0
,New Balance Men's ML574EGK  Sneaker-Black  (001) Size 8.5,New Balance Men's ML574EGK  Sneaker-Black  (001) Size 8.5,FBALYB Amazon,-45,-45,0,2,0,0
,New Balance Men's ML574EGK  Sneaker-Black  (001) Size 9,New Balance Men's ML574EGK  Sneaker-Black  (001) Size 9,FBALYB Amazon,16,16,0,0,0,0
,New Balance Men's ML574EGK  Sneaker-Black  (001) Size 9.5,New Balance Men's ML574EGK  Sneaker-Black  (001) Size 9.5,Default,0,0,0,0,0,1
,New Balance Men's ML574EGK  Sneaker-Black  (001) Size 9.5,New Balance Men's ML574EGK  Sneaker-Black  (001) Size 9.5,FBALYB Amazon,-25,-25,0,0,0,0
,New Balance Men's ML574EGN Sneaker-Black IRIS (037) Size 10,New Balance Men's ML574EGN Sneaker-Black IRIS (037) Size 10,FBALYB Amazon,16,16,0,0,0,0
,New Balance Men's ML574EGN Sneaker-Black IRIS (037) Size 10.5,New Balance Men's ML574EGN Sneaker-Black IRIS (037) Size 10.5,FBALYB Amazon,-2,-2,0,0,0,0
,New Balance Men's ML574EGN Sneaker-Black IRIS (037) Size 11,New Balance Men's ML574EGN Sneaker-Black IRIS (037) Size 11,FBALYB Amazon,-4,-4,0,0,0,0
,New Balance Men's ML574EGN Sneaker-Black Iris (037) Size 12,New Balance Men's ML574EGN Sneaker-Black Iris (037) Size 12,FBALYB Amazon,-1,-1,0,0,0,0
,New Balance Men's ML574EGN Sneaker-Black Iris (037) Size 13,New Balance Men's ML574EGN Sneaker-Black Iris (037) Size 13,FBALYB Amazon,-1,-1,0,0,0,0
,New Balance Men's ML574EGN Sneaker-Black IRIS (037) Size 7.5,New Balance Men's ML574EGN Sneaker-Black IRIS (037) Size 7.5,FBALYB Amazon,85,85,0,0,0,0
,New Balance Men's ML574EGN Sneaker-Black IRIS (037) Size 8,New Balance Men's ML574EGN Sneaker-Black IRIS (037) Size 8,Default Ridgefield,52,52,0,0,0,0
,New Balance Men's ML574EGN Sneaker-Black IRIS (037) Size 8,New Balance Men's ML574EGN Sneaker-Black IRIS (037) Size 8,FBALYB Amazon,119,117,2,0,2,0
,New Balance Men's ML574EGN Sneaker-Black IRIS (037) Size 8.5,New Balance Men's ML574EGN Sneaker-Black IRIS (037) Size 8.5,Default,0,0,0,0,0,2
,New Balance Men's ML574EGN Sneaker-Black IRIS (037) Size 8.5,New Balance Men's ML574EGN Sneaker-Black IRIS (037) Size 8.5,Default Ridgefield,78,78,0,0,0,0
,New Balance Men's ML574EGN Sneaker-Black IRIS (037) Size 8.5,New Balance Men's ML574EGN Sneaker-Black IRIS (037) Size 8.5,FBALYB Amazon,143,143,0,0,0,0
,New Balance Men's ML574EGN Sneaker-Black IRIS (037) Size 9,New Balance Men's ML574EGN Sneaker-Black IRIS (037) Size 9,FBALYB Amazon,138,137,1,2,1,0
,New Balance Men's ML574EGN Sneaker-Black IRIS (037) Size 9.5,New Balance Men's ML574EGN Sneaker-Black IRIS (037) Size 9.5,Default,0,0,0,0,0,1
,New Balance Men's ML574EGN Sneaker-Black IRIS (037) Size 9.5,New Balance Men's ML574EGN Sneaker-Black IRIS (037) Size 9.5,FBALYB Amazon,-5,-5,0,0,0,0
,New Balance Men's ML574EGW Sneaker-Nimbus Cloud (023)  Size 10,New Balance Men's ML574EGW Sneaker-Nimbus Cloud (023)  Size 10,Default,3,3,0,0,0,0
,New Balance Men's ML574EGW Sneaker-Nimbus Cloud (023)  Size 10,New Balance Men's ML574EGW Sneaker-Nimbus Cloud (023)  Size 10,FBALYB Amazon,-9,-9,0,0,0,0
,New Balance Men's ML574EGW Sneaker-Nimbus Cloud (023)  Size 10.5,New Balance Men's ML574EGW Sneaker-Nimbus Cloud (023)  Size 10.5,FBALYB Amazon,-1,-1,0,0,0,0
,New Balance Men's ML574EGW Sneaker-Nimbus Cloud (023)  Size 11,New Balance Men's ML574EGW Sneaker-Nimbus Cloud (023)  Size 11,Default,0,0,0,0,0,1
,New Balance Men's ML574EGW Sneaker-Nimbus Cloud (023)  Size 11,New Balance Men's ML574EGW Sneaker-Nimbus Cloud (023)  Size 11,Default Ridgefield,10,10,0,0,0,0
,New Balance Men's ML574EGW Sneaker-Nimbus Cloud (023)  Size 11,New Balance Men's ML574EGW Sneaker-Nimbus Cloud (023)  Size 11,FBALYB Amazon,-1,-1,0,0,0,0
,New Balance Men's ML574EGW Sneaker-Nimbus Cloud (023) Size 11.5,New Balance Men's ML574EGW Sneaker-Nimbus Cloud (023) Size 11.5,FBALYB Amazon,-2,-2,0,0,0,0
,New Balance Men's ML574EGW Sneaker-Nimbus Cloud (023) Size 12,New Balance Men's ML574EGW Sneaker-Nimbus Cloud (023) Size 12,Default,0,0,0,0,0,1
,New Balance Men's ML574EGW Sneaker-Nimbus Cloud (023) Size 12,New Balance Men's ML574EGW Sneaker-Nimbus Cloud (023) Size 12,FBALYB Amazon,-1,-1,0,0,0,0
,New Balance Men's ML574EGW Sneaker-Nimbus Cloud (023) Size 13,New Balance Men's ML574EGW Sneaker-Nimbus Cloud (023) Size 13,FBALYB Amazon,-1,-1,0,0,0,0
,New Balance Men's ML574EGW Sneaker-Nimbus Cloud (023)  Size 7.5,New Balance Men's ML574EGW Sneaker-Nimbus Cloud (023)  Size 7.5,FBALYB Amazon,18,18,0,0,0,0
,New Balance Men's ML574EGW Sneaker-Nimbus Cloud (023)  Size 8,New Balance Men's ML574EGW Sneaker-Nimbus Cloud (023)  Size 8,Default Ridgefield,5,5,0,0,0,0
,New Balance Men's ML574EGW Sneaker-Nimbus Cloud (023)  Size 8,New Balance Men's ML574EGW Sneaker-Nimbus Cloud (023)  Size 8,FBALYB Amazon,7,6,1,0,1,0
,New Balance Men's ML574EGW Sneaker-Nimbus Cloud (023)  Size 8.5,New Balance Men's ML574EGW Sneaker-Nimbus Cloud (023)  Size 8.5,FBALYB Amazon,-11,-11,0,0,0,0
,New Balance Men's ML574EGW Sneaker-Nimbus Cloud (023)  Size 9,New Balance Men's ML574EGW Sneaker-Nimbus Cloud (023)  Size 9,FBALYB Amazon,-4,-4,0,0,0,0
,New Balance Men's ML574EGW Sneaker-Nimbus Cloud (023)  Size 9.5,New Balance Men's ML574EGW Sneaker-Nimbus Cloud (023)  Size 9.5,FBALYB Amazon,-7,-7,0,3,0,0
,New Balance Men's ML574ERF Sneaker-Light Grey Size 10,New Balance Men's ML574ERF Sneaker-Light Grey Size 10,FBALYB Amazon,-2,-2,0,0,0,0
,New Balance Men's ML574ERF Sneaker-Light Grey Size 10.5,New Balance Men's ML574ERF Sneaker-Light Grey Size 10.5,FBALYB Amazon,-4,-4,0,0,0,0
,New Balance Men's ML574ERF Sneaker-Light Grey Size 11.5,New Balance Men's ML574ERF Sneaker-Light Grey Size 11.5,Default Ridgefield,4,4,0,0,0,0
,New Balance Men's ML574ERF Sneaker-Light Grey Size 11.5,New Balance Men's ML574ERF Sneaker-Light Grey Size 11.5,FBALYB Amazon,3,3,0,0,0,0
,New Balance Men's ML574ERF Sneaker-Light Grey Size 12,New Balance Men's ML574ERF Sneaker-Light Grey Size 12,Default Ridgefield,5,5,0,0,0,0
,New Balance Men's ML574ERF Sneaker-Light Grey Size 13,New Balance Men's ML574ERF Sneaker-Light Grey Size 13,Default Ridgefield,3,3,0,0,0,0
,New Balance Men's ML574ERF Sneaker-Light Grey Size 6.5,New Balance Men's ML574ERF Sneaker-Light Grey Size 6.5,Default Ridgefield,2,2,0,0,0,0
,New Balance Men's ML574ERF Sneaker-Light Grey Size 7.5,New Balance Men's ML574ERF Sneaker-Light Grey Size 7.5,FBALYB Amazon,1,1,0,0,0,0
,New Balance Men's ML574ERF Sneaker-Light Grey Size 8,New Balance Men's ML574ERF Sneaker-Light Grey Size 8,FBALYB Amazon,15,15,0,0,0,0
,New Balance Men's ML574ERF Sneaker-Light Grey Size 8.5,New Balance Men's ML574ERF Sneaker-Light Grey Size 8.5,Default,0,0,0,0,0,3
,New Balance Men's ML574ERF Sneaker-Light Grey Size 8.5,New Balance Men's ML574ERF Sneaker-Light Grey Size 8.5,FBALYB Amazon,33,33,0,0,0,0
,New Balance Men's ML574ERF Sneaker-Light Grey Size 9.5,New Balance Men's ML574ERF Sneaker-Light Grey Size 9.5,FBALYB Amazon,38,37,1,0,1,0
,New Balance Men's ML574ERG Sneaker-Blue Size 10,New Balance Men's ML574ERG Sneaker-Blue Size 10,FBALYB Amazon,-4,-4,0,0,0,0
,New Balance Men's ML574ERG Sneaker-Blue Size 10.5,New Balance Men's ML574ERG Sneaker-Blue Size 10.5,FBALYB Amazon,-3,-3,0,0,0,0
,New Balance Men's ML574ERG Sneaker-Blue Size 11,New Balance Men's ML574ERG Sneaker-Blue Size 11,FBALYB Amazon,-2,-2,0,0,0,0
,New Balance Men's ML574ERG Sneaker-Blue Size 11.5,New Balance Men's ML574ERG Sneaker-Blue Size 11.5,FBALYB Amazon,-1,-1,0,0,0,0
,New Balance Men's ML574ERG Sneaker-Blue Size 12,New Balance Men's ML574ERG Sneaker-Blue Size 12,Default Ridgefield,2,2,0,0,0,0
,New Balance Men's ML574ERG Sneaker-Blue Size 7.5,New Balance Men's ML574ERG Sneaker-Blue Size 7.5,Default,0,0,0,0,0,1
,New Balance Men's ML574ERG Sneaker-Blue Size 8,New Balance Men's ML574ERG Sneaker-Blue Size 8,Default Ridgefield,12,12,0,0,0,0
,New Balance Men's ML574ERG Sneaker-Blue Size 9,New Balance Men's ML574ERG Sneaker-Blue Size 9,FBALYB Amazon,-1,-1,0,0,0,0
,New Balance Men's ML574ERG Sneaker-Blue Size 9.5,New Balance Men's ML574ERG Sneaker-Blue Size 9.5,FBALYB Amazon,-3,-3,0,0,0,0
,New Balance Men's ML574ERH Sneaker-Light Grey/Blue Size 10,New Balance Men's ML574ERH Sneaker-Light Grey/Blue Size 10,Default Ridgefield,24,24,0,0,0,0
,New Balance Men's ML574ERH Sneaker-Light Grey/Blue Size 10.5,New Balance Men's ML574ERH Sneaker-Light Grey/Blue Size 10.5,FBALYB Amazon,-3,-3,0,0,0,0
,New Balance Men's ML574ERH Sneaker-Light Grey/Blue Size 11,New Balance Men's ML574ERH Sneaker-Light Grey/Blue Size 11,Default Ridgefield,3,3,0,0,0,0
,New Balance Men's ML574ERH Sneaker-Light Grey/Blue Size 11.5,New Balance Men's ML574ERH Sneaker-Light Grey/Blue Size 11.5,Default Ridgefield,14,14,0,0,0,0
,New Balance Men's ML574ERH Sneaker-Light Grey/Blue Size 12,New Balance Men's ML574ERH Sneaker-Light Grey/Blue Size 12,Default Ridgefield,15,15,0,0,0,0
,New Balance Men's ML574ERH Sneaker-Light Grey/Blue Size 13,New Balance Men's ML574ERH Sneaker-Light Grey/Blue Size 13,Default Ridgefield,10,10,0,0,0,0
,New Balance Men's ML574ERH Sneaker-Light Grey/Blue Size 6.5,New Balance Men's ML574ERH Sneaker-Light Grey/Blue Size 6.5,Default Ridgefield,6,6,0,0,0,0
,New Balance Men's ML574ERH Sneaker-Light Grey/Blue Size 7.5,New Balance Men's ML574ERH Sneaker-Light Grey/Blue Size 7.5,FBALYB Amazon,-1,-1,0,0,0,0
,New Balance Men's ML574ERH Sneaker-Light Grey/Blue Size 8.5,New Balance Men's ML574ERH Sneaker-Light Grey/Blue Size 8.5,Default,0,0,0,0,0,2
,New Balance Men's ML574ERH Sneaker-Light Grey/Blue Size 8.5,New Balance Men's ML574ERH Sneaker-Light Grey/Blue Size 8.5,FBALYB Amazon,-5,-5,0,0,0,0
,New Balance Men's ML574ERH Sneaker-Light Grey/Blue Size 9.5,New Balance Men's ML574ERH Sneaker-Light Grey/Blue Size 9.5,FBALYB Amazon,-3,-3,0,0,0,0
,New Balance Men's ML574NFT Sneaker-Beige Size 6.5,New Balance Men's ML574NFT Sneaker-Beige Size 6.5,FBALYB Amazon,5,5,0,0,0,0
,New Balance Men's ML574NFT Sneaker-Beige Size 8.5,New Balance Men's ML574NFT Sneaker-Beige Size 8.5,FBALYB Amazon,7,7,0,0,0,0
,New Balance Men's ML574NFT Sneaker-Beige Size 9.5,New Balance Men's ML574NFT Sneaker-Beige Size 9.5,FBALYB Amazon,-1,-1,0,0,0,0
,New Balance Men's ML574NFU Sneaker-Grey Size 10,New Balance Men's ML574NFU Sneaker-Grey Size 10,FBALYB Amazon,-1,-1,0,0,0,0
,New Balance Men's ML574NFU Sneaker-Grey Size 10.5,New Balance Men's ML574NFU Sneaker-Grey Size 10.5,FBALYB Amazon,-2,-2,0,0,0,0
,New Balance Men's ML574NFU Sneaker-Grey Size 11.5,New Balance Men's ML574NFU Sneaker-Grey Size 11.5,FBALYB Amazon,5,5,0,0,0,0
,New Balance Men's ML574NFU Sneaker-Grey Size 12,New Balance Men's ML574NFU Sneaker-Grey Size 12,Default,0,0,0,0,0,1
,New Balance Men's ML574NFU Sneaker-Grey Size 13,New Balance Men's ML574NFU Sneaker-Grey Size 13,Default,0,0,0,0,0,1
,New Balance Men's ML574NFU Sneaker-Grey Size 6.5,New Balance Men's ML574NFU Sneaker-Grey Size 6.5,Default Ridgefield,1,1,0,0,0,0
,New Balance Men's ML574NFU Sneaker-Grey Size 7.5,New Balance Men's ML574NFU Sneaker-Grey Size 7.5,FBALYB Amazon,5,5,0,0,0,0
,New Balance Men's ML574NFU Sneaker-Grey Size 8,New Balance Men's ML574NFU Sneaker-Grey Size 8,Default,0,0,0,0,0,2
,New Balance Men's ML574NFU Sneaker-Grey Size 8.5,New Balance Men's ML574NFU Sneaker-Grey Size 8.5,FBALYB Amazon,14,14,0,0,0,0
,New Balance Men's ML574NFU Sneaker-Grey Size 9.5,New Balance Men's ML574NFU Sneaker-Grey Size 9.5,FBALYB Amazon,21,19,2,0,2,0
,New Balance Men's MS247GI Sneaker-Black Size 10.5,New Balance Men's MS247GI Sneaker-Black Size 10.5,FBALYB Amazon,-1,-1,0,0,0,0
,New Balance Men's MS247GI Sneaker-Black Size 11.5,New Balance Men's MS247GI Sneaker-Black Size 11.5,FBALYB Amazon,1,1,0,0,0,0
,New Balance Men's MS247GI Sneaker-Black Size 12,New Balance Men's MS247GI Sneaker-Black Size 12,Default,0,0,0,0,0,1
,New Balance Men's MS247GI Sneaker-Black Size 13,New Balance Men's MS247GI Sneaker-Black Size 13,FBALYB Amazon,-1,-1,0,0,0,0
,New Balance Men's MS247GI Sneaker-Black Size 6.5,New Balance Men's MS247GI Sneaker-Black Size 6.5,FBALYB Amazon,3,3,0,1,0,0
,New Balance Men's MS247GI Sneaker-Black Size 7.5,New Balance Men's MS247GI Sneaker-Black Size 7.5,FBALYB Amazon,14,14,0,0,0,0
,New Balance Men's MS247GI Sneaker-Black Size 8.5,New Balance Men's MS247GI Sneaker-Black Size 8.5,Default,0,0,0,0,0,2
,New Balance Men's MS247GI Sneaker-Black Size 8.5,New Balance Men's MS247GI Sneaker-Black Size 8.5,FBALYB Amazon,20,20,0,0,0,0
,New Balance Men's MS247GI Sneaker-Black Size 9.5,New Balance Men's MS247GI Sneaker-Black Size 9.5,FBALYB Amazon,3,3,0,0,0,0
,New Balance Men's MS997HN Sneaker-Black/White Size 11.5,New Balance Men's MS997HN Sneaker-Black/White Size 11.5,FBALYB Amazon,7,7,0,0,0,0
,New Balance Men's MS997HN Sneaker-Black/White Size 12,New Balance Men's MS997HN Sneaker-Black/White Size 12,FBALYB Amazon,11,11,0,0,0,0
,New Balance Men's MS997HN Sneaker-Black/White Size 13,New Balance Men's MS997HN Sneaker-Black/White Size 13,FBALYB Amazon,1,1,0,0,0,0
,New Balance Men's MS997HN Sneaker-Black/White Size 6.5,New Balance Men's MS997HN Sneaker-Black/White Size 6.5,FBALYB Amazon,6,6,0,0,0,0
,New Balance Men's MS997HN Sneaker-Black/White Size 7.5,New Balance Men's MS997HN Sneaker-Black/White Size 7.5,FBALYB Amazon,11,11,0,0,0,0
,New Balance Men's MS997HN Sneaker-Black/White Size 8,New Balance Men's MS997HN Sneaker-Black/White Size 8,FBALYB Amazon,1,1,0,0,0,0
,New Balance Men's MS997HN Sneaker-Black/White Size 8.5,New Balance Men's MS997HN Sneaker-Black/White Size 8.5,FBALYB Amazon,14,14,0,0,0,0
,New Balance Men's MS997HN Sneaker-Black/White Size 9.5,New Balance Men's MS997HN Sneaker-Black/White Size 9.5,FBALYB Amazon,4,4,0,0,0,0
,New Balance Men's MS997HR Sneaker-Grey Size 10,New Balance Men's MS997HR Sneaker-Grey Size 10,Default,0,0,0,0,0,1
,New Balance Men's MS997HR Sneaker-Grey Size 10,New Balance Men's MS997HR Sneaker-Grey Size 10,Default Ridgefield,11,11,0,0,0,0
,New Balance Men's MS997HR Sneaker-Grey Size 10,New Balance Men's MS997HR Sneaker-Grey Size 10,FBALYB Amazon,-2,-2,0,0,0,0
,New Balance Men's MS997HR Sneaker-Grey Size 11,New Balance Men's MS997HR Sneaker-Grey Size 11,FBALYB Amazon,-3,-3,0,0,0,0
,New Balance Men's MS997HR Sneaker-Grey Size 12,New Balance Men's MS997HR Sneaker-Grey Size 12,Default,0,0,0,0,0,3
,New Balance Men's MS997HR Sneaker-Grey Size 12,New Balance Men's MS997HR Sneaker-Grey Size 12,Default Ridgefield,8,8,0,0,0,0
,New Balance Men's MS997HR Sneaker-Grey Size 13,New Balance Men's MS997HR Sneaker-Grey Size 13,Default,0,0,0,0,0,9
,New Balance Men's MS997HR Sneaker-Grey Size 13,New Balance Men's MS997HR Sneaker-Grey Size 13,Default Ridgefield,2,2,0,0,0,0
,New Balance Men's MS997HR Sneaker-Grey Size 13,New Balance Men's MS997HR Sneaker-Grey Size 13,FBALYB Amazon,-4,-4,0,0,0,0
,New Balance Men's MS997HR Sneaker-Grey Size 8,New Balance Men's MS997HR Sneaker-Grey Size 8,FBALYB Amazon,6,6,0,0,0,0
,New Balance Men's MS997HR Sneaker-Grey Size 8.5,New Balance Men's MS997HR Sneaker-Grey Size 8.5,FBALYB Amazon,12,12,0,0,0,0
,New Balance Men's MS997HR Sneaker-Grey Size 9.5,New Balance Men's MS997HR Sneaker-Grey Size 9.5,Default,0,0,0,0,0,1
,New Balance Men's MS997HR Sneaker-Grey Size 9.5,New Balance Men's MS997HR Sneaker-Grey Size 9.5,Default Ridgefield,12,12,0,0,0,0
,New Balance Men's MS997HR Sneaker-Grey Size 9.5,New Balance Men's MS997HR Sneaker-Grey Size 9.5,FBALYB Amazon,4,3,1,0,1,0
,New Balance Men's MS997JCD Sneaker-White/Moroccan Tile Size 10,New Balance Men's MS997JCD Sneaker-White/Moroccan Tile Size 10,Default Ridgefield,14,14,0,0,0,0
,New Balance Men's MS997JCD Sneaker-White/Moroccan Tile Size 10,New Balance Men's MS997JCD Sneaker-White/Moroccan Tile Size 10,FBALYB Amazon,14,14,0,1,0,0
,New Balance Men's MS997JCD Sneaker-White/Moroccan Tile Size 10.5,New Balance Men's MS997JCD Sneaker-White/Moroccan Tile Size 10.5,FBALYB Amazon,-1,-1,0,0,0,0
,New Balance Men's MS997JCD Sneaker-White/Moroccan Tile Size 11,New Balance Men's MS997JCD Sneaker-White/Moroccan Tile Size 11,FBALYB Amazon,-2,-2,0,0,0,0
,New Balance Men's MS997JCD Sneaker-White/Moroccan Tile Size 11.5,New Balance Men's MS997JCD Sneaker-White/Moroccan Tile Size 11.5,FBALYB Amazon,7,7,0,0,0,0
,New Balance Men's MS997JCD Sneaker-White/Moroccan Tile Size 12,New Balance Men's MS997JCD Sneaker-White/Moroccan Tile Size 12,FBALYB Amazon,2,2,0,0,0,0
,New Balance Men's MS997JCD Sneaker-White/Moroccan Tile Size 13,New Balance Men's MS997JCD Sneaker-White/Moroccan Tile Size 13,FBALYB Amazon,3,3,0,0,0,0
,New Balance Men's MS997JCD Sneaker-White/Moroccan Tile Size 6.5,New Balance Men's MS997JCD Sneaker-White/Moroccan Tile Size 6.5,FBALYB Amazon,3,3,0,0,0,0
,New Balance Men's MS997JCD Sneaker-White/Moroccan Tile Size 7.5,New Balance Men's MS997JCD Sneaker-White/Moroccan Tile Size 7.5,Default Ridgefield,4,4,0,0,0,0
,New Balance Men's MS997JCD Sneaker-White/Moroccan Tile Size 7.5,New Balance Men's MS997JCD Sneaker-White/Moroccan Tile Size 7.5,FBALYB Amazon,4,4,0,0,0,0
,New Balance Men's MS997JCD Sneaker-White/Moroccan Tile Size 8,New Balance Men's MS997JCD Sneaker-White/Moroccan Tile Size 8,FBALYB Amazon,6,5,1,0,1,0
,New Balance Men's MS997JCD Sneaker-White/Moroccan Tile Size 8.5,New Balance Men's MS997JCD Sneaker-White/Moroccan Tile Size 8.5,FBALYB Amazon,22,22,0,0,0,0
,New Balance Men's MS997JCD Sneaker-White/Moroccan Tile Size 9,New Balance Men's MS997JCD Sneaker-White/Moroccan Tile Size 9,FBALYB Amazon,-1,-1,0,0,0,0
,New Balance Men's MS997JCD Sneaker-White/Moroccan Tile Size 9.5,New Balance Men's MS997JCD Sneaker-White/Moroccan Tile Size 9.5,FBALYB Amazon,28,28,0,0,0,0
,New Balance Men's MS997JCF Sneaker-Castlerock/Amazonite Size 10,New Balance Men's MS997JCF Sneaker-Castlerock/Amazonite Size 10,FBALYB Amazon,4,4,0,0,0,0
,New Balance Men's MS997JCF Sneaker-Castlerock/Amazonite Size 10.5,New Balance Men's MS997JCF Sneaker-Castlerock/Amazonite Size 10.5,Default,0,0,0,0,0,3
,New Balance Men's MS997JCF Sneaker-Castlerock/Amazonite Size 10.5,New Balance Men's MS997JCF Sneaker-Castlerock/Amazonite Size 10.5,Default Ridgefield,10,10,0,0,0,0
,New Balance Men's MS997JCF Sneaker-Castlerock/Amazonite Size 10.5,New Balance Men's MS997JCF Sneaker-Castlerock/Amazonite Size 10.5,FBALYB Amazon,-4,-4,0,0,0,0
,New Balance Men's MS997JCF Sneaker-Castlerock/Amazonite Size 11,New Balance Men's MS997JCF Sneaker-Castlerock/Amazonite Size 11,FBALYB Amazon,-2,-2,0,0,0,0
,New Balance Men's MS997JCF Sneaker-Castlerock/Amazonite Size 11.5,New Balance Men's MS997JCF Sneaker-Castlerock/Amazonite Size 11.5,FBALYB Amazon,12,12,0,0,0,0
,New Balance Men's MS997JCF Sneaker-Castlerock/Amazonite Size 12,New Balance Men's MS997JCF Sneaker-Castlerock/Amazonite Size 12,FBALYB Amazon,0,-1,1,0,1,0
,New Balance Men's MS997JCF Sneaker-Castlerock/Amazonite Size 6.5,New Balance Men's MS997JCF Sneaker-Castlerock/Amazonite Size 6.5,Default,0,0,0,0,0,2
,New Balance Men's MS997JCF Sneaker-Castlerock/Amazonite Size 7.5,New Balance Men's MS997JCF Sneaker-Castlerock/Amazonite Size 7.5,FBALYB Amazon,13,13,0,0,0,0
,New Balance Men's MS997JCF Sneaker-Castlerock/Amazonite Size 8,New Balance Men's MS997JCF Sneaker-Castlerock/Amazonite Size 8,FBALYB Amazon,5,5,0,0,0,0
,New Balance Men's MS997JCF Sneaker-Castlerock/Amazonite Size 8.5,New Balance Men's MS997JCF Sneaker-Castlerock/Amazonite Size 8.5,Default,0,0,0,0,0,11
,New Balance Men's MS997JCF Sneaker-Castlerock/Amazonite Size 8.5,New Balance Men's MS997JCF Sneaker-Castlerock/Amazonite Size 8.5,FBALYB Amazon,13,13,0,0,0,0
,New Balance Men's MS997JCF Sneaker-Castlerock/Amazonite Size 9.5,New Balance Men's MS997JCF Sneaker-Castlerock/Amazonite Size 9.5,FBALYB Amazon,62,62,0,0,0,0
,New Balance Men's MS997JCG Sneaker-Gunmetal/Verdite Size 10.5,New Balance Men's MS997JCG Sneaker-Gunmetal/Verdite Size 10.5,FBALYB Amazon,1,1,0,0,0,0
,New Balance Men's MS997JCG Sneaker-Gunmetal/Verdite Size 11,New Balance Men's MS997JCG Sneaker-Gunmetal/Verdite Size 11,FBALYB Amazon,-1,-1,0,0,0,0
,New Balance Men's MS997JCG Sneaker-Gunmetal/Verdite Size 11.5,New Balance Men's MS997JCG Sneaker-Gunmetal/Verdite Size 11.5,FBALYB Amazon,-3,-3,0,0,0,0
,New Balance Men's MS997JCG Sneaker-Gunmetal/Verdite Size 13,New Balance Men's MS997JCG Sneaker-Gunmetal/Verdite Size 13,Default,0,0,0,0,0,1
,New Balance Men's MS997JCG Sneaker-Gunmetal/Verdite Size 6.5,New Balance Men's MS997JCG Sneaker-Gunmetal/Verdite Size 6.5,FBALYB Amazon,2,2,0,0,0,0
,New Balance Men's MS997JCG Sneaker-Gunmetal/Verdite Size 7.5,New Balance Men's MS997JCG Sneaker-Gunmetal/Verdite Size 7.5,FBALYB Amazon,6,6,0,0,0,0
,New Balance Men's MS997JCG Sneaker-Gunmetal/Verdite Size 8.5,New Balance Men's MS997JCG Sneaker-Gunmetal/Verdite Size 8.5,Default,0,0,0,0,0,1
,New Balance Men's MS997JCG Sneaker-Gunmetal/Verdite Size 8.5,New Balance Men's MS997JCG Sneaker-Gunmetal/Verdite Size 8.5,FBALYB Amazon,8,8,0,0,0,0
,New Balance Men's MS997JCG Sneaker-Gunmetal/Verdite Size 9.5,New Balance Men's MS997JCG Sneaker-Gunmetal/Verdite Size 9.5,FBALYB Amazon,15,15,0,0,0,0
,New Balance Men's MS997RA Sneaker-Light Aluminum/Bayside Size 10.5,New Balance Men's MS997RA Sneaker-Light Aluminum/Bayside Size 10.5,Default,0,0,0,0,0,1
,New Balance Men's MS997RA Sneaker-Light Aluminum/Bayside Size 10.5,New Balance Men's MS997RA Sneaker-Light Aluminum/Bayside Size 10.5,FBALYB Amazon,-2,-2,0,0,0,0
,New Balance Men's MS997RA Sneaker-Light Aluminum/Bayside Size 11.5,New Balance Men's MS997RA Sneaker-Light Aluminum/Bayside Size 11.5,FBALYB Amazon,-1,-1,0,0,0,0
,New Balance Men's MS997RA Sneaker-Light Aluminum/Bayside Size 13,New Balance Men's MS997RA Sneaker-Light Aluminum/Bayside Size 13,FBALYB Amazon,-1,-1,0,0,0,0
,New Balance Men's MS997RA Sneaker-Light Aluminum/Bayside Size 6.5,New Balance Men's MS997RA Sneaker-Light Aluminum/Bayside Size 6.5,FBALYB Amazon,5,5,0,0,0,0
,New Balance Men's MS997RA Sneaker-Light Aluminum/Bayside Size 7.5,New Balance Men's MS997RA Sneaker-Light Aluminum/Bayside Size 7.5,FBALYB Amazon,9,9,0,0,0,0
,New Balance Men's MS997RA Sneaker-Light Aluminum/Bayside Size 8.5,New Balance Men's MS997RA Sneaker-Light Aluminum/Bayside Size 8.5,FBALYB Amazon,9,9,0,0,0,0
,New Balance Men's MS997RA Sneaker-Light Aluminum/Bayside Size 9.5,New Balance Men's MS997RA Sneaker-Light Aluminum/Bayside Size 9.5,FBALYB Amazon,8,8,0,0,0,0
,New Balance Men's MZANPLB Sneaker-Chambray/Lynx Blue/Energy Red Size 7,New Balance Men's MZANPLB Sneaker-Chambray/Lynx Blue/Energy Red Size 7,Default,0,0,0,0,0,1
,New Balance Men's MZANPLB Sneaker-Chambray/Lynx Blue/Energy Red Size 7,New Balance Men's MZANPLB Sneaker-Chambray/Lynx Blue/Energy Red Size 7,FBALYB Amazon,-1,-1,0,0,0,0
,New Balance Men's MZANPLB Sneaker-Chambray/Lynx Blue/Energy Red Size 7.5,New Balance Men's MZANPLB Sneaker-Chambray/Lynx Blue/Energy Red Size 7.5,FBALYB Amazon,-1,-1,0,0,0,0
,New Balance Men's MZANPLB Sneaker-Chambray/Lynx Blue/Energy Red Size 8.5,New Balance Men's MZANPLB Sneaker-Chambray/Lynx Blue/Energy Red Size 8.5,Default Ridgefield,4,4,0,0,0,0
,New Balance Men's MZANPLB Sneaker-Chambray/Lynx Blue/Energy Red Size 9.5,New Balance Men's MZANPLB Sneaker-Chambray/Lynx Blue/Energy Red Size 9.5,FBALYB Amazon,1,1,0,0,0,0
,New Balance Men's MZANPSY Sneaker-Blue/Supercell Size 12.5,New Balance Men's MZANPSY Sneaker-Blue/Supercell Size 12.5,FBALYB Amazon,-1,-1,0,0,0,0
,New Balance Men's MZANPSY Sneaker-Blue/Supercell Size 7.5,New Balance Men's MZANPSY Sneaker-Blue/Supercell Size 7.5,FBALYB Amazon,1,1,0,0,0,0
,New Balance Men's MZANPSY Sneaker-Blue/Supercell Size 8.5,New Balance Men's MZANPSY Sneaker-Blue/Supercell Size 8.5,FBALYB Amazon,-2,-2,0,0,0,0
,New Balance Men's MZANPSY Sneaker-Blue/Supercell Size 9.5,New Balance Men's MZANPSY Sneaker-Blue/Supercell Size 9.5,FBALYB Amazon,-2,-2,0,1,0,0
,New Balance Women's CW997HKA Sneaker-White/Blue/Pink Size 5,New Balance Women's CW997HKA Sneaker-White/Blue/Pink Size 5,FBALYB Amazon,6,6,0,0,0,0
,New Balance Women's CW997HKA Sneaker-White/Blue/Pink Size 5.5,New Balance Women's CW997HKA Sneaker-White/Blue/Pink Size 5.5,FBALYB Amazon,6,6,0,0,0,0
,New Balance Women's CW997HKA Sneaker-White/Blue/Pink Size 6,New Balance Women's CW997HKA Sneaker-White/Blue/Pink Size 6,Default,0,0,0,0,0,1
,New Balance Women's CW997HKA Sneaker-White/Blue/Pink Size 6,New Balance Women's CW997HKA Sneaker-White/Blue/Pink Size 6,FBALYB Amazon,17,17,0,0,0,0
,New Balance Women's CW997HKA Sneaker-White/Blue/Pink Size 6.5,New Balance Women's CW997HKA Sneaker-White/Blue/Pink Size 6.5,Default,0,0,0,0,0,4
,New Balance Women's CW997HKA Sneaker-White/Blue/Pink Size 6.5,New Balance Women's CW997HKA Sneaker-White/Blue/Pink Size 6.5,FBALYB Amazon,11,11,0,0,0,0
,New Balance Women's CW997HKA Sneaker-White/Blue/Pink Size 7,New Balance Women's CW997HKA Sneaker-White/Blue/Pink Size 7,FBALYB Amazon,25,24,1,0,1,0
,New Balance Women's CW997HKA Sneaker-White/Blue/Pink Size 8,New Balance Women's CW997HKA Sneaker-White/Blue/Pink Size 8,FBALYB Amazon,26,26,0,0,0,0
,New Balance Women's CW997HKA Sneaker-White/Blue/Pink Size 8.5,New Balance Women's CW997HKA Sneaker-White/Blue/Pink Size 8.5,FBALYB Amazon,14,14,0,0,0,0
,New Balance Women's CW997HKA Sneaker-White/Blue/Pink Size 9,New Balance Women's CW997HKA Sneaker-White/Blue/Pink Size 9,FBALYB Amazon,2,2,0,0,0,0
,New Balance Women's CW997HKA Sneaker-White/Blue/Pink Size 9.5,New Balance Women's CW997HKA Sneaker-White/Blue/Pink Size 9.5,FBALYB Amazon,5,5,0,0,0,0
,New Balance Women's W870RP5 Sneaker-Oxegen Pink/Iodine Violet Size 10,New Balance Women's W870RP5 Sneaker-Oxegen Pink/Iodine Violet Size 10,FBALYB Amazon,-1,-1,0,0,0,0
,New Balance Women's W870RP5 Sneaker-Oxegen Pink/Iodine Violet Size 6,New Balance Women's W870RP5 Sneaker-Oxegen Pink/Iodine Violet Size 6,Default,0,0,0,0,0,2
,New Balance Women's W870RP5 Sneaker-Oxegen Pink/Iodine Violet Size 6,New Balance Women's W870RP5 Sneaker-Oxegen Pink/Iodine Violet Size 6,Default Ridgefield,10,10,0,0,0,0
,New Balance Women's W870RP5 Sneaker-Oxegen Pink/Iodine Violet Size 6,New Balance Women's W870RP5 Sneaker-Oxegen Pink/Iodine Violet Size 6,FBALYB Amazon,-3,-3,0,0,0,0
,New Balance Women's W870RP5 Sneaker-Oxegen Pink/Iodine Violet Size 7,New Balance Women's W870RP5 Sneaker-Oxegen Pink/Iodine Violet Size 7,Default,0,0,0,0,0,2
,New Balance Women's W870RP5 Sneaker-Oxegen Pink/Iodine Violet Size 7,New Balance Women's W870RP5 Sneaker-Oxegen Pink/Iodine Violet Size 7,Default Ridgefield,10,10,0,0,0,0
,New Balance Women's W870RP5 Sneaker-Oxegen Pink/Iodine Violet Size 7,New Balance Women's W870RP5 Sneaker-Oxegen Pink/Iodine Violet Size 7,FBALYB Amazon,-1,-1,0,0,0,0
,New Balance Women's W870RP5 Sneaker-Oxegen Pink/Iodine Violet Size 7.5,New Balance Women's W870RP5 Sneaker-Oxegen Pink/Iodine Violet Size 7.5,FBALYB Amazon,-1,-1,0,0,0,0
,New Balance Women's W870RP5 Sneaker-Oxegen Pink/Iodine Violet Size 8,New Balance Women's W870RP5 Sneaker-Oxegen Pink/Iodine Violet Size 8,FBALYB Amazon,-1,-1,0,0,0,0
,New Balance Women's W870RP5 Sneaker-Oxegen Pink/Iodine Violet Size 9,New Balance Women's W870RP5 Sneaker-Oxegen Pink/Iodine Violet Size 9,Default,0,0,0,0,0,1
,New Balance Women's W880PP9 Sneaker-Grey Size 10,New Balance Women's W880PP9 Sneaker-Grey Size 10,FBALYB Amazon,-1,-1,0,0,0,0
,New Balance Women's W880PP9 Sneaker-Grey Size 6,New Balance Women's W880PP9 Sneaker-Grey Size 6,Default,0,0,0,0,0,5
,New Balance Women's W880PP9 Sneaker-Grey Size 6,New Balance Women's W880PP9 Sneaker-Grey Size 6,Default Ridgefield,13,13,0,0,0,0
,New Balance Women's W880PP9 Sneaker-Grey Size 7,New Balance Women's W880PP9 Sneaker-Grey Size 7,Default,0,0,0,0,0,1
,New Balance Women's W880PP9 Sneaker-Grey Size 7,New Balance Women's W880PP9 Sneaker-Grey Size 7,Default Ridgefield,3,3,0,0,0,0
,New Balance Women's W880PP9 Sneaker-Grey Size 7,New Balance Women's W880PP9 Sneaker-Grey Size 7,FBALYB Amazon,-1,-1,0,0,0,0
,New Balance Women's W880PP9 Sneaker-Grey Size 8,New Balance Women's W880PP9 Sneaker-Grey Size 8,Default,0,0,0,0,0,1
,New Balance Women's W880PP9 Sneaker-Grey Size 8,New Balance Women's W880PP9 Sneaker-Grey Size 8,FBALYB Amazon,-2,-2,0,0,0,0
,New Balance Women's W880TB9 Sneaker-Black Size 5,New Balance Women's W880TB9 Sneaker-Black Size 5,Default,0,0,0,0,0,1
,New Balance Women's W880TB9 Sneaker-Black Size 5,New Balance Women's W880TB9 Sneaker-Black Size 5,Default Ridgefield,5,5,0,0,0,0
,New Balance Women's W880TB9 Sneaker-Black Size 5.5,New Balance Women's W880TB9 Sneaker-Black Size 5.5,Default,0,0,0,0,0,6
,New Balance Women's W880TB9 Sneaker-Black Size 6.5,New Balance Women's W880TB9 Sneaker-Black Size 6.5,Default,0,0,0,0,0,3
,New Balance Women's W880TB9 Sneaker-Black Size 6.5,New Balance Women's W880TB9 Sneaker-Black Size 6.5,Default Ridgefield,13,13,0,0,0,0
,New Balance Women's W880TB9 Sneaker-Black Size 7.5,New Balance Women's W880TB9 Sneaker-Black Size 7.5,Default,0,0,0,0,0,6
,New Balance Women's W880TB9 Sneaker-Black Size 7.5,New Balance Women's W880TB9 Sneaker-Black Size 7.5,Default Ridgefield,14,14,0,0,0,0
,New Balance Women's W880TB9 Sneaker-Black Size 8,New Balance Women's W880TB9 Sneaker-Black Size 8,FBALYB Amazon,-5,-5,0,0,0,0
,New Balance Women's W880TB9 Sneaker-Black Size 8.5,New Balance Women's W880TB9 Sneaker-Black Size 8.5,Default Ridgefield,10,10,0,0,0,0
,New Balance Women's W880TB9 Sneaker-Black Size 8.5,New Balance Women's W880TB9 Sneaker-Black Size 8.5,FBALYB Amazon,11,11,0,0,0,0
,New Balance Women's W880TB9 Sneaker-Black Size 9.5,New Balance Women's W880TB9 Sneaker-Black Size 9.5,FBALYB Amazon,-9,-9,0,0,0,0
,New Balance Women's WBECNBW2 Sneaker-Black/Orca Size 5,New Balance Women's WBECNBW2 Sneaker-Black/Orca Size 5,FBALYB Amazon,4,4,0,0,0,0
,New Balance Women's WBECNBW2 Sneaker-Black/Orca Size 5.5,New Balance Women's WBECNBW2 Sneaker-Black/Orca Size 5.5,FBALYB Amazon,-3,-3,0,0,0,0
,New Balance Women's WBECNBW2 Sneaker-Black/Orca Size 6.5,New Balance Women's WBECNBW2 Sneaker-Black/Orca Size 6.5,FBALYB Amazon,-2,-2,0,0,0,0
,New Balance Women's WBECNBW2 Sneaker-Black/Orca Size 7.5,New Balance Women's WBECNBW2 Sneaker-Black/Orca Size 7.5,FBALYB Amazon,-6,-6,0,0,0,0
,New Balance Women's WBECNBW2 Sneaker-Black/Orca Size 8,New Balance Women's WBECNBW2 Sneaker-Black/Orca Size 8,FBALYB Amazon,-4,-4,0,0,0,0
,New Balance Women's WBECNBW2 Sneaker-Black/Orca Size 8.5,New Balance Women's WBECNBW2 Sneaker-Black/Orca Size 8.5,FBALYB Amazon,-1,-1,0,0,0,0
,New Balance Women's WBECNBW2 Sneaker-Black/Orca Size 9.5,New Balance Women's WBECNBW2 Sneaker-Black/Orca Size 9.5,FBALYB Amazon,-2,-2,0,0,0,0
,New Balance Women's WBECNDF2 Sneaker-Dragon Fruit/Sedona/Peony Size 5,New Balance Women's WBECNDF2 Sneaker-Dragon Fruit/Sedona/Peony Size 5,FBALYB Amazon,1,1,0,0,0,0
,New Balance Women's WBECNDF2 Sneaker-Dragon Fruit/Sedona/Peony Size 6,New Balance Women's WBECNDF2 Sneaker-Dragon Fruit/Sedona/Peony Size 6,FBALYB Amazon,14,14,0,1,0,0
,New Balance Women's WBECNDF2 Sneaker-Dragon Fruit/Sedona/Peony Size 7,New Balance Women's WBECNDF2 Sneaker-Dragon Fruit/Sedona/Peony Size 7,FBALYB Amazon,-2,-2,0,0,0,0
,New Balance Women's WBECNDF2 Sneaker-Dragon Fruit/Sedona/Peony Size 8,New Balance Women's WBECNDF2 Sneaker-Dragon Fruit/Sedona/Peony Size 8,FBALYB Amazon,-2,-2,0,0,0,0
,New Balance Women's WBECNDF2 Sneaker-Dragon Fruit/Sedona/Peony Size 8.5,New Balance Women's WBECNDF2 Sneaker-Dragon Fruit/Sedona/Peony Size 8.5,FBALYB Amazon,-1,-1,0,0,0,0
,New Balance Women's WBECNDF2 Sneaker-Dragon Fruit/Sedona/Peony Size 9.5,New Balance Women's WBECNDF2 Sneaker-Dragon Fruit/Sedona/Peony Size 9.5,FBALYB Amazon,-1,-1,0,0,0,0
,New Balance Women's WBECNLP2 Sneaker-White/Summer Fog/Bayside Size 5.5,New Balance Women's WBECNLP2 Sneaker-White/Summer Fog/Bayside Size 5.5,FBALYB Amazon,1,1,0,0,0,0
,New Balance Women's WBECNLP2 Sneaker-White/Summer Fog/Bayside Size 6,New Balance Women's WBECNLP2 Sneaker-White/Summer Fog/Bayside Size 6,Default Ridgefield,5,5,0,0,0,0
,New Balance Women's WBECNLP2 Sneaker-White/Summer Fog/Bayside Size 6,New Balance Women's WBECNLP2 Sneaker-White/Summer Fog/Bayside Size 6,FBALYB Amazon,-2,-2,0,6,0,0
,New Balance Women's WBECNLP2 Sneaker-White/Summer Fog/Bayside Size 7,New Balance Women's WBECNLP2 Sneaker-White/Summer Fog/Bayside Size 7,FBALYB Amazon,-3,-3,0,0,0,0
,New Balance Women's WBECNLP2 Sneaker-White/Summer Fog/Bayside Size 8,New Balance Women's WBECNLP2 Sneaker-White/Summer Fog/Bayside Size 8,FBALYB Amazon,-2,-2,0,0,0,0
,New Balance Women's WL373WNB Sneaker-Black/White Size 6.5,New Balance Women's WL373WNB Sneaker-Black/White Size 6.5,Default,0,0,0,0,0,1
,New Balance Women's WL373WNB Sneaker-Black/White Size 6.5,New Balance Women's WL373WNB Sneaker-Black/White Size 6.5,Default Ridgefield,7,7,0,0,0,0
,New Balance Women's WL373WNB Sneaker-Black/White Size 7.5,New Balance Women's WL373WNB Sneaker-Black/White Size 7.5,Default,0,0,0,0,0,1
,New Balance Women's WL373WNB Sneaker-Black/White Size 7.5,New Balance Women's WL373WNB Sneaker-Black/White Size 7.5,Default Ridgefield,9,9,0,0,0,0
,New Balance Women's WL373WNB Sneaker-Black/White Size 8,New Balance Women's WL373WNB Sneaker-Black/White Size 8,Default Ridgefield,6,6,0,0,0,0
,New Balance Women's WL373WNB Sneaker-Black/White Size 9.5,New Balance Women's WL373WNB Sneaker-Black/White Size 9.5,Default Ridgefield,2,2,0,0,0,0
,New Balance Women's WL574EB Sneaker-Black (001) Size 5,New Balance Women's WL574EB Sneaker-Black (001) Size 5,FBALYB Amazon,-4,-4,0,0,0,0
,New Balance Women's WL574EB Sneaker-Black (001) Size 5.5,New Balance Women's WL574EB Sneaker-Black (001) Size 5.5,FBALYB Amazon,-1,-1,0,0,0,0
,New Balance Women's WL574EB Sneaker-Black (001) Size 6,New Balance Women's WL574EB Sneaker-Black (001) Size 6,FBALYB Amazon,-8,-8,0,0,0,0
,New Balance Women's WL574EB Sneaker-Black (001) Size 6.5,New Balance Women's WL574EB Sneaker-Black (001) Size 6.5,FBALYB Amazon,-10,-10,0,0,0,0
,New Balance Women's WL574EB Sneaker-Black (001) Size 7,New Balance Women's WL574EB Sneaker-Black (001) Size 7,Default,6,6,0,0,0,0
,New Balance Women's WL574EB Sneaker-Black (001) Size 7,New Balance Women's WL574EB Sneaker-Black (001) Size 7,FBALYB Amazon,-19,-20,1,0,1,0
,New Balance Women's WL574EB Sneaker-Black (001) Size 7.5,New Balance Women's WL574EB Sneaker-Black (001) Size 7.5,FBALYB Amazon,-23,-23,0,0,0,0
,New Balance Women's WL574EB Sneaker-Black (001) Size 8,New Balance Women's WL574EB Sneaker-Black (001) Size 8,FBALYB Amazon,-15,-15,0,0,0,0
,New Balance Women's WL574EB Sneaker-Black (001) Size 8.5,New Balance Women's WL574EB Sneaker-Black (001) Size 8.5,FBALYB Amazon,-1,-1,0,0,0,0
,New Balance Women's WL574EG Sneaker-Grey (030) Size 10.5,New Balance Women's WL574EG Sneaker-Grey (030) Size 10.5,FBALYB Amazon,-1,-1,0,0,0,0
,New Balance Women's WL574EG Sneaker-Grey (030) Size 5,New Balance Women's WL574EG Sneaker-Grey (030) Size 5,FBALYB Amazon,-7,-7,0,0,0,0
,New Balance Women's WL574EG Sneaker-Grey (030) Size 5.5,New Balance Women's WL574EG Sneaker-Grey (030) Size 5.5,FBALYB Amazon,-6,-6,0,0,0,0
,New Balance Women's WL574EG Sneaker-Grey (030) Size 6,New Balance Women's WL574EG Sneaker-Grey (030) Size 6,Default,3,3,0,0,0,0
,New Balance Women's WL574EG Sneaker-Grey (030) Size 6,New Balance Women's WL574EG Sneaker-Grey (030) Size 6,FBALYB Amazon,-8,-8,0,0,0,0
,New Balance Women's WL574EG Sneaker-Grey (030) Size 6.5,New Balance Women's WL574EG Sneaker-Grey (030) Size 6.5,Default Ridgefield,3,3,0,0,0,0
,New Balance Women's WL574EG Sneaker-Grey (030) Size 6.5,New Balance Women's WL574EG Sneaker-Grey (030) Size 6.5,FBALYB Amazon,-7,-7,0,3,0,0
,New Balance Women's WL574EG Sneaker-Grey (030) Size 7,New Balance Women's WL574EG Sneaker-Grey (030) Size 7,Default Ridgefield,3,3,0,0,0,0
,New Balance Women's WL574EG Sneaker-Grey (030) Size 7,New Balance Women's WL574EG Sneaker-Grey (030) Size 7,FBALYB Amazon,-23,-23,0,0,0,0
,New Balance Women's WL574EG Sneaker-Grey (030) Size 7.5,New Balance Women's WL574EG Sneaker-Grey (030) Size 7.5,Default Ridgefield,30,30,0,0,0,0
,New Balance Women's WL574EG Sneaker-Grey (030) Size 7.5,New Balance Women's WL574EG Sneaker-Grey (030) Size 7.5,FBALYB Amazon,-17,-17,0,1,0,0
,New Balance Women's WL574EG Sneaker-Grey (030) Size 8,New Balance Women's WL574EG Sneaker-Grey (030) Size 8,Default Ridgefield,15,15,0,0,0,0
,New Balance Women's WL574EG Sneaker-Grey (030) Size 8,New Balance Women's WL574EG Sneaker-Grey (030) Size 8,FBALYB Amazon,-10,-10,0,1,0,0
,New Balance Women's WL574EG Sneaker-Grey (030) Size 8.5,New Balance Women's WL574EG Sneaker-Grey (030) Size 8.5,FBALYB Amazon,-1,-1,0,0,0,0
,New Balance Women's WL574EG Sneaker-Grey (030) Size 9.5,New Balance Women's WL574EG Sneaker-Grey (030) Size 9.5,FBALYB Amazon,-4,-4,0,0,0,0
,New Balance Women's WL574EN Sneaker-Navy (410) Size 6,New Balance Women's WL574EN Sneaker-Navy (410) Size 6,FBALYB Amazon,12,12,0,0,0,0
,New Balance Women's WL574EN Sneaker-Navy (410) Size 6.5,New Balance Women's WL574EN Sneaker-Navy (410) Size 6.5,FBALYB Amazon,19,19,0,0,0,0
,New Balance Women's WL574EN Sneaker-Navy (410) Size 7,New Balance Women's WL574EN Sneaker-Navy (410) Size 7,Default Ridgefield,1,1,0,0,0,0
,New Balance Women's WL574EN Sneaker-Navy (410) Size 7,New Balance Women's WL574EN Sneaker-Navy (410) Size 7,FBALYB Amazon,-11,-11,0,0,0,0
,New Balance Women's WL574EN Sneaker-Navy (410) Size 7.5,New Balance Women's WL574EN Sneaker-Navy (410) Size 7.5,FBALYB Amazon,-25,-25,0,0,0,0
,New Balance Women's WL574EN Sneaker-Navy (410) Size 8,New Balance Women's WL574EN Sneaker-Navy (410) Size 8,FBALYB Amazon,-18,-18,0,0,0,0
,New Balance Women's WL574ER Sneaker-Burgundy/White Size 5,New Balance Women's WL574ER Sneaker-Burgundy/White Size 5,FBALYB Amazon,-4,-4,0,0,0,0
,New Balance Women's WL574ER Sneaker-Burgundy/White Size 5.5,New Balance Women's WL574ER Sneaker-Burgundy/White Size 5.5,FBALYB Amazon,-2,-2,0,0,0,0
,New Balance Women's WL574ER Sneaker-Burgundy/White Size 6,New Balance Women's WL574ER Sneaker-Burgundy/White Size 6,FBALYB Amazon,-3,-3,0,0,0,0
,New Balance Women's WL574ER Sneaker-Burgundy/White Size 6.5,New Balance Women's WL574ER Sneaker-Burgundy/White Size 6.5,FBALYB Amazon,-7,-7,0,0,0,0
,New Balance Women's WL574ER Sneaker-Burgundy/White Size 7,New Balance Women's WL574ER Sneaker-Burgundy/White Size 7,FBALYB Amazon,-5,-5,0,0,0,0
,New Balance Women's WL574ER Sneaker-Burgundy/White Size 7.5,New Balance Women's WL574ER Sneaker-Burgundy/White Size 7.5,FBALYB Amazon,-4,-4,0,0,0,0
,New Balance Women's WL574ER Sneaker-Burgundy/White Size 8,New Balance Women's WL574ER Sneaker-Burgundy/White Size 8,FBALYB Amazon,-7,-7,0,0,0,0
,New Balance Women's WL574ER Sneaker-Burgundy/White Size 8.5,New Balance Women's WL574ER Sneaker-Burgundy/White Size 8.5,FBALYB Amazon,-3,-3,0,0,0,0
,New Balance Women's WL574ER Sneaker-Burgundy/White Size 9,New Balance Women's WL574ER Sneaker-Burgundy/White Size 9,FBALYB Amazon,-1,-1,0,0,0,0
,New Balance Women's WL574ER Sneaker-Burgundy/White Size 9.5,New Balance Women's WL574ER Sneaker-Burgundy/White Size 9.5,FBALYB Amazon,-7,-7,0,0,0,0
,New Balance Women's WL574EW Sneaker-White (100) Size 6,New Balance Women's WL574EW Sneaker-White (100) Size 6,Default,3,3,0,0,0,0
,New Balance Women's WL574EW Sneaker-White (100) Size 6,New Balance Women's WL574EW Sneaker-White (100) Size 6,FBALYB Amazon,-5,-5,0,0,0,0
,New Balance Women's WL574EW Sneaker-White (100) Size 6.5,New Balance Women's WL574EW Sneaker-White (100) Size 6.5,Default Ridgefield,3,3,0,0,0,0
,New Balance Women's WL574EW Sneaker-White (100) Size 6.5,New Balance Women's WL574EW Sneaker-White (100) Size 6.5,FBALYB Amazon,-4,-4,0,0,0,0
,New Balance Women's WL574EW Sneaker-White (100) Size 7,New Balance Women's WL574EW Sneaker-White (100) Size 7,Default Ridgefield,3,3,0,0,0,0
,New Balance Women's WL574EW Sneaker-White (100) Size 7,New Balance Women's WL574EW Sneaker-White (100) Size 7,FBALYB Amazon,-12,-12,0,5,0,0
,New Balance Women's WL574EW Sneaker-White (100) Size 7.5,New Balance Women's WL574EW Sneaker-White (100) Size 7.5,FBALYB Amazon,-5,-5,0,0,0,0
,New Balance Women's WL574EW Sneaker-White (100) Size 8,New Balance Women's WL574EW Sneaker-White (100) Size 8,Default Ridgefield,3,3,0,0,0,0
,New Balance Women's WL574EW Sneaker-White (100) Size 8,New Balance Women's WL574EW Sneaker-White (100) Size 8,FBALYB Amazon,-2,-2,0,3,0,0
,New Balance Women's WL574NDB Sneaker-Grey/Pink Size 10.5,New Balance Women's WL574NDB Sneaker-Grey/Pink Size 10.5,Default Ridgefield,1,1,0,0,0,0
,New Balance Women's WL574NDB Sneaker-Grey/Pink Size 5,New Balance Women's WL574NDB Sneaker-Grey/Pink Size 5,FBALYB Amazon,12,12,0,0,0,0
,New Balance Women's WL574NDB Sneaker-Grey/Pink Size 6.5,New Balance Women's WL574NDB Sneaker-Grey/Pink Size 6.5,FBALYB Amazon,8,8,0,0,0,0
,New Balance Women's WL574NDB Sneaker-Grey/Pink Size 7,New Balance Women's WL574NDB Sneaker-Grey/Pink Size 7,Default,0,0,0,0,0,4
,New Balance Women's WL574NDB Sneaker-Grey/Pink Size 7,New Balance Women's WL574NDB Sneaker-Grey/Pink Size 7,FBALYB Amazon,-2,-2,0,0,0,0
,New Balance Women's WL574NDB Sneaker-Grey/Pink Size 7.5,New Balance Women's WL574NDB Sneaker-Grey/Pink Size 7.5,Default,0,0,0,0,0,1
,New Balance Women's WL574NDB Sneaker-Grey/Pink Size 7.5,New Balance Women's WL574NDB Sneaker-Grey/Pink Size 7.5,FBALYB Amazon,37,37,0,0,0,0
,New Balance Women's WL574NDB Sneaker-Grey/Pink Size 8,New Balance Women's WL574NDB Sneaker-Grey/Pink Size 8,Default,0,0,0,0,0,1
,New Balance Women's WL574NDB Sneaker-Grey/Pink Size 8,New Balance Women's WL574NDB Sneaker-Grey/Pink Size 8,FBALYB Amazon,14,12,2,0,2,0
,New Balance Women's WL574NDB Sneaker-Grey/Pink Size 8.5,New Balance Women's WL574NDB Sneaker-Grey/Pink Size 8.5,FBALYB Amazon,11,11,0,1,0,0
,New Balance Women's WL574NDB Sneaker-Grey/Pink Size 9.5,New Balance Women's WL574NDB Sneaker-Grey/Pink Size 9.5,FBALYB Amazon,15,15,0,0,0,0
,New Balance Women's WL574WNA Sneaker-Oyster/Pink Size 10,New Balance Women's WL574WNA Sneaker-Oyster/Pink Size 10,FBALYB Amazon,-1,-1,0,0,0,0
,New Balance Women's WL574WNA Sneaker-Oyster/Pink Size 10.5,New Balance Women's WL574WNA Sneaker-Oyster/Pink Size 10.5,FBALYB Amazon,-2,-2,0,0,0,0
,New Balance Women's WL574WNA Sneaker-Oyster/Pink Size 5,New Balance Women's WL574WNA Sneaker-Oyster/Pink Size 5,FBALYB Amazon,0,-1,1,0,1,0
,New Balance Women's WL574WNA Sneaker-Oyster/Pink Size 6,New Balance Women's WL574WNA Sneaker-Oyster/Pink Size 6,Default,0,0,0,0,0,1
,New Balance Women's WL574WNA Sneaker-Oyster/Pink Size 6.5,New Balance Women's WL574WNA Sneaker-Oyster/Pink Size 6.5,FBALYB Amazon,-3,-3,0,0,0,0
,New Balance Women's WL574WNA Sneaker-Oyster/Pink Size 7,New Balance Women's WL574WNA Sneaker-Oyster/Pink Size 7,FBALYB Amazon,-6,-6,0,0,0,0
,New Balance Women's WL574WNA Sneaker-Oyster/Pink Size 7.5,New Balance Women's WL574WNA Sneaker-Oyster/Pink Size 7.5,FBALYB Amazon,-2,-2,0,0,0,0
,New Balance Women's WL574WNA Sneaker-Oyster/Pink Size 8,New Balance Women's WL574WNA Sneaker-Oyster/Pink Size 8,FBALYB Amazon,-3,-3,0,0,0,0
,New Balance Women's WL574WNA Sneaker-Oyster/Pink Size 9,New Balance Women's WL574WNA Sneaker-Oyster/Pink Size 9,Default,0,0,0,0,0,1
,New Balance Women's WL996BB Sneaker-Summer Fog/Moroccan Tile Size 5.5W,New Balance Women's WL996BB Sneaker-Summer Fog/Moroccan Tile Size 5.5W,FBALYB Amazon,3,3,0,0,0,0
,New Balance Women's WL996BB Sneaker-Summer Fog/Moroccan Tile Size 6.5W,New Balance Women's WL996BB Sneaker-Summer Fog/Moroccan Tile Size 6.5W,FBALYB Amazon,1,1,0,0,0,0
,New Balance Women's WL996BB Sneaker-Summer Fog/Moroccan Tile Size 7.5W,New Balance Women's WL996BB Sneaker-Summer Fog/Moroccan Tile Size 7.5W,FBALYB Amazon,6,6,0,0,0,0
,New Balance Women's WL996BB Sneaker-Summer Fog/Moroccan Tile Size 8.5W,New Balance Women's WL996BB Sneaker-Summer Fog/Moroccan Tile Size 8.5W,FBALYB Amazon,-1,-1,0,0,0,0
,New Balance Women's WL996BB Sneaker-Summer Fog/Moroccan Tile Size 8W,New Balance Women's WL996BB Sneaker-Summer Fog/Moroccan Tile Size 8W,FBALYB Amazon,-3,-3,0,0,0,0
,New Balance Women's WL996BB Sneaker-Summer Fog/Moroccan Tile Size 9.5W,New Balance Women's WL996BB Sneaker-Summer Fog/Moroccan Tile Size 9.5W,FBALYB Amazon,2,2,0,0,0,0
,New Balance Women's WS997JCF Sneaker-White/Black Size 5,New Balance Women's WS997JCF Sneaker-White/Black Size 5,FBALYB Amazon,1,1,0,0,0,0
,New Balance Women's WS997JCF Sneaker-White/Black Size 5.5,New Balance Women's WS997JCF Sneaker-White/Black Size 5.5,FBALYB Amazon,4,4,0,0,0,0
,New Balance Women's WS997JCF Sneaker-White/Black Size 6,New Balance Women's WS997JCF Sneaker-White/Black Size 6,Default,0,0,0,0,0,1
,New Balance Women's WS997JCF Sneaker-White/Black Size 6,New Balance Women's WS997JCF Sneaker-White/Black Size 6,FBALYB Amazon,-6,-6,0,0,0,0
,New Balance Women's WS997JCF Sneaker-White/Black Size 7,New Balance Women's WS997JCF Sneaker-White/Black Size 7,FBALYB Amazon,-10,-10,0,0,0,0
,New Balance Women's WS997JCF Sneaker-White/Black Size 7.5,New Balance Women's WS997JCF Sneaker-White/Black Size 7.5,FBALYB Amazon,-2,-2,0,0,0,0
,New Balance Women's WS997JCF Sneaker-White/Black Size 8,New Balance Women's WS997JCF Sneaker-White/Black Size 8,FBALYB Amazon,-8,-8,0,0,0,0
,New Balance Women's WS997JCF Sneaker-White/Black Size 8.5,New Balance Women's WS997JCF Sneaker-White/Black Size 8.5,FBALYB Amazon,4,4,0,0,0,0
,New Balance Women's WS997JCF Sneaker-White/Black Size 9,New Balance Women's WS997JCF Sneaker-White/Black Size 9,FBALYB Amazon,-5,-5,0,0,0,0
,New Balance Women's WZANPFW Sneaker-White Size 5,New Balance Women's WZANPFW Sneaker-White Size 5,FBALYB Amazon,1,1,0,0,0,0
,New Balance Women's WZANPFW Sneaker-White Size 5.5,New Balance Women's WZANPFW Sneaker-White Size 5.5,Default Ridgefield,4,4,0,0,0,0
,New Balance Women's WZANPFW Sneaker-White Size 6,New Balance Women's WZANPFW Sneaker-White Size 6,Default Ridgefield,10,10,0,0,0,0
,New Balance Women's WZANPFW Sneaker-White Size 6,New Balance Women's WZANPFW Sneaker-White Size 6,FBALYB Amazon,10,10,0,0,0,0
,New Balance Women's WZANPFW Sneaker-White Size 6.5,New Balance Women's WZANPFW Sneaker-White Size 6.5,Default,0,0,0,0,0,1
,New Balance Women's WZANPFW Sneaker-White Size 6.5,New Balance Women's WZANPFW Sneaker-White Size 6.5,Default Ridgefield,10,10,0,0,0,0
,New Balance Women's WZANPFW Sneaker-White Size 6.5,New Balance Women's WZANPFW Sneaker-White Size 6.5,FBALYB Amazon,10,10,0,0,0,0
,New Balance Women's WZANPFW Sneaker-White Size 7,New Balance Women's WZANPFW Sneaker-White Size 7,Default Ridgefield,7,7,0,0,0,0
,New Balance Women's WZANPFW Sneaker-White Size 7,New Balance Women's WZANPFW Sneaker-White Size 7,FBALYB Amazon,7,7,0,0,0,0
,New Balance Women's WZANPFW Sneaker-White Size 8,New Balance Women's WZANPFW Sneaker-White Size 8,Default Ridgefield,14,14,0,0,0,0
,New Balance Women's WZANPFW Sneaker-White Size 8,New Balance Women's WZANPFW Sneaker-White Size 8,FBALYB Amazon,14,14,0,0,0,0
,New Balance Women's WZANPFW Sneaker-White Size 8.5,New Balance Women's WZANPFW Sneaker-White Size 8.5,Default Ridgefield,9,9,0,0,0,0
,New Balance Women's WZANPFW Sneaker-White Size 8.5,New Balance Women's WZANPFW Sneaker-White Size 8.5,FBALYB Amazon,9,9,0,0,0,0
,New Balance Women's WZANPFW Sneaker-White Size 9.5,New Balance Women's WZANPFW Sneaker-White Size 9.5,FBALYB Amazon,-2,-2,0,0,0,0
,New Era Headwear 10047511 OSFA,New Era Headwear 10047511 OSFA,Default,0,0,0,0,0,10
,New Era Headwear 10047511 OSFA,New Era Headwear 10047511 OSFA,FBALYB Amazon,-29,-29,0,0,0,0
,New Era Headwear 10975804 Size L/XL,New Era Headwear 10975804 Size L/XL,FBALYB Amazon,-4,-4,0,0,0,0
,New Era Headwear 10975804 Size M/L,New Era Headwear 10975804 Size M/L,Default,0,0,0,0,0,1
,New Era Headwear 10975804 Size M/L,New Era Headwear 10975804 Size M/L,FBALYB Amazon,102,94,8,1,8,0
,New Era Headwear 10975815 Size L/XL,New Era Headwear 10975815 Size L/XL,FBALYB Amazon,-12,-13,1,0,1,0
,New Era Headwear 10975815 Size M/L,New Era Headwear 10975815 Size M/L,Default Ridgefield,48,48,0,0,0,0
,New Era Headwear 10975815 Size M/L,New Era Headwear 10975815 Size M/L,FBALYB Amazon,-107,-107,0,0,0,0
,New Era Headwear 10975815 Size S/M,New Era Headwear 10975815 Size S/M,FBALYB Amazon,-22,-22,0,0,0,0
,New Era Headwear 10975835 Size L/XL,New Era Headwear 10975835 Size L/XL,FBALYB Amazon,-3,-3,0,0,0,0
,New Era Headwear 10975835 Size M/L,New Era Headwear 10975835 Size M/L,Default Ridgefield,12,12,0,0,0,0
,New Era Headwear 10975835 Size M/L,New Era Headwear 10975835 Size M/L,FBALYB Amazon,-38,-39,1,0,1,0
,New Era Headwear 10975835 Size S/M,New Era Headwear 10975835 Size S/M,Default Ridgefield,2,2,0,0,0,0
,New Era Headwear 10975835 Size S/M,New Era Headwear 10975835 Size S/M,FBALYB Amazon,-20,-23,3,0,3,0
,New Era Headwear 11591018 Size OSFA,New Era Headwear 11591018 Size OSFA,Default Ridgefield,1,1,0,0,0,0
,New Era Headwear 11591018 Size OSFA,New Era Headwear 11591018 Size OSFA,FBALYB Amazon,153,149,4,0,4,0
,New Era Headwear 11591024 Size OSFA,New Era Headwear 11591024 Size OSFA,Default Ridgefield,172,172,0,0,0,0
,New Era Headwear 11591025 Size OSFA,New Era Headwear 11591025 Size OSFA,Default Ridgefield,1,1,0,0,0,0
,New Era Headwear 11591025 Size OSFA,New Era Headwear 11591025 Size OSFA,FBALYB Amazon,28,9,19,0,19,0
,New Era Headwear 11591025 Size OSFA,New Era Headwear 11591025 Size OSFA,FBALYB Canada,0,0,0,20,0,0
,New Era Headwear 11591026 Size OSFA,New Era Headwear 11591026 Size OSFA,Default Ridgefield,206,206,0,0,0,0
,New Era Headwear 11591046 Size OSFA,New Era Headwear 11591046 Size OSFA,FBALYB Amazon,-7,-7,0,0,0,0
,New Era Headwear 11591047 Size OSFA,New Era Headwear 11591047 Size OSFA,FBALYB Amazon,-7,-7,0,0,0,0
,New Era Headwear 11591127 Size 7,New Era Headwear 11591127 Size 7,Default,0,0,0,0,0,28
,New Era Headwear 11591127 Size 7,New Era Headwear 11591127 Size 7,Default Ridgefield,1,1,0,0,0,0
,New Era Headwear 11591127 Size 7,New Era Headwear 11591127 Size 7,FBALYB Amazon,-12,-12,0,0,0,0
,New Era Headwear 11591127 Size 7 1/2,New Era Headwear 11591127 Size 7 1/2,Default Ridgefield,100,100,0,0,0,0
,New Era Headwear 11591127 Size 7 1/2,New Era Headwear 11591127 Size 7 1/2,FBALYB Amazon,-9,-9,0,0,0,0
,New Era Headwear 11591127 Size 7 1/4,New Era Headwear 11591127 Size 7 1/4,Default,0,0,0,0,0,2
,New Era Headwear 11591127 Size 7 1/4,New Era Headwear 11591127 Size 7 1/4,Default Ridgefield,194,194,0,0,0,0
,New Era Headwear 11591127 Size 7 1/4,New Era Headwear 11591127 Size 7 1/4,FBALYB Amazon,-39,-39,0,0,0,0
,New Era Headwear 11591127 Size 7 1/8,New Era Headwear 11591127 Size 7 1/8,Default Ridgefield,50,50,0,0,0,0
,New Era Headwear 11591127 Size 7 1/8,New Era Headwear 11591127 Size 7 1/8,FBALYB Amazon,47,47,0,0,0,0
,New Era Headwear 11591127 Size 7 3/8,New Era Headwear 11591127 Size 7 3/8,Default,0,0,0,0,0,2
,New Era Headwear 11591127 Size 7 3/8,New Era Headwear 11591127 Size 7 3/8,Default Ridgefield,52,52,0,0,0,0
,New Era Headwear 11591127 Size 7 3/8,New Era Headwear 11591127 Size 7 3/8,FBALYB Amazon,-11,-11,0,0,0,0
,New Era Headwear 11591127 Size 7 5/8,New Era Headwear 11591127 Size 7 5/8,Default,0,0,0,0,0,1
,New Era Headwear 11591127 Size 7 5/8,New Era Headwear 11591127 Size 7 5/8,Default Ridgefield,100,100,0,0,0,0
,New Era Headwear 11591127 Size 7 5/8,New Era Headwear 11591127 Size 7 5/8,FBALYB Amazon,-19,-19,0,0,0,0
,New Era Headwear 11591128 Size 7,New Era Headwear 11591128 Size 7,Default Ridgefield,47,47,0,0,0,0
,New Era Headwear 11591128 Size 7 1/2,New Era Headwear 11591128 Size 7 1/2,FBALYB Amazon,-13,-13,0,0,0,0
,New Era Headwear 11591128 Size 7 1/4,New Era Headwear 11591128 Size 7 1/4,Default,0,0,0,0,0,1
,New Era Headwear 11591128 Size 7 1/4,New Era Headwear 11591128 Size 7 1/4,FBALYB Amazon,-7,-7,0,1,0,0
,New Era Headwear 11591128 Size 7 1/8,New Era Headwear 11591128 Size 7 1/8,Default,0,0,0,0,0,1
,New Era Headwear 11591128 Size 7 1/8,New Era Headwear 11591128 Size 7 1/8,FBALYB Amazon,-11,-12,1,0,1,0
,New Era Headwear 11591128 Size 7 3/8,New Era Headwear 11591128 Size 7 3/8,Default,0,0,0,0,0,1
,New Era Headwear 11591128 Size 7 3/8,New Era Headwear 11591128 Size 7 3/8,FBALYB Amazon,-13,-13,0,0,0,0
,New Era Headwear 11591128 Size 7 5/8,New Era Headwear 11591128 Size 7 5/8,Default,0,0,0,0,0,6
,New Era Headwear 11591128 Size 7 5/8,New Era Headwear 11591128 Size 7 5/8,FBALYB Amazon,-19,-19,0,0,0,0
,New Era Headwear 11941921 Size OSFA,New Era Headwear 11941921 Size OSFA,Default Ridgefield,3,3,0,0,0,0
,New Era Headwear 11941921 Size OSFA,New Era Headwear 11941921 Size OSFA,FBALYB Amazon,-10,-10,0,0,0,0
,New Era Headwear 70331909 Size 6 7/8,New Era Headwear 70331909 Size 6 7/8,Default Ridgefield,0,-143,143,0,0,0
,New Era Headwear 70331909 Size 6 7/8,New Era Headwear 70331909 Size 6 7/8,FBALYB Amazon,-1,-1,0,0,0,0
,New Era Headwear 70331909 Size 7,New Era Headwear 70331909 Size 7,Default,0,0,0,0,0,1
,New Era Headwear 70331909 Size 7,New Era Headwear 70331909 Size 7,Default Ridgefield,241,241,0,0,0,0
,New Era Headwear 70331909 Size 7,New Era Headwear 70331909 Size 7,FBALYB Amazon,211,200,11,0,11,0
,New Era Headwear 70331909 Size 7 1/2,New Era Headwear 70331909 Size 7 1/2,Default,0,0,0,0,0,2
,New Era Headwear 70331909 Size 7 1/2,New Era Headwear 70331909 Size 7 1/2,Default Ridgefield,1042,1042,0,0,0,0
,New Era Headwear 70331909 Size 7 1/2,New Era Headwear 70331909 Size 7 1/2,FBALYB Amazon,-65,-80,15,0,15,0
,New Era Headwear 70331909 Size 7 1/4,New Era Headwear 70331909 Size 7 1/4,Default Ridgefield,324,324,0,0,0,0
,New Era Headwear 70331909 Size 7 1/4,New Era Headwear 70331909 Size 7 1/4,FBALYB Amazon,251,238,13,1,13,0
,New Era Headwear 70331909 Size 7 1/8,New Era Headwear 70331909 Size 7 1/8,Default,0,0,0,0,0,1
,New Era Headwear 70331909 Size 7 1/8,New Era Headwear 70331909 Size 7 1/8,Default Ridgefield,593,593,0,0,0,0
,New Era Headwear 70331909 Size 7 1/8,New Era Headwear 70331909 Size 7 1/8,FBALYB Amazon,-84,-89,5,0,5,0
,New Era Headwear 70331909 Size 7 3/4,New Era Headwear 70331909 Size 7 3/4,FBALYB Amazon,-22,-22,0,0,0,0
,New Era Headwear 70331909 Size 7 3/8,New Era Headwear 70331909 Size 7 3/8,Default Ridgefield,736,736,0,0,0,0
,New Era Headwear 70331909 Size 7 3/8,New Era Headwear 70331909 Size 7 3/8,FBALYB Amazon,-69,-70,1,0,1,0
,New Era Headwear 70331909 Size 7 5/8,New Era Headwear 70331909 Size 7 5/8,Default,0,0,0,0,0,4
,New Era Headwear 70331909 Size 7 5/8,New Era Headwear 70331909 Size 7 5/8,Default Ridgefield,717,717,0,0,0,0
,New Era Headwear 70331909 Size 7 5/8,New Era Headwear 70331909 Size 7 5/8,FBALYB Amazon,-39,-43,4,0,4,0
,New Era Headwear 70331911 Size 7,New Era Headwear 70331911 Size 7,Default Ridgefield,112,112,0,0,0,0
,New Era Headwear 70331911 Size 7,New Era Headwear 70331911 Size 7,FBALYB Amazon,-19,-19,0,0,0,0
,New Era Headwear 70331911 Size 7 1/2,New Era Headwear 70331911 Size 7 1/2,Default,0,0,0,0,0,1
,New Era Headwear 70331911 Size 7 1/2,New Era Headwear 70331911 Size 7 1/2,Default Ridgefield,397,397,0,0,0,0
,New Era Headwear 70331911 Size 7 1/2,New Era Headwear 70331911 Size 7 1/2,FBALYB Amazon,-23,-23,0,0,0,0
,New Era Headwear 70331911 Size 7 1/4,New Era Headwear 70331911 Size 7 1/4,Default,0,0,0,0,0,125
,New Era Headwear 70331911 Size 7 1/4,New Era Headwear 70331911 Size 7 1/4,Default Ridgefield,472,472,0,0,0,0
,New Era Headwear 70331911 Size 7 1/4,New Era Headwear 70331911 Size 7 1/4,FBALYB Amazon,-32,-35,3,0,3,0
,New Era Headwear 70331911 Size 7 1/8,New Era Headwear 70331911 Size 7 1/8,Default,0,0,0,0,0,5
,New Era Headwear 70331911 Size 7 1/8,New Era Headwear 70331911 Size 7 1/8,Default Ridgefield,386,386,0,0,0,0
,New Era Headwear 70331911 Size 7 1/8,New Era Headwear 70331911 Size 7 1/8,FBALYB Amazon,-49,-49,0,0,0,0
,New Era Headwear 70331911 Size 7 3/4,New Era Headwear 70331911 Size 7 3/4,FBALYB Amazon,-5,-7,2,0,2,0
,New Era Headwear 70331911 Size 7 3/8,New Era Headwear 70331911 Size 7 3/8,Default Ridgefield,557,557,0,0,0,0
,New Era Headwear 70331911 Size 7 3/8,New Era Headwear 70331911 Size 7 3/8,FBALYB Amazon,-32,-33,1,0,1,0
,New Era Headwear 70331911 Size 7 5/8,New Era Headwear 70331911 Size 7 5/8,Default Ridgefield,146,146,0,0,0,0
,New Era Headwear 70331911 Size 7 5/8,New Era Headwear 70331911 Size 7 5/8,FBALYB Amazon,1,0,1,0,1,0
,New Era Headwear 70331911 Size 7 7/8,New Era Headwear 70331911 Size 7 7/8,Default Ridgefield,14,14,0,0,0,0
,New Era Headwear 70331911 Size 7 7/8,New Era Headwear 70331911 Size 7 7/8,FBALYB Amazon,-2,-3,1,0,1,0
,New Era Headwear 70331962 Size 6 7/8,New Era Headwear 70331962 Size 6 7/8,FBALYB Amazon,-8,-8,0,0,0,0
,New Era Headwear 70331962 Size 7,New Era Headwear 70331962 Size 7,Default Ridgefield,261,261,0,0,0,0
,New Era Headwear 70331962 Size 7,New Era Headwear 70331962 Size 7,FBALYB Amazon,-7,-7,0,0,0,0
,New Era Headwear 70331962 Size 7 1/2,New Era Headwear 70331962 Size 7 1/2,Default Ridgefield,375,375,0,0,0,0
,New Era Headwear 70331962 Size 7 1/2,New Era Headwear 70331962 Size 7 1/2,FBALYB Amazon,-35,-39,4,0,4,0
,New Era Headwear 70331962 Size 7 1/4,New Era Headwear 70331962 Size 7 1/4,Default Ridgefield,788,788,0,0,0,0
,New Era Headwear 70331962 Size 7 1/4,New Era Headwear 70331962 Size 7 1/4,FBALYB Amazon,-15,-15,0,0,0,0
,New Era Headwear 70331962 Size 7 1/8,New Era Headwear 70331962 Size 7 1/8,Default Ridgefield,388,388,0,0,0,0
,New Era Headwear 70331962 Size 7 1/8,New Era Headwear 70331962 Size 7 1/8,FBALYB Amazon,-10,-11,1,0,1,0
,New Era Headwear 70331962 Size 7 3/4,New Era Headwear 70331962 Size 7 3/4,FBALYB Amazon,-4,-4,0,0,0,0
,New Era Headwear 70331962 Size 7 3/8,New Era Headwear 70331962 Size 7 3/8,Default Ridgefield,388,388,0,0,0,0
,New Era Headwear 70331962 Size 7 3/8,New Era Headwear 70331962 Size 7 3/8,FBALYB Amazon,-14,-14,0,0,0,0
,New Era Headwear 70331962 Size 7 5/8,New Era Headwear 70331962 Size 7 5/8,Default Ridgefield,786,786,0,0,0,0
,New Era Headwear 70331962 Size 7 5/8,New Era Headwear 70331962 Size 7 5/8,FBALYB Amazon,256,256,0,0,0,0
,New Era Headwear 70331962 Size 7 7/8,New Era Headwear 70331962 Size 7 7/8,FBALYB Amazon,-19,-19,0,0,0,0
,New Era Headwear 70360926 Size 7,New Era Headwear 70360926 Size 7,FBALYB Amazon,0,0,0,1,0,0
,New Era Headwear 70360926 Size 7 1/2,New Era Headwear 70360926 Size 7 1/2,Default,0,0,0,0,0,1
,New Era Headwear 70360926 Size 7 1/2,New Era Headwear 70360926 Size 7 1/2,FBALYB Amazon,-3,-3,0,0,0,0
,New Era Headwear 70360926 Size 7 1/4,New Era Headwear 70360926 Size 7 1/4,FBALYB Amazon,-4,-4,0,0,0,0
,New Era Headwear 70360926 Size 7 1/8,New Era Headwear 70360926 Size 7 1/8,FBALYB Amazon,-5,-6,1,0,1,0
,New Era Headwear 70360926 Size 7 3/8,New Era Headwear 70360926 Size 7 3/8,Default Ridgefield,44,44,0,0,0,0
,New Era Headwear 70360926 Size 7 5/8,New Era Headwear 70360926 Size 7 5/8,FBALYB Amazon,-1,-1,0,0,0,0
,New Era Headwear 70457659 OSFA,New Era Headwear 70457659 OSFA,Default Ridgefield,166,166,0,0,0,0
,New Era Headwear 70457659 OSFA,New Era Headwear 70457659 OSFA,FBALYB Amazon,-7,-7,0,0,0,0
,"New Febreze 5 count, 2 gain, 2 linen,1 ice","New Febreze 5 count, 2 gain, 2 linen,1 ice",Default,0,-8,8,0,0,0
,"New Febreze 5 count, 2 gain, 2 linen,1 ice","New Febreze 5 count, 2 gain, 2 linen,1 ice",Default Ridgefield,1554,1554,0,0,0,0
,"New Febreze 5 count, 2 gain, 2 linen,1 ice","New Febreze 5 count, 2 gain, 2 linen,1 ice",FBALYB Amazon,89,87,2,0,2,0
,New Head Mens Ultrasfit Running Gloves with Touchscreen Black- Large,New Head Mens Ultrasfit Running Gloves with Touchscreen Black- Large,FBALYB Amazon,-5,-5,0,0,0,0
,New Milk Bone Brushing Chew Small 46 Treats,New Milk Bone Brushing Chew Small 46 Treats,Default Ridgefield,40,40,0,0,0,0
,New Milk Bone Brushing Chew Small 46 Treats,New Milk Bone Brushing Chew Small 46 Treats,FBALYB Amazon,718,704,14,49,14,0
,(New) Oral B Glide Advanced 6 ct,(New) Oral B Glide Advanced 6 ct,Avrami - Ebay,540,540,0,0,0,0
,(New) Oral B Glide Advanced 6 ct,(New) Oral B Glide Advanced 6 ct,FBALYB Amazon,-7,-7,0,0,0,0
,New Simple LTD Micellar 20 ct 5pk,New Simple LTD Micellar 20 ct 5pk,FBALYB Amazon,132,112,20,0,20,0
,New Simple Micellar Wipes LTD,New Simple Micellar Wipes LTD,Default CT,9164,9164,0,0,0,0
,New Woolite dark 4.4 L,New Woolite dark 4.4 L,Default Ridgefield,26,26,0,0,0,0
,New Woolite dark 4.4 L,New Woolite dark 4.4 L,FBALYB Amazon,110,82,28,416,28,0
,Nexcare Acne Absorbing Covers 2pk,Nexcare Acne Absorbing Covers 2pk,FBALYB Amazon,3,3,0,0,0,0
,Nexcare Acne Absorbing Covers 36ct 3pk,Nexcare Acne Absorbing Covers 36ct 3pk,FBALYB Amazon,-4,-11,7,6,7,0
,Nexcare Acne Absorbing Covers  36 Ct Single Box,Nexcare Acne Absorbing Covers  36 Ct Single Box,Default,0,-705,705,0,0,0
,"Nexium 24HR, 3 bottles x 14ct","Nexium 24HR, 3 bottles x 14ct",FBALYB Amazon,0,0,0,1,0,0
,Nexxus 15oz comb thru mist 2pc,Nexxus 15oz comb thru mist 2pc,FBALYB Amazon,-2,-2,0,0,0,0
,Nexxus Comb Thru Spray 2pc 10 oz,Nexxus Comb Thru Spray 2pc 10 oz,FBALYB Amazon,-3,-3,0,2,0,0
,Nexxus Therappe & Humectress 33.8OZ 2pk,Nexxus Therappe & Humectress 33.8OZ 2pk,FBALYB Amazon,1,1,0,0,0,0
,"Nielsen-Massey Tahitian Pure Vanilla, 4 oz","Nielsen-Massey Tahitian Pure Vanilla, 4 oz",Default Ridgefield,34,34,0,0,0,0
,Nike Accessories N.000.0013.662.OS NIKE FUEL JUG 64 OZ UNIVERSITY RED/ANTHRACITE/WHITE OSFM,Nike Accessories N.000.0013.662.OS NIKE FUEL JUG 64 OZ UNIVERSITY RED/ANTHRACITE/WHITE OSFM,Default Ridgefield,125,125,0,0,0,0
,Nike Accessories N.000.0013.662.OS NIKE FUEL JUG 64 OZ UNIVERSITY RED/ANTHRACITE/WHITE OSFM,Nike Accessories N.000.0013.662.OS NIKE FUEL JUG 64 OZ UNIVERSITY RED/ANTHRACITE/WHITE OSFM,FBALYB Amazon,58,54,4,0,4,0
,Nike Accessories N.000.0245.176.OS NIKE DRI-FIT HEAD TIE 2.0 REVERSIBLE PRINTED WHITE/BLACK/WHITE OSFM,Nike Accessories N.000.0245.176.OS NIKE DRI-FIT HEAD TIE 2.0 REVERSIBLE PRINTED WHITE/BLACK/WHITE OSFM,Default Ridgefield,20,20,0,0,0,0
,Nike Accessories N.000.0245.176.OS NIKE DRI-FIT HEAD TIE 2.0 REVERSIBLE PRINTED WHITE/BLACK/WHITE OSFM,Nike Accessories N.000.0245.176.OS NIKE DRI-FIT HEAD TIE 2.0 REVERSIBLE PRINTED WHITE/BLACK/WHITE OSFM,FBALYB Amazon,-3,-4,1,0,1,0
,Nike Accessories N.000.1064.222.09 NIKE VAPOR 24/7 2.0 FB BROWN/WHITE/METALLIC SILVER/BLACK 9 OFFICIAL,Nike Accessories N.000.1064.222.09 NIKE VAPOR 24/7 2.0 FB BROWN/WHITE/METALLIC SILVER/BLACK 9 OFFICIAL,Default Ridgefield,1,1,0,0,0,0
,Nike Accessories N.000.1064.222.09 NIKE VAPOR 24/7 2.0 FB BROWN/WHITE/METALLIC SILVER/BLACK 9 OFFICIAL,Nike Accessories N.000.1064.222.09 NIKE VAPOR 24/7 2.0 FB BROWN/WHITE/METALLIC SILVER/BLACK 9 OFFICIAL,FBALYB Amazon,-31,-33,2,0,2,0
,Nike Accessories N.000.2044.027.LX NIKE PRO ELITE SLEEVES 2.0 BLACK/WHITE/WHITE L/XL,Nike Accessories N.000.2044.027.LX NIKE PRO ELITE SLEEVES 2.0 BLACK/WHITE/WHITE L/XL,Default Ridgefield,2,2,0,0,0,0
,Nike Accessories N.000.2044.027.LX NIKE PRO ELITE SLEEVES 2.0 BLACK/WHITE/WHITE L/XL,Nike Accessories N.000.2044.027.LX NIKE PRO ELITE SLEEVES 2.0 BLACK/WHITE/WHITE L/XL,FBALYB Amazon,6,2,4,0,4,0
,Nike Accessories N.000.2044.127.SM NIKE PRO ELITE SLEEVES 2.0 WHITE/BLACK/BLACK S/M,Nike Accessories N.000.2044.127.SM NIKE PRO ELITE SLEEVES 2.0 WHITE/BLACK/BLACK S/M,Default Ridgefield,153,153,0,0,0,0
,Nike Accessories N.000.2044.127.SM NIKE PRO ELITE SLEEVES 2.0 WHITE/BLACK/BLACK S/M,Nike Accessories N.000.2044.127.SM NIKE PRO ELITE SLEEVES 2.0 WHITE/BLACK/BLACK S/M,FBALYB Amazon,77,72,5,0,5,0
,Nike Accessories N.000.2545.117.OS NIKE HEADBANDS 6 PK PRINTED WHITE/UNIVERSITY RED/COURT PURPLE OSFM,Nike Accessories N.000.2545.117.OS NIKE HEADBANDS 6 PK PRINTED WHITE/UNIVERSITY RED/COURT PURPLE OSFM,Default Ridgefield,4,4,0,0,0,0
,Nike Accessories N.000.2545.117.OS NIKE HEADBANDS 6 PK PRINTED WHITE/UNIVERSITY RED/COURT PURPLE OSFM,Nike Accessories N.000.2545.117.OS NIKE HEADBANDS 6 PK PRINTED WHITE/UNIVERSITY RED/COURT PURPLE OSFM,FBALYB Amazon,0,-2,2,0,2,0
,Nike Accessories N.000.3178.084.32 NIKE HYPERFUEL BOTTLE 32 OZ ANTHRACITE/BLACK/BLACK/WHITE 32OZ,Nike Accessories N.000.3178.084.32 NIKE HYPERFUEL BOTTLE 32 OZ ANTHRACITE/BLACK/BLACK/WHITE 32OZ,FBALYB Amazon,2,1,1,0,1,0
,Nike Accessories N.000.3706.010.OS NIKE DRI-FIT HEAD TIE 3.0 BLACK/WHITE OSFM,Nike Accessories N.000.3706.010.OS NIKE DRI-FIT HEAD TIE 3.0 BLACK/WHITE OSFM,Default Ridgefield,25,25,0,0,0,0
,Nike Accessories N.000.3706.010.OS NIKE DRI-FIT HEAD TIE 3.0 BLACK/WHITE OSFM,Nike Accessories N.000.3706.010.OS NIKE DRI-FIT HEAD TIE 3.0 BLACK/WHITE OSFM,FBALYB Amazon,8,-2,10,0,10,0
,Nike Accessories N.000.3706.101.OS NIKE DRI-FIT HEAD TIE 3.0 WHITE/BLACK OSFM,Nike Accessories N.000.3706.101.OS NIKE DRI-FIT HEAD TIE 3.0 WHITE/BLACK OSFM,Default Ridgefield,2,2,0,0,0,0
,Nike Accessories N.000.3706.101.OS NIKE DRI-FIT HEAD TIE 3.0 WHITE/BLACK OSFM,Nike Accessories N.000.3706.101.OS NIKE DRI-FIT HEAD TIE 3.0 WHITE/BLACK OSFM,FBALYB Amazon,301,301,0,0,0,0
,Nike Accessories N.000.3706.413.OS NIKE DRI-FIT HEAD TIE 3.0 GAME ROYAL/WHITE OSFM,Nike Accessories N.000.3706.413.OS NIKE DRI-FIT HEAD TIE 3.0 GAME ROYAL/WHITE OSFM,Default Ridgefield,21,21,0,0,0,0
,Nike Accessories N.000.3706.413.OS NIKE DRI-FIT HEAD TIE 3.0 GAME ROYAL/WHITE OSFM,Nike Accessories N.000.3706.413.OS NIKE DRI-FIT HEAD TIE 3.0 GAME ROYAL/WHITE OSFM,FBALYB Amazon,2,-1,3,0,3,0
,Nike Accessories N.000.3706.416.OS NIKE DRI-FIT HEAD TIE 3.0 MIDNIGHT NAVY/WHITE OSFM,Nike Accessories N.000.3706.416.OS NIKE DRI-FIT HEAD TIE 3.0 MIDNIGHT NAVY/WHITE OSFM,FBALYB Amazon,3,-1,4,0,4,0
,Nike Accessories N.000.3706.608.OS NIKE DRI-FIT HEAD TIE 3.0 GYM RED/WHITE OSFM,Nike Accessories N.000.3706.608.OS NIKE DRI-FIT HEAD TIE 3.0 GYM RED/WHITE OSFM,Default Ridgefield,11,11,0,0,0,0
,Nike Accessories N.000.3706.608.OS NIKE DRI-FIT HEAD TIE 3.0 GYM RED/WHITE OSFM,Nike Accessories N.000.3706.608.OS NIKE DRI-FIT HEAD TIE 3.0 GYM RED/WHITE OSFM,FBALYB Amazon,-3,-7,4,0,4,0
,Nike Accessories N.100.0106.958.24 NIKE TR HYPERCHARGE SHAKER BOTTLE 24 OZ CLEAR/BLACK/BLACK/BLACK,Nike Accessories N.100.0106.958.24 NIKE TR HYPERCHARGE SHAKER BOTTLE 24 OZ CLEAR/BLACK/BLACK/BLACK,Default Ridgefield,1,1,0,0,0,0
,Nike Accessories N.100.0106.958.24 NIKE TR HYPERCHARGE SHAKER BOTTLE 24 OZ CLEAR/BLACK/BLACK/BLACK,Nike Accessories N.100.0106.958.24 NIKE TR HYPERCHARGE SHAKER BOTTLE 24 OZ CLEAR/BLACK/BLACK/BLACK,FBALYB Amazon,-2,-2,0,0,0,0
,Nike Accessories N.100.0506.281.ML NIKE DURA FEEL IX GG REG 2 PK L PEARL WHITE/BLACK/BLACK M/L,Nike Accessories N.100.0506.281.ML NIKE DURA FEEL IX GG REG 2 PK L PEARL WHITE/BLACK/BLACK M/L,Default Ridgefield,79,79,0,0,0,0
,Nike Accessories N.100.0765.101.OS NIKE PERFORMANCE GOLF TOWEL ONE SIZE WHITE/BLACK OSFM,Nike Accessories N.100.0765.101.OS NIKE PERFORMANCE GOLF TOWEL ONE SIZE WHITE/BLACK OSFM,Default Ridgefield,17,17,0,0,0,0
,Nike Accessories N.100.0765.101.OS NIKE PERFORMANCE GOLF TOWEL ONE SIZE WHITE/BLACK OSFM,Nike Accessories N.100.0765.101.OS NIKE PERFORMANCE GOLF TOWEL ONE SIZE WHITE/BLACK OSFM,FBALYB Amazon,-1,-2,1,0,1,0
,Nike Accessories N.100.0771.010.LX NIKE PRO DRI-FIT SLEEVES 4.0 BLACK/WHITE L/XL,Nike Accessories N.100.0771.010.LX NIKE PRO DRI-FIT SLEEVES 4.0 BLACK/WHITE L/XL,FBALYB Amazon,-2,-2,0,0,0,0
,Nike Accessories N.100.0771.010.SM NIKE PRO DRI-FIT SLEEVES 4.0 BLACK/WHITE S/M,Nike Accessories N.100.0771.010.SM NIKE PRO DRI-FIT SLEEVES 4.0 BLACK/WHITE S/M,Default Ridgefield,2,2,0,0,0,0
,Nike Accessories N.100.0771.010.SM NIKE PRO DRI-FIT SLEEVES 4.0 BLACK/WHITE S/M,Nike Accessories N.100.0771.010.SM NIKE PRO DRI-FIT SLEEVES 4.0 BLACK/WHITE S/M,FBALYB Amazon,-7,-8,1,0,1,0
,Nike Accessories N.100.0828.082.OS NIKE SLIM WAIST PACK 2.0 BLACK/BLACK/SILVER OSFM,Nike Accessories N.100.0828.082.OS NIKE SLIM WAIST PACK 2.0 BLACK/BLACK/SILVER OSFM,Default Ridgefield,23,23,0,0,0,0
,Nike Accessories N.100.0828.082.OS NIKE SLIM WAIST PACK 2.0 BLACK/BLACK/SILVER OSFM,Nike Accessories N.100.0828.082.OS NIKE SLIM WAIST PACK 2.0 BLACK/BLACK/SILVER OSFM,FBALYB Amazon,-6,-10,4,0,4,0
,Nike Accessories N.100.0923.001.OS NIKE SWOOSH BICEP BANDS 2 PK BLACK/WHITE OSFM,Nike Accessories N.100.0923.001.OS NIKE SWOOSH BICEP BANDS 2 PK BLACK/WHITE OSFM,Default Ridgefield,19,19,0,0,0,0
,Nike Accessories N.100.0923.001.OS NIKE SWOOSH BICEP BANDS 2 PK BLACK/WHITE OSFM,Nike Accessories N.100.0923.001.OS NIKE SWOOSH BICEP BANDS 2 PK BLACK/WHITE OSFM,FBALYB Amazon,2,0,2,0,2,0
,Nike Accessories N.100.0924.630.OS NIKE DRI-FIT SKINNY BANDS 2 PK PINK/WHITE OSFM,Nike Accessories N.100.0924.630.OS NIKE DRI-FIT SKINNY BANDS 2 PK PINK/WHITE OSFM,FBALYB Amazon,1,-1,2,0,2,0
,Nike Accessories N.100.0925.101.NS NIKE FOOTBALL TOWEL NO SIZE WHITE/BLACK NS,Nike Accessories N.100.0925.101.NS NIKE FOOTBALL TOWEL NO SIZE WHITE/BLACK NS,FBALYB Amazon,-3,-3,0,0,0,0
,Nike Accessories N.BA.21.015.LX NIKE PRO FLOOD SLEEVE WOLF GREY/BLACK L/XL,Nike Accessories N.BA.21.015.LX NIKE PRO FLOOD SLEEVE WOLF GREY/BLACK L/XL,Default Ridgefield,21,21,0,0,0,0
,Nike Accessories N.BA.21.015.LX NIKE PRO FLOOD SLEEVE WOLF GREY/BLACK L/XL,Nike Accessories N.BA.21.015.LX NIKE PRO FLOOD SLEEVE WOLF GREY/BLACK L/XL,FBALYB Amazon,59,58,1,0,1,0
,Nike Accessories N.BL.07.010.OS NIKE BASEBALL BELT 2.0 BLACK/WHITE OSFM,Nike Accessories N.BL.07.010.OS NIKE BASEBALL BELT 2.0 BLACK/WHITE OSFM,Default Ridgefield,6,6,0,0,0,0
,Nike Accessories N.BL.07.010.OS NIKE BASEBALL BELT 2.0 BLACK/WHITE OSFM,Nike Accessories N.BL.07.010.OS NIKE BASEBALL BELT 2.0 BLACK/WHITE OSFM,FBALYB Amazon,-11,-12,1,0,1,0
,Nike Accessories N.BL.07.416.OS NIKE BASEBALL BELT 2.0 MIDNIGHT NAVY/WHITE OSFM,Nike Accessories N.BL.07.416.OS NIKE BASEBALL BELT 2.0 MIDNIGHT NAVY/WHITE OSFM,FBALYB Amazon,-3,-3,0,0,0,0
,Nike Accessories N.BL.09.010.OS NIKE Y BASEBALL BELT 2.0 BLACK/WHITE OSFM,Nike Accessories N.BL.09.010.OS NIKE Y BASEBALL BELT 2.0 BLACK/WHITE OSFM,FBALYB Amazon,-7,-7,0,0,0,0
,Nike Accessories N.BL.09.101.OS NIKE Y BASEBALL BELT 2.0 WHITE/BLACK OSFM,Nike Accessories N.BL.09.101.OS NIKE Y BASEBALL BELT 2.0 WHITE/BLACK OSFM,FBALYB Amazon,20,20,0,0,0,0
,Nike Accessories N.BL.09.413.OS NIKE Y BASEBALL BELT 2.0 GAMEROYAL/WHITE OSFM,Nike Accessories N.BL.09.413.OS NIKE Y BASEBALL BELT 2.0 GAMEROYAL/WHITE OSFM,FBALYB Amazon,-5,-6,1,0,1,0
,Nike Accessories N.BL.09.416.OS NIKE Y BASEBALL BELT 2.0 MIDNIGHT NAVY/WHITE OSFM,Nike Accessories N.BL.09.416.OS NIKE Y BASEBALL BELT 2.0 MIDNIGHT NAVY/WHITE OSFM,Default Ridgefield,57,57,0,0,0,0
,Nike Accessories N.BL.09.416.OS NIKE Y BASEBALL BELT 2.0 MIDNIGHT NAVY/WHITE OSFM,Nike Accessories N.BL.09.416.OS NIKE Y BASEBALL BELT 2.0 MIDNIGHT NAVY/WHITE OSFM,FBALYB Amazon,-6,-6,0,0,0,0
,Nike Accessories N.BL.09.688.OS NIKE Y BASEBALL BELT 2.0 UNIVERSITY RED/WHITE OSFM,Nike Accessories N.BL.09.688.OS NIKE Y BASEBALL BELT 2.0 UNIVERSITY RED/WHITE OSFM,FBALYB Amazon,261,260,1,0,1,0
,Nike Accessories N.HK.60.125.OS NIKE PRO HYPERCOOL VAPOR SKULL CAP 4.0 WHITE/WOLF GREY/BLACK OSFM,Nike Accessories N.HK.60.125.OS NIKE PRO HYPERCOOL VAPOR SKULL CAP 4.0 WHITE/WOLF GREY/BLACK OSFM,Default Ridgefield,11,11,0,0,0,0
,Nike Accessories N.HK.60.125.OS NIKE PRO HYPERCOOL VAPOR SKULL CAP 4.0 WHITE/WOLF GREY/BLACK OSFM,Nike Accessories N.HK.60.125.OS NIKE PRO HYPERCOOL VAPOR SKULL CAP 4.0 WHITE/WOLF GREY/BLACK OSFM,FBALYB Amazon,4,0,4,0,4,0
,Nike Accessories N.HK.63.058.OS NIKE PRO HYPERWARM HOOD BLACK/BLACK/WHITE OSFM,Nike Accessories N.HK.63.058.OS NIKE PRO HYPERWARM HOOD BLACK/BLACK/WHITE OSFM,FBALYB Amazon,2,-4,6,0,6,0
,Nike Accessories N.JN.D8.010.OS NIKE FURY HEADBAND 2.0 BLACK/WHITE OSFM,Nike Accessories N.JN.D8.010.OS NIKE FURY HEADBAND 2.0 BLACK/WHITE OSFM,Default Ridgefield,-1,-1,0,0,0,0
,Nike Accessories N.JN.D8.010.OS NIKE FURY HEADBAND 2.0 BLACK/WHITE OSFM,Nike Accessories N.JN.D8.010.OS NIKE FURY HEADBAND 2.0 BLACK/WHITE OSFM,FBALYB Amazon,-15,-25,10,6,10,0
,Nike Accessories N.JN.D8.101.OS NIKE FURY HEADBAND 2.0 WHITE/BLACK OSFM,Nike Accessories N.JN.D8.101.OS NIKE FURY HEADBAND 2.0 WHITE/BLACK OSFM,FBALYB Amazon,15,-3,18,0,18,0
,Nike Accessories N.JN.D8.401.OS NIKE FURY HEADBAND 2.0 MIDNIGHT NAVY/WHITE OSFM,Nike Accessories N.JN.D8.401.OS NIKE FURY HEADBAND 2.0 MIDNIGHT NAVY/WHITE OSFM,Default Ridgefield,100,100,0,0,0,0
,Nike Accessories N.JN.D8.413.OS NIKE FURY HEADBAND 2.0 GAME,Nike Accessories N.JN.D8.413.OS NIKE FURY HEADBAND 2.0 GAME,Default Ridgefield,260,260,0,0,0,0
,Nike Accessories N.JN.D8.413.OS NIKE FURY HEADBAND 2.0 GAME,Nike Accessories N.JN.D8.413.OS NIKE FURY HEADBAND 2.0 GAME,FBALYB Amazon,-2,-2,0,0,0,0
,Nike Accessories N.JN.D8.608.OS NIKE FURY HEADBAND 2.0 GYM RED/WHITE OSFM,Nike Accessories N.JN.D8.608.OS NIKE FURY HEADBAND 2.0 GYM RED/WHITE OSFM,Default Ridgefield,1,1,0,0,0,0
,Nike Accessories N.JN.D8.608.OS NIKE FURY HEADBAND 2.0 GYM RED/WHITE OSFM,Nike Accessories N.JN.D8.608.OS NIKE FURY HEADBAND 2.0 GYM RED/WHITE OSFM,FBALYB Amazon,-2,-3,1,0,1,0
,Nike Accessories N.JN.J4.060.OS NIKE FURY HEADBAND HEATHERED CHARCOAL HEATHER/BLACK OSFM,Nike Accessories N.JN.J4.060.OS NIKE FURY HEADBAND HEATHERED CHARCOAL HEATHER/BLACK OSFM,Default Ridgefield,3,3,0,0,0,0
,Nike Accessories N.JN.J4.060.OS NIKE FURY HEADBAND HEATHERED CHARCOAL HEATHER/BLACK OSFM,Nike Accessories N.JN.J4.060.OS NIKE FURY HEADBAND HEATHERED CHARCOAL HEATHER/BLACK OSFM,FBALYB Amazon,44,33,11,0,11,0
,Nike Accessories N.KI.32.855.07 NIKE BALLER 8P AMBER/BLACK/METALLIC SILVER/BLACK 07,Nike Accessories N.KI.32.855.07 NIKE BALLER 8P AMBER/BLACK/METALLIC SILVER/BLACK 07,Default Ridgefield,95,95,0,0,0,0
,Nike Accessories N.KI.32.855.07 NIKE BALLER 8P AMBER/BLACK/METALLIC SILVER/BLACK 07,Nike Accessories N.KI.32.855.07 NIKE BALLER 8P AMBER/BLACK/METALLIC SILVER/BLACK 07,FBALYB Amazon,1,1,0,15,0,0
,Nike Accessories N.KI.58.855.07 NIKE ELITE CHAMPIONSHIP 8P AMBER/BLACK/METALLIC SILVER/BLACK 07,Nike Accessories N.KI.58.855.07 NIKE ELITE CHAMPIONSHIP 8P AMBER/BLACK/METALLIC SILVER/BLACK 07,FBALYB Amazon,15,12,3,35,3,0
,Nike Accessories N.NN.22.101.OS NIKE SPEED PERFORMANCE ACTIVITY HEADBAND WHITE/BLACK OSFM,Nike Accessories N.NN.22.101.OS NIKE SPEED PERFORMANCE ACTIVITY HEADBAND WHITE/BLACK OSFM,Default Ridgefield,23,23,0,0,0,0
,Nike Accessories N.NN.22.101.OS NIKE SPEED PERFORMANCE ACTIVITY HEADBAND WHITE/BLACK OSFM,Nike Accessories N.NN.22.101.OS NIKE SPEED PERFORMANCE ACTIVITY HEADBAND WHITE/BLACK OSFM,FBALYB Amazon,2,-2,4,0,4,0
,Nike Accessories N.VP.06.001.2S NIKE ESSENTIAL VOLLEYBALL KNEE PADS BLACK/ XS/S,Nike Accessories N.VP.06.001.2S NIKE ESSENTIAL VOLLEYBALL KNEE PADS BLACK/ XS/S,Default Ridgefield,20,20,0,0,0,0
,Nike Accessories N.VP.06.001.2S NIKE ESSENTIAL VOLLEYBALL KNEE PADS BLACK/ XS/S,Nike Accessories N.VP.06.001.2S NIKE ESSENTIAL VOLLEYBALL KNEE PADS BLACK/ XS/S,FBALYB Amazon,-3,-30,27,0,27,0
,Nike Accessories N.VP.06.001.XX NIKE ESSENTIAL VOLLEYBALL KNEE PADS BLACK/ XL/XXL,Nike Accessories N.VP.06.001.XX NIKE ESSENTIAL VOLLEYBALL KNEE PADS BLACK/ XL/XXL,Default Ridgefield,20,20,0,0,0,0
,Nike Accessories N.VP.06.001.XX NIKE ESSENTIAL VOLLEYBALL KNEE PADS BLACK/ XL/XXL,Nike Accessories N.VP.06.001.XX NIKE ESSENTIAL VOLLEYBALL KNEE PADS BLACK/ XL/XXL,FBALYB Amazon,-64,-78,14,0,14,0
,Nike Accessories N.VP.06.100.XX NIKE ESSENTIAL VOLLEYBALL KNEE PADS WHITE/ XL/XXL,Nike Accessories N.VP.06.100.XX NIKE ESSENTIAL VOLLEYBALL KNEE PADS WHITE/ XL/XXL,Default Ridgefield,1,1,0,0,0,0
,Nike Accessories N.VP.06.100.XX NIKE ESSENTIAL VOLLEYBALL KNEE PADS WHITE/ XL/XXL,Nike Accessories N.VP.06.100.XX NIKE ESSENTIAL VOLLEYBALL KNEE PADS WHITE/ XL/XXL,FBALYB Amazon,-6,-7,1,0,1,0
,Nike Air Max Oketo Women's Size 7.5 AQ2231-002-WF,Nike Air Max Oketo Women's Size 7.5 AQ2231-002-WF,FBALYB Amazon,-2,-2,0,0,0,0
,Nike Air Max Oketo Women's Size 7.5 AQ2231-100-WF,Nike Air Max Oketo Women's Size 7.5 AQ2231-100-WF,FBALYB Amazon,-3,-3,0,0,0,0
,Nike Air Max Oketo Women's Size 7 AQ2231-100-WF,Nike Air Max Oketo Women's Size 7 AQ2231-100-WF,FBALYB Amazon,-1,-1,0,0,0,0
,Nike Air Max Oketo Women's Size 8 AQ2231-002-WF,Nike Air Max Oketo Women's Size 8 AQ2231-002-WF,FBALYB Amazon,-1,-1,0,0,0,0
,Nike Air Max Oketo Women's Size 8 AQ2231-100-WF,Nike Air Max Oketo Women's Size 8 AQ2231-100-WF,FBALYB Amazon,-2,-2,0,0,0,0
,Nike Air Max Oketo Women's Size 9 AQ2231-100-WF,Nike Air Max Oketo Women's Size 9 AQ2231-100-WF,FBALYB Amazon,-1,-1,0,0,0,0
,Nike Air Zoom Pegasus 36 Men's Size 10.5 AQ2203-002-M9,Nike Air Zoom Pegasus 36 Men's Size 10.5 AQ2203-002-M9,FBALYB Amazon,-4,-4,0,0,0,0
,Nike Air Zoom Pegasus 36 Men's Size 10 AQ2203-002-M8,Nike Air Zoom Pegasus 36 Men's Size 10 AQ2203-002-M8,FBALYB Amazon,-9,-9,0,0,0,0
,Nike Air Zoom Pegasus 36 Men's Size 11 AQ2203-002-M9,Nike Air Zoom Pegasus 36 Men's Size 11 AQ2203-002-M9,FBALYB Amazon,-3,-3,0,0,0,0
,Nike Air Zoom Pegasus 36 Men's Size 12 AQ2203-002-M9,Nike Air Zoom Pegasus 36 Men's Size 12 AQ2203-002-M9,FBALYB Amazon,-2,-2,0,0,0,0
,Nike Air Zoom Pegasus 36 Men's Size 9.5 AQ2203-002-M8,Nike Air Zoom Pegasus 36 Men's Size 9.5 AQ2203-002-M8,FBALYB Amazon,-1,-1,0,0,0,0
,Nike Air Zoom Pegasus 36 Men's Size 9 AQ2203-002-M8,Nike Air Zoom Pegasus 36 Men's Size 9 AQ2203-002-M8,FBALYB Amazon,-2,-2,0,0,0,0
,Nike Air Zoom Pegasus 36 Women's Size 8.5 AQ2210-012-W6,Nike Air Zoom Pegasus 36 Women's Size 8.5 AQ2210-012-W6,FBALYB Amazon,-3,-3,0,0,0,0
,Nike Air Zoom Pegasus 36 Women's Size 8 AQ2210-012-W6,Nike Air Zoom Pegasus 36 Women's Size 8 AQ2210-012-W6,FBALYB Amazon,-2,-2,0,0,0,0
,Nike Air Zoom Pegasus 36 Women's Size 9 AQ2210-012-W6,Nike Air Zoom Pegasus 36 Women's Size 9 AQ2210-012-W6,FBALYB Amazon,-2,-2,0,0,0,0
,Nike Air Zoom Structure 22 Men's Size 10.5 AA1636-002-M9,Nike Air Zoom Structure 22 Men's Size 10.5 AA1636-002-M9,Default Ridgefield,0,0,0,0,0,4
,Nike Air Zoom Structure 22 Men's Size 10 AA1636-002-M9,Nike Air Zoom Structure 22 Men's Size 10 AA1636-002-M9,Default Ridgefield,0,0,0,0,0,4
,Nike Air Zoom Structure 22 Men's Size 10 AA1636-002-M9,Nike Air Zoom Structure 22 Men's Size 10 AA1636-002-M9,FBALYB Amazon,-1,-1,0,0,0,0
,Nike Air Zoom Structure 22 Men's Size 11 AA1636-002-M9,Nike Air Zoom Structure 22 Men's Size 11 AA1636-002-M9,Default Ridgefield,0,0,0,0,0,2
,Nike Air Zoom Structure 22 Men's Size 12 AA1636-002-M9,Nike Air Zoom Structure 22 Men's Size 12 AA1636-002-M9,Default Ridgefield,0,0,0,0,0,2
,Nike Air Zoom Structure 22 Men's Size 8.5 AA1636-002-M8,Nike Air Zoom Structure 22 Men's Size 8.5 AA1636-002-M8,FBALYB Amazon,-7,-7,0,0,0,0
,Nike Air Zoom Structure 22 Men's Size 9.5 AA1636-002-M8,Nike Air Zoom Structure 22 Men's Size 9.5 AA1636-002-M8,FBALYB Amazon,2,2,0,0,0,0
,Nike Air Zoom Structure 22 Men's Size 9 AA1636-002-M8,Nike Air Zoom Structure 22 Men's Size 9 AA1636-002-M8,FBALYB Amazon,-7,-7,0,1,0,0
,Nike Air Zoom Vomero 14 Men's Size 10.5 AH7857-008-M6,Nike Air Zoom Vomero 14 Men's Size 10.5 AH7857-008-M6,FBALYB Amazon,-1,-1,0,0,0,0
,Nike Air Zoom Vomero 14 Men's Size 10 AH7857-008-M6,Nike Air Zoom Vomero 14 Men's Size 10 AH7857-008-M6,FBALYB Amazon,-2,-2,0,0,0,0
,Nike Air Zoom Vomero 14 Men's Size 11.5 AH7857-008-M6,Nike Air Zoom Vomero 14 Men's Size 11.5 AH7857-008-M6,FBALYB Amazon,-2,-2,0,0,0,0
,Nike Air Zoom Vomero 14 Men's Size 11 AH7857-008-M6,Nike Air Zoom Vomero 14 Men's Size 11 AH7857-008-M6,FBALYB Amazon,-1,-1,0,0,0,0
,Nike Air Zoom Vomero 14 Men's Size 12 AH7857-008-M6,Nike Air Zoom Vomero 14 Men's Size 12 AH7857-008-M6,FBALYB Amazon,-1,-1,0,0,0,0
,Nike Air Zoom Vomero 14 Men's Size 13 AH7857-008-M6,Nike Air Zoom Vomero 14 Men's Size 13 AH7857-008-M6,FBALYB Amazon,4,4,0,0,0,0
,Nike Air Zoom Winflo 6 Women's Size 10 AQ8228-006-W6,Nike Air Zoom Winflo 6 Women's Size 10 AQ8228-006-W6,FBALYB Amazon,-1,-1,0,0,0,0
,Nike Air Zoom Winflo 6 Women's Size 8.5 AQ8228-006-W6,Nike Air Zoom Winflo 6 Women's Size 8.5 AQ8228-006-W6,FBALYB Amazon,-3,-3,0,0,0,0
,Nike Air Zoom Winflo 6 Women's Size 8 AQ8228-006-W6,Nike Air Zoom Winflo 6 Women's Size 8 AQ8228-006-W6,FBALYB Amazon,-1,-1,0,0,0,0
,Nike Air Zoom Winflo 6 Women's Size 9 AQ8228-006-W6,Nike Air Zoom Winflo 6 Women's Size 9 AQ8228-006-W6,FBALYB Amazon,-1,-1,0,0,0,0
,Nike Cortez Basic Men's Size 10.5 819719-012-M6,Nike Cortez Basic Men's Size 10.5 819719-012-M6,FBALYB Amazon,-8,-8,0,0,0,0
,Nike Cortez Basic Men's Size 10 819719-012-M6,Nike Cortez Basic Men's Size 10 819719-012-M6,FBALYB Amazon,-2,-2,0,0,0,0
,Nike Cortez Basic Men's Size 11.5 819719-012-M6,Nike Cortez Basic Men's Size 11.5 819719-012-M6,FBALYB Amazon,-1,-1,0,0,0,0
,Nike Cortez Basic Men's Size 11 819719-012-M6,Nike Cortez Basic Men's Size 11 819719-012-M6,FBALYB Amazon,-3,-3,0,0,0,0
,Nike Cortez Basic Men's Size 12 819719-012-M6,Nike Cortez Basic Men's Size 12 819719-012-M6,FBALYB Amazon,-2,-2,0,0,0,0
,Nike Court Royale AC Men's Size 10 BQ4222-002-M9,Nike Court Royale AC Men's Size 10 BQ4222-002-M9,FBALYB Amazon,-1,-1,0,0,0,0
,Nike Court Royale AC Men's Size 12 BQ4222-002-M9,Nike Court Royale AC Men's Size 12 BQ4222-002-M9,FBALYB Amazon,-2,-2,0,0,0,0
,Nike Court Vision Low Men's Size 10.5 CD5463-001-M9,Nike Court Vision Low Men's Size 10.5 CD5463-001-M9,FBALYB Amazon,-6,-6,0,0,0,0
,Nike Court Vision Low Men's Size 10.5 CD5463-003-MF,Nike Court Vision Low Men's Size 10.5 CD5463-003-MF,FBALYB Amazon,-1,-1,0,0,0,0
,Nike Court Vision Low Men's Size 10.5 CD5463-100-M6,Nike Court Vision Low Men's Size 10.5 CD5463-100-M6,FBALYB Amazon,-2,-2,0,1,0,0
,Nike Court Vision Low Men's Size 10 CD5463-001-M8,Nike Court Vision Low Men's Size 10 CD5463-001-M8,FBALYB Amazon,-98,-98,0,0,0,0
,Nike Court Vision Low Men's Size 10 CD5463-001-M9,Nike Court Vision Low Men's Size 10 CD5463-001-M9,FBALYB Amazon,84,84,0,0,0,0
,Nike Court Vision Low Men's Size 10 CD5463-003-MF,Nike Court Vision Low Men's Size 10 CD5463-003-MF,FBALYB Amazon,-2,-2,0,0,0,0
,Nike Court Vision Low Men's Size 10 CD5463-100-M6,Nike Court Vision Low Men's Size 10 CD5463-100-M6,FBALYB Amazon,-1,-1,0,0,0,0
,Nike Court Vision Low Men's Size 11 CD5463-001-M9,Nike Court Vision Low Men's Size 11 CD5463-001-M9,FBALYB Amazon,-4,-4,0,0,0,0
,Nike Court Vision Low Men's Size 11 CD5463-003-MF,Nike Court Vision Low Men's Size 11 CD5463-003-MF,FBALYB Amazon,-3,-3,0,0,0,0
,Nike Court Vision Low Men's Size 11 CD5463-100-M6,Nike Court Vision Low Men's Size 11 CD5463-100-M6,FBALYB Amazon,-5,-5,0,0,0,0
,Nike Court Vision Low Men's Size 12 CD5463-001-M9,Nike Court Vision Low Men's Size 12 CD5463-001-M9,FBALYB Amazon,-6,-6,0,0,0,0
,Nike Court Vision Low Men's Size 12 CD5463-100-M6,Nike Court Vision Low Men's Size 12 CD5463-100-M6,FBALYB Amazon,-2,-2,0,0,0,0
,Nike Court Vision Low Men's Size 13 CD5463-100-M6,Nike Court Vision Low Men's Size 13 CD5463-100-M6,FBALYB Amazon,-1,-1,0,0,0,0
,Nike Court Vision Low Men's Size 8.5 CD5463-001-M8,Nike Court Vision Low Men's Size 8.5 CD5463-001-M8,FBALYB Amazon,-1,-1,0,0,0,0
,Nike Court Vision Low Men's Size 9.5 CD5463-001-M8,Nike Court Vision Low Men's Size 9.5 CD5463-001-M8,FBALYB Amazon,-1,-1,0,0,0,0
,Nike Court Vision Low Men's Size 9.5 CD5463-003-MF,Nike Court Vision Low Men's Size 9.5 CD5463-003-MF,FBALYB Amazon,-2,-2,0,0,0,0
,Nike Court Vision Low Men's Size 9 CD5463-001-M8,Nike Court Vision Low Men's Size 9 CD5463-001-M8,FBALYB Amazon,-1,-1,0,0,0,0
,Nike Court Vision Low Men's Size 9 CD5463-003-MF,Nike Court Vision Low Men's Size 9 CD5463-003-MF,FBALYB Amazon,-1,-1,0,0,0,0
,Nike Downshifter 9 Men's Size 10.5 AQ7481-002-M6,Nike Downshifter 9 Men's Size 10.5 AQ7481-002-M6,FBALYB Amazon,-37,-37,0,0,0,0
,Nike Downshifter 9 Men's Size 10.5 AQ7481-002-MF,Nike Downshifter 9 Men's Size 10.5 AQ7481-002-MF,FBALYB Amazon,19,19,0,0,0,0
,Nike Downshifter 9 Men's Size 10.5 AQ7481-005-M9,Nike Downshifter 9 Men's Size 10.5 AQ7481-005-M9,FBALYB Amazon,-2,-2,0,0,0,0
,Nike Downshifter 9 Men's Size 10.5 AQ7481-400-M9,Nike Downshifter 9 Men's Size 10.5 AQ7481-400-M9,FBALYB Amazon,50,49,1,0,1,0
,Nike Downshifter 9 Men's Size 10 AQ7481-002-M6,Nike Downshifter 9 Men's Size 10 AQ7481-002-M6,FBALYB Amazon,-68,-68,0,1,0,0
,Nike Downshifter 9 Men's Size 10 AQ7481-002-M8,Nike Downshifter 9 Men's Size 10 AQ7481-002-M8,Default Ridgefield,6,6,0,0,0,0
,Nike Downshifter 9 Men's Size 10 AQ7481-002-M8,Nike Downshifter 9 Men's Size 10 AQ7481-002-M8,FBALYB Amazon,-1,-1,0,0,0,0
,Nike Downshifter 9 Men's Size 10 AQ7481-002-MF,Nike Downshifter 9 Men's Size 10 AQ7481-002-MF,FBALYB Amazon,43,43,0,0,0,0
,Nike Downshifter 9 Men's Size 10 AQ7481-005-M9,Nike Downshifter 9 Men's Size 10 AQ7481-005-M9,FBALYB Amazon,-4,-4,0,0,0,0
,Nike Downshifter 9 Men's Size 10 AQ7481-400-M8,Nike Downshifter 9 Men's Size 10 AQ7481-400-M8,FBALYB Amazon,-38,-38,0,0,0,0
,Nike Downshifter 9 Men's Size 10 AQ7481-400-M9,Nike Downshifter 9 Men's Size 10 AQ7481-400-M9,Default Ridgefield,18,18,0,0,0,0
,Nike Downshifter 9 Men's Size 10 AQ7481-400-M9,Nike Downshifter 9 Men's Size 10 AQ7481-400-M9,FBALYB Amazon,78,78,0,0,0,0
,Nike Downshifter 9 Men's Size 11.5 AQ7481-002-M6,Nike Downshifter 9 Men's Size 11.5 AQ7481-002-M6,FBALYB Amazon,-2,-2,0,0,0,0
,Nike Downshifter 9 Men's Size 11 AQ7481-002-M6,Nike Downshifter 9 Men's Size 11 AQ7481-002-M6,FBALYB Amazon,-35,-35,0,0,0,0
,Nike Downshifter 9 Men's Size 11 AQ7481-002-MF,Nike Downshifter 9 Men's Size 11 AQ7481-002-MF,FBALYB Amazon,24,24,0,0,0,0
,Nike Downshifter 9 Men's Size 11 AQ7481-400-M9,Nike Downshifter 9 Men's Size 11 AQ7481-400-M9,FBALYB Amazon,29,29,0,0,0,0
,Nike Downshifter 9 Men's Size 12 AQ7481-002-M6,Nike Downshifter 9 Men's Size 12 AQ7481-002-M6,FBALYB Amazon,-6,-6,0,0,0,0
,Nike Downshifter 9 Men's Size 12 AQ7481-005-M9,Nike Downshifter 9 Men's Size 12 AQ7481-005-M9,FBALYB Amazon,-1,-1,0,0,0,0
,Nike Downshifter 9 Men's Size 12 AQ7481-400-M9,Nike Downshifter 9 Men's Size 12 AQ7481-400-M9,FBALYB Amazon,28,28,0,0,0,0
,Nike Downshifter 9 Men's Size 13 AQ7481-002-M6,Nike Downshifter 9 Men's Size 13 AQ7481-002-M6,FBALYB Amazon,-1,-1,0,0,0,0
,Nike Downshifter 9 Men's Size 7.5 AQ7481-002-M5,Nike Downshifter 9 Men's Size 7.5 AQ7481-002-M5,FBALYB Amazon,-6,-6,0,0,0,0
,Nike Downshifter 9 Men's Size 7 AQ7481-002-M5,Nike Downshifter 9 Men's Size 7 AQ7481-002-M5,FBALYB Amazon,-5,-5,0,0,0,0
,Nike Downshifter 9 Men's Size 8.5 AQ7481-002-M5,Nike Downshifter 9 Men's Size 8.5 AQ7481-002-M5,FBALYB Amazon,-7,-7,0,0,0,0
,Nike Downshifter 9 Men's Size 8.5 AQ7481-002-M8,Nike Downshifter 9 Men's Size 8.5 AQ7481-002-M8,Default Ridgefield,6,6,0,0,0,0
,Nike Downshifter 9 Men's Size 8.5 AQ7481-002-M8,Nike Downshifter 9 Men's Size 8.5 AQ7481-002-M8,FBALYB Amazon,31,30,1,0,1,0
,Nike Downshifter 9 Men's Size 8.5 AQ7481-400-M8,Nike Downshifter 9 Men's Size 8.5 AQ7481-400-M8,FBALYB Amazon,-2,-2,0,0,0,0
,Nike Downshifter 9 Men's Size 8 AQ7481-002-M5,Nike Downshifter 9 Men's Size 8 AQ7481-002-M5,FBALYB Amazon,-8,-8,0,0,0,0
,Nike Downshifter 9 Men's Size 9.5 AQ7481-002-M5,Nike Downshifter 9 Men's Size 9.5 AQ7481-002-M5,FBALYB Amazon,-13,-13,0,0,0,0
,Nike Downshifter 9 Men's Size 9.5 AQ7481-002-M8,Nike Downshifter 9 Men's Size 9.5 AQ7481-002-M8,Default Ridgefield,6,6,0,0,0,0
,Nike Downshifter 9 Men's Size 9.5 AQ7481-002-M8,Nike Downshifter 9 Men's Size 9.5 AQ7481-002-M8,FBALYB Amazon,57,57,0,0,0,0
,Nike Downshifter 9 Men's Size 9.5 AQ7481-002-MF,Nike Downshifter 9 Men's Size 9.5 AQ7481-002-MF,FBALYB Amazon,1,1,0,0,0,0
,Nike Downshifter 9 Men's Size 9.5 AQ7481-400-M8,Nike Downshifter 9 Men's Size 9.5 AQ7481-400-M8,FBALYB Amazon,-6,-6,0,0,0,0
,Nike Downshifter 9 Men's Size 9 AQ7481-002-M5,Nike Downshifter 9 Men's Size 9 AQ7481-002-M5,FBALYB Amazon,-17,-17,0,0,0,0
,Nike Downshifter 9 Men's Size 9 AQ7481-002-M8,Nike Downshifter 9 Men's Size 9 AQ7481-002-M8,FBALYB Amazon,58,58,0,0,0,0
,Nike Downshifter 9 Men's Size 9 AQ7481-002-MF,Nike Downshifter 9 Men's Size 9 AQ7481-002-MF,FBALYB Amazon,6,6,0,0,0,0
,Nike Downshifter 9 Women's Size 10 AQ7486-005-W6,Nike Downshifter 9 Women's Size 10 AQ7486-005-W6,FBALYB Amazon,-2,-2,0,0,0,0
,Nike Downshifter 9 Women's Size 7.5 AQ7486-001-WF,Nike Downshifter 9 Women's Size 7.5 AQ7486-001-WF,FBALYB Amazon,-6,-6,0,0,0,0
,Nike Downshifter 9 Women's Size 7 AQ7486-001-WF,Nike Downshifter 9 Women's Size 7 AQ7486-001-WF,FBALYB Amazon,-6,-6,0,0,0,0
,Nike Downshifter 9 Women's Size 8.5 AQ7486-001-WF,Nike Downshifter 9 Women's Size 8.5 AQ7486-001-WF,Default,1,1,0,0,0,0
,Nike Downshifter 9 Women's Size 8.5 AQ7486-001-WF,Nike Downshifter 9 Women's Size 8.5 AQ7486-001-WF,FBALYB Amazon,-7,-7,0,0,0,0
,Nike Downshifter 9 Women's Size 8.5 AQ7486-005-W6,Nike Downshifter 9 Women's Size 8.5 AQ7486-005-W6,FBALYB Amazon,-5,-5,0,0,0,0
,Nike Downshifter 9 Women's Size 8 AQ7486-001-WF,Nike Downshifter 9 Women's Size 8 AQ7486-001-WF,FBALYB Amazon,-10,-10,0,0,0,0
,Nike Downshifter 9 Women's Size 8 AQ7486-005-W6,Nike Downshifter 9 Women's Size 8 AQ7486-005-W6,FBALYB Amazon,-3,-3,0,0,0,0
,Nike Downshifter 9 Women's Size 9.5 AQ7486-001-WF,Nike Downshifter 9 Women's Size 9.5 AQ7486-001-WF,FBALYB Amazon,-5,-5,0,0,0,0
,Nike Downshifter 9 Women's Size 9 AQ7486-001-WF,Nike Downshifter 9 Women's Size 9 AQ7486-001-WF,FBALYB Amazon,-8,-8,0,0,0,0
,Nike Downshifter 9 Women's Size 9 AQ7486-005-W6,Nike Downshifter 9 Women's Size 9 AQ7486-005-W6,FBALYB Amazon,-2,-2,0,0,0,0
,NIKE DRI-FIT HEADBAND HOME & AWAY WHITE/BLACK OSFM N.NN.B1.101.OS,NIKE DRI-FIT HEADBAND HOME & AWAY WHITE/BLACK OSFM N.NN.B1.101.OS,Default Ridgefield,505,505,0,0,0,0
,NIKE DRI-FIT HEADBAND HOME & AWAY WHITE/BLACK OSFM N.NN.B1.101.OS,NIKE DRI-FIT HEADBAND HOME & AWAY WHITE/BLACK OSFM N.NN.B1.101.OS,FBALYB Amazon,496,490,6,0,6,0
,NIKE ESSENTIAL VOLLEYBALL KNEE PADS BLACK/ M/L N.VP.06.001.ML,NIKE ESSENTIAL VOLLEYBALL KNEE PADS BLACK/ M/L N.VP.06.001.ML,Default Ridgefield,8,8,0,0,0,0
,NIKE ESSENTIAL VOLLEYBALL KNEE PADS BLACK/ M/L N.VP.06.001.ML,NIKE ESSENTIAL VOLLEYBALL KNEE PADS BLACK/ M/L N.VP.06.001.ML,FBALYB Amazon,-75,-107,32,2,32,0
,NIKE ESSENTIAL VOLLEYBALL KNEE PADS WHITE/ M/L N.VP.06.100.ML,NIKE ESSENTIAL VOLLEYBALL KNEE PADS WHITE/ M/L N.VP.06.100.ML,FBALYB Amazon,9,-27,36,0,36,0
,NIKE ESSENTIAL VOLLEYBALL KNEE PADS WHITE/ XS/S N.VP.06.100.2S,NIKE ESSENTIAL VOLLEYBALL KNEE PADS WHITE/ XS/S N.VP.06.100.2S,FBALYB Amazon,-24,-33,9,0,9,0
,Nike Flex Control 3 Men's Size 10.5 AJ5911-001-M6,Nike Flex Control 3 Men's Size 10.5 AJ5911-001-M6,FBALYB Amazon,-21,-21,0,0,0,0
,Nike Flex Control 3 Men's Size 10.5 AJ5911-001-M9,Nike Flex Control 3 Men's Size 10.5 AJ5911-001-M9,FBALYB Amazon,16,16,0,0,0,0
,Nike Flex Control 3 Men's Size 10 AJ5911-001-M6,Nike Flex Control 3 Men's Size 10 AJ5911-001-M6,FBALYB Amazon,-28,-28,0,0,0,0
,Nike Flex Control 3 Men's Size 10 AJ5911-001-M8,Nike Flex Control 3 Men's Size 10 AJ5911-001-M8,Default Ridgefield,24,24,0,0,0,0
,Nike Flex Control 3 Men's Size 10 AJ5911-001-M9,Nike Flex Control 3 Men's Size 10 AJ5911-001-M9,FBALYB Amazon,15,15,0,0,0,0
,Nike Flex Control 3 Men's Size 11.5 AJ5911-001-M6,Nike Flex Control 3 Men's Size 11.5 AJ5911-001-M6,FBALYB Amazon,-2,-2,0,0,0,0
,Nike Flex Control 3 Men's Size 11 AJ5911-001-M6,Nike Flex Control 3 Men's Size 11 AJ5911-001-M6,FBALYB Amazon,-16,-16,0,0,0,0
,Nike Flex Control 3 Men's Size 11 AJ5911-001-M9,Nike Flex Control 3 Men's Size 11 AJ5911-001-M9,FBALYB Amazon,9,9,0,0,0,0
,Nike Flex Control 3 Men's Size 12 AJ5911-001-M6,Nike Flex Control 3 Men's Size 12 AJ5911-001-M6,FBALYB Amazon,-10,-10,0,0,0,0
,Nike Flex Control 3 Men's Size 12 AJ5911-001-M9,Nike Flex Control 3 Men's Size 12 AJ5911-001-M9,FBALYB Amazon,8,8,0,0,0,0
,Nike Flex Control 3 Men's Size 8.5 AJ5911-001-M8,Nike Flex Control 3 Men's Size 8.5 AJ5911-001-M8,Default Ridgefield,25,25,0,0,0,0
,Nike Flex Control 3 Men's Size 9.5 AJ5911-001-M8,Nike Flex Control 3 Men's Size 9.5 AJ5911-001-M8,Default Ridgefield,10,10,0,0,0,0
,Nike Flex Control 3 Men's Size 9.5 AJ5911-001-M8,Nike Flex Control 3 Men's Size 9.5 AJ5911-001-M8,FBALYB Amazon,21,21,0,0,0,0
,Nike Flex Control 3 Men's Size 9 AJ5911-001-M8,Nike Flex Control 3 Men's Size 9 AJ5911-001-M8,Default Ridgefield,9,9,0,0,0,0
,Nike Flex Control 3 Men's Size 9 AJ5911-001-M8,Nike Flex Control 3 Men's Size 9 AJ5911-001-M8,FBALYB Amazon,39,39,0,0,0,0
,Nike Flex Experience RN 8 Men's Size 10.5 AJ5900-007-M9,Nike Flex Experience RN 8 Men's Size 10.5 AJ5900-007-M9,FBALYB Amazon,-7,-7,0,0,0,0
,Nike Flex Experience RN 8 Men's Size 10 AJ5900-007-M9,Nike Flex Experience RN 8 Men's Size 10 AJ5900-007-M9,Default,0,0,0,0,0,1
,Nike Flex Experience RN 8 Men's Size 10 AJ5900-007-M9,Nike Flex Experience RN 8 Men's Size 10 AJ5900-007-M9,FBALYB Amazon,-5,-5,0,0,0,0
,Nike Flex Experience RN 8 Men's Size 11 AJ5900-007-M9,Nike Flex Experience RN 8 Men's Size 11 AJ5900-007-M9,FBALYB Amazon,-2,-2,0,0,0,0
,Nike Flex Experience RN 8 Men's Size 12 AJ5900-007-M9,Nike Flex Experience RN 8 Men's Size 12 AJ5900-007-M9,FBALYB Amazon,-2,-2,0,0,0,0
,Nike Flex Runner Kid's Size 10.5C AT4663-001-PE1,Nike Flex Runner Kid's Size 10.5C AT4663-001-PE1,Default Ridgefield,56,56,0,0,0,0
,Nike Flex Runner Kid's Size 10C AT4665-001-I2,Nike Flex Runner Kid's Size 10C AT4665-001-I2,FBALYB Amazon,-6,-6,0,0,0,0
,Nike Flex Runner Kid's Size 11.5C AT4663-001-PE1,Nike Flex Runner Kid's Size 11.5C AT4663-001-PE1,FBALYB Amazon,-3,-3,0,0,0,0
,Nike Flex Runner Kid's Size 11C AT4663-001-PE1,Nike Flex Runner Kid's Size 11C AT4663-001-PE1,FBALYB Amazon,-7,-7,0,0,0,0
,Nike Flex Runner Kid's Size 12.5C AT4663-001-PE1,Nike Flex Runner Kid's Size 12.5C AT4663-001-PE1,FBALYB Amazon,-1,-1,0,0,0,0
,Nike Flex Runner Kid's Size 12C AT4663-001-PE1,Nike Flex Runner Kid's Size 12C AT4663-001-PE1,FBALYB Amazon,-3,-3,0,0,0,0
,Nike Flex Runner Kid's Size 13.5C AT4663-001-PE2,Nike Flex Runner Kid's Size 13.5C AT4663-001-PE2,FBALYB Amazon,-2,-2,0,0,0,0
,Nike Flex Runner Kid's Size 13C AT4663-001-PE1,Nike Flex Runner Kid's Size 13C AT4663-001-PE1,FBALYB Amazon,-6,-6,0,0,0,0
,Nike Flex Runner Kid's Size 1.5Y AT4663-001-PE2,Nike Flex Runner Kid's Size 1.5Y AT4663-001-PE2,FBALYB Amazon,-6,-6,0,0,0,0
,Nike Flex Runner Kid's Size 1Y AT4663-001-PE2,Nike Flex Runner Kid's Size 1Y AT4663-001-PE2,Default,1,1,0,0,0,0
,Nike Flex Runner Kid's Size 1Y AT4663-001-PE2,Nike Flex Runner Kid's Size 1Y AT4663-001-PE2,FBALYB Amazon,-7,-7,0,0,0,0
,Nike Flex Runner Kid's Size 2.5Y AT4663-001-PE2,Nike Flex Runner Kid's Size 2.5Y AT4663-001-PE2,FBALYB Amazon,-5,-5,0,0,0,0
,Nike Flex Runner Kid's Size 2Y AT4663-001-PE2,Nike Flex Runner Kid's Size 2Y AT4663-001-PE2,FBALYB Amazon,-6,-6,0,0,0,0
,Nike Flex Runner Kid's Size 3.5Y AT4662-001-GS3,Nike Flex Runner Kid's Size 3.5Y AT4662-001-GS3,FBALYB Amazon,-8,-8,0,0,0,0
,Nike Flex Runner Kid's Size 3Y AT4663-001-PE2,Nike Flex Runner Kid's Size 3Y AT4663-001-PE2,FBALYB Amazon,-5,-5,0,0,0,0
,Nike Flex Runner Kid's Size 4.5Y AT4662-001-GS3,Nike Flex Runner Kid's Size 4.5Y AT4662-001-GS3,FBALYB Amazon,-7,-7,0,0,0,0
,Nike Flex Runner Kid's Size 4Y AT4662-001-GS3,Nike Flex Runner Kid's Size 4Y AT4662-001-GS3,FBALYB Amazon,-18,-18,0,0,0,0
,Nike Flex Runner Kid's Size 5.5Y AT4662-001-GS2,Nike Flex Runner Kid's Size 5.5Y AT4662-001-GS2,FBALYB Amazon,-16,-16,0,0,0,0
,Nike Flex Runner Kid's Size 5C AT4665-001-I1,Nike Flex Runner Kid's Size 5C AT4665-001-I1,Default,1,1,0,0,0,0
,Nike Flex Runner Kid's Size 5C AT4665-001-I1,Nike Flex Runner Kid's Size 5C AT4665-001-I1,FBALYB Amazon,-3,-3,0,0,0,0
,Nike Flex Runner Kid's Size 5Y AT4662-001-GS2,Nike Flex Runner Kid's Size 5Y AT4662-001-GS2,Default,0,0,0,0,0,1
,Nike Flex Runner Kid's Size 5Y AT4662-001-GS2,Nike Flex Runner Kid's Size 5Y AT4662-001-GS2,FBALYB Amazon,-15,-15,0,0,0,0
,Nike Flex Runner Kid's Size 6.5Y AT4662-001-GS2,Nike Flex Runner Kid's Size 6.5Y AT4662-001-GS2,Default,0,0,0,0,0,1
,Nike Flex Runner Kid's Size 6.5Y AT4662-001-GS2,Nike Flex Runner Kid's Size 6.5Y AT4662-001-GS2,FBALYB Amazon,-6,-6,0,0,0,0
,Nike Flex Runner Kid's Size 6C AT4665-001-I1,Nike Flex Runner Kid's Size 6C AT4665-001-I1,FBALYB Amazon,-13,-13,0,0,0,0
,Nike Flex Runner Kid's Size 6Y AT4662-001-GS2,Nike Flex Runner Kid's Size 6Y AT4662-001-GS2,FBALYB Amazon,-17,-17,0,0,0,0
,Nike Flex Runner Kid's Size 7C AT4665-001-I1,Nike Flex Runner Kid's Size 7C AT4665-001-I1,FBALYB Amazon,-14,-14,0,0,0,0
,Nike Flex Runner Kid's Size 7Y AT4662-001-GS2,Nike Flex Runner Kid's Size 7Y AT4662-001-GS2,FBALYB Amazon,-5,-5,0,0,0,0
,Nike Flex Runner Kid's Size 8C AT4665-001-I2,Nike Flex Runner Kid's Size 8C AT4665-001-I2,Default,1,1,0,0,0,0
,Nike Flex Runner Kid's Size 8C AT4665-001-I2,Nike Flex Runner Kid's Size 8C AT4665-001-I2,FBALYB Amazon,-7,-7,0,0,0,0
,Nike Flex Runner Kid's Size 9C AT4665-001-I2,Nike Flex Runner Kid's Size 9C AT4665-001-I2,FBALYB Amazon,-4,-4,0,0,0,0
,Nike Flex Runner Shoes Kid's Size 10.5C AT4663-405-PE1,Nike Flex Runner Shoes Kid's Size 10.5C AT4663-405-PE1,FBALYB Amazon,-2,-2,0,0,0,0
,Nike Flex Runner Shoes Kid's Size 11C AT4663-405-PE1,Nike Flex Runner Shoes Kid's Size 11C AT4663-405-PE1,Default Ridgefield,1,1,0,0,0,0
,Nike Flex Runner Shoes Kid's Size 12.5C AT4663-405-PE1,Nike Flex Runner Shoes Kid's Size 12.5C AT4663-405-PE1,Default,1,1,0,0,0,0
,Nike Flex Runner Shoes Kid's Size 12.5C AT4663-405-PE1,Nike Flex Runner Shoes Kid's Size 12.5C AT4663-405-PE1,FBALYB Amazon,-1,-1,0,0,0,0
,Nike Flex Runner Shoes Kid's Size 13.5C AT4663-405-PE2,Nike Flex Runner Shoes Kid's Size 13.5C AT4663-405-PE2,FBALYB Amazon,-1,-1,0,0,0,0
,Nike Flex Runner Shoes Kid's Size 1Y AT4663-405-PE2,Nike Flex Runner Shoes Kid's Size 1Y AT4663-405-PE2,Default,1,1,0,0,0,0
,Nike Flex Runner Shoes Kid's Size 1Y AT4663-405-PE2,Nike Flex Runner Shoes Kid's Size 1Y AT4663-405-PE2,FBALYB Amazon,-2,-2,0,0,0,0
,Nike Flex Runner Shoes Kid's Size 2.5Y AT4663-405-PE2,Nike Flex Runner Shoes Kid's Size 2.5Y AT4663-405-PE2,FBALYB Amazon,-1,-1,0,0,0,0
,Nike Flex Runner Shoes Kid's Size 3Y AT4663-405-PE2,Nike Flex Runner Shoes Kid's Size 3Y AT4663-405-PE2,FBALYB Amazon,-3,-3,0,0,0,0
,Nike Joyride Nova Kid's Size 5.5Y AQ3141-003-GS2,Nike Joyride Nova Kid's Size 5.5Y AQ3141-003-GS2,FBALYB Amazon,13,13,0,0,0,0
,Nike Joyride Nova Kid's Size 5Y AQ3141-003-GS2,Nike Joyride Nova Kid's Size 5Y AQ3141-003-GS2,Default Ridgefield,10,10,0,0,0,0
,Nike Joyride Nova Kid's Size 6.5Y AQ3141-003-GS2,Nike Joyride Nova Kid's Size 6.5Y AQ3141-003-GS2,FBALYB Amazon,15,15,0,0,0,0
,Nike Joyride Nova Kid's Size 6Y AQ3141-003-GS2,Nike Joyride Nova Kid's Size 6Y AQ3141-003-GS2,Default Ridgefield,10,10,0,0,0,0
,Nike Joyride Nova Kid's Size 6Y AQ3141-003-GS2,Nike Joyride Nova Kid's Size 6Y AQ3141-003-GS2,FBALYB Amazon,15,15,0,0,0,0
,Nike Joyride Nova Kid's Size 7Y AQ3141-003-GS2,Nike Joyride Nova Kid's Size 7Y AQ3141-003-GS2,FBALYB Amazon,16,16,0,0,0,0
,Nike Kawa Men's Size 10 832528-001-S2,Nike Kawa Men's Size 10 832528-001-S2,FBALYB Amazon,-44,-44,0,0,0,0
,Nike Kawa Men's Size 11 832528-001-S2,Nike Kawa Men's Size 11 832528-001-S2,FBALYB Amazon,-32,-32,0,0,0,0
,Nike Kawa Men's Size 12 832528-001-S2,Nike Kawa Men's Size 12 832528-001-S2,FBALYB Amazon,-29,-29,0,0,0,0
,Nike Kawa Men's Size 8 832528-001-S3,Nike Kawa Men's Size 8 832528-001-S3,FBALYB Amazon,-3,-3,0,0,0,0
,Nike Kawa Men's Size 9 832528-001-S3,Nike Kawa Men's Size 9 832528-001-S3,FBALYB Amazon,-10,-10,0,0,0,0
,Nike Kids 943307-004 Sz 10.5C,Nike Kids Nike Revolution 4 Negro Fuschia 943307-004 P-2 US Size 10.5C,Default Ridgefield,1,1,0,0,0,0
,Nike Legend Trainer Men's Size 10.5 924206-001-M6,Nike Legend Trainer Men's Size 10.5 924206-001-M6,FBALYB Amazon,7,7,0,0,0,0
,Nike Legend Trainer Men's Size 10.5 924206-001-M9,Nike Legend Trainer Men's Size 10.5 924206-001-M9,FBALYB Amazon,-10,-10,0,0,0,0
,Nike Legend Trainer Men's Size 10 924206-001-M6,Nike Legend Trainer Men's Size 10 924206-001-M6,Default,0,0,0,0,0,1
,Nike Legend Trainer Men's Size 10 924206-001-M6,Nike Legend Trainer Men's Size 10 924206-001-M6,FBALYB Amazon,2,2,0,0,0,0
,Nike Legend Trainer Men's Size 10 924206-001-M9,Nike Legend Trainer Men's Size 10 924206-001-M9,FBALYB Amazon,-6,-6,0,0,0,0
,Nike Legend Trainer Men's Size 11.5 924206-001-M6,Nike Legend Trainer Men's Size 11.5 924206-001-M6,FBALYB Amazon,-7,-7,0,0,0,0
,Nike Legend Trainer Men's Size 11 924206-001-M6,Nike Legend Trainer Men's Size 11 924206-001-M6,FBALYB Amazon,11,11,0,0,0,0
,Nike Legend Trainer Men's Size 11 924206-001-M9,Nike Legend Trainer Men's Size 11 924206-001-M9,FBALYB Amazon,-14,-14,0,0,0,0
,Nike Legend Trainer Men's Size 12 924206-001-M6,Nike Legend Trainer Men's Size 12 924206-001-M6,FBALYB Amazon,5,5,0,0,0,0
,Nike Legend Trainer Men's Size 12 924206-001-M9,Nike Legend Trainer Men's Size 12 924206-001-M9,FBALYB Amazon,-10,-10,0,0,0,0
,Nike Legend Trainer Men's Size 13 924206-001-M6,Nike Legend Trainer Men's Size 13 924206-001-M6,FBALYB Amazon,-2,-2,0,0,0,0
,Nike Men CD4162-606 M9/ 12,Nike Mens Nike Phantom Vision 2 Pro DF FG Laser Crimson/Metallic Silver/Black CD4162-606 M9/ US Size 12,Default Ridgefield,11,11,0,0,0,0
,Nike Men NIKE TODOS WHITE/UNIV RED-BLACK BQ3198-101 Size 10,Nike Men NIKE TODOS WHITE/UNIV RED-BLACK BQ3198-101 Size 10,Default Ridgefield,61,61,0,0,0,75
,Nike Men NIKE TODOS WHITE/UNIV RED-BLACK BQ3198-101 Size 10,Nike Men NIKE TODOS WHITE/UNIV RED-BLACK BQ3198-101 Size 10,FBALYB Amazon,135,135,0,0,0,0
,Nike Men NIKE TODOS WHITE/UNIV RED-BLACK BQ3198-101 Size 105,Nike Men NIKE TODOS WHITE/UNIV RED-BLACK BQ3198-101 Size 105,Default Ridgefield,70,70,0,0,0,75
,Nike Men NIKE TODOS WHITE/UNIV RED-BLACK BQ3198-101 Size 105,Nike Men NIKE TODOS WHITE/UNIV RED-BLACK BQ3198-101 Size 105,FBALYB Amazon,125,125,0,0,0,0
,Nike Men NIKE TODOS WHITE/UNIV RED-BLACK BQ3198-101 Size 11,Nike Men NIKE TODOS WHITE/UNIV RED-BLACK BQ3198-101 Size 11,Default Ridgefield,36,36,0,0,0,49
,Nike Men NIKE TODOS WHITE/UNIV RED-BLACK BQ3198-101 Size 11,Nike Men NIKE TODOS WHITE/UNIV RED-BLACK BQ3198-101 Size 11,FBALYB Amazon,84,84,0,0,0,0
,Nike Men NIKE TODOS WHITE/UNIV RED-BLACK BQ3198-101 Size 12,Nike Men NIKE TODOS WHITE/UNIV RED-BLACK BQ3198-101 Size 12,Default Ridgefield,35,35,0,0,0,49
,Nike Men NIKE TODOS WHITE/UNIV RED-BLACK BQ3198-101 Size 12,Nike Men NIKE TODOS WHITE/UNIV RED-BLACK BQ3198-101 Size 12,FBALYB Amazon,84,84,0,0,0,0
,Nike Men SUPERFLY 7 ACADEMY TF BLACK/BLACK AT7978-010 Size 10,Nike Men SUPERFLY 7 ACADEMY TF BLACK/BLACK AT7978-010 Size 10,Default Ridgefield,46,46,0,0,0,32
,Nike Men SUPERFLY 7 ACADEMY TF BLACK/BLACK AT7978-010 Size 10.5,Nike Men SUPERFLY 7 ACADEMY TF BLACK/BLACK AT7978-010 Size 10.5,Default Ridgefield,27,27,0,0,0,32
,Nike Men SUPERFLY 7 ACADEMY TF BLACK/BLACK AT7978-010 Size 10.5,Nike Men SUPERFLY 7 ACADEMY TF BLACK/BLACK AT7978-010 Size 10.5,FBALYB Amazon,6,5,1,0,1,0
,Nike Men SUPERFLY 7 ACADEMY TF BLACK/BLACK AT7978-010 Size 11,Nike Men SUPERFLY 7 ACADEMY TF BLACK/BLACK AT7978-010 Size 11,Default Ridgefield,22,22,0,0,0,16
,Nike Men SUPERFLY 7 ACADEMY TF BLACK/BLACK AT7978-010 Size 12,Nike Men SUPERFLY 7 ACADEMY TF BLACK/BLACK AT7978-010 Size 12,Default Ridgefield,20,20,0,0,0,16
,Nike Men VAPOR 13 ACADEMY FG/MG LASER CRMSN/BLK-LASER CRMSN AT5269-606 Size 10,Nike Men VAPOR 13 ACADEMY FG/MG LASER CRMSN/BLK-LASER CRMSN AT5269-606 Size 10,Default Ridgefield,15,15,0,0,0,0
,Nike Men VAPOR 13 ACADEMY FG/MG LASER CRMSN/BLK-LASER CRMSN AT5269-606 Size 8.5,Nike Men VAPOR 13 ACADEMY FG/MG LASER CRMSN/BLK-LASER CRMSN AT5269-606 Size 8.5,Default Ridgefield,13,13,0,0,0,0
,Nike Men VAPOR 13 ACADEMY FG/MG LASER CRMSN/BLK-LASER CRMSN AT5269-606 Size 9,Nike Men VAPOR 13 ACADEMY FG/MG LASER CRMSN/BLK-LASER CRMSN AT5269-606 Size 9,Default Ridgefield,34,34,0,0,0,0
,Nike Men VAPOR 13 ACADEMY FG/MG LASER CRMSN/BLK-LASER CRMSN AT5269-606 Size 9.5,Nike Men VAPOR 13 ACADEMY FG/MG LASER CRMSN/BLK-LASER CRMSN AT5269-606 Size 9.5,Default Ridgefield,34,34,0,0,0,0
,Nike Metcon 5 Men's Size 10.5 AQ1189-010-M9,Nike Metcon 5 Men's Size 10.5 AQ1189-010-M9,Default Ridgefield,42,42,0,0,0,0
,Nike Metcon 5 Men's Size 10.5 AQ1189-010-M9,Nike Metcon 5 Men's Size 10.5 AQ1189-010-M9,FBALYB Amazon,48,48,0,0,0,0
,Nike Metcon 5 Men's Size 10 AQ1189-010-M9,Nike Metcon 5 Men's Size 10 AQ1189-010-M9,Default Ridgefield,50,50,0,0,0,0
,Nike Metcon 5 Men's Size 10 AQ1189-010-M9,Nike Metcon 5 Men's Size 10 AQ1189-010-M9,FBALYB Amazon,53,53,0,0,0,0
,Nike Metcon 5 Men's Size 11 AQ1189-010-M9,Nike Metcon 5 Men's Size 11 AQ1189-010-M9,Default Ridgefield,16,16,0,0,0,0
,Nike Metcon 5 Men's Size 11 AQ1189-010-M9,Nike Metcon 5 Men's Size 11 AQ1189-010-M9,FBALYB Amazon,16,16,0,0,0,0
,Nike Metcon 5 Men's Size 12 AQ1189-010-M9,Nike Metcon 5 Men's Size 12 AQ1189-010-M9,Default Ridgefield,11,11,0,0,0,0
,Nike Metcon 5 Men's Size 12 AQ1189-010-M9,Nike Metcon 5 Men's Size 12 AQ1189-010-M9,FBALYB Amazon,17,17,0,0,0,0
,Nike Metcon Sport Men's Size 10.5 AQ7489-004-M6,Nike Metcon Sport Men's Size 10.5 AQ7489-004-M6,FBALYB Amazon,2,2,0,0,0,0
,Nike Metcon Sport Men's Size 10.5 AQ7489-004-M9,Nike Metcon Sport Men's Size 10.5 AQ7489-004-M9,FBALYB Amazon,-8,-9,1,0,1,0
,Nike Metcon Sport Men's Size 10 AQ7489-004-M6,Nike Metcon Sport Men's Size 10 AQ7489-004-M6,FBALYB Amazon,9,9,0,0,0,0
,Nike Metcon Sport Men's Size 10 AQ7489-004-M9,Nike Metcon Sport Men's Size 10 AQ7489-004-M9,FBALYB Amazon,-13,-13,0,0,0,0
,Nike Metcon Sport Men's Size 11 AQ7489-004-M6,Nike Metcon Sport Men's Size 11 AQ7489-004-M6,FBALYB Amazon,10,10,0,0,0,0
,Nike Metcon Sport Men's Size 11 AQ7489-004-M9,Nike Metcon Sport Men's Size 11 AQ7489-004-M9,FBALYB Amazon,-12,-12,0,0,0,0
,Nike Metcon Sport Men's Size 12 AQ7489-004-M6,Nike Metcon Sport Men's Size 12 AQ7489-004-M6,FBALYB Amazon,8,8,0,0,0,0
,Nike Metcon Sport Men's Size 12 AQ7489-004-M9,Nike Metcon Sport Men's Size 12 AQ7489-004-M9,FBALYB Amazon,-10,-10,0,0,0,0
,Nike Metcon Sport Men's Size 13 AQ7489-004-M6,Nike Metcon Sport Men's Size 13 AQ7489-004-M6,FBALYB Amazon,-1,-1,0,0,0,0
,Nike Offcourt Slide Men's Size 10 BQ4639-003-S3,Nike Offcourt Slide Men's Size 10 BQ4639-003-S3,FBALYB Amazon,-5,-5,0,0,0,0
,Nike Offcourt Slide Men's Size 11 BQ4639-003-S3,Nike Offcourt Slide Men's Size 11 BQ4639-003-S3,FBALYB Amazon,-2,-2,0,0,0,0
,Nike Offcourt Slide Men's Size 9 BQ4639-003-S3,Nike Offcourt Slide Men's Size 9 BQ4639-003-S3,FBALYB Amazon,-3,-3,0,0,0,0
,Nike Offcourt Slide Women's Size 10 BQ4632-005-SW2,Nike Offcourt Slide Women's Size 10 BQ4632-005-SW2,FBALYB Amazon,-1,-1,0,0,0,0
,Nike Offcourt Slide Women's Size 11 BQ4632-005-SW2,Nike Offcourt Slide Women's Size 11 BQ4632-005-SW2,FBALYB Amazon,-2,-2,0,0,0,0
,Nike Offcourt Slide Women's Size 7 BQ4632-005-SW1,Nike Offcourt Slide Women's Size 7 BQ4632-005-SW1,FBALYB Amazon,1,1,0,0,0,0
,Nike Offcourt Slide Women's Size 8 BQ4632-005-SW1,Nike Offcourt Slide Women's Size 8 BQ4632-005-SW1,FBALYB Amazon,-1,-1,0,0,0,0
,Nike Offcourt Slide Women's Size 9 BQ4632-005-SW2,Nike Offcourt Slide Women's Size 9 BQ4632-005-SW2,FBALYB Amazon,-1,-1,0,0,0,0
,Nike Renew Run Men's Size 10.5 CK6357-400-M9,Nike Renew Run Men's Size 10.5 CK6357-400-M9,Avrami - Ebay,65,65,0,0,0,0
,Nike Renew Run Men's Size 10 CK6357-400-M9,Nike Renew Run Men's Size 10 CK6357-400-M9,Avrami - Ebay,66,66,0,0,0,0
,Nike Renew Run Men's Size 11 CK6357-400-M9,Nike Renew Run Men's Size 11 CK6357-400-M9,Avrami - Ebay,33,33,0,0,0,0
,Nike Renew Run Men's Size 12 CK6357-400-M9,Nike Renew Run Men's Size 12 CK6357-400-M9,Avrami - Ebay,29,29,0,0,0,0
,Nike Renew Run Men's Size 12 CK6357-400-M9,Nike Renew Run Men's Size 12 CK6357-400-M9,Default,0,0,0,0,0,3
,Nike Revolution 4 Men's Size 10.5 908988-001-M8,Nike Revolution 4 Men's Size 10.5 908988-001-M8,FBALYB Amazon,-6,-6,0,0,0,0
,Nike Revolution 4 Men's Size 10.5 908988-002-M9,Nike Revolution 4 Men's Size 10.5 908988-002-M9,FBALYB Amazon,-4,-4,0,0,0,0
,Nike Revolution 4 Men's Size 10 908988-001-M8,Nike Revolution 4 Men's Size 10 908988-001-M8,FBALYB Amazon,-16,-16,0,0,0,0
,Nike Revolution 4 Men's Size 10 908988-002-M5,Nike Revolution 4 Men's Size 10 908988-002-M5,FBALYB Amazon,-78,-79,1,0,1,0
,Nike Revolution 4 Men's Size 10 908988-002-M9,Nike Revolution 4 Men's Size 10 908988-002-M9,FBALYB Amazon,70,70,0,0,0,0
,Nike Revolution 4 Men's Size 11 908988-001-M8,Nike Revolution 4 Men's Size 11 908988-001-M8,FBALYB Amazon,-3,-3,0,0,0,0
,Nike Revolution 4 Men's Size 11 908988-002-M9,Nike Revolution 4 Men's Size 11 908988-002-M9,FBALYB Amazon,-2,-2,0,0,0,0
,Nike Revolution 4 Men's Size 12 908988-001-M8,Nike Revolution 4 Men's Size 12 908988-001-M8,FBALYB Amazon,-4,-4,0,0,0,0
,Nike Revolution 4 Men's Size 7.5 908988-002-M5,Nike Revolution 4 Men's Size 7.5 908988-002-M5,FBALYB Amazon,-5,-5,0,0,0,0
,Nike Revolution 4 Men's Size 8.5 908988-001-M8,Nike Revolution 4 Men's Size 8.5 908988-001-M8,FBALYB Amazon,-3,-3,0,0,0,0
,Nike Revolution 4 Men's Size 8.5 908988-002-M5,Nike Revolution 4 Men's Size 8.5 908988-002-M5,FBALYB Amazon,-5,-5,0,0,0,0
,Nike Revolution 4 Men's Size 8 908988-002-M5,Nike Revolution 4 Men's Size 8 908988-002-M5,FBALYB Amazon,-3,-3,0,0,0,0
,Nike Revolution 4 Men's Size 9.5 908988-001-M8,Nike Revolution 4 Men's Size 9.5 908988-001-M8,FBALYB Amazon,-3,-3,0,0,0,0
,Nike Revolution 4 Men's Size 9.5 908988-002-M5,Nike Revolution 4 Men's Size 9.5 908988-002-M5,FBALYB Amazon,-9,-9,0,0,0,0
,Nike Revolution 4 Men's Size 9 908988-001-M8,Nike Revolution 4 Men's Size 9 908988-001-M8,FBALYB Amazon,-10,-10,0,0,0,0
,Nike Revolution 4 Men's Size 9 908988-002-M5,Nike Revolution 4 Men's Size 9 908988-002-M5,FBALYB Amazon,-11,-11,0,0,0,0
,Nike Revolution 5 Men's Size 10.5 BQ3204-003-M6,Nike Revolution 5 Men's Size 10.5 BQ3204-003-M6,FBALYB Amazon,7,7,0,0,0,0
,Nike Revolution 5 Men's Size 10.5 BQ3204-400-M6,Nike Revolution 5 Men's Size 10.5 BQ3204-400-M6,FBALYB Amazon,93,87,6,0,6,0
,Nike Revolution 5 Men's Size 10 BQ3204-003-M6,Nike Revolution 5 Men's Size 10 BQ3204-003-M6,FBALYB Amazon,29,29,0,0,0,0
,Nike Revolution 5 Men's Size 10 BQ3204-400-M6,Nike Revolution 5 Men's Size 10 BQ3204-400-M6,Default Ridgefield,2,2,0,0,0,0
,Nike Revolution 5 Men's Size 10 BQ3204-400-M6,Nike Revolution 5 Men's Size 10 BQ3204-400-M6,FBALYB Amazon,29,21,8,0,8,0
,Nike Revolution 5 Men's Size 11.5 BQ3204-003-M6,Nike Revolution 5 Men's Size 11.5 BQ3204-003-M6,FBALYB Amazon,21,21,0,0,0,0
,Nike Revolution 5 Men's Size 11.5 BQ3204-400-M6,Nike Revolution 5 Men's Size 11.5 BQ3204-400-M6,Default Ridgefield,2,2,0,0,0,0
,Nike Revolution 5 Men's Size 11.5 BQ3204-400-M6,Nike Revolution 5 Men's Size 11.5 BQ3204-400-M6,FBALYB Amazon,-1,-1,0,0,0,0
,Nike Revolution 5 Men's Size 11 BQ3204-003-M6,Nike Revolution 5 Men's Size 11 BQ3204-003-M6,FBALYB Amazon,29,29,0,0,0,0
,Nike Revolution 5 Men's Size 11 BQ3204-400-M6,Nike Revolution 5 Men's Size 11 BQ3204-400-M6,FBALYB Amazon,0,-1,1,0,1,0
,Nike Revolution 5 Men's Size 12 BQ3204-003-M6,Nike Revolution 5 Men's Size 12 BQ3204-003-M6,FBALYB Amazon,25,25,0,0,0,0
,Nike Revolution 5 Men's Size 12 BQ3204-400-M6,Nike Revolution 5 Men's Size 12 BQ3204-400-M6,Default Ridgefield,2,2,0,0,0,0
,Nike Revolution 5 Men's Size 12 BQ3204-400-M6,Nike Revolution 5 Men's Size 12 BQ3204-400-M6,FBALYB Amazon,7,3,4,0,4,0
,Nike Revolution 5 Men's Size 13 BQ3204-003-M6,Nike Revolution 5 Men's Size 13 BQ3204-003-M6,Default,0,0,0,0,0,2
,Nike Revolution 5 Men's Size 13 BQ3204-003-M6,Nike Revolution 5 Men's Size 13 BQ3204-003-M6,FBALYB Amazon,17,17,0,0,0,0
,Nike Revolution 5 Men's Size 13 BQ3204-400-M6,Nike Revolution 5 Men's Size 13 BQ3204-400-M6,Default Ridgefield,2,2,0,0,0,0
,Nike Revolution 5 Men's Size 13 BQ3204-400-M6,Nike Revolution 5 Men's Size 13 BQ3204-400-M6,FBALYB Amazon,6,4,2,0,2,0
,Nike Revolution 5 Women's Size 8.5 BQ3207-002-W6,Nike Revolution 5 Women's Size 8.5 BQ3207-002-W6,Default Ridgefield,8,8,0,0,0,0
,Nike Revolution 5 Women's Size 8 BQ3207-002-W6,Nike Revolution 5 Women's Size 8 BQ3207-002-W6,Default Ridgefield,7,7,0,0,0,0
,Nike Revolution 5 Women's Size 8 BQ3207-002-W6,Nike Revolution 5 Women's Size 8 BQ3207-002-W6,FBALYB Amazon,0,-1,1,0,1,0
,Nike Revolution 5 Women's Size 9 BQ3207-002-W6,Nike Revolution 5 Women's Size 9 BQ3207-002-W6,Default Ridgefield,4,4,0,0,0,0
,Nike Shox NZ Men's Size 10.5 378341-017-M9,Nike Shox NZ Men's Size 10.5 378341-017-M9,FBALYB Amazon,-1,-1,0,0,0,0
,Nike Shox NZ Men's Size 10.5 501524-106-M6,Nike Shox NZ Men's Size 10.5 501524-106-M6,FBALYB Amazon,-1,-1,0,0,0,0
,Nike Shox NZ Men's Size 11 501524-106-M6,Nike Shox NZ Men's Size 11 501524-106-M6,FBALYB Amazon,-1,-1,0,0,0,0
,Nike Shox NZ Men's Size 11.5 501524-106-M6,Nike Shox NZ Men's Size 11.5 501524-106-M6,FBALYB Amazon,-1,-1,0,0,0,0
,Nike Shox NZ Men's Size 13 501524-106-M6,Nike Shox NZ Men's Size 13 501524-106-M6,FBALYB Amazon,-2,-2,0,0,0,0
,Nike Star Runner 2 Kid's Size 3.5Y AQ3542-001-GS3,Nike Star Runner 2 Kid's Size 3.5Y AQ3542-001-GS3,Default Ridgefield,30,30,0,0,0,0
,Nike Star Runner 2 Kid's Size 4.5Y AQ3542-001-GS3,Nike Star Runner 2 Kid's Size 4.5Y AQ3542-001-GS3,FBALYB Amazon,-4,-4,0,0,0,0
,Nike Star Runner 2 Kid's Size 4Y AQ3542-001-GS3,Nike Star Runner 2 Kid's Size 4Y AQ3542-001-GS3,Default,0,0,0,0,0,1
,Nike Star Runner 2 Kid's Size 4Y AQ3542-001-GS3,Nike Star Runner 2 Kid's Size 4Y AQ3542-001-GS3,FBALYB Amazon,-3,-3,0,0,0,0
,Nike Star Runner 2 Kid's Size 5.5Y AQ3542-001-GS3,Nike Star Runner 2 Kid's Size 5.5Y AQ3542-001-GS3,Default Ridgefield,30,30,0,0,0,0
,Nike Star Runner 2 Kid's Size 5Y AQ3542-001-GS3,Nike Star Runner 2 Kid's Size 5Y AQ3542-001-GS3,Default Ridgefield,30,30,0,0,0,0
,Nike Star Runner 2 Kid's Size 6Y AQ3542-001-GS3,Nike Star Runner 2 Kid's Size 6Y AQ3542-001-GS3,Default Ridgefield,30,30,0,0,0,0
,NIKE STREAK VOLLEYBALL KNEE PADS BLACK/ M/L N.VP.05.001.ML,NIKE STREAK VOLLEYBALL KNEE PADS BLACK/ M/L N.VP.05.001.ML,FBALYB Amazon,-19,-19,0,0,0,0
,NIKE STREAK VOLLEYBALL KNEE PADS BLACK/ XL/XXL N.VP.05.001.XX,NIKE STREAK VOLLEYBALL KNEE PADS BLACK/ XL/XXL N.VP.05.001.XX,Default Ridgefield,74,74,0,0,0,0
,NIKE STREAK VOLLEYBALL KNEE PADS BLACK/ XL/XXL N.VP.05.001.XX,NIKE STREAK VOLLEYBALL KNEE PADS BLACK/ XL/XXL N.VP.05.001.XX,FBALYB Amazon,-5,-5,0,0,0,0
,NIKE STREAK VOLLEYBALL KNEE PADS BLACK/ XS/S N.VP.05.001.2S,NIKE STREAK VOLLEYBALL KNEE PADS BLACK/ XS/S N.VP.05.001.2S,FBALYB Amazon,-19,-19,0,0,0,0
,NIKE STREAK VOLLEYBALL KNEE PADS WHITE/ M/L N.VP.05.100.ML,NIKE STREAK VOLLEYBALL KNEE PADS WHITE/ M/L N.VP.05.100.ML,Default Ridgefield,100,100,0,0,0,0
,NIKE STREAK VOLLEYBALL KNEE PADS WHITE/ M/L N.VP.05.100.ML,NIKE STREAK VOLLEYBALL KNEE PADS WHITE/ M/L N.VP.05.100.ML,FBALYB Amazon,-13,-13,0,0,0,0
,NIKE STREAK VOLLEYBALL KNEE PADS WHITE/ XL/XXL N.VP.05.100.XX,NIKE STREAK VOLLEYBALL KNEE PADS WHITE/ XL/XXL N.VP.05.100.XX,FBALYB Amazon,-8,-8,0,0,0,0
,NIKE STREAK VOLLEYBALL KNEE PADS WHITE/ XS/S N.VP.05.100.2S,NIKE STREAK VOLLEYBALL KNEE PADS WHITE/ XS/S N.VP.05.100.2S,FBALYB Amazon,-3,-3,0,0,0,0
,Nike Tanjun Kid's Size 10.5C 844868-011-PE1,Nike Tanjun Kid's Size 10.5C 844868-011-PE1,Default Ridgefield,16,16,0,0,0,0
,Nike Tanjun Kid's Size 10.5C 844868-011-PE1,Nike Tanjun Kid's Size 10.5C 844868-011-PE1,FBALYB Amazon,16,16,0,0,0,0
,Nike Tanjun Kid's Size 11.5C 844868-011-PE1,Nike Tanjun Kid's Size 11.5C 844868-011-PE1,Default Ridgefield,15,15,0,0,0,0
,Nike Tanjun Kid's Size 11.5C 844868-011-PE1,Nike Tanjun Kid's Size 11.5C 844868-011-PE1,FBALYB Amazon,16,16,0,0,0,0
,Nike Tanjun Kid's Size 11C 844868-011-PE1,Nike Tanjun Kid's Size 11C 844868-011-PE1,Default Ridgefield,8,8,0,0,0,0
,Nike Tanjun Kid's Size 11C 844868-011-PE1,Nike Tanjun Kid's Size 11C 844868-011-PE1,FBALYB Amazon,10,10,0,0,0,0
,Nike Tanjun Kid's Size 12.5C 844868-011-PE1,Nike Tanjun Kid's Size 12.5C 844868-011-PE1,Default Ridgefield,7,7,0,0,0,0
,Nike Tanjun Kid's Size 12.5C 844868-011-PE1,Nike Tanjun Kid's Size 12.5C 844868-011-PE1,FBALYB Amazon,15,15,0,0,0,0
,Nike Tanjun Kid's Size 12C 844868-011-PE1,Nike Tanjun Kid's Size 12C 844868-011-PE1,FBALYB Amazon,-5,-5,0,0,0,0
,Nike Tanjun Kid's Size 13.5 844868-011-PE2,Nike Tanjun Kid's Size 13.5 844868-011-PE2,Default Ridgefield,54,54,0,0,0,0
,Nike Tanjun Kid's Size 13.5 844868-011-PE2,Nike Tanjun Kid's Size 13.5 844868-011-PE2,FBALYB Amazon,49,49,0,0,0,0
,Nike Tanjun Kid's Size 13C 844868-011-PE1,Nike Tanjun Kid's Size 13C 844868-011-PE1,Default Ridgefield,2,2,0,0,0,0
,Nike Tanjun Kid's Size 13C 844868-011-PE1,Nike Tanjun Kid's Size 13C 844868-011-PE1,FBALYB Amazon,1,1,0,0,0,0
,Nike Tanjun Kid's Size 1.5Y 844868-011-PE2,Nike Tanjun Kid's Size 1.5Y 844868-011-PE2,Default Ridgefield,40,40,0,0,0,0
,Nike Tanjun Kid's Size 1.5Y 844868-011-PE2,Nike Tanjun Kid's Size 1.5Y 844868-011-PE2,FBALYB Amazon,38,38,0,0,0,0
,Nike Tanjun Kid's Size 1Y 844868-011-PE2,Nike Tanjun Kid's Size 1Y 844868-011-PE2,Default Ridgefield,25,25,0,0,0,0
,Nike Tanjun Kid's Size 1Y 844868-011-PE2,Nike Tanjun Kid's Size 1Y 844868-011-PE2,FBALYB Amazon,29,29,0,0,0,0
,Nike Tanjun Kid's Size 2.5Y 844868-011-PE2,Nike Tanjun Kid's Size 2.5Y 844868-011-PE2,Default Ridgefield,33,33,0,0,0,0
,Nike Tanjun Kid's Size 2.5Y 844868-011-PE2,Nike Tanjun Kid's Size 2.5Y 844868-011-PE2,FBALYB Amazon,29,29,0,0,0,0
,Nike Tanjun Kid's Size 2Y 844868-011-PE2,Nike Tanjun Kid's Size 2Y 844868-011-PE2,Default Ridgefield,40,40,0,0,0,0
,Nike Tanjun Kid's Size 2Y 844868-011-PE2,Nike Tanjun Kid's Size 2Y 844868-011-PE2,FBALYB Amazon,32,32,0,0,0,0
,Nike Tanjun Kid's Size 3Y 844868-011-PE2,Nike Tanjun Kid's Size 3Y 844868-011-PE2,Default Ridgefield,43,43,0,0,0,0
,Nike Tanjun Kid's Size 3Y 844868-011-PE2,Nike Tanjun Kid's Size 3Y 844868-011-PE2,FBALYB Amazon,37,37,0,0,0,0
,NIKE TODOS Men BLACK/BLACK-BLACK-ANTHRACITE BQ3198-001 Size 10,NIKE TODOS Men BLACK/BLACK-BLACK-ANTHRACITE BQ3198-001 Size 10,Default Ridgefield,37,37,0,0,0,0
,NIKE TODOS Men BLACK/BLACK-BLACK-ANTHRACITE BQ3198-001 Size 10.5,NIKE TODOS Men BLACK/BLACK-BLACK-ANTHRACITE BQ3198-001 Size 10.5,Default Ridgefield,39,39,0,0,0,0
,NIKE TODOS Men BLACK/BLACK-BLACK-ANTHRACITE BQ3198-001 Size 11,NIKE TODOS Men BLACK/BLACK-BLACK-ANTHRACITE BQ3198-001 Size 11,Default Ridgefield,20,20,0,0,0,0
,NIKE TODOS Men BLACK/BLACK-BLACK-ANTHRACITE BQ3198-001 Size 12,NIKE TODOS Men BLACK/BLACK-BLACK-ANTHRACITE BQ3198-001 Size 12,Default Ridgefield,19,19,0,0,0,0
,Nike Todos RN Men's Size 10.5 BQ3198-001-M9,Nike Todos RN Men's Size 10.5 BQ3198-001-M9,FBALYB Amazon,35,35,0,0,0,0
,Nike Todos RN Men's Size 10.5 BQ3198-002-M6,Nike Todos RN Men's Size 10.5 BQ3198-002-M6,FBALYB Amazon,-7,-7,0,0,0,0
,Nike Todos RN Men's Size 10 BQ3198-001-M8,Nike Todos RN Men's Size 10 BQ3198-001-M8,FBALYB Amazon,43,43,0,0,0,0
,Nike Todos RN Men's Size 10 BQ3198-001-M9,Nike Todos RN Men's Size 10 BQ3198-001-M9,FBALYB Amazon,21,21,0,0,0,0
,Nike Todos RN Men's Size 10 BQ3198-002-M6,Nike Todos RN Men's Size 10 BQ3198-002-M6,FBALYB Amazon,-9,-9,0,0,0,0
,Nike Todos RN Men's Size 11 BQ3198-001-M9,Nike Todos RN Men's Size 11 BQ3198-001-M9,FBALYB Amazon,3,3,0,0,0,0
,Nike Todos RN Men's Size 11 BQ3198-002-M6,Nike Todos RN Men's Size 11 BQ3198-002-M6,FBALYB Amazon,-4,-4,0,0,0,0
,Nike Todos RN Men's Size 12 BQ3198-001-M9,Nike Todos RN Men's Size 12 BQ3198-001-M9,FBALYB Amazon,19,19,0,0,0,0
,Nike Todos RN Men's Size 12 BQ3198-002-M6,Nike Todos RN Men's Size 12 BQ3198-002-M6,FBALYB Amazon,1,1,0,0,0,0
,Nike Todos RN Men's Size 8.5 BQ3198-001-M8,Nike Todos RN Men's Size 8.5 BQ3198-001-M8,FBALYB Amazon,6,6,0,0,0,0
,Nike Todos RN Men's Size 8.5 BQ3198-001-M9,Nike Todos RN Men's Size 8.5 BQ3198-001-M9,FBALYB Amazon,-8,-8,0,0,0,0
,Nike Todos RN Men's Size 9.5 BQ3198-001-M8,Nike Todos RN Men's Size 9.5 BQ3198-001-M8,FBALYB Amazon,13,13,0,0,0,0
,Nike Todos RN Men's Size 9.5 BQ3198-001-M9,Nike Todos RN Men's Size 9.5 BQ3198-001-M9,FBALYB Amazon,15,15,0,0,0,0
,Nike Todos RN Men's Size 9 BQ3198-001-M8,Nike Todos RN Men's Size 9 BQ3198-001-M8,FBALYB Amazon,15,15,0,0,0,0
,Nike Todos RN Men's Size 9 BQ3198-001-M9,Nike Todos RN Men's Size 9 BQ3198-001-M9,FBALYB Amazon,18,18,0,0,0,0
,Nike Todos RN Women's Size 10 BQ3201-001-W6,Nike Todos RN Women's Size 10 BQ3201-001-W6,FBALYB Amazon,-4,-4,0,0,0,0
,Nike Todos RN Women's Size 10 BQ3201-002-W6,Nike Todos RN Women's Size 10 BQ3201-002-W6,Default,0,0,0,0,0,4
,Nike Todos RN Women's Size 10 BQ3201-101-W4,Nike Todos RN Women's Size 10 BQ3201-101-W4,Default Ridgefield,13,13,0,0,0,0
,Nike Todos RN Women's Size 10 BQ3201-101-W4,Nike Todos RN Women's Size 10 BQ3201-101-W4,FBALYB Amazon,3,3,0,0,0,0
,Nike Todos RN Women's Size 8.5 BQ3201-001-W6,Nike Todos RN Women's Size 8.5 BQ3201-001-W6,FBALYB Amazon,-7,-7,0,0,0,0
,Nike Todos RN Women's Size 8.5 BQ3201-002-W6,Nike Todos RN Women's Size 8.5 BQ3201-002-W6,Default,0,0,0,0,0,8
,Nike Todos RN Women's Size 8.5 BQ3201-101-W4,Nike Todos RN Women's Size 8.5 BQ3201-101-W4,FBALYB Amazon,37,35,2,0,2,0
,Nike Todos RN Women's Size 8 BQ3201-001-W6,Nike Todos RN Women's Size 8 BQ3201-001-W6,FBALYB Amazon,-5,-5,0,0,0,0
,Nike Todos RN Women's Size 8 BQ3201-002-W6,Nike Todos RN Women's Size 8 BQ3201-002-W6,Default,0,0,0,0,0,8
,Nike Todos RN Women's Size 8 BQ3201-101-W4,Nike Todos RN Women's Size 8 BQ3201-101-W4,Default Ridgefield,16,16,0,0,0,0
,Nike Todos RN Women's Size 8 BQ3201-101-W4,Nike Todos RN Women's Size 8 BQ3201-101-W4,FBALYB Amazon,20,20,0,0,0,0
,Nike Todos RN Women's Size 9.5 BQ3201-101-W4,Nike Todos RN Women's Size 9.5 BQ3201-101-W4,Default,0,0,0,0,0,33
,Nike Todos RN Women's Size 9 BQ3201-001-W6,Nike Todos RN Women's Size 9 BQ3201-001-W6,FBALYB Amazon,-4,-4,0,0,0,0
,Nike Todos RN Women's Size 9 BQ3201-002-W6,Nike Todos RN Women's Size 9 BQ3201-002-W6,Default,0,0,0,0,0,4
,Nike Todos RN Women's Size 9 BQ3201-101-W4,Nike Todos RN Women's Size 9 BQ3201-101-W4,Default,0,0,0,0,0,14
,Nike Todos RN Women's Size 9 BQ3201-101-W4,Nike Todos RN Women's Size 9 BQ3201-101-W4,Default Ridgefield,4,4,0,0,0,0
,Nike Todos RN Women's Size 9 BQ3201-101-W4,Nike Todos RN Women's Size 9 BQ3201-101-W4,FBALYB Amazon,14,14,0,0,0,0
,NIKE VAPOR JET 6.0 FG BLACK/BLACK/DARK GREY M N.100.0605.029.MD,NIKE VAPOR JET 6.0 FG BLACK/BLACK/DARK GREY M N.100.0605.029.MD,FBALYB Amazon,-7,-9,2,0,2,0
,NIKE VAPOR JET 6.0 FG BLACK/BLACK/DARK GREY XL N.100.0605.029.XL,NIKE VAPOR JET 6.0 FG BLACK/BLACK/DARK GREY XL N.100.0605.029.XL,FBALYB Amazon,-1,-2,1,0,1,0
,Nike Varsity Compete TR 2 Men's Size 10.5 AT1239-003-M9,Nike Varsity Compete TR 2 Men's Size 10.5 AT1239-003-M9,FBALYB Amazon,-6,-6,0,0,0,0
,Nike Varsity Compete TR 2 Men's Size 10 AT1239-003-M9,Nike Varsity Compete TR 2 Men's Size 10 AT1239-003-M9,FBALYB Amazon,-4,-4,0,0,0,0
,Nike Varsity Compete TR 2 Men's Size 11 AT1239-003-M9,Nike Varsity Compete TR 2 Men's Size 11 AT1239-003-M9,FBALYB Amazon,-5,-5,0,0,0,0
,Nike Varsity Compete TR 2 Men's Size 12 AT1239-003-M9,Nike Varsity Compete TR 2 Men's Size 12 AT1239-003-M9,FBALYB Amazon,-5,-5,0,0,0,0
,Nike Women AQ1316-302 Sz 10,Nike Womens Nike Free RN 5.0 Ocean cube / MTLC Cool Gray AQ1316-302 US Size 10,Default Ridgefield,12,12,0,0,0,0
,Nike Women AQ1316-302 Sz 8,Nike Womens Nike Free RN 5.0 Ocean cube / MTLC Cool Gray AQ1316-302 US Size 8,Default Ridgefield,24,24,0,0,0,0
,Nike Women AQ1316-302 Sz 8.5,Nike Womens Nike Free RN 5.0 Ocean cube / MTLC Cool Gray AQ1316-302 US Size 8.5,Default Ridgefield,24,24,0,0,0,0
,Nike Women AQ1316-302 Sz 9,Nike Womens Nike Free RN 5.0 Ocean cube / MTLC Cool Gray AQ1316-302 US Size 9,Default Ridgefield,12,12,0,0,0,0
,Nike Women WMNS NIKE DOWNSHIFTER 9 INDG/SNDD PRPL-AMTHYST T H19 AQ7486-501 Size 10,Nike Women WMNS NIKE DOWNSHIFTER 9 INDG/SNDD PRPL-AMTHYST T H19 AQ7486-501 Size 10,Default Ridgefield,15,15,0,0,0,0
,Nike Women WMNS NIKE DOWNSHIFTER 9 INDG/SNDD PRPL-AMTHYST T H19 AQ7486-501 Size 8,Nike Women WMNS NIKE DOWNSHIFTER 9 INDG/SNDD PRPL-AMTHYST T H19 AQ7486-501 Size 8,Default Ridgefield,2,2,0,0,0,0
,Nike Women WMNS NIKE DOWNSHIFTER 9 INDG/SNDD PRPL-AMTHYST T H19 AQ7486-501 Size 8,Nike Women WMNS NIKE DOWNSHIFTER 9 INDG/SNDD PRPL-AMTHYST T H19 AQ7486-501 Size 8,FBALYB Amazon,30,30,0,0,0,0
,Nike Women WMNS NIKE DOWNSHIFTER 9 INDG/SNDD PRPL-AMTHYST T H19 AQ7486-501 Size 8.5,Nike Women WMNS NIKE DOWNSHIFTER 9 INDG/SNDD PRPL-AMTHYST T H19 AQ7486-501 Size 8.5,Default Ridgefield,1,1,0,0,0,0
,Nike Women WMNS NIKE DOWNSHIFTER 9 INDG/SNDD PRPL-AMTHYST T H19 AQ7486-501 Size 8.5,Nike Women WMNS NIKE DOWNSHIFTER 9 INDG/SNDD PRPL-AMTHYST T H19 AQ7486-501 Size 8.5,FBALYB Amazon,32,32,0,0,0,0
,Nike Women WMNS NIKE DOWNSHIFTER 9 INDG/SNDD PRPL-AMTHYST T H19 AQ7486-501 Size 9,Nike Women WMNS NIKE DOWNSHIFTER 9 INDG/SNDD PRPL-AMTHYST T H19 AQ7486-501 Size 9,FBALYB Amazon,17,17,0,0,0,0
,Nike Women WMNS NIKE DOWNSHIFTER 9 PRPL/WHT-LVNDR-GRY F19 AQ7486-500 Size 10,Nike Women WMNS NIKE DOWNSHIFTER 9 PRPL/WHT-LVNDR-GRY F19 AQ7486-500 Size 10,FBALYB Amazon,33,33,0,0,0,0
,Nike Women WMNS NIKE DOWNSHIFTER 9 PRPL/WHT-LVNDR-GRY F19 AQ7486-500 Size 8,Nike Women WMNS NIKE DOWNSHIFTER 9 PRPL/WHT-LVNDR-GRY F19 AQ7486-500 Size 8,Default Ridgefield,41,41,0,0,0,0
,Nike Women WMNS NIKE DOWNSHIFTER 9 PRPL/WHT-LVNDR-GRY F19 AQ7486-500 Size 8,Nike Women WMNS NIKE DOWNSHIFTER 9 PRPL/WHT-LVNDR-GRY F19 AQ7486-500 Size 8,FBALYB Amazon,26,26,0,0,0,0
,Nike Women WMNS NIKE DOWNSHIFTER 9 PRPL/WHT-LVNDR-GRY F19 AQ7486-500 Size 8.5,Nike Women WMNS NIKE DOWNSHIFTER 9 PRPL/WHT-LVNDR-GRY F19 AQ7486-500 Size 8.5,Default Ridgefield,67,67,0,0,0,0
,Nike Women WMNS NIKE DOWNSHIFTER 9 PRPL/WHT-LVNDR-GRY F19 AQ7486-500 Size 9,Nike Women WMNS NIKE DOWNSHIFTER 9 PRPL/WHT-LVNDR-GRY F19 AQ7486-500 Size 9,FBALYB Amazon,33,33,0,0,0,0
,Nike Women WMNS NIKE FREE RN 5.0 BLACK/PINK BLAST-TRUE BERRY AQ1316-007 Size 10,Nike Women WMNS NIKE FREE RN 5.0 BLACK/PINK BLAST-TRUE BERRY AQ1316-007 Size 10,Default Ridgefield,20,20,0,0,0,0
,Nike Women WMNS NIKE FREE RN 5.0 BLACK/PINK BLAST-TRUE BERRY AQ1316-007 Size 8,Nike Women WMNS NIKE FREE RN 5.0 BLACK/PINK BLAST-TRUE BERRY AQ1316-007 Size 8,Default Ridgefield,44,44,0,0,0,0
,Nike Women WMNS NIKE FREE RN 5.0 BLACK/PINK BLAST-TRUE BERRY AQ1316-007 Size 8.5,Nike Women WMNS NIKE FREE RN 5.0 BLACK/PINK BLAST-TRUE BERRY AQ1316-007 Size 8.5,Default Ridgefield,42,42,0,0,0,0
,Nike Women WMNS NIKE FREE RN 5.0 BLACK/PINK BLAST-TRUE BERRY AQ1316-007 Size 9,Nike Women WMNS NIKE FREE RN 5.0 BLACK/PINK BLAST-TRUE BERRY AQ1316-007 Size 9,Default Ridgefield,22,22,0,0,0,0
,Nike Women W NIKE SHOX ENIGMA DUST/RFLT SLVR-VLRN BLU-PRPL BQ9001-009 Size 10,Nike Women W NIKE SHOX ENIGMA DUST/RFLT SLVR-VLRN BLU-PRPL BQ9001-009 Size 10,Default Ridgefield,22,22,0,0,0,0
,Nike Women W NIKE SHOX ENIGMA DUST/RFLT SLVR-VLRN BLU-PRPL BQ9001-009 Size 8,Nike Women W NIKE SHOX ENIGMA DUST/RFLT SLVR-VLRN BLU-PRPL BQ9001-009 Size 8,Default Ridgefield,45,45,0,0,0,0
,Nike Women W NIKE SHOX ENIGMA DUST/RFLT SLVR-VLRN BLU-PRPL BQ9001-009 Size 8.5,Nike Women W NIKE SHOX ENIGMA DUST/RFLT SLVR-VLRN BLU-PRPL BQ9001-009 Size 8.5,Default Ridgefield,46,46,0,0,0,0
,Nike Women W NIKE SHOX ENIGMA DUST/RFLT SLVR-VLRN BLU-PRPL BQ9001-009 Size 9,Nike Women W NIKE SHOX ENIGMA DUST/RFLT SLVR-VLRN BLU-PRPL BQ9001-009 Size 9,Default Ridgefield,23,23,0,0,0,0
,Nike Women W NIKE SHOX ENIGMA WHITE/WHITE-WHITE BQ9001-101 Size 10,Nike Women W NIKE SHOX ENIGMA WHITE/WHITE-WHITE BQ9001-101 Size 10,Default Ridgefield,18,18,0,0,0,0
,Nike Women W NIKE SHOX ENIGMA WHITE/WHITE-WHITE BQ9001-101 Size 8,Nike Women W NIKE SHOX ENIGMA WHITE/WHITE-WHITE BQ9001-101 Size 8,Default Ridgefield,36,36,0,0,0,0
,Nike Women W NIKE SHOX ENIGMA WHITE/WHITE-WHITE BQ9001-101 Size 8.5,Nike Women W NIKE SHOX ENIGMA WHITE/WHITE-WHITE BQ9001-101 Size 8.5,Default Ridgefield,35,35,0,0,0,0
,Nike Women W NIKE SHOX ENIGMA WHITE/WHITE-WHITE BQ9001-101 Size 9,Nike Women W NIKE SHOX ENIGMA WHITE/WHITE-WHITE BQ9001-101 Size 9,Default Ridgefield,17,17,0,0,0,0
,Nikon Coolpix L32,Nikon Coolpix L32 20.1MP Digital Camera with 5x Optical Zoom and HD 720p Video,FBALYB Amazon,-1,-1,0,0,0,0
,Ninja BL494,Ninja Kitchen System with Auto-iQ Boost (BL494),Default,0,0,0,0,0,1
,Ninja BL681C Blender,Ninja BL681C Blender,FBASKCK Amazon,416,416,0,0,0,0
,NINJA BL688,NINJA BL688,FBASKCK Amazon,100,100,0,0,0,0
,Ninja BL770 Mega Blender,Ninja BL770 Mega Blender,Default,0,0,0,0,0,2
,Ninja Coffe Glass Carafe CF082 622356540,"Ninja Coffee Bar Brewer, Glass Carafe (CF082)",Default,0,-1,1,0,0,1
,Ninja CT682SP Black,"Ninja CT682SP Intelli-Sense Kitchen System with Auto-Spiralizer, Black",Default,0,0,0,0,0,1
,Ninja CT810 Chef High-Speed Blender,Ninja CT810 Chef High-Speed Blender,FBALYB Amazon,-3,-3,0,0,0,0
,Ninja Professional Blender,Ninja Professional Blender (NJ600),Default,0,0,0,0,0,19
,Ninja Professional Blender,Ninja Professional Blender (NJ600),FBALYB Amazon,-7,-7,0,4,0,0
,Nintendo 2DS with Zelda,Nintendo 2DS with The Legend of Zelda : Ocarina of Time 3D,Default,0,0,0,0,0,21
,NIOB Ultrabrite Desk Lamp,NIOB Ultrabrite Desk Lamp,FBALYB Amazon,-3,-3,0,0,0,0
,Nivea 150ml invisible deodorant 3pk,Nivea 150ml invisible deodorant 3pk,FBALYB Amazon,3,3,0,2,0,0
,Nivea Cool Kick Deo Spray 3pack,Nivea Cool Kick Deo Spray 3pack,Default,0,-1,1,0,0,0
,Nivea Cool Kick Deo Spray 3pack,Nivea Cool Kick Deo Spray 3pack,FBALYB Amazon,4,-1,5,0,5,0
,Nivea Cream 400ml / 13.5 Oz - Blue Can,Nivea Cream 400ml / 13.5 Oz - Blue Can,FBALYB Amazon,588,570,18,66,18,0
,Nivea Cream 400ml / 13.5 Oz - Blue Can,Nivea Cream 400ml / 13.5 Oz - Blue Can,WFS,-95,-95,0,0,0,0
,Nivea Deodorant Men Cool Kick,Nivea Deodorant Men Cool Kick,Avrami - Ebay,216,216,0,0,0,0
,Nivea Deodorant Men Cool Kick,Nivea Deodorant Men Cool Kick,Default CT,2970,2970,0,0,0,0
,Nivea Deodorant Men Cool Kick,Nivea Deodorant Men Cool Kick,Default Ridgefield,99,99,0,0,0,0
,Nivea Deodorant Roll-on Silver 6pk,Nivea Deodorant Roll-on Silver 6pk,FBALYB Amazon,-17,-18,1,5,1,0
,NIVEA DEODORANT SPRAY PEARL & BEAUTY 150ML Womens,NIVEA DEODORANT SPRAY PEARL & BEAUTY 150ML Womens,Default CT,1200,1200,0,0,0,0
,NIVEA DEODORANT SPRAY PEARL & BEAUTY 150ML Womens 2pk,NIVEA DEODORANT SPRAY PEARL & BEAUTY 150ML Womens 2pk,FBALYB Amazon,-9,-9,0,1,0,0
,NIVEA DEODORANT SPRAY PEARL & BEAUTY 150ML Womens   3PACK,NIVEA DEODORANT SPRAY PEARL & BEAUTY 150ML Womens   3PACK,FBALYB Amazon,117,117,0,0,0,0
,Nivea Deodorant Women Black White Clear,Nivea Deodorant Women Black White Clear,Default,0,-8400,8400,0,0,0
,Nivea Deo Roll on 50ML Double Effect 3pk,Nivea Deo Roll on 50ML Double Effect 3pk,FBALYB Amazon,2,2,0,0,0,0
,Nivea Deo Roll on 50ML Invisible B&W Fresh,Nivea Deo Roll on 50ML Invisible B&W Fresh,Default,0,0,0,0,0,1
,Nivea Essentially Enriched 2/21oz,Nivea Essentially Enriched 2/21oz,FBALYB Amazon,31,30,1,0,1,0
,Nivea For Men Invisible Power 6ck Spray,Nivea For Men Invisible Power 6ck Spray,FBALYB Amazon,23,23,0,2,0,0
,Nivea Men Cool Kick Roll-on 3pk,Nivea Men Cool Kick Roll-on 3pk,FBALYB Amazon,21,20,1,3,1,0
,Nivea Men Cool Kick Roll-on 3pk,Nivea Men Cool Kick Roll-on 3pk,WFS,-22,-22,0,0,0,0
,Nivea Men Deodorant Roll-on 3pk,Nivea Men Deodorant Roll-on 3pk,FBALYB Amazon,10,7,3,0,3,0
,Nivea Men Dry Impact Spray,Nivea Men Dry Impact Spray,Default CT,1620,1620,0,0,0,0
,Nivea Men Dry Impact Spray,Nivea Men Dry Impact Spray,Default Oxford,162,162,0,0,0,0
,Nivea Men Dry Impact Spray,Nivea Men Dry Impact Spray,Default Ridgefield,2646,2646,0,0,0,0
,Nivea Men Invisible Black & White Antiperspirant Spray - 150ml,Nivea Men Invisible Black & White Antiperspirant Spray - 150ml,Default Ridgefield,1236,1236,0,0,0,0
,Nivea Mens Cool Kick 6pk Spray,Nivea Mens Cool Kick 6pk Spray,FBALYB Amazon,9,0,9,0,9,0
,Nivea Mens Cool Kick 6pk Spray,Nivea Mens Cool Kick 6pk Spray,WFS,-7,-8,1,0,1,0
,Nivea Q10 Day,Nivea Q10 Day,FBALYB Amazon,-3,-3,0,1,0,0
,Nivea Q10 Day,Nivea Q10 Day,WFS,-49,-49,0,0,0,0
,NIVEA Q10 Day Care Cream 2pk,NIVEA Q10 Day Care Cream 2pk,FBALYB Amazon,1,1,0,0,0,0
,Nivea Q10 Night,Nivea Q10 Night ,FBALYB Amazon,-33,-39,6,16,6,0
,Nivea Q10 Night 3pack,Nivea Q10 Night 3pack,FBALYB Amazon,-25,-25,0,0,0,0
,Nivea Roll on Dry Comfort 2pk,Nivea Roll on Dry Comfort 2pk,FBALYB Amazon,1,-5,6,3,6,0
,Nivea Roll on Dry Comfort 3pk,Nivea Roll on Dry Comfort 3pk,FBALYB Amazon,-1,-5,4,0,4,0
,Nivea Roll On Men Black and White 50ml,Nivea Roll On Men Black and White 50ml,Default Ridgefield,183,183,0,0,0,0
,Nivea Roll On Mens Cool Kick,Nivea Roll On Mens Cool Kick,Avrami - Ebay,1065,1065,0,0,0,0
,Nivea Roll On Mens Dry Impact T000128,Nivea Roll On Mens Dry Impact T000128,Default Ridgefield,873,873,0,0,0,0
,Nivea Roll On Mens Dry Impact T000128 3PK,Nivea Roll On Mens Dry Impact T000128 3PK,FBALYB Amazon,-2,-2,0,10,0,0
,Nivea Roll On Mens Fresh Active 3PK,Nivea Roll On Mens Fresh Active 3PK,FBALYB Amazon,-5,-5,0,0,0,0
,Nivea Roll On Mens Fresh Active 3PK,Nivea Roll On Mens Fresh Active 3PK,WFS,-3,-3,0,0,0,0
,Nivea Roll On Men Silver Protect 50ml,Nivea Roll On Men Silver Protect 50ml,Default Ridgefield,360,360,0,0,0,0
,Nivea Roll On Mens Invisible B&W 3PK,Nivea Roll On Mens Invisible B&W 3PK,FBALYB Amazon,161,148,13,13,13,0
,Nivea Roll On Mens Invisible B&W T000130,Nivea Roll On Mens Invisible B&W T000130,Default,0,-600,600,0,0,0
,Nivea Roll On Women Fresh Energy 6PK,Nivea Roll On Women Fresh Energy 6PK,FBALYB Amazon,-2,-2,0,0,0,0
,Nivea Roll On Women Invisible Black & White Clear 3 PK,Nivea Roll On Women Invisible Black & White Clear 3 PK,FBALYB Amazon,-42,-42,0,49,0,0
,Nivea Roll On Women Invisible Black & White Pure 50ml,Nivea Roll On Women Invisible Black & White Pure 50ml,Default,0,0,0,0,0,2400
,Nivea Roll On Women Pearl & Beauty T000131,Nivea Roll On Women Pearl & Beauty T000131,Default Ridgefield,48,48,0,0,0,0
,Nivea Roll On Women Pearl & Beauty T000131 3PK,Nivea Roll On Women Pearl & Beauty T000131 3PK,FBALYB Amazon,14,5,9,12,9,0
,Nivea Roll On Women Protect & Care,Nivea Roll On Women Protect & Care,Avrami - Ebay,180,180,0,0,0,0
,Nivea Roll On Women Protect & Care,Nivea Roll On Women Protect & Care,Default Ridgefield,90,90,0,0,0,0
,Nivea Roll On Women Protect&Care 4pk,Nivea Roll On Women Protect&Care 4pk,FBALYB Amazon,-1,-2,1,0,1,0
,Nivea Roll On Womens Fresh Natural 6PK,Nivea Roll On Womens Fresh Natural 6PK,FBALYB Amazon,2,2,0,0,0,0
,Nivea Roll On Womens Fresh Natural T000125,Nivea Roll On Womens Fresh Natural T000125,Avrami - Ebay,990,990,0,0,0,0
,Nivea Roll On Womens Fresh Natural T000125,Nivea Roll On Womens Fresh Natural T000125,Default Ridgefield,30,30,0,0,0,0
,Nivea Women Energy Fresh 6pk,Nivea Women Energy Fresh 6pk,FBALYB Amazon,0,-2,2,0,2,0
,Nivea Women Fresh Natural 6pk,Nivea Women Fresh Natural 6pk,FBALYB Amazon,1,0,1,0,1,0
,Nivea Women Invisible Black&White 3pk,Nivea Women Invisible Black&White 3pk,FBALYB Amazon,-3,-3,0,1,0,0
,Nivea Womens Deo Invisible Black 150ml,Nivea Womens Deo Invisible Black 150ml,Default,0,-1644,1644,0,0,0
,Nivea Women's Invisible Black/White 6pk,Nivea Women's Invisible Black/White 6pk,FBALYB Amazon,499,499,0,0,0,0
,Nivea Women's Invisible Black/White 6pk,Nivea Women's Invisible Black/White 6pk,WFS,-60,-62,2,0,2,0
,NM Flaxseed 1400mg 2PACK,NM Flaxseed 1400mg 2PACK,FBALYB Amazon,-90,-90,0,72,0,0
,Non Gauze Disk Milk Filter,Non Gauze Disk Milk Filter,Default Ridgefield,19,19,0,0,0,0
,Non Gauze Disk Milk Filter,Non Gauze Disk Milk Filter,FBALYB Amazon,33,33,0,0,0,0
,Nong Shim Hot Spicy Noodle Soup Bowl,Nong Shim Hot Spicy Noodle Soup Bowl,FBALYB Amazon,2,2,0,0,0,0
,NONNI 25/1.33Z CIOCCOLATI BIS,NONNI 25/1.33Z CIOCCOLATI BIS,FBALYB Amazon,252,252,0,0,0,0
,NONNI'S 37 OZ MINI BISCOTTI,NONNI'S 37 OZ MINI BISCOTTI,Default,0,-1,1,0,0,0
,NONNI'S 37 OZ MINI BISCOTTI,NONNI'S 37 OZ MINI BISCOTTI,FBALYB Amazon,31,31,0,1,0,0
,Nonni's Almond D.C. Biscotti,"Nonni's Almond Dark Chocolate Biscotti ‑ 25 count, 2 lb jar",Default,0,0,0,0,0,500
,Nonni's Almond D.C. Biscotti,"Nonni's Almond Dark Chocolate Biscotti ‑ 25 count, 2 lb jar",FBALYB Amazon,-31,-32,1,27,1,0
,Nonnis Cranberry Almond 18ct,Nonnis THINaddictives Cranberry Almond 18ct,FBALYB Amazon,3,3,0,0,0,0
,"Nootie Japanese Cherry Blossom Spritz,8 oz","Nootie Japanese Cherry Blossom Spritz,8 oz",Default,0,0,0,0,0,40
,"NORTH FORK FLDR, DP, AXIS, G10 B15031-1","NORTH FORK FLDR, DP, AXIS, G10 B15031-1",FBALYB Amazon,5,5,0,0,0,0
,Nostalgia SCM502,Nostalgia SCM502 Snow Cone Maker,FBALYB Amazon,-1,-1,0,0,0,0
,Now Fresh Grain Free Small Breed Puppy Recipe - 6lb,Now Fresh Grain Free Small Breed Puppy Recipe - 6lb,FBALYB Amazon,2,2,0,0,0,0
,Nubz + Buddy Sample,Nubz + Buddy Sample,FBALYB Amazon,-9,-9,0,1,0,0
,Nutella 1KG 2PK,Nutella 1KG 2PK,FBALYB Amazon,76,76,0,0,0,0
,"Nutella Go Hazelnut, 12 pk","Nutella Go Hazelnut Spread and Breadsticks, 12 packs",Default,-2,-2,0,0,0,0
,"Nutella Go Hazelnut, 12 pk","Nutella Go Hazelnut Spread and Breadsticks, 12 packs",FBALYB Amazon,1,1,0,0,0,0
,Nutella Hazelnut 2/33.5oz,Nutella Hazelnut Spread 2/33.5  oz (4.187 LB),FBALYB Amazon,36,36,0,0,0,0
,Nutella Hazlenut Spread Value 2pk,Nutella Hazlenut Spread Value 2pk,FBALYB Amazon,-29,-29,0,44,0,0
,Nutella Spread 1KG,Nutella Spread 1KG,Default,0,0,0,0,0,4
,Nutella Spread 1KG,Nutella Spread 1KG,FBALYB Amazon,5,5,0,0,0,0
,"Nu-Therapy Power Beets Juice Powder, 11.6 oz.","Nu-Therapy Power Beets Juice Powder, 11.6 oz.",FBALYB Amazon,-1,-1,0,0,0,0
,Nutri-Grain Variety Pack 48 Ct,"Nutri-Grain Soft Baked Cereal Bars, Variety Pack, 1.3 oz, 48 ct",FBALYB Amazon,51,51,0,2,0,0
,Nutri Ninja BL641,Nutri Ninja Nutri Bowl DUO With Auto‑iQ BL641 Blender,Default,0,0,0,0,0,5
,Nutri Ninja BL641,Nutri Ninja Nutri Bowl DUO With Auto‑iQ BL641 Blender,FBALYB Amazon,-5,-5,0,0,0,0
,Nutri Ninja Blender 1974410,Nutri Ninja Single Blender 1974410,Default,0,-3,3,0,0,0
,Nutri Ninja Blender 1974410,Nutri Ninja Single Blender 1974410,FBALYB Amazon,-1,-1,0,0,0,0
,Nutrisource Dog GF Chicken Rice 13oz 12pk,Nutrisource Dog GF Chicken Rice 13oz 12pk,Default,0,0,0,0,0,1
,Nutrisource Dog GF Chicken Rice 13oz 12pk,Nutrisource Dog GF Chicken Rice 13oz 12pk,FBALYB Amazon,-2,-2,0,0,0,0
,Nutrisource GF Heartland 13oz 12pk,Nutrisource GF Heartland 13oz 12pk,Default,0,0,0,0,0,1
,Nutrisource GF Heartland 13oz 12pk,Nutrisource GF Heartland 13oz 12pk,FBALYB Amazon,2,2,0,0,0,0
,Nutri‑Vet 3 oz Hairball Feline Paw Gel 2pk,Nutri‑Vet 3 oz Hairball Feline Paw Gel 2pk,FBALYB Amazon,3,3,0,0,0,0
,Nutri-Vet Aspirin Small Dog 100ct,Nutri-Vet Aspirin Small Dog 100ct,FBALYB Amazon,5,5,0,0,0,0
,Nutri-Vet Breath/Tartar Chicken 19.5oz,Nutri-Vet Breath/Tartar Chicken 19.5oz,Default,0,0,0,0,0,6
,Nutri-Vet Eye Rinse Dogs 4oz,Nutri-Vet Eye Rinse Dogs 4oz,FBALYB Amazon,0,-1,1,0,1,0
,Nutro Chewy 3 Variety 10oz 3pk,Nutro Chewy 3 Variety 10oz 3pk,FBALYB Amazon,23,23,0,4,0,0
,Nutro Chicken and Sweet Potato 15 lb,Nutro Chicken and Sweet Potato 15 lb,FBALYB Amazon,-2,-2,0,0,0,0
,Nutro Crunchy 2 Variety 10oz 2pk,Nutro Crunchy 2 Variety 10oz 2pk,FBALYB Amazon,124,124,0,0,0,0
,Nutro Crunchy Dog Chicken & Carrot 10oz,Nutro Crunchy Dog Chicken & Carrot 10oz,Default,0,0,0,0,0,288
,Nutro Crunchy Dog Treats Banana 10oz,Nutro Crunchy Dog Treats Banana 10oz,FBALYB Amazon,273,273,0,0,0,0
,Nutro Crunchy Dog Treats Berries 10oz,Nutro Crunchy Dog Treats Berries 10oz,Default,0,0,0,0,0,2
,Nutro Crunchy Dog Treats Berries 10oz 2pk,Nutro Crunchy Dog Treats Berries 10oz 2pk,FBALYB Amazon,1,1,0,0,0,0
,Nutro Crunchy Dog Treats Berries 16oz,Nutro Crunchy Dog Treats Berries 16oz,Default,0,0,0,0,0,2
,Nutro Crunchy Dog Treats Berries 16oz,Nutro Crunchy Dog Treats Berries 16oz,FBALYB Amazon,43,43,0,0,0,0
,Nutro Crunchy Dog Treats P.Butter 10oz,Nutro Crunchy Dog Treats P.Butter 10oz,Default,0,0,0,0,0,10
,Nutro Crunchy Dog Treats P.Butter 10oz 2pk,Nutro Crunchy Dog Treats P.Butter 10oz 2pk,FBALYB Amazon,-1,-1,0,0,0,0
,Nutro Crunchy Dog Treats P.Butter 16oz,Nutro Crunchy Dog Treats P.Butter 16oz,Default,0,0,0,0,0,2
,Nutro Max Cat Food Variety 3oz 12pk,Nutro Max Cat Food Variety 3oz 12pk,FBALYB Amazon,4,4,0,0,0,0
,NUTRO MAX CAT Indoor Adult 3 LBs,NUTRO MAX CAT Indoor Adult 3 LBs,FBALYB Amazon,42,42,0,1,0,0
,Nutro Max Chicken Supreme 3oz 24pk,Nutro Max Chicken Supreme 3oz 24pk,FBALYB Amazon,-2,-2,0,2,0,0
,Nutro Max Kitten Variety 3oz 12pk,Nutro Max Kitten Variety 3oz 12pk,FBALYB Amazon,1,1,0,0,0,0
,Nutro Max Lamb & Turkey 3oz 24pk,Nutro Max Lamb & Turkey 3oz 24pk,FBALYB Amazon,-4,-4,0,4,0,0
,Nutro Max Roasted Chicken Kitten 6lb,Nutro Max Roasted Chicken Kitten 6lb,FBALYB Amazon,16,16,0,0,0,0
,Nutro Max Savory Venison 3oz 24pk,Nutro Max Savory Venison 3oz 24pk,FBALYB Amazon,3,3,0,0,0,0
,Nutro Natural Choice Dog Tartar Control 32oz,Nutro Natural Choice Dog Tartar Control 32oz,Default,0,0,0,0,0,240
,Nutro Protein Boost Turkey Pate 3.5oz,Nutro Protein Boost Turkey Pate 3.5oz,Default,0,0,0,0,0,480
,"Nutro Small Breed Chicken, BRice, SPotato 5lb","Nutro Small Breed Chicken, BRice, SPotato 5lb",FBALYB Amazon,75,75,0,0,0,0
,Nutro Soft Loaf 2 Variety 8pk,Nutro Soft Loaf 2 Variety 8pk,FBALYB Amazon,86,86,0,12,0,0
,Nutro Soft Loaf Chicken 2.65oz,Nutro Soft Loaf Chicken 2.65oz,Default,0,0,0,0,0,960
,Nutro Soft Loaf Chicken 2 Variety 8pk,Nutro Soft Loaf Chicken 2 Variety 8pk,FBALYB Amazon,2,2,0,0,0,0
,Nutro Soft Loaf Chicken & Liver 2.65oz,Nutro Soft Loaf Chicken & Liver 2.65oz,Default,0,0,0,0,0,48
,Nutro Soft Loaf Chicken & Shrimp 2.65oz,Nutro Soft Loaf Chicken & Shrimp 2.65oz,Default,0,0,0,0,0,480
,Nutro Soft Loaf Salmon & Tuna 2.65oz,Nutro Soft Loaf Salmon & Tuna 2.65oz,Default,0,0,0,0,0,960
,Nutro Soft Loaf Turkey 2.65oz,Nutro Soft Loaf Turkey 2.65oz,Default,0,0,0,0,0,480
,Nutro Soft Loaf Turkey & Liver 2.65oz,Nutro Soft Loaf Turkey & Liver 2.65oz,Default,0,0,0,0,0,24
,Nutro Ultra Antioxidant Chicken 3.5oz,Nutro Ultra Antioxidant Chicken 3.5oz,Default,0,0,0,0,0,480
,Nutro Ultra Biscuit 16oz Variety 2pk,Nutro Ultra Biscuit 16oz Variety 2pk,FBALYB Amazon,1,1,0,0,0,0
,Nutro Ultra Biscuit Small Breed Superfood 16oz,Nutro Ultra Biscuit Small Breed Superfood 16oz,FBALYB Amazon,-1,-1,0,0,0,0
,Nutro Ultra Large Breed 12.5 oz 12pk,Nutro Ultra Large Breed 12.5 oz 12pk,FBALYB Amazon,7,7,0,0,0,0
,Nutro Ultra Large Breed Can 12.5oz,Nutro Ultra Large Breed Can 12.5oz,Default,0,0,0,0,0,432
,Nutro Ultra Puppy Can 12.5oz,Nutro Ultra Puppy Can 12.5oz,Default,0,0,0,0,0,432
,Nutro Ultra Shiny Coat Salmon 3.5oz,Nutro Ultra Shiny Coat Salmon 3.5oz,Default,0,0,0,0,0,480
,Nutro Ultra Small Puppy 12.5 oz 12 pk,Nutro Ultra Small Puppy 12.5 oz 12 pk,FBALYB Amazon,1,1,0,0,0,0
,NUTRO ULTRA Weight Management Dog Food 30 lbs,NUTRO ULTRA Weight Management Dog Food 30 lbs,FBALYB Amazon,1,1,0,0,0,0
,"Nutro Wholesome Essentials Adult Pasture-Fed Lamb & Rice Recipe Dry Dog Food, 30 Lb"," Nutro Wholesome Essentials Adult Pasture-Fed Lamb & Rice Recipe Dry Dog Food, 30 Lb",FBALYB Amazon,-27,-27,0,0,0,0
,"NUTRO WHOLESOME ESSENTIALS Chicken, Brown Rice & Sweet Potato Recipe 30 lbs","NUTRO WHOLESOME ESSENTIALS Chicken, Brown Rice & Sweet Potato Recipe 30 lbs",FBALYB Amazon,1,1,0,0,0,0
,"Nutro Wholesome Essentials Healthy Weight Adult Pasture Fed Lamb & Rice Recipe Dry Dog Food, 30-lb bag","Nutro Wholesome Essentials Healthy Weight Adult Pasture Fed Lamb & Rice Recipe Dry Dog Food, 30-lb bag",Default,5,5,0,0,0,0
,"Nutro Wholesome Essentials Healthy Weight Adult Pasture Fed Lamb & Rice Recipe Dry Dog Food, 30-lb bag","Nutro Wholesome Essentials Healthy Weight Adult Pasture Fed Lamb & Rice Recipe Dry Dog Food, 30-lb bag",FBALYB Amazon,2,2,0,0,0,0
,NuWave 10-qt. Air Fryer,NuWave 10-qt. Digital Air Fryer,Default,0,0,0,0,0,3
,NuWave 10-qt. Air Fryer,NuWave 10-qt. Digital Air Fryer,FBALYB Amazon,-5,-5,0,0,0,0
,Nuwave 30532,"NuWave PIC Flex Precision Induction Cooktop with Fry Pan - Black - 9""",Default,0,0,0,0,0,1
,Nuwave 30532,"NuWave PIC Flex Precision Induction Cooktop with Fry Pan - Black - 9""",FBALYB Amazon,14,14,0,0,0,0
,Nuwave 36011 - 3 Quart,Nuwave 36011 Brio Air Fryer (2nd Gen) 3 Quart,Default,0,0,0,0,0,17
,Nuwave 36011 - 3 Quart,Nuwave 36011 Brio Air Fryer (2nd Gen) 3 Quart,Default Ridgefield,1,1,0,0,0,0
,Nuwave 36011 - 3 Quart,Nuwave 36011 Brio Air Fryer (2nd Gen) 3 Quart,FBALYB Amazon,-10,-10,0,9,0,0
,"Nuwave 6 qt air fryer, black","Nuwave 6 qt air fryer, black",Default,0,-40,40,0,0,14
,"Nuwave 6 qt air fryer, black","Nuwave 6 qt air fryer, black",FBALYB Amazon,-79,-79,0,30,0,0
,Nuwave 6 qt. Brio Air Fryer (Red),Nuwave 6 qt. Brio Air Fryer (Red),Default,0,0,0,0,0,1
,Nuwave Brio Air fryer Accessory Pack,Nuwave Brio Air fryer Accessory Pack,Default,0,0,0,0,0,25
,Nuwave Brio Air fryer Accessory Pack,Nuwave Brio Air fryer Accessory Pack,FBALYB Amazon,33,33,0,0,0,0
,Nuwave Brio Air fryer bundle,Brio Bundle,FBALYB Amazon,-1,-1,0,0,0,0
,NV801 Red,NV801 Red,Default,0,0,0,0,0,7
,Nylabone Advanced Oral Care Cat Dental Kit,Nylabone Advanced Oral Care Cat Dental Kit,FBALYB Amazon,3,3,0,0,0,0
,Nylabone Advanced Oral Care Freshener 16oz,Nylabone Advanced Oral Care Freshener 16oz,Default,0,0,0,0,0,1
,Nylabone Advanced Oral Care Freshener 16oz,Nylabone Advanced Oral Care Freshener 16oz,FBALYB Amazon,-20,-20,0,30,0,0
,Nylabone Advanced Oral Care Tartar 16oz,Nylabone Advanced Oral Care Tartar 16oz,Default,0,0,0,0,0,5
,Nylabone Advanced Oral Care Tartar 16oz,Nylabone Advanced Oral Care Tartar 16oz,FBALYB Amazon,-1,-1,0,2,0,0
,Nylabone DuraChew Dinosaur Large,Nylabone DuraChew Dinosaur Large,FBALYB Amazon,1,1,0,0,0,0
,Nylabone Flexi Chew Bone Chicken Regular,Nylabone Flexi Chew Bone Chicken Regular,Default,0,0,0,0,0,2
,Nylabone Flexi Chew Bone Chicken Regular,Nylabone Flexi Chew Bone Chicken Regular,FBALYB Amazon,1,1,0,0,0,0
,Nylabone Lamb/Apple DHA Puppy Chews 4ct,Nylabone Lamb And Apple DHA Puppy Chews 4ct,FBALYB Amazon,1,1,0,0,0,0
,Nylabone Natural Nubz,Nylabone Natural Nubz,Default,0,0,0,0,0,231
,Nylabone Natural Nubz,Nylabone Natural Nubz,Default Ridgefield,14053,14053,0,0,0,12480
,Nylabone Natural Nubz,Nylabone Natural Nubz,FBALYB Amazon,1666,1657,9,845,9,0
,Nylabone Natural Nubz,Nylabone Natural Nubz,WFS,256,256,0,0,0,0
,NYLABONE NUBZ 2 PACK,NYLABONE NUBZ 2 PACK,Default,0,-262,262,0,0,0
,NYLABONE NUBZ 2 PACK,NYLABONE NUBZ 2 PACK,FBALYB Amazon,657,413,244,2439,244,0
,Nylabone Nubz 3 Pack,Nylabone Nubz 3 Pack,Default,0,-1,1,0,0,0
,Nylabone Nubz 3 Pack,Nylabone Nubz 3 Pack,FBALYB Amazon,-26,-41,15,326,15,0
,Nylabone Puppy Bone Chicken Wolf,Nylabone Puppy Bone Chicken Wolf,FBALYB Amazon,1,0,1,0,1,0
,Nylabone Puppy Chew Twin Pack Petite 2pk,Nylabone Puppy Chew Twin Pack Petite 2pk,FBALYB Amazon,1,0,1,0,1,0
,Nylabone Puppy Teething Pacifier X-Small,Nylabone Puppy Teething Pacifier X-Small,FBALYB Amazon,-2,-2,0,0,0,0
,Nylabone Puppy Toy Bundle,"Nylabone Puppy Toy Bundle with Chew Toy Starter Kit, Puppy Teething Pacifier, Dino Puppy Chew Toy, and Puppy Teething Rings",Default,0,0,0,0,0,1
,Nylabone Romp n Chomp Treat Refill 12ct,Nylabone Romp n Chomp Treat Refill 12ct,Default,0,0,0,0,0,30
,O4-P60Q-Z0JE,"Fuji 35mm QuickSnap Single Use Camera, 400 ASA (FUJ7033661) Category: Single ...",FBALYB Amazon,-1,-1,0,0,0,0
,Ocean Mist Neutrogena Rainbath 2pk,Ocean Mist Neutrogena Rainbath 2pk,FBALYB Amazon,23,23,0,0,0,0
,Ocean Nutrition Formula One Marine Pellets Small 200g, Ocean Nutrition Formula One Marine Pellets Small 200g,Default,0,0,0,0,0,50
,Ocean Nutrition Formula One Marine Pellets Small 200g, Ocean Nutrition Formula One Marine Pellets Small 200g,FBALYB Amazon,-50,-50,0,0,0,0
,Ocean Nutrition Green Algae Seaweed 10 Sheets,Ocean Nutrition Green Algae Seaweed 10 Sheets,FBALYB Amazon,1,1,0,0,0,0
,Ocean Spray Craisins 64oz,"Ocean Spray Craisins Cranberry, 64 Ounce",FBALYB Amazon,62,62,0,0,0,0
,Ocean Two Marine Pellets Medium 200g,Ocean Nutrition Formula Two Marine Pellets Medium 200g,Default,0,0,0,0,0,20
,Ocean Two Marine Pellets Medium 200g,Ocean Nutrition Formula Two Marine Pellets Medium 200g,FBALYB Amazon,-18,-18,0,0,0,0
,Octane Dart 50 oz Black/Atomic Blue,Octane Dart 50 oz Black/Atomic Blue,Default,0,0,0,0,0,360
,Octane Dart 50 oz Black/Atomic Blue,Octane Dart 50 oz Black/Atomic Blue,Default Ridgefield,211,211,0,0,0,0
,Octane Dart 50 oz Black/Atomic Blue,Octane Dart 50 oz Black/Atomic Blue,FBALYB Amazon,141,141,0,1,0,0
,Octane SPOT 325 HEADLAMP,Octane SPOT 325 HEADLAMP,FBALYB Amazon,-7,-7,0,0,0,0
,Octane XCT 70 oz Black/Atomic Blue,Octane XCT 70 oz Black/Atomic Blue,Default,0,0,0,0,0,56
,Octane XCT 70 oz Black/Atomic Blue,Octane XCT 70 oz Black/Atomic Blue,Default Ridgefield,2,2,0,0,0,0
,Octane XCT 70 oz Black/Atomic Blue,Octane XCT 70 oz Black/Atomic Blue,FBALYB Amazon,36,34,2,0,2,0
,Ocuvite Adult 50+ 150ct,Ocuvite Adult 50+ 150ct,Default,0,0,0,0,0,4
,Ocuvite Adult 50+ 150ct,Ocuvite Adult 50+ 150ct,FBALYB Amazon,-6,-6,0,0,0,0
,OGX COCONUG CURLS SHAMPOO 385ML,OGX COCONUG CURLS SHAMPOO 385ML,Avrami - Ebay,18,18,0,0,0,0
,OGX COCONUG CURLS SHAMPOO 385ML,OGX COCONUG CURLS SHAMPOO 385ML,Default Ridgefield,822,822,0,0,0,0
,OGX CONDITIONER 385ML BONDING PLEX,OGX CONDITIONER 385ML BONDING PLEX,Default Ridgefield,372,372,0,0,0,0
,OGX CONDITIONER 385ML SHEA SOFT & SMOOTH,OGX CONDITIONER 385ML SHEA SOFT & SMOOTH,Default Ridgefield,144,144,0,0,0,0
,OGX SHAMPOO 385ML BONDING PLEX,OGX SHAMPOO 385ML BONDING PLEX,Avrami - Ebay,13,13,0,0,0,0
,OGX SHAMPOO 385ML BONDING PLEX,OGX SHAMPOO 385ML BONDING PLEX,Default Ridgefield,131,131,0,0,0,0
,OGX SHAMPOO 385ML SHEA SOFT & SMOOTH,OGX SHAMPOO 385ML SHEA SOFT & SMOOTH,Avrami - Ebay,36,36,0,0,0,0
,OGX SHAMPOO 385ML SHEA SOFT & SMOOTH,OGX SHAMPOO 385ML SHEA SOFT & SMOOTH,Default Ridgefield,108,108,0,0,0,0
,Oil Paint Alizarin Crimson 200ml,Bob Ross Oil Paint Alizarin Crimson 200ml,Default,0,0,0,0,0,41
,Oil Paint Alizarin Crimson 200ml,Bob Ross Oil Paint Alizarin Crimson 200ml,Default Ridgefield,221,221,0,0,0,0
,Oil Paint Dark Sienna 200ml,Bob Ross Oil Paint Dark Sienna 200ml,Default Ridgefield,251,251,0,0,0,0
,Oil Paint Dark Sienna 200ml,Bob Ross Oil Paint Dark Sienna 200ml,FBALYB Amazon,15,15,0,0,0,0
,Oil Paint Prussian Blue 200ml,Bob Ross Oil Paint Prussian Blue 200ml,Default Ridgefield,221,221,0,0,0,0
,Oil Paint Prussian Blue 200ml,Bob Ross Oil Paint Prussian Blue 200ml,FBALYB Amazon,26,26,0,0,0,0
,Oil Paint Van Dyke 200ml,Bob Ross Oil Paint VanDyke 200ml,Default Ridgefield,221,221,0,0,0,0
,Oil Paint Van Dyke 200ml,Bob Ross Oil Paint VanDyke 200ml,FBALYB Amazon,2,2,0,6,0,0
,OLAY Regenerating Serum 1.7 oz 2pk,OLAY Regenerating Serum 1.7 oz 2pk,FBALYB Amazon,-1,-1,0,0,0,0
,Olay Regenerist Daily Serum 1.7oz,Olay Regenerist Daily Serum 1.7oz,FBALYB Amazon,-2,-2,0,0,0,0
,Olay Regenerist Serum 2-1.7 fl oz & Travel Size,Olay Regenerist Serum 2-1.7 fl oz & Travel Size,FBALYB Amazon,-29,-29,0,30,0,0
,Olay Ultra Moisture Beauty Bars 16 ct (4 oz each),Olay Ultra Moisture Beauty Bars 16 ct (4 oz each),Default,0,0,0,0,0,80
,Olay Ultra Moisture Beauty Bars 16 ct (4 oz each),Olay Ultra Moisture Beauty Bars 16 ct (4 oz each),FBALYB Amazon,-296,-301,5,319,5,0
,Olay Ultra Moisture Bodywash 23.6 fl oz 2pk,Olay Ultra Moisture Bodywash 23.6 fl oz 2pk,FBALYB Amazon,-169,-170,1,235,1,0
,"Olay Ultra Moisture Body Wash 23.6 fl. oz., 3-pack","Olay Ultra Moisture Body Wash 23.6 fl. oz., 3-pack ",Default,0,0,0,0,0,34
,Olay Ultra Moisture Bodywash 23.6 fl oz 3pk,Olay Ultra Moisture Bodywash 23.6 fl oz 3pk,FBALYB Amazon,5,5,0,3,0,0
,Olay Ultra Moisture Bodywash 2.6 fl oz,Olay Ultra Moisture Bodywash 26 fl oz,Default,0,-7360,7360,0,0,0
,Olay Ultra Moisture Bodywash 2.6 fl oz,Olay Ultra Moisture Bodywash 26 fl oz,Default Ridgefield,540,540,0,0,0,0
,Old spice 40oz body wash with Shea butter,Old spice 40oz body wash with Shea butter,FBALYB Amazon,-3,-3,0,0,0,0
,OLD SPICE BDY WSH PURE SPRT,OLD SPICE BDY WSH PURE SPRT   ,FBALYB Amazon,2,2,0,0,0,0
,"Old Spice Champion Body Wash, 16oz 6pk","Old Spice Champion Body Wash, 16oz 6pk",FBALYB Amazon,2,2,0,1,0,0
,Old Spice Deo 5 PK,Old Spice Deo 5 PK,Avrami - Ebay,12,12,0,0,0,0
,Old Spice Deo 5 PK,Old Spice Deo 5 PK,FBALYB Amazon,-70,-70,0,120,0,0
,Old Spice Deoderant 1piece,Old Spice Deoderant 1piece,Avrami - Ebay,108,108,0,0,0,0
,Old Spice Deoderant 1piece,Old Spice Deoderant 1piece,Default,0,-8376,8376,0,0,0
,Old Spice Deoderant 1piece,Old Spice Deoderant 1piece,Default Ridgefield,68,68,0,0,0,0
,Old Spice Deodorant 4PK,Old Spice Deodorant 4PK,FBALYB Amazon,-2,-5,3,1,3,0
,Old Spice Deodorant 6PK,Old Spice Deodorant 6PK,FBALYB Amazon,6,5,1,0,1,0
,Old Spice High Endurance Deodorant 10pk,Old Spice High Endurance Deodorant 10pk,FBALYB Amazon,-9,-10,1,3,1,0
,Old Spice High Endurance Deodorant 5pk,"Old Spice High Endurance Deodorant, Pure Sport, 85g 5 Piece",Default,0,-480,480,0,0,0
,Old Spice High Endurance Deodorant 5pk,"Old Spice High Endurance Deodorant, Pure Sport, 85g 5 Piece",Default Ridgefield,78,78,0,0,0,0
,Old Spice High Endurance Deodorant 5pk,"Old Spice High Endurance Deodorant, Pure Sport, 85g 5 Piece",FBALYB Amazon,57,57,0,18,0,0
,Old Spice Original Scent 3oz 10pk,Old Spice Original Scent 3oz 10pk,FBALYB Amazon,-1,-1,0,0,0,0
,Old Spice Red Zone Pure Sport Scent Foamer Body Wash for MEN 293 g,Old Spice Red Zone Pure Sport Scent Foamer Body Wash for MEN 293 g,Default Ridgefield,1280,1280,0,0,0,0
,Old Spice Red Zone Pure Sport Scent Foamer Body Wash for MEN 293 g,Old Spice Red Zone Pure Sport Scent Foamer Body Wash for MEN 293 g,FBALYB Amazon,115,115,0,0,0,0
,Old Spice Red Zone Pure Sport Scent Foamer Body Wash for MEN 293 g 4pk,Old Spice Red Zone Pure Sport Scent Foamer Body Wash for MEN 293 g 4pk,FBALYB Amazon,206,206,0,0,0,0
,Old Spice Red Zone Swagger 2ct/30oz,Old Spice Red Zone Swagger Body Wash 2ct/30oz,FBALYB Amazon,-943,-962,19,966,19,0
,"Old Spice Red Zone Swagger Scent Foamer Body Wash for MEN, 293 g","Old Spice Red Zone Swagger Scent Foamer Body Wash for MEN, 293 g",Default Ridgefield,1278,1278,0,0,0,0
,"Old Spice Red Zone Swagger Scent Foamer Body Wash for MEN, 293 g","Old Spice Red Zone Swagger Scent Foamer Body Wash for MEN, 293 g",FBALYB Amazon,114,114,0,0,0,0
,"Old Spice Red Zone Swagger Scent Foamer Body Wash for MEN, 293 g 4PK","Old Spice Red Zone Swagger Scent Foamer Body Wash for MEN, 293 g 4PK",FBALYB Amazon,196,195,1,0,1,0
,"Old Spice Swagger Body Wash, 2 ct./32 oz.","Old Spice Swagger Body Wash, 2 ct./32 oz.",FBALYB Amazon,18,18,0,0,0,0
,Olive Garden Dressing,Olive Garden Dressing,Default,0,0,0,0,0,113
,Olivia Garden - Brush Cleaner BC-1,Olivia Garden - Brush Cleaner BC-1,FBALYB Amazon,0,0,0,1,0,0
,"Olivia Garden CI-25 - C + I Thermal 1""","Olivia Garden CI-25 - C + I Thermal 1""",FBALYB Amazon,-2,-2,0,0,0,0
,"Olivia Garden CI-35 - C + I Thermal 1-3/8""","Olivia Garden CI-35 - C + I Thermal 1-3/8""",Default Ridgefield,36,36,0,0,0,0
,"Olivia Garden - C + I Mega 3 1/2"" CI-65","Olivia Garden - C + I Mega 3 1/2"" CI-65",FBALYB Amazon,-5,-5,0,1,0,0
,"Olivia Garden - C + I Mega 4 1/4"" CI-80","Olivia Garden - C + I Mega 4 1/4"" CI-80",FBALYB Amazon,-4,-4,0,0,0,0
,"Olivia Garden - C + I Thermal 1-3/4"" CI-45","Olivia Garden - C + I Thermal 1-3/4"" CI-45",Default,1,1,0,0,0,0
,"Olivia Garden - C + I Thermal 1-3/4"" CI-45","Olivia Garden - C + I Thermal 1-3/4"" CI-45",FBALYB Amazon,-2,-9,7,0,7,0
,"Olivia Garden - C + I Thermal 2-1/8"" CI-55","Olivia Garden - C + I Thermal 2-1/8"" CI-55",FBALYB Amazon,-1,-1,0,0,0,0
,Olivia Garden - C + I Turbo Vent Pro Shaper CITVPRO-SPR,Olivia Garden - C + I Turbo Vent Pro Shaper CITVPRO-SPR,Default Ridgefield,18,18,0,0,0,0
,Olivia Garden - C + I XL Pro Vent CIXL-PROVNT,Olivia Garden - C + I XL Pro Vent CIXL-PROVNT,Default Ridgefield,5,5,0,0,0,0
,"Olivia Garden - NanoThermic Ceramic + Ion 1 1/4"" NT-34","Olivia Garden - NanoThermic Ceramic + Ion 1 1/4"" NT-34",Default Ridgefield,64,64,0,0,0,0
,"Olivia Garden - NanoThermic Ceramic + Ion 1 3/4"" NT-44","Olivia Garden - NanoThermic Ceramic + Ion 1 3/4"" NT-44",Default Ridgefield,62,62,0,0,0,0
,"Olivia Garden - NanoThermic Ceramic + Ion 1 3/4"" NT-44","Olivia Garden - NanoThermic Ceramic + Ion 1 3/4"" NT-44",FBALYB Amazon,60,60,0,0,0,0
,"Olivia Garden - NanoThermic Ceramic + Ion 1"" NT-24","Olivia Garden - NanoThermic Ceramic + Ion 1"" NT-24 ",Default Ridgefield,12,12,0,0,0,0
,"Olivia Garden - NanoThermic Ceramic + Ion 2 1/8"" NT-54","Olivia Garden - NanoThermic Ceramic + Ion 2 1/8"" NT-54",Default Ridgefield,53,53,0,0,0,0
,"Olivia Garden - NanoThermic Ceramic + Ion 2 1/8"" NT-54","Olivia Garden - NanoThermic Ceramic + Ion 2 1/8"" NT-54",FBALYB Amazon,57,57,0,0,0,0
,"Olivia Garden - NanoThermic Ceramic + Ion 2 3/4"" NT-64","Olivia Garden - NanoThermic Ceramic + Ion 2 3/4"" NT-64",FBALYB Amazon,7,7,0,0,0,0
,"Olivia Garden - NanoThermic Ceramic + Ion Square Shaper 1 1/2"" NT-S40","Olivia Garden - NanoThermic Ceramic + Ion Square Shaper 1 1/2"" NT-S40",Default Ridgefield,24,24,0,0,0,0
,One a Day Mens 220ct,One a Day Mens 220ct,FBALYB Amazon,23,23,0,0,0,0
,One a Day Mens 220ct 2pk,One a Day Mens 220ct 2pk,FBALYB Amazon,-4,-4,0,0,0,0
,One a Day Womens 220ct,One a Day Womens 220ct,FBALYB Amazon,203,203,0,0,0,0
,Oofas Oah 1100 Black M10/W12,Oofas Oah 1100 Black M10/W12,Default,5,5,0,0,0,0
,Oofas Oah 1100 Black M10/W12,Oofas Oah 1100 Black M10/W12,FBALYB Amazon,-20,-20,0,0,0,0
,Oofas Oah 1100 Black M11/W13,Oofas Oah 1100 Black M11/W13,FBALYB Amazon,-10,-10,0,0,0,0
,Oofas Oah 1100 Black M4/W6,Oofas Oah 1100 Black M4/W6,Default Oxford,24,24,0,0,0,0
,Oofas Oah 1100 Black M4/W6,Oofas Oah 1100 Black M4/W6,FBALYB Amazon,-12,-12,0,0,0,0
,Oofas Oah 1100 Black M5/W7,Oofas Oah 1100 Black M5/W7,FBALYB Amazon,-14,-14,0,0,0,0
,Oofas Oah 1100 Black M6/W8,Oofas Oah 1100 Black M6/W8,FBALYB Amazon,-14,-14,0,1,0,0
,Oofas Oah 1100 Black M8/W10,Oofas Oah 1100 Black M8/W10,FBALYB Amazon,-6,-6,0,0,0,0
,Oofas Oah 1100 Black M9/W11,Oofas Oah 1100 Black M9/W11,FBALYB Amazon,-7,-7,0,0,0,0
,Oofas Oah 1101 Black Luxe M3/W5,Oofas Oah 1101 Black Luxe M3/W5,FBALYB Amazon,-4,-4,0,0,0,0
,Oofas Oah 1101 Black Luxe M4/W6,Oofas Oah 1101 Black Luxe M4/W6,FBALYB Amazon,-5,-5,0,0,0,0
,Oofas Oah 1101 Black Luxe M5/W7,Oofas Oah 1101 Black Luxe M5/W7,FBALYB Amazon,-6,-6,0,0,0,0
,Oofas Oah 1101 Black Luxe M6/W8,Oofas Oah 1101 Black Luxe M6/W8,FBALYB Amazon,-7,-7,0,0,0,0
,Oofas Oah 1101 Black Luxe M7/W9,Oofas Oah 1101 Black Luxe M7/W9,FBALYB Amazon,-3,-3,0,0,0,0
,Oofas Oah 1101 Black Luxe M8/W10,Oofas Oah 1101 Black Luxe M8/W10,FBALYB Amazon,-6,-6,0,0,0,0
,Oofas Oah Sport 1500 Black M10/W12,Oofas Oah Sport 1500 Black M10/W12,FBALYB Amazon,-3,-3,0,0,0,0
,Oofas Oah Sport 1500 Black M11/W13,Oofas Oah Sport 1500 Black M11/W13,FBALYB Amazon,-3,-3,0,0,0,0
,Oofas Oah Sport 1500 Black M12/W14,Oofas Oah Sport 1500 Black M12/W14,FBALYB Amazon,-1,-1,0,0,0,0
,Oofas Oah Sport 1500 Black M3/W5,Oofas Oah Sport 1500 Black M3/W5,FBALYB Amazon,-11,-11,0,0,0,0
,Oofas Oah Sport 1500 Black M4/W6,Oofas Oah Sport 1500 Black M4/W6,FBALYB Amazon,-8,-8,0,0,0,0
,Oofas Oah Sport 1500 Black M5/W7,Oofas Oah Sport 1500 Black M5/W7,FBALYB Amazon,-6,-6,0,0,0,0
,Oofas Oah Sport 1500 Black M7/W9,Oofas Oah Sport 1500 Black M7/W9,FBALYB Amazon,-1,-1,0,0,0,0
,Oofas Oah Sport 1500 Black M8/W10,Oofas Oah Sport 1500 Black M8/W10,FBALYB Amazon,-3,-3,0,0,0,0
,Oofas Oah Sport 1500 Black M9/W11,Oofas Oah Sport 1500 Black M9/W11,FBALYB Amazon,-5,-5,0,0,0,0
,Oofas Oclog 1200 Black/Black M10/W12,Oofas Oclog 1200 Black/Black M10/W12,FBALYB Amazon,-3,-3,0,0,0,0
,Oofas Oclog 1200 Black/Black M11/W13,Oofas Oclog 1200 Black/Black M11/W13,FBALYB Amazon,-8,-8,0,0,0,0
,Oofas Oclog 1200 Black/Black M7/W9,Oofas Oclog 1200 Black/Black M7/W9,FBALYB Amazon,-4,-4,0,0,0,0
,Oofas Oclog 1200 Black/Black M8/W10,Oofas Oclog 1200 Black/Black M8/W10,FBALYB Amazon,15,15,0,0,0,0
,Oofas Oclog 1200 Black/Black M9/W11,Oofas Oclog 1200 Black/Black M9/W11,FBALYB Amazon,-18,-18,0,0,0,0
,Oofas Olala 1400 Aurora M3/W5,Oofas Olala 1400 Aurora M3/W5,FBALYB Amazon,-2,-2,0,0,0,0
,Oofas Olala 1400 Aurora M4/W6,Oofas Olala 1400 Aurora M4/W6,FBALYB Amazon,-3,-3,0,0,0,0
,Oofas Olala 1400 Black/Bluejay M3/W5,Oofas Olala 1400 Black/Bluejay M3/W5,FBALYB Amazon,-4,-4,0,0,0,0
,Oofas Olala 1400 Black/Bluejay M4/W6,Oofas Olala 1400 Black/Bluejay M4/W6,FBALYB Amazon,7,7,0,0,0,0
,Oofas Olala 1400 Black/Bluejay M5/W7,Oofas Olala 1400 Black/Bluejay M5/W7,FBALYB Amazon,-3,-3,0,0,0,0
,Oofas Olala 1400 Black/Bluejay M6/W8,Oofas Olala 1400 Black/Bluejay M6/W8,FBALYB Amazon,-6,-6,0,0,0,0
,Oofas Olala 1400 Black/Bluejay M7/W9,Oofas Olala 1400 Black/Bluejay M7/W9,FBALYB Amazon,-5,-5,0,0,0,0
,Oofas Olala 1400 Black/Bluejay M8/W10,Oofas Olala 1400 Black/Bluejay M8/W10,Default,5,5,0,0,0,0
,Oofas Olala 1400 Black/Bluejay M8/W10,Oofas Olala 1400 Black/Bluejay M8/W10,FBALYB Amazon,-9,-9,0,0,0,0
,Oofas Olala 1400 Black M4/W6,Oofas Olala 1400 Black M4/W6,FBALYB Amazon,-9,-9,0,0,0,0
,Oofas Olala 1400 Black M5/W7,Oofas Olala 1400 Black M5/W7,FBALYB Amazon,-5,-5,0,0,0,0
,Oofas Olala 1400 Black M6/W8,Oofas Olala 1400 Black M6/W8,FBALYB Amazon,-5,-6,1,0,1,0
,Oofas Olala 1400 Black M7/W9,Oofas Olala 1400 Black M7/W9,FBALYB Amazon,-5,-5,0,0,0,0
,Oofas Olala 1400 Black M8/W10,Oofas Olala 1400 Black M8/W10,FBALYB Amazon,-6,-6,0,0,0,0
,Oofas Olala 1400 Calypso M9/W10,Oofas Olala 1400 Calypso M9/W10,FBALYB Amazon,-1,-1,0,0,0,0
,Oofas Olala 1400 Navy M3/W5,Oofas Olala 1400 Navy M3/W5,FBALYB Amazon,-2,-2,0,0,0,0
,Oofas Olala 1400 Navy M4/W6,Oofas Olala 1400 Navy M4/W6,Default,0,-1,1,0,0,0
,Oofas Original Sport 1001 Aqua M10/W12,Oofas Original Sport 1001 Aqua M10/W12,FBALYB Amazon,-3,-3,0,0,0,0
,Oofas Original Sport 1001 Aqua M11/W13,Oofas Original Sport 1001 Aqua M11/W13,FBALYB Amazon,-2,-2,0,0,0,0
,Oofas Original Sport 1001 Aqua M3/W5,Oofas Original Sport 1001 Aqua M3/W5,FBALYB Amazon,-6,-6,0,0,0,0
,Oofas Original Sport 1001 Aqua M6/W8,Oofas Original Sport 1001 Aqua M6/W8,FBALYB Amazon,-1,-1,0,0,0,0
,Oofas Original Sport 1001 Aqua M7/W9,Oofas Original Sport 1001 Aqua M7/W9,FBALYB Amazon,-2,-2,0,0,0,0
,Oofas Original Sport 1001 Aqua M8/W10,Oofas Original Sport 1001 Aqua M8/W10,FBALYB Amazon,-1,-1,0,0,0,0
,Oofas Original Sport 1001 Aqua M9/W11,Oofas Original Sport 1001 Aqua M9/W11,FBALYB Amazon,-3,-3,0,0,0,0
,Oofas Original Sport 1001 Graphite M10/W12,Oofas Original Sport 1001 Graphite M10/W12,FBALYB Amazon,-1,-1,0,0,0,0
,Oofas Original Sport 1001 Graphite M11/W13,Oofas Original Sport 1001 Graphite M11/W13,FBALYB Amazon,-2,-2,0,0,0,0
,Oofas Original Sport 1001 Graphite M4/W6,Oofas Original Sport 1001 Graphite M4/W6,Default,3,3,0,0,0,0
,Oofas Original Sport 1001 Graphite M4/W6,Oofas Original Sport 1001 Graphite M4/W6,FBALYB Amazon,-4,-4,0,0,0,0
,Oofas Original Sport 1001 Graphite M5/W7,Oofas Original Sport 1001 Graphite M5/W7,FBALYB Amazon,-2,-2,0,0,0,0
,Oofas Original Sport 1001 Graphite M6/W8,Oofas Original Sport 1001 Graphite M6/W8,FBALYB Amazon,-2,-2,0,0,0,0
,Oofas Original Sport 1001 Graphite M7/W9,Oofas Original Sport 1001 Graphite M7/W9,Avrami - Ebay,3,3,0,0,0,0
,Oofas Original Sport 1001 Graphite M7/W9,Oofas Original Sport 1001 Graphite M7/W9,FBALYB Amazon,-1,-1,0,0,0,0
,Oofas Original Sport 1001 Graphite M8/W10,Oofas Original Sport 1001 Graphite M8/W10,FBALYB Amazon,-1,-1,0,0,0,0
,Oofas Original Sport 1001 Graphite M9/W11,Oofas Original Sport 1001 Graphite M9/W11,FBALYB Amazon,-3,-3,0,0,0,0
,Oofas Original Sport 1001 Pink M3/W5,Oofas Original Sport 1001 Pink M3/W5,FBALYB Amazon,-2,-2,0,0,0,0
,Oofas Original Sport 1001 Pink M4/W6,Oofas Original Sport 1001 Pink M4/W6,FBALYB Amazon,-3,-3,0,0,0,0
,Oofas Original Sport 1001 Pink M5/W7,Oofas Original Sport 1001 Pink M5/W7,FBALYB Amazon,-1,-1,0,0,0,0
,Oofas Original Sport 1001 Pink M6/W8,Oofas Original Sport 1001 Pink M6/W8,FBALYB Amazon,-3,-3,0,0,0,0
,Oofas Original Sport 1001 Pink M7/W9,Oofas Original Sport 1001 Pink M7/W9,FBALYB Amazon,-1,-1,0,0,0,0
,Oofas Original Sport 1001 Pink M8/W10,Oofas Original Sport 1001 Pink M8/W10,FBALYB Amazon,-1,-1,0,0,0,0
,Oofas Original Sport 1001 Yellow M11/W13,Oofas Original Sport 1001 Yellow M11/W13,FBALYB Amazon,-1,-1,0,0,0,0
,Oofas Original Sport 1001 Yellow M12/W14,Oofas Original Sport 1001 Yellow M12/W14,FBALYB Amazon,-3,-3,0,0,0,0
,Oofas Original Sport 1001 Yellow M13/W15,Oofas Original Sport 1001 Yellow M13/W15,FBALYB Amazon,-2,-2,0,0,0,0
,Oofas Original Sport 1001 Yellow M3/W5,Oofas Original Sport 1001 Yellow M3/W5,FBALYB Amazon,19,19,0,0,0,0
,Oofas Original Sport 1001 Yellow M4/W6,Oofas Original Sport 1001 Yellow M4/W6,FBALYB Amazon,-2,-2,0,0,0,0
,Oofas Original Sport 1001 Yellow M5/W7,Oofas Original Sport 1001 Yellow M5/W7,FBALYB Amazon,-2,-2,0,0,0,0
,Oofas Original Sport 1001 Yellow M6/W8,Oofas Original Sport 1001 Yellow M6/W8,FBALYB Amazon,-1,-1,0,0,0,0
,Oofas Original Sport 1001 Yellow M8/W10,Oofas Original Sport 1001 Yellow M8/W10,FBALYB Amazon,-8,-8,0,0,0,0
,Oofas Original Sport 1001 Yellow M9/W11,Oofas Original Sport 1001 Yellow M9/W11,FBALYB Amazon,-1,-1,0,0,0,0
,Oofas Original Thong 1000 Bermuda Blue M6/W8,Oofas Original Thong 1000 Bermuda Blue M6/W8,FBALYB Amazon,-1,-1,0,0,0,0
,Oofas Original Thong 1000 Bermuda Blue M7/W9,Oofas Original Thong 1000 Bermuda Blue M7/W9,FBALYB Amazon,-4,-4,0,0,0,0
,Oofas Original Thong 1000 Bermuda Blue M8/W10,Oofas Original Thong 1000 Bermuda Blue M8/W10,FBALYB Amazon,-1,-1,0,0,0,0
,Oofas Original Thong 1000 Black M10/W12,Oofas Original Thong 1000 Black M10/W12,FBALYB Amazon,-2,-2,0,5,0,0
,Oofas Original Thong 1000 Black M11/W13,Oofas Original Thong 1000 Black M11/W13,FBALYB Amazon,-9,-9,0,0,0,0
,Oofas Original Thong 1000 Black M12/W14,Oofas Original Thong 1000 Black M12/W14,FBALYB Amazon,-6,-6,0,6,0,0
,Oofas Original Thong 1000 Black M4/W6,Oofas Original Thong 1000 Black M4/W6,FBALYB Amazon,-1,-1,0,0,0,0
,Oofas Original Thong 1000 Black M5/W7,Oofas Original Thong 1000 Black M5/W7,FBALYB Amazon,-6,-6,0,0,0,0
,Oofas Original Thong 1000 Black M6/W8,Oofas Original Thong 1000 Black M6/W8,FBALYB Amazon,-3,-3,0,0,0,0
,Oofas Original Thong 1000 Black M7/W9,Oofas Original Thong 1000 Black M7/W9,FBALYB Amazon,-10,-10,0,0,0,0
,Oofas Original Thong 1000 Fuschia M4/W6,Oofas Original Thong 1000 Fuschia M4/W6,FBALYB Amazon,-16,-16,0,1,0,0
,Oofas Original Thong 1000 Fuschia M5/W7,Oofas Original Thong 1000 Fuschia M5/W7,FBALYB Amazon,-8,-8,0,0,0,0
,Oofas Original Thong 1000 Fuschia M6/W8,Oofas Original Thong 1000 Fuschia M6/W8,FBALYB Amazon,-17,-17,0,0,0,0
,Oofas Original Thong 1000 Fuschia M7/W9,Oofas Original Thong 1000 Fuschia M7/W9,FBALYB Amazon,-7,-7,0,0,0,0
,Oofas Original Thong 1000 Fuschia M8/W10,Oofas Original Thong 1000 Fuschia M8/W10,FBALYB Amazon,-19,-19,0,0,0,0
,Oofas Original Thong 1000 Fuschia M9/W10,Oofas Original Thong 1000 Fuschia M9/W10,FBALYB Amazon,-5,-5,0,0,0,0
,Oofas Original Thong 1000 Navy M10/W12,Oofas Original Thong 1000 Navy M10/W12,FBALYB Amazon,-1,-1,0,0,0,0
,Oofas Original Thong 1000 Navy M12/W14,Oofas Original Thong 1000 Navy M12/W14,FBALYB Amazon,-5,-5,0,0,0,0
,Oofas Original Thong 1000 Navy M4/W6,Oofas Original Thong 1000 Navy M4/W6,FBALYB Amazon,-9,-9,0,0,0,0
,Oofas Original Thong 1000 Navy M5/W7,Oofas Original Thong 1000 Navy M5/W7,FBALYB Amazon,-3,-3,0,0,0,0
,Oofas Original Thong 1000 Navy M6/W8,Oofas Original Thong 1000 Navy M6/W8,FBALYB Amazon,-4,-4,0,0,0,0
,Oofas Original Thong 1000 Navy M7/W9,Oofas Original Thong 1000 Navy M7/W9,FBALYB Amazon,-2,-2,0,0,0,0
,Oofas Original Thong 1000 Navy M8/W10,Oofas Original Thong 1000 Navy M8/W10,FBALYB Amazon,-8,-8,0,0,0,0
,Oofas Original Thong 1000 Navy M9/W11,Oofas Original Thong 1000 Navy M9/W11,FBALYB Amazon,-3,-3,0,0,0,0
,Oofos Olala OOF-1400 - Black/Black -M4 / W6,Oofos Olala OOF-1400 - Black/Black -M4 / W6,FBALYB Amazon,-19,-19,0,0,0,0
,Oofos Olala OOF-1400 - Black/Black -M5 / W7,Oofos Olala OOF-1400 - Black/Black -M5 / W7,FBALYB Amazon,-14,-14,0,0,0,0
,Oofos Olala OOF-1400 - Black/Black -M6 / W8,Oofos Olala OOF-1400 - Black/Black -M6 / W8,FBALYB Amazon,-7,-7,0,0,0,0
,Oofos Olala OOF-1400 - Black/Black -M7 / W9,Oofos Olala OOF-1400 - Black/Black -M7 / W9,FBAAP Amazon,20,20,0,0,0,0
,Oofos Olala OOF-1400 - Black/Black -M7 / W9,Oofos Olala OOF-1400 - Black/Black -M7 / W9,FBALYB Amazon,-5,-5,0,0,0,0
,Oofos Original OOF-1000 - Black-M11 / W13,Oofos Original OOF-1000 - Black-M11 / W13,FBALYB Amazon,-4,-4,0,0,0,0
,Oofos Original OOF-1000 - Black-M4 / W6,Oofos Original OOF-1000 - Black-M4 / W6,FBALYB Amazon,-2,-2,0,0,0,0
,Oofos Original OOF-1000 - Black-M5 / W7,Oofos Original OOF-1000 - Black-M5 / W7,FBALYB Amazon,-3,-3,0,0,0,0
,Oofos Original OOF-1000 - Black-M6 / W8,Oofos Original OOF-1000 - Black-M6 / W8,FBALYB Amazon,-7,-7,0,0,0,0
,Oofos Original OOF-1000 - Black-M7 / W9,Oofos Original OOF-1000 - Black-M7 / W9,FBALYB Amazon,-9,-9,0,0,0,0
,Oofos Original OOF-1000 - Black-M8 / W10,Oofos Original OOF-1000 - Black-M8 / W10,FBALYB Amazon,-7,-7,0,0,0,0
,Oofos Original OOF-1000 - Black-M9 / W11,Oofos Original OOF-1000 - Black-M9 / W11,FBALYB Amazon,-2,-2,0,0,0,0
,Oofos Original OOF-1000 - Navy-M10 / W12,Oofos Original OOF-1000 - Navy-M10 / W12,FBALYB Amazon,-6,-6,0,0,0,0
,Oofos Original OOF-1000 - Navy-M11 / W13,Oofos Original OOF-1000 - Navy-M11 / W13,FBALYB Amazon,-5,-5,0,2,0,0
,Oofos Original OOF-1000 - Navy-M5 / W7,Oofos Original OOF-1000 - Navy-M5 / W7,FBALYB Amazon,-2,-2,0,0,0,0
,Oofos Original OOF-1000 - Navy-M6 / W8,Oofos Original OOF-1000 - Navy-M6 / W8,FBALYB Amazon,-2,-2,0,0,0,0
,Oofos Original OOF-1000 - Navy-M7 / W9,Oofos Original OOF-1000 - Navy-M7 / W9,FBALYB Amazon,-1,-1,0,0,0,0
,Oofos Original OOF-1000 - Navy-M8 / W10,Oofos Original OOF-1000 - Navy-M8 / W10,FBALYB Amazon,-3,-3,0,0,0,0
,Oofos Original OOF-1000 - Navy-M9 / W11,Oofos Original OOF-1000 - Navy-M9 / W11,FBALYB Amazon,-6,-6,0,0,0,0
,Oofos Original OOF-1000 - Periwinkle- M10 / W12,Oofos Original OOF-1000 - Periwinkle- M10 / W12,FBALYB Amazon,-4,-4,0,0,0,0
,Oofos Original OOF-1000 - Periwinkle- M11 / W13,Oofos Original OOF-1000 - Periwinkle- M11 / W13,FBALYB Amazon,-3,-3,0,0,0,0
,Oofos Original OOF-1000 - Periwinkle- M5 / W7,Oofos Original OOF-1000 - Periwinkle- M5 / W7,FBALYB Amazon,-2,-2,0,0,0,0
,Oofos Original OOF-1000 - Periwinkle- M6 / W8,Oofos Original OOF-1000 - Periwinkle- M6 / W8,FBALYB Amazon,-2,-2,0,0,0,0
,Oofos Original OOF-1000 - Periwinkle- M7 / W9,Oofos Original OOF-1000 - Periwinkle- M7 / W9,Default,1,1,0,0,0,0
,Oofos Original OOF-1000 - Periwinkle- M7 / W9,Oofos Original OOF-1000 - Periwinkle- M7 / W9,FBALYB Amazon,-3,-3,0,0,0,0
,Oofos Original OOF-1000 - Periwinkle- M8 / W10,Oofos Original OOF-1000 - Periwinkle- M8 / W10,Default,1,1,0,0,0,0
,Oofos Original OOF-1000 - Periwinkle- M8 / W10,Oofos Original OOF-1000 - Periwinkle- M8 / W10,FBALYB Amazon,-2,-2,0,0,0,0
,Oofos Original OOF-1000 - Periwinkle- M9 / W11,Oofos Original OOF-1000 - Periwinkle- M9 / W11,FBALYB Amazon,-2,-3,1,0,1,0
,Ooofos Original OOF-1000 - Black-M10 / W12,Ooofos Original OOF-1000 - Black-M10 / W12,FBALYB Amazon,-3,-3,0,0,0,0
,Optimum Nutrition Gold Standard,Optimum Nutrition Gold Standard ,Default,0,0,0,0,0,3
,Optimum Nutrition Gold Standard,Optimum Nutrition Gold Standard ,FBALYB Amazon,29,29,0,0,0,0
,Oracoat Xylimelts Dry Mouth Regular 40ct,Oracoat Xylimelts Dry Mouth Regular 40ct,Default,0,0,0,0,0,50
,Oral B 3D White Brush Heads 2 Ct,Oral B 3D White Brush Heads 2 Ct,Default,0,-1480,1480,0,0,0
,Oral B 3D White Brush Heads 2 Ct,Oral B 3D White Brush Heads 2 Ct,Default Ridgefield,416,-784,1200,0,0,0
,Oral B 3D White Brush Heads 2 Ct,Oral B 3D White Brush Heads 2 Ct,FBALYB Amazon,232,230,2,0,2,0
,Oral-B 3DWhite EB18-3+1 4210201152569,Oral-B 3DWhite EB18-3+1 4210201152569,Avrami - Ebay,1302,1302,0,0,0,0
,Oral-B 3DWhite EB18-3+1 4210201152569,Oral-B 3DWhite EB18-3+1 4210201152569,Default Oxford,1028,1028,0,0,0,0
,Oral-B 3DWhite EB18-3+1 4210201152569,Oral-B 3DWhite EB18-3+1 4210201152569,FBALYB Amazon,135,123,12,0,12,0
,Oral-B 3DWhite EB18-3+1 4210201152569,Oral-B 3DWhite EB18-3+1 4210201152569,WFS,-19,-19,0,0,0,0
,Oral-B Advance Power Toothbrush DB4010 4210201822264,Oral-B Advance Power Toothbrush DB4010 4210201822264,Default Oxford,300,300,0,0,0,0
,Oral-B Advance Power Toothbrush DB4010 4210201822264,Oral-B Advance Power Toothbrush DB4010 4210201822264,Default Ridgefield,284,284,0,0,0,0
,Oral-B Advance Power Toothbrush DB4010 4210201822264,Oral-B Advance Power Toothbrush DB4010 4210201822264,WFS,-13,-13,0,0,0,0
,Oral-B b-50 Cross Action Refill 4pc,"Oral-B b-50 Cross Action Refill 4pc 	",Avrami - Ebay,300,300,0,0,0,0
,Oral-B b-50 Cross Action Refill 4pc,"Oral-B b-50 Cross Action Refill 4pc 	",Default Ridgefield,12,12,0,0,0,0
,Oral-B b-50 Cross Action Refill 4pc,"Oral-B b-50 Cross Action Refill 4pc 	",FBALYB Amazon,-436,-436,0,357,0,0
,ORAL-B BRUSH HEADS 3+1 PACK DEEP CLEAN,ORAL-B BRUSH HEADS 3+1 PACK DEEP CLEAN,Avrami - Ebay,1032,1032,0,0,0,0
,ORAL-B BRUSH HEADS 3+1 PACK DEEP CLEAN,ORAL-B BRUSH HEADS 3+1 PACK DEEP CLEAN,Default Oxford,294,294,0,0,0,0
,Oral-B CrossAction EB 50 3+1 4210201207238,Oral-B CrossAction EB 50 3+1 4210201207238,FBALYB Amazon,25,15,10,0,10,0
,Oral-B CrossAction EB 50 3+1 4210201207238,Oral-B CrossAction EB 50 3+1 4210201207238,WFS,-19,-19,0,0,0,0
,Oral-B Cross Action EB 50 8+2 Bakterienschutz 4210201207290,Oral-B Cross Action EB 50 8+2 Bakterienschutz 4210201207290,Avrami - Ebay,480,480,0,0,0,0
,Oral-B Cross Action EB 50 8+2 Bakterienschutz 4210201207290,Oral-B Cross Action EB 50 8+2 Bakterienschutz 4210201207290,Default Ridgefield,125,125,0,0,0,0
,Oral-B Cross Action EB 50 8+2 Bakterienschutz 4210201207290,Oral-B Cross Action EB 50 8+2 Bakterienschutz 4210201207290,FBALYB Amazon,54,33,21,179,21,0
,Oral-B Cross Action EB 50 8+2 Bakterienschutz 4210201207290,Oral-B Cross Action EB 50 8+2 Bakterienschutz 4210201207290,WFS,-223,-223,0,0,0,0
,"Oral-B CrossAction Power Brush, 2pk.","Oral-B CrossAction Power Brush, 2pk.",FBALYB Amazon,-3,-3,0,0,0,0
,Oral-B EB60 8+2 Sensitive Ultra Thin 4210201176923,Oral-B EB60 8+2 Sensitive Ultra Thin 4210201176923,FBALYB Amazon,-4,-5,1,0,1,0
,Oral-B Glide Floss 6pk,Oral-B Glide Floss 6pk,FBALYB Amazon,-36,-38,2,74,2,0
,Oral B Prec Clean (Clean Maximizer) 6 ct   2PACK (total 12ct),Oral B Prec Clean (Clean Maximizer) 6 ct   2PACK (total 12ct),FBALYB Amazon,97,97,0,0,0,0
,Oral-B Precision 2+1ct 2pk,Oral-B Precision 2+1ct 2pk,FBALYB Amazon,-2,-3,1,0,1,0
,Oral B Precision Clean 2+1 Refills,Oral B Precision Clean 2+1 Refills,FBALYB Amazon,-372,-377,5,4,5,0
,Oral-B Precision Clean Brush Heads 4+1,Oral-B Precision Clean Brush Heads 4+1,Avrami - Ebay,165,165,0,0,0,0
,Oral-B Precision Clean Brush Heads 4+1,Oral-B Precision Clean Brush Heads 4+1,FBALYB Amazon,-5,-5,0,0,0,0
,Oral-B Precision Clean EB 20 4 Brush 4210201848233,Oral-B Precision Clean EB 20 4 Brush 4210201848233,Default,0,0,0,0,0,4
,Oral-B Precision Clean EB 20 4 Brush 4210201848233,Oral-B Precision Clean EB 20 4 Brush 4210201848233,FBALYB Amazon,475,473,2,1,2,0
,Oral-B Precision Clean EB 20 4 Brush 4210201848233,Oral-B Precision Clean EB 20 4 Brush 4210201848233,WFS,-1,-1,0,0,0,0
,Oral-B Precision Clean EB 20 8+2 4210201207498,Oral-B Precision Clean EB 20 8+2 4210201207498,Default,0,-3215,3215,0,0,0
,Oral-B Precision Clean EB 20 8+2 4210201207498,Oral-B Precision Clean EB 20 8+2 4210201207498,Default Ridgefield,7,7,0,0,0,0
,Oral-B Precision Clean EB 20 8+2 4210201207498,Oral-B Precision Clean EB 20 8+2 4210201207498,FBALYB Amazon,-1574,-1579,5,1541,5,0
,Oral B Pulsar 4ct Toothbrushes,Oral B Pulsar 4ct Toothbrushes,Avrami - Ebay,500,500,0,0,0,0
,Oral B Pulsar 4ct Toothbrushes,Oral B Pulsar 4ct Toothbrushes,FBALYB Amazon,180,180,0,4,0,0
,Oral B Pulsar 4ct Toothbrushes,Oral B Pulsar 4ct Toothbrushes,WFS,-324,-325,1,0,1,0
,Oral B Pulsar 4ct Toothbrushes MEDIUM,Oral B Pulsar 4ct Toothbrushes MEDIUM,Default Ridgefield,723,723,0,0,0,0
,Oral B Pulsar 4ct Toothbrushes MEDIUM,Oral B Pulsar 4ct Toothbrushes MEDIUM,FBALYB Amazon,134,113,21,3,21,0
,Oral B Pulsar 4ct Toothbrushes MEDIUM,Oral B Pulsar 4ct Toothbrushes MEDIUM,FBALYB Canada,12,12,0,1,0,0
,Oral-B Pulsar Bacteria Guard S 4ct,Oral-B Pulsar Bacteria Guard S 4ct,Avrami - Ebay,2,2,0,0,0,0
,Oral-B Pulsar Bacteria Guard S 4ct,Oral-B Pulsar Bacteria Guard S 4ct,Default,0,-600,600,0,0,0
,Oral-B Pulsar Bacteria Guard S 4ct,Oral-B Pulsar Bacteria Guard S 4ct,FBALYB Amazon,-234,-234,0,240,0,0
,Oral B Pulsar Medium,Oral B Pulsar Medium,Default,0,-1,1,0,0,0
,Oral B Pulsar Medium,Oral B Pulsar Medium,FBALYB Amazon,-1,-1,0,0,0,0
,Oral B Pulsar Medium,Oral B Pulsar Medium,FBALYB Canada,44,44,0,0,0,0
,Oral B Pulsar Small 4 ct,Oral B Pulsar Small 4 ct,Default,0,-1,1,0,0,0
,Oral B Pulsar Small 4 ct,Oral B Pulsar Small 4 ct,FBALYB Amazon,-122,-150,28,1,28,0
,Oral B Pulsar Small 4 ct,Oral B Pulsar Small 4 ct,FBALYB Canada,1,1,0,0,0,0
,Oral B refill Cross Action 3 pack,Oral B refill Cross Action 3 pack,Avrami - Ebay,108,108,0,0,0,0
,Oral B refill Cross Action 3 pack,Oral B refill Cross Action 3 pack,Default,0,0,0,0,0,18
,Oral B refill Cross Action 3 pack,Oral B refill Cross Action 3 pack,Default Ridgefield,9,9,0,0,0,0
,Oral B refill Cross Action 3 pack,Oral B refill Cross Action 3 pack,FBALYB Amazon,-15,-15,0,0,0,0
,Oral B refill Cross Action 3 pack,Oral B refill Cross Action 3 pack,WFS,-106,-106,0,0,0,0
,Oral B refill Cross Action Black Edition 2ct 4pk,Oral B refill Cross Action Black Edition 8 total 2ct 4pk,FBALYB Amazon,-1,-1,0,0,0,0
,Oral B refill Cross Action Black Edition 2ct 4pk,Oral B refill Cross Action Black Edition 8 total 2ct 4pk,FBALYB Canada,-1,-1,0,0,0,0
,Oral B refill Cross Action Black Edition 2 pack,Oral B refill Cross Action Black Edition 2 pack,FBALYB Amazon,42,40,2,0,2,0
,Oral B refill Cross Action Black Edition 3+1 pack,Oral B refill Cross Action Black Edition 3+1 pack,Default Ridgefield,139,139,0,0,0,0
,Oral B refill Cross Action Black Edition 3+1 pack,Oral B refill Cross Action Black Edition 3+1 pack,FBALYB Amazon,-614,-615,1,1,1,0
,Oral B refill Cross Action Black Edition 3+1 pack,Oral B refill Cross Action Black Edition 3+1 pack,FBALYB Canada,20,20,0,6,0,0
,Oral B refill Cross Action Black Edition 4 total 2 ct 2 pack,Oral B refill Cross Action Black Edition 4 total 2 ct 2 pack,FBALYB Amazon,32,7,25,0,25,0
,Oral B refill Cross Action Black Edition 4 total 2 ct 2 pack,Oral B refill Cross Action Black Edition 4 total 2 ct 2 pack,FBALYB Canada,13,13,0,0,0,0
,Oral B refill Floss Action 3 pack,Oral B refill Floss Action 3 pack,Avrami - Ebay,188,188,0,0,0,0
,Oral B refill Floss Action 3 pack,Oral B refill Floss Action 3 pack,FBALYB Amazon,-1,-1,0,0,0,0
,Oral B refill Floss Action 3 pack,Oral B refill Floss Action 3 pack,WFS,-182,-182,0,0,0,0
,Oral B refill Precision Clean 12 pack,Oral B refill Precision Clean 12 pack,Default,0,0,0,0,0,36
,Oral B refill Precision Clean 12 pack,Oral B refill Precision Clean 12 pack,Default Ridgefield,208,208,0,0,0,0
,Oral B refill Precision Clean 12 pack,Oral B refill Precision Clean 12 pack,FBALYB Amazon,424,421,3,0,3,0
,Oral B refill Precision Clean 12 pack,Oral B refill Precision Clean 12 pack,FBALYB Canada,16,16,0,0,0,0
,Oral-B Refill Precision Clean 3+1 4ct.,Oral-B Refill Precision Clean 3+1 4ct.,FBALYB Amazon,133,115,18,6,18,0
,Oral-B Refill Precision Clean 6ct,Oral-B Refill Precision Clean 6ct,FBALYB Amazon,-13,-13,0,54,0,0
,Oral-B Refill Precision Clean 6ct,Oral-B Refill Precision Clean 6ct,WFS,-16,-17,1,0,1,0
,Oral B refill Sensi Ultra Thin 3+1 8ct (2pack of the 3+1),Oral B refill Sensi Ultra Thin 3+1 8ct (2pack of the 3+1),FBALYB Amazon,192,186,6,0,6,0
,Oral B refill Sensi Ultra Thin 3+1 pack,Oral B refill Sensi Ultra Thin 3+1 pack,Default Ridgefield,-34,-34,0,0,0,0
,Oral B refill Sensi Ultra Thin 3+1 pack,Oral B refill Sensi Ultra Thin 3+1 pack,FBALYB Amazon,331,292,39,0,39,0
,Oral B refill Sensi Ultra Thin 3+1 pack,Oral B refill Sensi Ultra Thin 3+1 pack,FBALYB Canada,0,0,0,60,0,0
,Oral B refill Sensi Ultra Thin 3 pack,Oral B refill Sensi Ultra Thin 3 pack,Default,0,0,0,0,0,6
,Oral B refill Sensi Ultra Thin 3 pack,Oral B refill Sensi Ultra Thin 3 pack,Default Ridgefield,1668,1668,0,0,0,0
,Oral B refill Sensi Ultra Thin 3 pack,Oral B refill Sensi Ultra Thin 3 pack,FBALYB Amazon,191,191,0,0,0,0
,Oral-B Sensi Rplcmnt TothbrshHeads 4 pck,Oral-B Sensi Rplcmnt TothbrshHeads 4 pck,FBALYB Amazon,-5,-5,0,5,0,0
,Oral-B Sensi Rplcmnt TothbrshHeads 4 pck,Oral-B Sensi Rplcmnt TothbrshHeads 4 pck,WFS,-16,-16,0,0,0,0
,Oral-B Sensitive Clean EB17-3 2xEB17 Sensitive 1x EB60 Sensi Ultrathin 4210201849810,Oral-B Sensitive Clean EB17-3 2xEB17 Sensitive 1x EB60 Sensi Ultrathin 4210201849810,FBALYB Amazon,-2,-2,0,1,0,0
,Oral-B Sensitive Clean Ultra Thin 2pk,Oral-B Sensitive Clean Ultra Thin 2pk,FBALYB Amazon,144,144,0,0,0,0
,Oral-B Sensitive Clean Ultra Thin EB60-2 4210201176503,Oral-B Sensitive Clean Ultra Thin EB60-2 4210201176503,FBALYB Amazon,-11,-11,0,0,0,0
,Oral-B Super Floss Mint 3pk,Oral-B Super Floss Mint 3pk,FBALYB Amazon,-6,-6,0,3,0,0
,Oral-B Super Floss Mint 6pk,Oral-B Super Floss Mint 6pk,FBALYB Amazon,-199,-219,20,191,20,0
,Organic Grain free cereal Coconut crunch,Organic Grain free cereal Coconut crunch,Default Ridgefield,6,6,0,0,0,0
,Original Donut Shop Regular K-Cup 100ct,Original Donut Shop Regular K-Cup 100ct,Default,0,0,0,0,0,64
,Original Donut Shop Regular K-Cup 100ct,Original Donut Shop Regular K-Cup 100ct,FBALYB Amazon,-34,-34,0,52,0,0
,Original Source Lime Shower Gel 250ml,Original Source Lime Shower Gel 250ml,Default,0,-354,354,0,0,0
,Original Source Lime Shower Gel 250ml,Original Source Lime Shower Gel 250ml,Default CT,12,12,0,0,0,0
,Original Source Lime Shower Gel 250ml 6pk,Original Source Lime Shower Gel 250ml 6pk,FBALYB Amazon,29,29,0,170,0,0
,Original Source Shower Gel Mint and Tea Tree 250ml,Original Source Shower Gel Mint and Tea Tree 250ml ,Default,0,-2208,2208,0,0,0
,Original Source Shower Gel Mint and Tea Tree 250ml,Original Source Shower Gel Mint and Tea Tree 250ml ,Default CT,972,972,0,0,0,0
,Original Source Shower Gel Mint and Tea Tree 250ml,Original Source Shower Gel Mint and Tea Tree 250ml ,Default Ridgefield,129,129,0,0,0,0
,Original Source Shower Gel Mint and Tea Tree 250ml 6 PK,Original Source Shower Gel Mint and Tea Tree 250ml 6 PK,FBALYB Amazon,6,0,6,37,6,0
,Original Sprout Deep Conditioner 33oz,Original Sprout Deep Conditioner 33oz,Default Ridgefield,109,109,0,0,0,0
,Original Sprout Deep Conditioner 33oz,Original Sprout Deep Conditioner 33oz,FBALYB Amazon,143,138,5,1,5,0
,Original Sprout Deep Conditioner 4oz,Original Sprout Deep Conditioner 4oz,Default Ridgefield,408,408,0,0,0,0
,Original Sprout Deep Conditioner 4oz,Original Sprout Deep Conditioner 4oz,FBALYB Amazon,356,355,1,0,1,0
,Original Sprout Hair & Body BabyWash 12oz 2pk,Original Sprout Hair & Body BabyWash 12oz 2pk,FBALYB Amazon,65,65,0,3,0,0
,Original Sprout Hair & Body BabyWash 33oz,Original Sprout Hair & Body BabyWash 33oz,Default Ridgefield,193,193,0,0,0,0
,Original Sprout Hair & Body BabyWash 33oz,Original Sprout Hair & Body BabyWash 33oz,FBALYB Amazon,179,172,7,0,7,0
,Original Sprout Hair & Body BabyWash 33oz 2 pack,Original Sprout Hair & Body BabyWash 33oz 2 pack,FBALYB Amazon,22,20,2,191,2,0
,Original Sprout Hair & Body BabyWash 4oz,Original Sprout Hair & Body BabyWash 4oz,Default Ridgefield,184,184,0,0,0,0
,Original Sprout Hair & Body BabyWash 4oz,Original Sprout Hair & Body BabyWash 4oz,FBALYB Amazon,155,155,0,0,0,0
,Original Sprout Leave In Conditioner 12oz,Original Sprout Leave In Conditioner 12oz,Default Ridgefield,71,71,0,0,0,0
,Original Sprout Leave In Conditioner 12oz,Original Sprout Leave In Conditioner 12oz,FBALYB Amazon,44,37,7,0,7,0
,Original Sprout Leave In Conditioner 4oz,Original Sprout Leave In Conditioner 4oz,FBALYB Amazon,-2,-2,0,0,0,0
,Original Sprout Miracle Detangler 12oz,Original Sprout Miracle Detangler 12oz,Default Ridgefield,545,545,0,0,0,0
,Original Sprout Miracle Detangler 12oz,Original Sprout Miracle Detangler 12oz,FBALYB Amazon,58,43,15,0,15,0
,Original Sprout Miracle Detangler 4oz,Original Sprout Miracle Detangler 4oz,FBALYB Amazon,6,6,0,1,0,0
,Original Sprout Natural Curl Calmer 4oz,Original Sprout Natural Curl Calmer 4oz,Default,0,-78,78,0,0,0
,Original Sprout Natural Curl Calmer 4oz,Original Sprout Natural Curl Calmer 4oz,FBALYB Amazon,59,45,14,2,14,0
,Original Sprout Natural Curl Calmer 4oz 2pk,Original Sprout Natural Curl Calmer 4oz 2pk,FBALYB Amazon,4,4,0,12,0,0
,Original Sprout Natural Hair Gel 4oz,Original Sprout Natural Hair Gel 4oz,Default Ridgefield,429,429,0,0,0,0
,Original Sprout Natural Hair Gel 4oz,Original Sprout Natural Hair Gel 4oz,FBALYB Amazon,3,3,0,0,0,0
,Original Sprout Natural Shampoo 12oz,Original Sprout Natural Shampoo 12oz,Default Ridgefield,488,488,0,0,0,0
,Original Sprout Natural Shampoo 12oz,Original Sprout Natural Shampoo 12oz,FBALYB Amazon,161,160,1,0,1,0
,Original Sprout Natural Shampoo 12oz 2pk,Original Sprout Natural Shampoo 12oz 2pk,FBALYB Amazon,178,178,0,0,0,0
,Original Sprout Natural Shampoo 33oz,Original Sprout Natural Shampoo 33oz,Default Ridgefield,282,282,0,0,0,0
,Original Sprout Natural Shampoo 33oz,Original Sprout Natural Shampoo 33oz,FBALYB Amazon,1099,1082,17,0,17,0
,Original Sprout Natural Shampoo 33oz,Original Sprout Natural Shampoo 33oz,WFS,-73,-73,0,0,0,0
,Original Sprout Natural Shampoo 33oz 2pk,Original Sprout Natural Shampoo 33oz 2pk,FBALYB Amazon,12,12,0,0,0,0
,Original Sprout Natural Shampoo 4oz,Original Sprout Natural Shampoo 4oz,Default Ridgefield,141,141,0,0,0,0
,Original Sprout Natural Shampoo 4oz,Original Sprout Natural Shampoo 4oz,FBALYB Amazon,191,191,0,0,0,0
,Original Sprout Natural Shampoo 4oz 2pk,Original Sprout Natural Shampoo 4oz 2pk,FBALYB Amazon,2,2,0,0,0,0
,Original Sprout Natural Shampoo + Conditioner 33oz duo,Original Sprout Natural Shampoo + Conditioner 33oz duo,FBALYB Amazon,43,37,6,0,6,0
,Original Sprout Natural Styling Balm 2oz,Original Sprout Natural Styling Balm 2oz,FBALYB Amazon,257,253,4,0,4,0
,Original Sprout Natural Styling Balm 2oz 2pk,Original Sprout Natural Styling Balm 2oz 2pk,FBALYB Amazon,28,28,0,0,0,0
,Original Sprout Scrumptious Baby Cream 12oz,Original Sprout Scrumptious Baby Cream 12oz,Default Ridgefield,108,108,0,0,0,0
,Original Sprout Scrumptious Baby Cream 12oz,Original Sprout Scrumptious Baby Cream 12oz,FBALYB Amazon,64,62,2,0,2,0
,Original Sprout Scrumptious Baby Cream 8oz,Original Sprout Scrumptious Baby Cream 8oz,FBALYB Amazon,128,127,1,0,1,0
,Original Sprout Tahitian Hair Oil 4oz,Original Sprout Tahitian Hair Oil 4oz,FBALYB Amazon,1,1,0,1,0,0
,Original Weatherproof Vintage Men's Size 34 X 30 Blue,Original Weatherproof Vintage Men's Size 34 X 30 Blue,Default Ridgefield,7,7,0,0,0,0
,ORIGING GINZING 5 OZ REFRESHING SCRUB,ORIGING GINZING 5 OZ REFRESHING SCRUB,Default Ridgefield,801,801,0,0,0,0
,ORIGING GINZING 5 OZ REFRESHING SCRUB,ORIGING GINZING 5 OZ REFRESHING SCRUB,FBALYB Amazon,215,207,8,2,8,0
,ORIGINS ANTIOXIDANT 1.7 OZ MOIST. WHITETEA,ORIGINS ANTIOXIDANT 1.7 OZ MOIST. WHITETEA,Default Ridgefield,396,396,0,0,0,0
,ORIGINS ANTIOXIDANT 1.7 OZ MOIST. WHITETEA,ORIGINS ANTIOXIDANT 1.7 OZ MOIST. WHITETEA,FBALYB Amazon,-2,-3,1,0,1,0
,"ORIGINS CLEANSER 6,7 OZ MEGAMUSHROOM DR WEIL","ORIGINS CLEANSER 6,7 OZ MEGAMUSHROOM DR WEIL",Default Ridgefield,135,135,0,0,0,0
,"ORIGINS CLEANSER 6,7 OZ MEGAMUSHROOM DR WEIL","ORIGINS CLEANSER 6,7 OZ MEGAMUSHROOM DR WEIL",FBALYB Amazon,137,137,0,1,0,0
,Origins Eye Doctor Moisture Care For Skin Around Eyes 15ml .5 oz,Origins Eye Doctor Moisture Care For Skin Around Eyes 15ml .5 oz,Default Ridgefield,294,294,0,0,0,0
,Origins Eye Doctor Moisture Care For Skin Around Eyes 15ml .5 oz,Origins Eye Doctor Moisture Care For Skin Around Eyes 15ml .5 oz,FBALYB Amazon,-1,-2,1,0,1,0
,ORIGINS FACE CREAM 1.7 OZ MEGAMUSHROOM RELIE,ORIGINS FACE CREAM 1.7 OZ MEGAMUSHROOM RELIE,Default Ridgefield,324,324,0,0,0,0
,ORIGINS FACE CREAM 1.7 OZ MEGAMUSHROOM RELIE,ORIGINS FACE CREAM 1.7 OZ MEGAMUSHROOM RELIE,FBALYB Amazon,80,77,3,2,3,0
,ORIGINS FACE CREAM 1.7 OZ MEGAMUSHROOM RELIE,ORIGINS FACE CREAM 1.7 OZ MEGAMUSHROOM RELIE,FBALYB Canada,10,10,0,0,0,0
,ORIGINS FACE WASH 5 OZ CHECKS BALANCES,ORIGINS FACE WASH 5 OZ CHECKS BALANCES,Default Ridgefield,787,787,0,0,0,0
,ORIGINS FACE WASH 5 OZ CHECKS BALANCES,ORIGINS FACE WASH 5 OZ CHECKS BALANCES,FBALYB Amazon,1662,1584,78,7,78,0
,ORIGINS GINGER 1.07 OZ ESSENCE SENSUOUS SKIN,ORIGINS GINGER 1.07 OZ ESSENCE SENSUOUS SKIN,Default Ridgefield,0,-1,1,0,0,0
,ORIGINS GINGER 3.4 OZ ESSENCE SENSUOUS SKIN S,ORIGINS GINGER 3.4 OZ ESSENCE SENSUOUS SKIN S,Default Ridgefield,65,65,0,0,0,0
,ORIGINS GINGER 3.4 OZ ESSENCE SENSUOUS SKIN S,ORIGINS GINGER 3.4 OZ ESSENCE SENSUOUS SKIN S,FBALYB Amazon,77,68,9,0,9,0
,ORIGINS GINGER 7 OZ SOUFFLE WHIPPED BODY CREA,ORIGINS GINGER 6.7 OZ SOUFFLE WHIPPED BODY CREA,Default,0,0,0,0,0,4
,ORIGINS GINGER 7 OZ SOUFFLE WHIPPED BODY CREA,ORIGINS GINGER 6.7 OZ SOUFFLE WHIPPED BODY CREA,Default Ridgefield,630,629,1,0,0,0
,ORIGINS GINGER 7 OZ SOUFFLE WHIPPED BODY CREA,ORIGINS GINGER 6.7 OZ SOUFFLE WHIPPED BODY CREA,FBALYB Amazon,587,575,12,7,12,0
,ORIGINS GINGER 7 OZ SOUFFLE WHIPPED BODY CREA,ORIGINS GINGER 6.7 OZ SOUFFLE WHIPPED BODY CREA,FBALYB Canada,11,11,0,0,0,0
,ORIGINS GINZING 15ML EYE CREAM REFRESHING,ORIGINS GINZING 15ML EYE CREAM REFRESHING,Default,0,0,0,0,0,48
,ORIGINS GINZING 15ML EYE CREAM REFRESHING,ORIGINS GINZING 15ML EYE CREAM REFRESHING,Default Ridgefield,1366,1366,0,0,0,0
,ORIGINS GINZING 15ML EYE CREAM REFRESHING,ORIGINS GINZING 15ML EYE CREAM REFRESHING,FBALYB Amazon,223,201,22,22,22,0
,ORIGINS GINZING 50ML MOISTURIZERENERGY BOOST,ORIGINS OIL FREE GINZING 50ML MOISTURIZERENERGY BOOST,Default,0,-48,48,0,0,0
,ORIGINS GINZING 50ML MOISTURIZERENERGY BOOST,ORIGINS OIL FREE GINZING 50ML MOISTURIZERENERGY BOOST,Default Ridgefield,744,744,0,0,0,0
,ORIGINS GINZING 50ML MOISTURIZERENERGY BOOST,ORIGINS OIL FREE GINZING 50ML MOISTURIZERENERGY BOOST,FBALYB Amazon,648,644,4,1,4,0
,ORIGINS GINZING MOISTURIZER 1.7 OZ BOOSTING TI,ORIGINS GINZING MOISTURIZER 1.7 OZ BOOSTING TI,Default Ridgefield,740,740,0,0,0,0
,ORIGINS GINZING MOISTURIZER 1.7 OZ BOOSTING TI,ORIGINS GINZING MOISTURIZER 1.7 OZ BOOSTING TI,FBALYB Amazon,131,108,23,12,23,0
,ORIGINS GINZING MOISTURIZER 1.7 OZ ENERGY UPG,ORIGINS GINZING MOISTURIZER 1.7 OZ ENERGY UPG,FBALYB Amazon,-25,-25,0,4,0,0
,ORIGINS GINZING RICH CREAM 1.7 OZ ULTRA HYD.,ORIGINS GINZING RICH CREAM 1.7 OZ ULTRA HYD.,Default Ridgefield,1342,1342,0,0,0,0
,ORIGINS GINZING RICH CREAM 1.7 OZ ULTRA HYD.,ORIGINS GINZING RICH CREAM 1.7 OZ ULTRA HYD.,FBALYB Amazon,143,136,7,64,7,0
,ORIGINS GINZING RICH CREAM 1.7 OZ ULTRA HYD.,ORIGINS GINZING RICH CREAM 1.7 OZ ULTRA HYD.,FBALYB Canada,10,10,0,0,0,0
,ORIGINS MAKEADIFFERENCE CREAM 1.7 OZ ULTRA RI,ORIGINS MAKEADIFFERENCE CREAM 1.7 OZ ULTRA RI,Default Ridgefield,30,30,0,0,0,0
,ORIGINS MAKEADIFFERENCE CREAM 1.7 OZ ULTRA RI,ORIGINS MAKEADIFFERENCE CREAM 1.7 OZ ULTRA RI,FBALYB Amazon,1,1,0,0,0,0
,ORIGINS MEGA MUSHROOM TREAMENT 200ML LOTION,ORIGINS MEGA MUSHROOM TREAMENT 200ML LOTION,FBALYB Amazon,-22,-22,0,0,0,0
,ORIGINS MEGA MUSHROOM TREATMENT 200ML LOTION,ORIGINS MEGA MUSHROOM TREATMENT 200ML LOTION,Default Ridgefield,2563,2563,0,0,0,0
,ORIGINS MEGA MUSHROOM TREATMENT 200ML LOTION,ORIGINS MEGA MUSHROOM TREATMENT 200ML LOTION,FBALYB Amazon,375,373,2,5,2,0
,ORIGINS ORIGINAL MOISTURIZER 50ML MATTE WILLO,ORIGINS ORIGINAL MOISTURIZER 50ML MATTE WILLO,Default Ridgefield,1387,1387,0,0,0,0
,ORIGINS ORIGINAL MOISTURIZER 50ML MATTE WILLO,ORIGINS ORIGINAL MOISTURIZER 50ML MATTE WILLO,FBALYB Amazon,690,690,0,0,0,0
,ORIGINS PERFECT CLEANSER 5 OZ ANTIOXIDANT WHI,ORIGINS PERFECT CLEANSER 5 OZ ANTIOXIDANT WHI,Default Ridgefield,642,642,0,0,0,0
,ORIGINS PERFECT CLEANSER 5 OZ ANTIOXIDANT WHI,ORIGINS PERFECT CLEANSER 5 OZ ANTIOXIDANT WHI,FBALYB Amazon,9,7,2,6,2,0
,ORIGINS PERFECT MOISTURIZER 1.7 OZ AGE DEF. SPF,ORIGINS PERFECT MOISTURIZER 1.7 OZ AGE DEF. SPF,Default Ridgefield,32,32,0,0,0,0
,ORIGINS PERFECT MOISTURIZER 1.7 OZ AGE DEF. SPF,ORIGINS PERFECT MOISTURIZER 1.7 OZ AGE DEF. SPF,FBALYB Amazon,6,0,6,0,6,0
,ORIGINS PERFECT MOISTURIZER 1.7 OZ AGE DEF. SPF,ORIGINS PERFECT MOISTURIZER 1.7 OZ AGE DEF. SPF,FBALYB Canada,16,16,0,0,0,0
,ORIGINS PERFECT TREATMENT 5 OZ AGE DEF. WHITET,ORIGINS PERFECT TREATMENT 5 OZ AGE DEF. WHITET,Default,0,-88,88,0,0,0
,ORIGINS PERFECT TREATMENT 5 OZ AGE DEF. WHITET,ORIGINS PERFECT TREATMENT 5 OZ AGE DEF. WHITET,Default Ridgefield,20,20,0,0,0,0
,ORIGINS PERFECT TREATMENT 5 OZ AGE DEF. WHITET,ORIGINS PERFECT TREATMENT 5 OZ AGE DEF. WHITET,FBALYB Amazon,-4,-4,0,0,0,0
,ORIGINS PLANTSCRIPT 0.5 OZ ANTIAGING POWER EYE CREAM,ORIGINS PLANTSCRIPT 0.5 OZ ANTIAGING POWER EYE CREAM,Default Ridgefield,378,378,0,0,0,0
,ORIGINS PLANTSCRIPT 0.5 OZ ANTIAGING POWER EYE CREAM,ORIGINS PLANTSCRIPT 0.5 OZ ANTIAGING POWER EYE CREAM,FBALYB Amazon,70,67,3,0,3,0
,ORIGINS PLANTSCRIPT 0.5 OZ ANTIAGING TREATMENT,ORIGINS PLANTSCRIPT 0.5 OZ ANTIAGING TREATMENT,Default Ridgefield,480,480,0,0,0,0
,ORIGINS PLANTSCRIPT 0.5 OZ ANTIAGING TREATMENT,ORIGINS PLANTSCRIPT 0.5 OZ ANTIAGING TREATMENT,FBALYB Amazon,4,4,0,1,0,0
,ORIGINS PLANTSCRIPT 1.7 OZ ANTI-AGE SPF25 OILFR,ORIGINS PLANTSCRIPT 1.7 OZ ANTI-AGE SPF25 OILFR,Default Ridgefield,180,180,0,0,0,0
,ORIGINS PLANTSCRIPT 1.7 OZ ANTI-AGE SPF25 OILFR,ORIGINS PLANTSCRIPT 1.7 OZ ANTI-AGE SPF25 OILFR,FBALYB Amazon,52,42,10,0,10,0
,ORIGINS PLANTSCRIPT 1.7 OZ ANTI-AGING SPF25,ORIGINS PLANTSCRIPT 1.7 OZ ANTI-AGING SPF25,Default Ridgefield,409,409,0,0,0,0
,ORIGINS PLANTSCRIPT 1.7 OZ ANTI-AGING SPF25,ORIGINS PLANTSCRIPT 1.7 OZ ANTI-AGING SPF25,FBALYB Amazon,118,108,10,4,10,0
,ORIGINS PLANTSCRIPTION CLEANSER 150ML ANTI-AGI,ORIGINS PLANTSCRIPTION CLEANSER 150ML ANTI-AGI,Default,0,0,0,0,0,4
,ORIGINS PLANTSCRIPTION CLEANSER 150ML ANTI-AGI,ORIGINS PLANTSCRIPTION CLEANSER 150ML ANTI-AGI,Default Ridgefield,996,996,0,0,0,0
,ORIGINS PLANTSCRIPTION CLEANSER 150ML ANTI-AGI,ORIGINS PLANTSCRIPTION CLEANSER 150ML ANTI-AGI,FBALYB Amazon,211,196,15,2,15,0
,ORIGINS PLANTSCRIPT TREAMENT 5 OZ LOTION,ORIGINS PLANTSCRIPT TREAMENT 5 OZ LOTION,FBALYB Amazon,-2,-2,0,0,0,0
,ORIGINS TONIC 5 OZ BALANCING TONIC,ORIGINS TONIC 5 OZ BALANCING TONIC,FBALYB Amazon,10,10,0,0,0,0
,ORIGINS TREATMENT 0.3 OZ SUPERSPOTREMOVER AC,ORIGINS TREATMENT 0.3 OZ SUPERSPOTREMOVER AC,Default Ridgefield,1501,1501,0,0,0,0
,ORIGINS TREATMENT 0.3 OZ SUPERSPOTREMOVER AC,ORIGINS TREATMENT 0.3 OZ SUPERSPOTREMOVER AC,FBALYB Amazon,975,949,26,0,26,0
,ORIGINS VITAZING MOISTURIZER 1.7 OZ SPF15 ENER,ORIGINS VITAZING MOISTURIZER 1.7 OZ SPF15 ENER,FBALYB Amazon,49,32,17,1,17,0
,Orville Popcorn Kernels 5lb,"Orville Redenbacher's Gourmet Popcorn Kernels, Original Yellow, 5 lb, 12 oz ",FBALYB Amazon,26,26,0,0,0,0
,Orville Popcorn Kernels 5lb 2pk,Orville Popcorn Kernels 5lb 2pk,FBALYB Amazon,2,2,0,0,0,0
,"OSBORNE, BARRAGE, TANTO, AXA 583BK","OSBORNE, BARRAGE, TANTO, AXA 583BK",FBALYB Amazon,-4,-4,0,30,0,0
,"OSBORNE, BARRAGE, TANTO, AXA 583SBK","OSBORNE, BARRAGE, TANTO, AXA 583SBK",Avrami - Ebay,5,5,0,0,0,0
,"OSBORNE, BARRAGE, TANTO, AXA 583SBK","OSBORNE, BARRAGE, TANTO, AXA 583SBK",FBALYB Amazon,-8,-8,0,2,0,0
,"OSBORNE, REVERSE TANTO, AXIS 940-1","OSBORNE, REVERSE TANTO, AXIS 940-1 ",Default Ridgefield,3,3,0,0,0,0
,"OSBORNE, REVERSE TANTO, AXIS 940-1","OSBORNE, REVERSE TANTO, AXIS 940-1 ",FBALYB Amazon,-4,-6,2,0,2,0
,"OSBORNE, REVERSE TANTO, AXIS 940-2","OSBORNE, REVERSE TANTO, AXIS 940-2",Default Ridgefield,20,20,0,0,0,0
,"OSBORNE, REVERSE TANTO, AXIS 940-2","OSBORNE, REVERSE TANTO, AXIS 940-2",FBALYB Amazon,-17,-21,4,1,4,0
,Osprey Aether AG 60 Adriondack Green - LG,Osprey Aether AG 60 Adriondack Green - LG,FBALYB Amazon,13,13,0,0,0,0
,Osprey Aether AG 60 Adriondack Green - MD,Osprey Aether AG 60 Adriondack Green - MD,FBALYB Amazon,4,4,0,0,0,0
,Osprey Airporter - M,Osprey Airporter - M,FBALYB Amazon,-4,-4,0,0,0,0
,Osprey Airporter - S,Osprey Airporter - S,FBALYB Amazon,-1,-1,0,0,0,0
,Osprey Arcane Large Day Stonewash Black_SIZE - O/S,Osprey Arcane Large Day Stonewash Black_SIZE - O/S,FBALYB Amazon,-27,-27,0,0,0,0
,Osprey Arcane Small Day Stonewash Black_SIZE - O/S,Osprey Arcane Small Day Stonewash Black_SIZE - O/S,FBALYB Amazon,35,35,0,12,0,0
,Osprey Atmos AG 65 Abyss Grey - LG,Osprey Atmos AG 65 Abyss Grey - LG,Default,0,0,0,0,0,1
,Osprey Atmos AG 65 Abyss Grey - LG,Osprey Atmos AG 65 Abyss Grey - LG,FBALYB Amazon,-9,-9,0,0,0,0
,Osprey Atmos AG 65 Abyss Grey - MD,Osprey Atmos AG 65 Abyss Grey - MD,Default,1,1,0,0,0,0
,Osprey Atmos AG 65 Abyss Grey - MD,Osprey Atmos AG 65 Abyss Grey - MD,FBALYB Amazon,-6,-6,0,0,0,0
,Osprey Atmos AG 65 LG Rigby Red,Osprey Atmos AG 65 LG Rigby Red,Default Ridgefield,7,7,0,0,0,0
,Osprey Atmos AG 65 MD Rigby Red,Osprey Atmos AG 65 MD Rigby Red,Default Ridgefield,12,12,0,0,0,0
,Osprey Atmos AG 65 Unity Blue - LG,Osprey Atmos AG 65 Unity Blue - LG,FBALYB Amazon,-3,-3,0,0,0,0
,Osprey Atmos AG 65 Unity Blue - MD,Osprey Atmos AG 65 Unity Blue - MD,FBALYB Amazon,44,44,0,0,0,0
,Osprey Daylite Cosmic Red O/S,Osprey Daylite Cosmic Red O/S,FBALYB Amazon,50,47,3,0,3,0
,Osprey Daylite Dream Purple O/S,Osprey Daylite Dream Purple O/S,Default Ridgefield,1,1,0,0,0,0
,Osprey Daylite Dream Purple O/S,Osprey Daylite Dream Purple O/S,FBALYB Amazon,39,29,10,0,10,0
,Osprey Daylite Granny Smith Green - O/S,Osprey Daylite Granny Smith Green - O/S,FBALYB Amazon,30,30,0,0,0,0
,Osprey Daylite Plus Aluminum Grey O/S,Osprey Daylite Plus Aluminum Grey O/S,FBALYB Amazon,188,186,2,0,2,0
,Osprey Daylite Plus Amulet Purple_SIZE - O/S,Osprey Daylite Plus Amulet Purple_SIZE - O/S,FBALYB Amazon,-19,-20,1,0,1,0
,Osprey Daylite Plus Black_SIZE - O/S,Osprey Daylite Plus Black_SIZE - O/S,Default Ridgefield,2,2,0,0,0,0
,Osprey Daylite Plus Black_SIZE - O/S,Osprey Daylite Plus Black_SIZE - O/S,FBALYB Amazon,127,126,1,5,1,0
,Osprey Daylite Plus Cosmic Red O/S,Osprey Daylite Plus Cosmic Red O/S,FBALYB Amazon,107,106,1,0,1,0
,Osprey Daylite Plus Dream Purple O/S,Osprey Daylite Plus Dream Purple O/S,Default Ridgefield,12,12,0,0,0,0
,Osprey Daylite Plus Dream Purple O/S,Osprey Daylite Plus Dream Purple O/S,FBALYB Amazon,97,97,0,0,0,0
,Osprey Daylite Plus Petrol Blue - O/S,Osprey Daylite Plus Petrol Blue - O/S,FBALYB Amazon,-1,-1,0,0,0,0
,Osprey Daylite Plus Real Red - O/S,Osprey Daylite Plus Real Red - O/S,Default Ridgefield,15,15,0,0,0,0
,Osprey Daylite Plus Real Red - O/S,Osprey Daylite Plus Real Red - O/S,FBALYB Amazon,-5,-5,0,0,0,0
,Osprey Daylite Plus Wave Blue O/S,Osprey Daylite Plus Wave Blue O/S,FBALYB Amazon,-3,-3,0,0,0,0
,Osprey Daylite Sling Amulet Purple - O/S,Osprey Daylite Sling Amulet Purple - O/S,FBALYB Amazon,-2,-2,0,0,0,0
,Osprey Daylite Sling Petrol Blue - O/S,Osprey Daylite Sling Petrol Blue - O/S,FBALYB Amazon,-5,-5,0,0,0,0
,Osprey Daylite Travel Amulet Purple - O/S,Osprey Daylite Travel Amulet Purple - O/S,FBALYB Amazon,-12,-12,0,0,0,0
,Osprey Daylite Travel Black - O/S,Osprey Daylite Travel Black - O/S,Default Ridgefield,298,298,0,0,0,0
,Osprey Daylite Travel Black - O/S,Osprey Daylite Travel Black - O/S,FBALYB Amazon,84,84,0,0,0,0
,Osprey Daylite Travel Petrol Blue - O/S,Osprey Daylite Travel Petrol Blue - O/S,FBALYB Amazon,-2,-2,0,0,0,0
,Osprey Daylite Wave Blue O/S,Osprey Daylite Wave Blue O/S,Default Ridgefield,160,160,0,0,0,0
,Osprey Duro 6 Phoenix Red - M/L,Osprey Duro 6 Phoenix Red - M/L,FBALYB Amazon,6,6,0,0,0,0
,Osprey Duro 6 Phoenix Red - S/M,Osprey Duro 6 Phoenix Red - S/M,FBALYB Amazon,-3,-3,0,0,0,0
,Osprey Exos 48 Blaze Black - LG,Osprey Exos 48 Blaze Black - LG,Default Ridgefield,35,35,0,0,0,0
,Osprey Exos 48 Blaze Black - LG,Osprey Exos 48 Blaze Black - LG,FBAFBA LYB AUSTRALIA,0,0,0,5,0,0
,Osprey Exos 48 Blaze Black - LG,Osprey Exos 48 Blaze Black - LG,FBALYB Amazon,10,10,0,0,0,0
,Osprey Exos 48 Blaze Black - MD,Osprey Exos 48 Blaze Black - MD,Default Ridgefield,2,2,0,0,0,0
,Osprey Exos 48 Blaze Black - MD,Osprey Exos 48 Blaze Black - MD,FBALYB Amazon,66,66,0,0,0,0
,Osprey Exos 58 Blaze Black - LG,Osprey Exos 58 Blaze Black - LG,FBALYB Amazon,-3,-3,0,0,0,0
,Osprey Exos 58 Tunnel Green - LG,Osprey Exos 58 Tunnel Green - LG,FBALYB Amazon,-1,-1,0,0,0,0
,Osprey Fairview 40 Misty Grey_SIZE - WS/WM,Osprey Fairview 40 Misty Grey_SIZE - WS/WM,FBALYB Amazon,25,25,0,0,0,0
,Osprey Fairview 40 Misty Grey - WS/WM,Osprey Fairview 40 Misty Grey - WS/WM,Default Ridgefield,256,256,0,0,0,0
,Osprey Fairview 40 Misty Grey - WS/WM,Osprey Fairview 40 Misty Grey - WS/WM,FBALYB Amazon,140,134,6,1,6,0
,Osprey Fairview 40 Misty Grey XS/S,Osprey Fairview 40 Misty Grey XS/S,Default Ridgefield,233,233,0,0,0,0
,Osprey Fairview 40 Rainforest Green_SIZE - WS/WM,Osprey Fairview 40 Rainforest Green_SIZE - WS/WM,Default Ridgefield,0,-2,2,0,0,0
,Osprey Fairview 40 Rainforest Green_SIZE - WS/WM,Osprey Fairview 40 Rainforest Green_SIZE - WS/WM,FBALYB Amazon,125,124,1,0,1,0
,Osprey Fairview 40 RGreen XS/S,Osprey Fairview 40 Rainforest Green XS/S,Default Ridgefield,114,114,0,0,0,0
,Osprey Fairview 55 Misty Grey S/M,Osprey Fairview 55 Misty Grey S/M,Default Ridgefield,221,221,0,0,0,0
,Osprey Fairview 55 RGreen S/M,Osprey Fairview 55 Rainforest Green S/M,Default Ridgefield,116,116,0,0,0,0
,Osprey Fairview 70 Misty Grey S/M,Osprey Fairview 70 Misty Grey S/M,Default Ridgefield,44,44,0,0,0,0
,Osprey Fairview 70 Misty Grey S/M,Osprey Fairview 70 Misty Grey S/M,FBALYB Amazon,36,35,1,0,1,0
,Osprey Farpoint 40 Jasper Red_SIZE - M/L,Osprey Farpoint 40 Jasper Red_SIZE - M/L,Default Ridgefield,11,11,0,0,0,0
,Osprey Farpoint 40 Jasper Red_SIZE - M/L,Osprey Farpoint 40 Jasper Red_SIZE - M/L,FBALYB Amazon,-3,-3,0,1,0,0
,Osprey Farpoint 40 Jasper Red - S/M,Osprey Farpoint 40 Jasper Red - S/M,Default Ridgefield,4,4,0,0,0,0
,Osprey Farpoint 40 Jasper Red - S/M,Osprey Farpoint 40 Jasper Red - S/M,FBALYB Amazon,37,37,0,0,0,0
,Osprey Farpoint 40 Volcanic Grey_SIZE - M/L,Osprey Farpoint 40 Volcanic Grey_SIZE - M/L,Default,0,0,0,0,0,2
,Osprey Farpoint 40 Volcanic Grey_SIZE - M/L,Osprey Farpoint 40 Volcanic Grey_SIZE - M/L,Default Ridgefield,131,131,0,0,0,0
,Osprey Farpoint 40 Volcanic Grey_SIZE - M/L,Osprey Farpoint 40 Volcanic Grey_SIZE - M/L,FBAFBA LYB AUSTRALIA,0,0,0,5,0,0
,Osprey Farpoint 40 Volcanic Grey_SIZE - M/L,Osprey Farpoint 40 Volcanic Grey_SIZE - M/L,FBALYB Amazon,211,207,4,0,4,0
,Osprey Farpoint 40 Volcanic Grey_SIZE - M/L,Osprey Farpoint 40 Volcanic Grey_SIZE - M/L,FBALYB Canada,0,-1,1,0,1,0
,Osprey Farpoint 40 Volcanic Grey_SIZE - S/M,Osprey Farpoint 40 Volcanic Grey_SIZE - S/M,Default Ridgefield,331,331,0,0,0,0
,Osprey Farpoint 40 Volcanic Grey_SIZE - S/M,Osprey Farpoint 40 Volcanic Grey_SIZE - S/M,FBALYB Amazon,239,234,5,0,5,0
,Osprey Farpoint 55 Jasper Red_SIZE - M/L,Osprey Farpoint 55 Jasper Red_SIZE - M/L,Default Ridgefield,111,111,0,0,0,0
,Osprey Farpoint 55 S/M Jasper Red,Osprey Farpoint 55 S/M Jasper Red,Default Ridgefield,129,129,0,0,0,0
,Osprey Farpoint 55 S/M Jasper Red,Osprey Farpoint 55 S/M Jasper Red,FBALYB Amazon,6,6,0,0,0,0
,Osprey Farpoint 55 Volcanic Grey_SIZE - M/L,Osprey Farpoint 55 Volcanic Grey_SIZE - M/L,Default Ridgefield,158,158,0,0,0,0
,Osprey Farpoint 55 Volcanic Grey_SIZE - M/L,Osprey Farpoint 55 Volcanic Grey_SIZE - M/L,FBALYB Amazon,100,98,2,0,2,0
,Osprey Farpoint 55 Volcanic Grey_SIZE - S/M,Osprey Farpoint 55 Volcanic Grey_SIZE - S/M,FBALYB Amazon,54,51,3,0,3,0
,Osprey Farpoint 70 Jasper Red M/L,Osprey Farpoint 70 Jasper Red M/L,Default Ridgefield,56,56,0,0,0,0
,Osprey Farpoint 70 Jasper Red M/L,Osprey Farpoint 70 Jasper Red M/L,FBALYB Amazon,38,37,1,0,1,0
,Osprey Farpoint 70 Volcanic Grey M/L,Osprey Farpoint 70 VGry M/L,Default Ridgefield,239,239,0,0,0,0
,Osprey Farpoint 70 Volcnic Gry S/M,Osprey Farpoint 70 Volcanic Grey S/M,Default Ridgefield,76,76,0,0,0,0
,Osprey Hikelite 18 O/S Aloe Green,Osprey Hikelite 18 O/S Aloe Green,FBALYB Amazon,-2,-2,0,0,0,0
,Osprey Hikelite 18 O/S Black,Osprey Hikelite 18 O/S Black,FBALYB Amazon,-2,-2,0,0,0,0
,Osprey Hikelite 26 Black - O/S,Osprey Hikelite 26 Black - O/S,FBALYB Amazon,-14,-15,1,0,1,0
,Osprey Hikelite 26 O/S Aloe Green,Osprey Hikelite 26 O/S Aloe Green,FBALYB Amazon,-2,-2,0,0,0,0
,Osprey Hikelite 26 O/S Bacca Blue,Osprey Hikelite 26 O/S Bacca Blue,FBALYB Amazon,-3,-3,0,0,0,0
,Osprey Hikelite 26 Shiitake Grey - O/S,Osprey Hikelite 26 Shiitake Grey - O/S,FBALYB Amazon,-5,-6,1,0,1,0
,Osprey Katari 7 Black O/S,Osprey Katari 7 Black O/S,Default Ridgefield,47,47,0,0,0,0
,Osprey Katari 7 Black O/S,Osprey Katari 7 Black O/S,FBALYB Amazon,3,2,1,0,1,0
,Osprey Katari 7 Cobalt Blue O/S,Osprey Katari 7 Cobalt Blue O/S,Default Ridgefield,12,12,0,0,0,0
,Osprey Katari 7 Lime Stone O/S,Osprey Katari 7 Lime Stone O/S,Default Ridgefield,30,30,0,0,0,0
,Osprey Katari 7 Lime Stone O/S,Osprey Katari 7 Lime Stone O/S,FBALYB Amazon,21,20,1,0,1,0
,Osprey Kestrel 48 Black - M/L,Osprey Kestrel 48 Black - M/L,FBALYB Amazon,2,0,2,0,2,0
,Osprey Kestrel 48 Loch Blue - M/L,Osprey Kestrel 48 Loch Blue - M/L,Default Ridgefield,10,10,0,0,0,0
,Osprey Kestrel 48 Loch Blue - M/L,Osprey Kestrel 48 Loch Blue - M/L,FBALYB Amazon,43,43,0,0,0,0
,Osprey Manta 24 Black O/S,Osprey Manta 24 Black O/S,Default Ridgefield,100,100,0,0,0,0
,Osprey Manta 24 Black O/S,Osprey Manta 24 Black O/S,FBALYB Amazon,48,48,0,0,0,0
,Osprey Manta 24 Green Shade O/S,Osprey Manta 24 Green Shade O/S,FBALYB Amazon,98,98,0,0,0,0
,Osprey Manta 34 Black - O/S,Osprey Manta 34 Black - O/S,FBALYB Amazon,34,34,0,0,0,0
,Osprey Manta 34 Green Shade O/S,Osprey Manta 34 Green Shade O/S,FBALYB Amazon,9,8,1,0,1,0
,Osprey Nebula Black O/S,Osprey Nebula Black O/S,Default Ridgefield,0,-5,5,0,0,0
,Osprey Nebula Black O/S,Osprey Nebula Black O/S,FBALYB Amazon,80,79,1,0,1,0
,Osprey Nebula Kraken Blue O/S,Osprey Nebula Kraken Blue O/S,FBALYB Amazon,-2,-2,0,0,0,0
,Osprey Nebula Sentinel Grey O/S,Osprey Nebula Sentinel Grey O/S,FBALYB Amazon,3,3,0,0,0,0
,Osprey Poco Plus Child Carrier Starry Black O/S,Osprey Poco Plus Child Carrier Starry Black O/S,Default Ridgefield,16,16,0,0,0,0
,Osprey Poco Plus Child Carrier Starry Black O/S,Osprey Poco Plus Child Carrier Starry Black O/S,FBALYB Amazon,13,8,5,0,5,0
,Osprey Porter 30 Black_SIZE - O/S,Osprey Porter 30 Black_SIZE - O/S,FBALYB Amazon,-9,-11,2,10,2,0
,Osprey Porter 30 Castle Grey_SIZE - O/S,Osprey Porter 30 Castle Grey_SIZE - O/S,FBALYB Amazon,73,67,6,1,6,0
,Osprey Porter 30 Mineral Teal - O/S,Osprey Porter 30 Mineral Teal - O/S,FBALYB Amazon,-37,-37,0,30,0,0
,Osprey Porter 46 Black_SIZE - O/S,Osprey Porter 46 Black_SIZE - O/S,FBALYB Amazon,5,2,3,0,3,0
,Osprey Porter 46 Castle Grey_SIZE - O/S,Osprey Porter 46 Castle Grey_SIZE - O/S,FBALYB Amazon,-4,-4,0,0,0,0
,Osprey Porter 46 Diablo Red_SIZE - O/S,Osprey Porter 46 Diablo Red_SIZE - O/S,Default Ridgefield,242,242,0,0,0,0
,Osprey Porter 46 Diablo Red_SIZE - O/S,Osprey Porter 46 Diablo Red_SIZE - O/S,FBALYB Amazon,44,44,0,0,0,0
,Osprey Porter 46 Mineral Teal_SIZE - O/S,Osprey Porter 46 Mineral Teal_SIZE - O/S,FBALYB Amazon,-2,-2,0,0,0,0
,Osprey Raptor 10 O/S Black,Osprey Raptor 10 O/S Black,Default Ridgefield,117,117,0,0,0,0
,Osprey Raptor 10 O/S Black,Osprey Raptor 10 O/S Black,FBALYB Amazon,-11,-14,3,0,3,0
,Osprey Raptor 10 O/S Cedar Green,Osprey Raptor 10 O/S Cedar Green,FBALYB Amazon,125,125,0,0,0,0
,Osprey Raptor 10 O/S Wildfire Red,Osprey Raptor 10 O/S Wildfire Red,Default Ridgefield,2,2,0,0,0,0
,Osprey Raptor 10 O/S Wildfire Red,Osprey Raptor 10 O/S Wildfire Red,FBALYB Amazon,-1,-1,0,11,0,0
,Osprey Raptor 14 O/S Black,Osprey Raptor 14 O/S Black,Default Ridgefield,10,10,0,0,0,0
,Osprey Raptor 14 O/S Black,Osprey Raptor 14 O/S Black,FBALYB Amazon,6,3,3,1,3,0
,Osprey Raptor 14 O/S Cedar Green,Osprey Raptor 14 O/S Cedar Green,Default Ridgefield,10,10,0,0,0,0
,Osprey Raptor 14 O/S Cedar Green,Osprey Raptor 14 O/S Cedar Green,FBALYB Amazon,3,1,2,0,2,0
,Osprey Raptor 14 O/S Wildfire Red,Osprey Raptor 14 O/S Wildfire Red,FBALYB Amazon,36,35,1,0,1,0
,Osprey Renn 50 Cinder Grey - O/S,Osprey Renn 50 Cinder Grey - O/S,FBALYB Amazon,-3,-3,0,0,0,0
,Osprey Rook 50 Black - O/S,Osprey Rook 50 Black - O/S,FBALYB Amazon,42,42,0,0,0,0
,Osprey Rook 50 Mallard Green - O/S,Osprey Rook 50 Mallard Green - O/S,FBALYB Amazon,17,17,0,0,0,0
,Osprey Rook 65 Black - O/S,Osprey Rook 65 Black - O/S,FBALYB Amazon,-8,-9,1,6,1,0
,Osprey Rook 65 Mallard Green - O/S,Osprey Rook 65 Mallard Green - O/S,Default Ridgefield,29,29,0,0,0,0
,Osprey Rook 65 Mallard Green - O/S,Osprey Rook 65 Mallard Green - O/S,FBALYB Amazon,-24,-24,0,12,0,0
,Osprey Sirrus 24 O/S Black,Osprey Sirrus 24 O/S Black,FBALYB Amazon,-3,-3,0,0,0,0
,Osprey Sirrus 24 O/S Summit Blue,Osprey Sirrus 24 O/S Summit Blue,FBALYB Amazon,-4,-4,0,0,0,0
,Osprey Skarab 22 O/S Black,Osprey Skarab 22 O/S Black,Default Ridgefield,42,42,0,0,0,0
,Osprey Skarab 22 O/S Deep Blue,Osprey Skarab 22 O/S Deep Blue,Default Ridgefield,9,9,0,0,0,0
,Osprey Skarab 22 O/S Deep Blue,Osprey Skarab 22 O/S Deep Blue,FBALYB Amazon,28,27,1,0,1,0
,Osprey Skarab 30 O/S Black,Osprey Skarab 30 O/S Black,Default Ridgefield,5,5,0,0,0,0
,Osprey Skarab 30 O/S Black,Osprey Skarab 30 O/S Black,FBALYB Amazon,38,38,0,0,0,0
,Osprey Skarab 30 O/S Deep Blue,Osprey Skarab 30 O/S Deep Blue,FBALYB Amazon,16,16,0,0,0,0
,Osprey Skarab 30 O/S Mystic Red,Osprey Skarab 30 O/S Mystic Red,FBALYB Amazon,35,34,1,0,1,0
,Osprey Stratos 24 Black - O/S,Osprey Stratos 24 Black - O/S,Default Ridgefield,4,4,0,0,0,0
,Osprey Stratos 24 Black - O/S,Osprey Stratos 24 Black - O/S,FBALYB Amazon,-6,-8,2,0,2,0
,Osprey Stratos 24 Eclipse Blue - O/S,Osprey Stratos 24 Eclipse Blue - O/S,FBALYB Amazon,25,25,0,0,0,0
,Osprey Stratos 24 Gator Green_SIZE - O/S,Osprey Stratos 24 Gator Green_SIZE - O/S,FBALYB Amazon,-15,-15,0,0,0,0
,Osprey Stratos 34 Black - M/L,Osprey Stratos 34 Black - M/L,FBALYB Amazon,-10,-10,0,0,0,0
,Osprey Stratos 34 Black - S/M,Osprey Stratos 34 Black - S/M,FBALYB Amazon,-4,-4,0,0,0,0
,Osprey Stratos 36 Black - S/M,Osprey Stratos 36 Black - S/M,FBALYB Amazon,-2,-2,0,0,0,0
,Osprey Stratos 36 Eclipse Blue - M/L,Osprey Stratos 36 Eclipse Blue - M/L,FBALYB Amazon,-5,-5,0,0,0,0
,Osprey Stratos 36 Gator Green - M/L,Osprey Stratos 36 Gator Green - M/L,FBALYB Amazon,-2,-2,0,0,0,0
,Osprey Stratos 36 Gator Green - S/M,Osprey Stratos 36 Gator Green - S/M,Default Ridgefield,5,5,0,0,0,0
,Osprey Stratos 50 M/L Black,Osprey Stratos 50 M/L Black,Default Ridgefield,100,100,0,0,0,0
,Osprey Syncro 12 O/S Black,Osprey Syncro 12 O/S Black,Default Ridgefield,1,1,0,0,0,0
,Osprey Syncro 12 O/S Black,Osprey Syncro 12 O/S Black,FBALYB Amazon,28,26,2,0,2,0
,Osprey Syncro 12 O/S Firebelly Red,Osprey Syncro 12 O/S Firebelly Red,FBALYB Amazon,5,5,0,0,0,0
,Osprey Syncro 12 O/S Wolf Grey,Osprey Syncro 12 O/S Wolf Grey,Default Ridgefield,1,1,0,0,0,0
,Osprey Syncro 12 O/S Wolf Grey,Osprey Syncro 12 O/S Wolf Grey,FBALYB Amazon,50,50,0,0,0,0
,Osprey Talon 11 Ceramic Blue L/XL,Osprey Talon 11 Ceramic Blue L/XL,FBALYB Amazon,86,86,0,0,0,0
,Osprey Talon 11 Ceramic Blue S/M,Osprey Talon 11 Ceramic Blue S/M,FBALYB Amazon,24,24,0,0,0,0
,Osprey Talon 11 Cosmic Red L/XL,Osprey Talon 11 Cosmic Red L/XL,FBALYB Amazon,61,60,1,0,1,0
,Osprey Talon 11 Cosmic Red S/M,Osprey Talon 11 Cosmic Red S/M,FBALYB Amazon,7,5,2,0,2,0
,Osprey Talon 11 Limon Green L/XL,Osprey Talon 11 Limon Green L/XL,Default Ridgefield,50,50,0,0,0,0
,Osprey Talon 11 Limon Green S/M,Osprey Talon 11 Limon Green S/M,Default Ridgefield,10,10,0,0,0,0
,Osprey Talon 11 Stealth Black L/XL,Osprey Talon 11 Stealth Black L/XL,Default Ridgefield,15,15,0,0,0,0
,Osprey Talon 11 Stealth Black L/XL,Osprey Talon 11 Stealth Black L/XL,FBALYB Amazon,103,103,0,0,0,0
,Osprey Talon 11 Stealth Black S/M,Osprey Talon 11 Stealth Black S/M,FBALYB Amazon,42,42,0,0,0,0
,Osprey Talon 22 Black_SIZE - M/L,Osprey Talon 22 Black_SIZE - M/L,Default,2,2,0,0,0,0
,Osprey Talon 22 Black_SIZE - M/L,Osprey Talon 22 Black_SIZE - M/L,FBALYB Amazon,-19,-19,0,0,0,0
,Osprey Talon 22 Black - S/M,Osprey Talon 22 Black - S/M,FBALYB Amazon,-6,-6,0,0,0,0
,Osprey Talon 22 Ceramic Blue L/XL,Osprey Talon 22 Ceramic Blue L/XL,Default Ridgefield,350,350,0,0,0,0
,Osprey Talon 22 Ceramic Blue L/XL,Osprey Talon 22 Ceramic Blue L/XL,FBALYB Amazon,83,82,1,2,1,0
,Osprey Talon 22 Ceramic Blue S/M,Osprey Talon 22 Ceramic Blue S/M,FBALYB Amazon,-2,-2,0,0,0,0
,Osprey Talon 22 Cosmic Red L/XL,Osprey Talon 22 Cosmic Red L/XL,Default Ridgefield,11,11,0,0,0,0
,Osprey Talon 22 Cosmic Red L/XL,Osprey Talon 22 Cosmic Red L/XL,FBALYB Amazon,65,65,0,0,0,0
,Osprey Talon 22 Cosmic Red S/M,Osprey Talon 22 Cosmic Red S/M,FBALYB Amazon,-3,-3,0,0,0,0
,Osprey Talon 22 Limon Green L/XL,Osprey Talon 22 Limon Green L/XL,Default Ridgefield,329,329,0,0,0,0
,Osprey Talon 22 Limon Green L/XL,Osprey Talon 22 Limon Green L/XL,FBAFBA LYB AUSTRALIA,0,0,0,10,0,0
,Osprey Talon 22 Limon Green S/M,Osprey Talon 22 Limon Green S/M,Default Ridgefield,20,20,0,0,0,0
,Osprey Talon 22 Martian Red - M/L,Osprey Talon 22 Martian Red - M/L,FBALYB Amazon,12,12,0,0,0,0
,Osprey Talon 22 Martian Red - S/M,Osprey Talon 22 Martian Red - S/M,Default,0,0,0,0,0,4
,Osprey Talon 22 Martian Red - S/M,Osprey Talon 22 Martian Red - S/M,FBALYB Amazon,-7,-7,0,0,0,0
,Osprey Talon 22 Stealth Black L/XL,Osprey Talon 22 Stealth Black L/XL,FBALYB Amazon,450,450,0,0,0,0
,Osprey Talon 22 Stealth Black S/M,Osprey Talon 22 Stealth Black S/M,FBALYB Amazon,-1,-1,0,0,0,0
,Osprey Talon 22 Ultramarine Blue_SIZE - M/L,Osprey Talon 22 Ultramarine Blue_SIZE - M/L,FBALYB Amazon,286,286,0,0,0,0
,Osprey Talon 22 Yerba Green - M/L,Osprey Talon 22 Yerba Green - M/L,FBALYB Amazon,5,5,0,0,0,0
,Osprey Talon 33 Black - M/L,Osprey Talon 33 Black - M/L,Default Ridgefield,47,47,0,0,0,0
,Osprey Talon 33 Black - M/L,Osprey Talon 33 Black - M/L,FBALYB Amazon,25,25,0,0,0,0
,Osprey Talon 33 Ceramic Blue L/XL,Osprey Talon 33 Ceramic Blue L/XL,FBALYB Amazon,77,77,0,0,0,0
,Osprey Talon 33 Ceramic Blue S/M,Osprey Talon 33 Ceramic Blue S/M,FBALYB Amazon,19,19,0,0,0,0
,Osprey Talon 33 Cosmic Red L/XL,Osprey Talon 33 Cosmic Red L/XL,Default Ridgefield,6,6,0,0,0,0
,Osprey Talon 33 Cosmic Red L/XL,Osprey Talon 33 Cosmic Red L/XL,FBALYB Amazon,51,50,1,1,1,0
,Osprey Talon 33 Cosmic Red S/M,Osprey Talon 33 Cosmic Red S/M,FBALYB Amazon,13,13,0,0,0,0
,Osprey Talon 33 Martian Red - M/L,Osprey Talon 33 Martian Red - M/L,FBALYB Amazon,-2,-2,0,0,0,0
,Osprey Talon 33 Martian Red - S/M,Osprey Talon 33 Martian Red - S/M,FBALYB Amazon,-1,-1,0,0,0,0
,Osprey Talon 33 Stealth Black L/XL,Osprey Talon 33 Stealth Black L/XL,FBALYB Amazon,101,101,0,0,0,0
,Osprey Talon 33 Stealth Black S/M,Osprey Talon 33 Stealth Black S/M,Default Ridgefield,0,-39,39,0,0,0
,Osprey Talon 33 Stealth Black S/M,Osprey Talon 33 Stealth Black S/M,FBALYB Amazon,43,43,0,0,0,0
,Osprey Talon 33 Ultramarine Blue - M/L,Osprey Talon 33 Ultramarine Blue - M/L,FBALYB Amazon,-5,-5,0,0,0,0
,Osprey Talon 33 Ultramarine Blue - S/M,Osprey Talon 33 Ultramarine Blue - S/M,FBALYB Amazon,-2,-2,0,0,0,0
,Osprey Talon 33 Yerba Green - M/L,Osprey Talon 33 Yerba Green - M/L,FBALYB Amazon,6,6,0,0,0,0
,Osprey Talon 6 Cosmic Red O/S,Osprey Talon 6 Cosmic Red O/S,Default Ridgefield,14,14,0,0,0,0
,Osprey Talon 6 Cosmic Red O/S,Osprey Talon 6 Cosmic Red O/S,FBALYB Amazon,25,25,0,0,0,0
,Osprey Talon 6 Stealth Black O/S,Osprey Talon 6 Stealth Black O/S,Default Ridgefield,20,20,0,0,0,0
,Osprey Talon 6 Stealth Black O/S,Osprey Talon 6 Stealth Black O/S,FBALYB Amazon,143,143,0,0,0,0
,Osprey Tempest 20 Jasper Green WM/L,Osprey Tempest 20 Jasper Green WM/L,FBALYB Amazon,73,72,1,0,1,0
,Osprey Tempest 20 Jasper Green WXS/S,Osprey Tempest 20 Jasper Green WXS/S,FBALYB Amazon,-10,-12,2,0,2,0
,Osprey Tempest 20 Stealth Black WM/L,Osprey Tempest 20 Stealth Black WM/L,FBALYB Amazon,64,64,0,0,0,0
,Osprey Tempest 20 Stealth Black WXS/S,Osprey Tempest 20 Stealth Black WXS/S,FBALYB Amazon,6,6,0,0,0,0
,Osprey Tempest 20 Violac Purple WM/L,Osprey Tempest 20 Violac Purple WM/L,Default Ridgefield,56,56,0,0,0,0
,Osprey Tempest 20 Violac Purple WM/L,Osprey Tempest 20 Violac Purple WM/L,FBALYB Amazon,80,80,0,3,0,0
,Osprey Tempest 20 Violac Purple WXS/S,Osprey Tempest 20 Violac Purple WXS/S,Default Ridgefield,0,-3,3,0,0,0
,Osprey Tempest 20 Violac Purple WXS/S,Osprey Tempest 20 Violac Purple WXS/S,FBALYB Amazon,51,50,1,9,1,0
,Osprey Tempest 40 Stealth Black WM/L,Osprey Tempest 40 Stealth Black WM/L,FBALYB Amazon,59,59,0,0,0,0
,Osprey Tempest 40 Stealth Black WXS/S,Osprey Tempest 40 Stealth Black WXS/S,FBALYB Amazon,37,37,0,0,0,0
,Osprey Tempest 40 Violac Purple WM/L,Osprey Tempest 40 Violac Purple WM/L,FBALYB Amazon,67,67,0,1,0,0
,Osprey Tempest 40 Violac Purple WXS/S,Osprey Tempest 40 Violac Purple WXS/S,Default Ridgefield,38,38,0,0,0,0
,Osprey Tempest 40 Violac Purple WXS/S,Osprey Tempest 40 Violac Purple WXS/S,FBALYB Amazon,14,14,0,0,0,0
,Osprey Tempest 9 Iris Blue - WS/WM,Osprey Tempest 9 Iris Blue - WS/WM,FBALYB Amazon,14,14,0,0,0,0
,Osprey Tempest 9 Jasper Green WM/L,Osprey Tempest 9 Jasper Green WM/L,FBALYB Amazon,25,25,0,0,0,0
,Osprey Tempest 9 Jasper Green WXS/S,Osprey Tempest 9 Jasper Green WXS/S,FBALYB Amazon,-4,-5,1,0,1,0
,Osprey Tempest 9 Stealth Black WM/L,Osprey Tempest 9 Stealth Black WM/L,Default Ridgefield,125,125,0,0,0,0
,Osprey Tempest 9 Stealth Black WM/L,Osprey Tempest 9 Stealth Black WM/L,FBALYB Amazon,27,27,0,0,0,0
,Osprey Tempest 9 Stealth Black WXS/S,Osprey Tempest 9 Stealth Black WXS/S,FBALYB Amazon,8,7,1,0,1,0
,Osprey Tempest 9 Violac Purple WM/L,Osprey Tempest 9 Violac Purple WM/L,Default Ridgefield,116,116,0,0,0,0
,Osprey Tempest 9 Violac Purple WXS/S,Osprey Tempest 9 Violac Purple WXS/S,FBALYB Amazon,-5,-5,0,0,0,0
,Osprey Transporter 65 Westwind Teal - O/S,Osprey Transporter 65 Westwind Teal - O/S,FBALYB Amazon,-1,-1,0,0,0,0
,Osprey Ultralight DrySack 12 Electric Lime,Osprey Ultralight DrySack 12 Electric Lime,FBALYB Amazon,-8,-8,0,0,0,0
,Osprey Ultralight DrySack 12 Poppy Orange,Osprey Ultralight DrySack 12 Poppy Orange,Default Ridgefield,78,78,0,0,0,0
,Osprey Ultralight DrySack 12 Poppy Orange,Osprey Ultralight DrySack 12 Poppy Orange,FBALYB Amazon,-5,-5,0,0,0,0
,Osprey Ultralight DrySack 12 Shadow Grey,Osprey Ultralight DrySack 12 Shadow Grey,Default,0,0,0,0,0,100
,Osprey Ultralight DrySack 12 Shadow Grey,Osprey Ultralight DrySack 12 Shadow Grey,FBALYB Amazon,-6,-6,0,0,0,0
,Osprey Ultralight DrySack 12 Tropic Teal,Osprey Ultralight DrySack 12 Tropic Teal,Default,0,0,0,0,0,100
,Osprey Ultralight DrySack 12 Tropic Teal,Osprey Ultralight DrySack 12 Tropic Teal,FBALYB Amazon,-6,-6,0,0,0,0
,Osprey Ultralight DrySack 20 Electric Lime,Osprey Ultralight DrySack 20 Electric Lime,FBALYB Amazon,-1,-1,0,0,0,0
,Osprey Ultralight DrySack 20 Poppy Orange,Osprey Ultralight DrySack 20 Poppy Orange,FBALYB Amazon,-1,-1,0,0,0,0
,Osprey Ultralight DrySack 20 Shadow Grey,Osprey Ultralight DrySack 20 Shadow Grey,Default,0,0,0,0,0,300
,Osprey Ultralight DrySack 20 Shadow Grey,Osprey Ultralight DrySack 20 Shadow Grey,FBALYB Amazon,-4,-4,0,0,0,0
,Osprey Ultralight DrySack 30 Poppy Orange,Osprey Ultralight DrySack 30 Poppy Orange,FBALYB Amazon,73,73,0,0,0,0
,Osprey Ultralight DrySack 30 Shadow Grey,Osprey Ultralight DrySack 30 Shadow Grey,FBALYB Amazon,-1,-1,0,0,0,0
,Osprey Ultralight DrySack 30 Tropic Teal,Osprey Ultralight DrySack 30 Tropic Teal,FBALYB Amazon,-1,-1,0,0,0,0
,Osprey Ultralight DrySack 6 Poppy Orange,Osprey Ultralight DrySack 6 Poppy Orange,FBALYB Amazon,-2,-2,0,0,0,0
,Osprey Ultralight DrySack 6 Shadow Grey,Osprey Ultralight DrySack 6 Shadow Grey,Default,0,0,0,0,0,50
,Osprey Ultralight DrySack 6 Shadow Grey,Osprey Ultralight DrySack 6 Shadow Grey,FBALYB Amazon,-1,-1,0,0,0,0
,Osprey Ultralight DrySack 6 Tropic Teal,Osprey Ultralight DrySack 6 Tropic Teal,FBALYB Amazon,-3,-3,0,0,0,0
,Osprey Ultralight Packing Cube Set Electric Lime - S/M/L,Osprey Ultralight Packing Cube Set Electric Lime - S/M/L,FBALYB Amazon,-5,-5,0,0,0,0
,Osprey Ultralight Packing Cube Set Shadow Grey - S/M/L,Osprey Ultralight Packing Cube Set Shadow Grey - S/M/L,FBALYB Amazon,6,1,5,0,5,0
,Osprey Ultralight Pack Liner Shadow Grey - L,Osprey Ultralight Pack Liner Shadow Grey - L,FBALYB Amazon,-2,-2,0,0,0,0
,Osprey Ultralight Pack Liner Shadow Grey - M,Osprey Ultralight Pack Liner Shadow Grey - M,FBALYB Amazon,-3,-3,0,0,0,0
,Osprey Ultralight Washbag Padded Poppy Orange,Osprey Ultralight Washbag Padded Poppy Orange,FBALYB Amazon,-4,-4,0,0,0,0
,Osprey Ultralight Washbag Roll Electric Lime,Osprey Ultralight Washbag Roll Electric Lime,Default Ridgefield,10,10,0,0,0,0
,Osprey Ultralight Washbag Roll Electric Lime,Osprey Ultralight Washbag Roll Electric Lime,FBALYB Amazon,89,88,1,0,1,0
,Osprey Ultralight Washbag Roll Poppy Orange,Osprey Ultralight Washbag Roll Poppy Orange,FBALYB Amazon,-7,-11,4,0,4,0
,Osprey Ultralight Washbag Zip Poppy Orange,Osprey Ultralight Washbag Zip Poppy Orange,FBALYB Amazon,-4,-4,0,0,0,0
,Osteo Bi-Flex,Osteo Bi-Flex,Default,0,-1120,1120,0,0,0
,Osteo Bi-Flex,Osteo Bi-Flex,FBALYB Amazon,148,148,0,0,0,0
,Osteo Bi-Flex 2pk,Osteo Bi-Flex 2pk,FBALYB Amazon,-24,-24,0,5,0,0
,"Osteo Bi-Flex Ease Tablets, 70 ct.","Osteo Bi-Flex Ease Tablets, 70 ct.",FBALYB Amazon,-8,-8,0,8,0,0
,"Osteo Bi-Flex Ease Tablets, 70 ct. 2pk","Osteo Bi-Flex Ease Tablets, 70 ct. 2pk",FBALYB Amazon,-4,-4,0,0,0,0
,Osteo Bi-Flex Glucosamine with MSM - 200 Tablets,Osteo Bi-Flex Glucosamine with MSM - 200 Tablets,Default,0,-2560,2560,0,0,0
,Osteo Bi-Flex Glucosamine with MSM - 200 Tablets 2PK,Osteo Bi-Flex Glucosamine with MSM - 200 Tablets 2PK,FBALYB Amazon,-2,-2,0,8,0,0
,Osteo Bi Flex Triple Strength 200 Orange Bottle,Osteo Bi Flex Triple Strength 200 Orange Bottle,Default,0,-960,960,0,0,0
,Osteo Bi Flex Triple Strength 200 Orange Bottle,Osteo Bi Flex Triple Strength 200 Orange Bottle,FBALYB Amazon,-27,-27,0,23,0,0
,Otostick,Otostick,Default,0,-200,200,0,0,0
,Otostick,Otostick,FBALYB Amazon,-36,-36,0,0,0,0
,Our Pet Cosmic 8 oz Catnip Spray Bottle,Our Pet Cosmic 8 oz Catnip Spray Bottle,FBALYB Amazon,10,10,0,0,0,0
,OurPets Catnip 24 Karat Cat Toy,OurPets Catnip 24 Karat Cat Toy,Default Ridgefield,95,95,0,0,0,0
,OurPets Catnip 24 Karat Cat Toy,OurPets Catnip 24 Karat Cat Toy,FBALYB Amazon,217,217,0,0,0,0
,OurPets Catnip 24 Karat Cat Toy,OurPets Catnip 24 Karat Cat Toy,FBALYB Canada,0,0,0,25,0,0
,Our Pets Catty Whack,Our Pets Catty Whack,Default,0,0,0,0,0,8
,Our Pets Catty Whack,Our Pets Catty Whack,FBALYB Amazon,-61,-61,0,64,0,0
,Ourpets Opb Bird In A Cage Toy Blue,Ourpets Opb Bird In A Cage Toy Blue,Default,0,0,0,0,0,16
,Our Pets Twinkle Mouse Light Up Cat Toy,Our Pets Twinkle Mouse Light Up Cat Toy,FBALYB Amazon,2,2,0,0,0,0
,Outward Hound Dog Toys Hedgehog,Outward Hound Dog Toys Hedgehog ,FBALYB Amazon,278,278,0,0,0,0
,Outward Hound Dog Toys Hedgehog 2pk,Outward Hound Dog Toys Hedgehog 2pk,FBALYB Amazon,118,118,0,0,0,0
,Outward Hound Fun Fish Dog Life Jacket Large,Outward Hound Fun Fish Dog Life Jacket Large,FBALYB Amazon,-3,-3,0,0,0,0
,Outward Hound Gator Squeaker Mat Toy,Outward Hound Gator Squeaker Mat Toy,Default,0,0,0,0,0,35
,Outward Hound Gator Squeaker Mat Toy,Outward Hound Gator Squeaker Mat Toy,Default Ridgefield,169,169,0,0,0,0
,Outward Hound Gator Squeaker Mat Toy,Outward Hound Gator Squeaker Mat Toy,FBALYB Amazon,36,36,0,0,0,0
,Outward Hound Invincibles Mini Duck,Outward Hound Invincibles Mini Duck,Default,0,0,0,0,0,1
,Outward Hound Invincibles Mini Duck 2pk,Outward Hound Invincibles Mini Duck 2pk,FBALYB Amazon,61,61,0,0,0,0
,Outward Hound Port Blue Medium 48oz 2pk,Outward Hound Port Blue Medium 48oz 2pk,FBALYB Amazon,10,10,0,0,0,0
,Outward Hound Snake Squeaker Toy,Outward Hound Invincibles Snake Squeaker Toy - Green & Blue,Default,0,0,0,0,0,35
,Outward Hound Snake Squeaker Toy,Outward Hound Invincibles Snake Squeaker Toy - Green & Blue,FBALYB Amazon,2,2,0,0,0,0
,Outward Hound Squeakin Eggs 3ct 2pk,Outward Hound Squeakin Eggs 3ct 2pk,FBALYB Amazon,1,1,0,0,0,0
,OWYN Choc Prtn Pwdr 1.1lb,OWYN Chocolate 20g Plant Protein Powder 1.1lb,Default Ridgefield,2,2,0,0,0,0
,OWYN Choc Prtn Pwdr 1.1lb,OWYN Chocolate 20g Plant Protein Powder 1.1lb,FBALYB Amazon,1872,1872,0,14,0,0
,OWYN Vanll Prtn Pwdr 1.05lb,OWYN Vanilla 20g Plant Protein Powder 1.05lb,FBALYB Amazon,1787,1783,4,5,4,0
,Oxbow Adult Guinea Pig 4lb,Oxbow Adult Guinea Pig 4lb,FBALYB Amazon,0,0,0,8,0,0
,Oxbow Adult Rabbit Food 4lb,Oxbow Adult Rabbit Food 4lb,FBALYB Amazon,15,15,0,0,0,0
,Oxbow Adult Rabbit Pet Food,Oxbow Animal Health Bunny Basics Essentials Adult Rabbit Pet Food,FBALYB Amazon,-5,-5,0,0,0,0
,Oxbow Animal Health Alfalfa Hay (15 Oz),Oxbow Animal Health Alfalfa Hay (15 Oz),Default,0,0,0,0,0,625
,Oxbow BeneTerra Meadow Hay 15oz,Oxbow BeneTerra Meadow Hay 15oz,Default,0,0,0,0,0,6
,Oxbow BeneTerra Meadow Hay 15oz 2pk,Oxbow BeneTerra Meadow Hay 15oz 2pk,FBALYB Amazon,-1,-1,0,0,0,0
,Oxbow Chinchilla Food 10lb,Oxbow Chinchilla Food 10lb,Default,0,0,0,0,0,8
,Oxbow Chinchilla Food 10lb,Oxbow Chinchilla Food 10lb,FBALYB Amazon,8,8,0,0,0,0
,Oxbow Essentials A Guinea Pig,Oxbow Essentials Adult Guinea Pig 10lbs,FBALYB Amazon,3,3,0,0,0,0
,Oxbow Hamster Gerbil 1.5lb,Oxbow Hamster Gerbil 1.5lb,FBALYB Amazon,1,1,0,0,0,0
,Oxbow Harvest Stack Western Timothy Hay,Oxbow Harvest Stack Western Timothy Hay,FBALYB Amazon,-1,-1,0,0,0,0
,Oxbow Health Orchard Grass Hay 15oz,Oxbow Health Orchard Grass Hay 15oz,FBALYB Amazon,1,1,0,0,0,0
,Oxbow Natural Science - Digestive Supplement 2pk,Oxbow Natural Science - Digestive Supplement 2pk,FBALYB Amazon,-6,-6,0,4,0,0
,Oxbow Natural Science Multi Vitamin 60ct,Oxbow Natural Science Multi Vitamin 60ct,FBALYB Amazon,1,1,0,0,0,0
,Oxbow Natural Science Urinary Supplement - 60 ct.,Oxbow Natural Science Urinary Supplement - 60 ct.,FBALYB Amazon,299,299,0,1,0,0
,"Oxbow Natural Science Vitamin C, 60ct","Oxbow Natural Science Vitamin C, 60ct",Default,1,1,0,0,0,0
,"Oxbow Natural Science Vitamin C, 60ct","Oxbow Natural Science Vitamin C, 60ct",FBALYB Amazon,-3,-3,0,0,0,0
,"Oxbow Natural Science Vitamin C, 60ct 2pk","Oxbow Natural Science Vitamin C, 60ct 2pk",FBALYB Amazon,-1,-1,0,0,0,0
,Oxbow Oat Hay ‑ 15 oz bag,Oxbow Oat Hay ‑ 15 oz bag,Default,0,0,0,0,0,300
,Oxbow Performance Y Guinea Pig,Oxbow Performance Young Guinea Pig 5lb,FBALYB Amazon,3,3,0,0,0,0
,oxbow Pure Comfort Bedding 54L,oxbow Pure Comfort Bedding 54L,FBALYB Amazon,2,2,0,0,0,0
,Oxbow Rabbit Food Pellets 3 lbs 2pk,Oxbow Rabbit Food Pellets 3 lbs 2pk,FBALYB Amazon,1,1,0,0,0,0
,Oxbow Simple Rewards Variety 4pk,Oxbow Simple Rewards Variety 4pk,FBALYB Amazon,-7,-7,0,0,0,0
,Oxbow Simple Rewards Veggie Treats 3oz 3pk,Oxbow Simple Rewards Veggie Treats 3oz 3pk,Default,-3,-3,0,0,0,0
,Oxbow Simple Rewards Veggie Treats 3oz 3pk,Oxbow Simple Rewards Veggie Treats 3oz 3pk,FBALYB Amazon,1,1,0,0,0,0
,Oxbow Timothy Bungalow Large,Oxbow Timothy Bungalow Large,Default Ridgefield,2,2,0,0,0,0
,Oxbow Timothy Bungalow Large,Oxbow Timothy Bungalow Large,FBALYB Amazon,-3,-3,0,0,0,0
,Oxbow Timothy Bungalow Medium,Oxbow Timothy Bungalow Medium,Default Ridgefield,36,36,0,0,0,0
,Oxbow Timothy Mat Medium,Oxbow Timothy Mat Medium,Default Ridgefield,16,16,0,0,0,0
,Oxbow Timothy Mat Medium 2 pack,Oxbow Timothy Mat Medium 2 pack,FBALYB Amazon,4,0,4,0,4,0
,Oxbow Timothy Tunnel,Oxbow Timothy Tunnel,FBALYB Amazon,-5,-5,0,4,0,0
,Oxbow Western Timothy Hay 15oz,Oxbow Western Timothy Hay 15oz,FBALYB Amazon,1,1,0,0,0,0
,Oxbow Young Rabbit Pet Food,Oxbow Young Rabbit Pet Food 5lb,Default,0,0,0,0,0,1
,Oxbow Young Rabbit Pet Food,Oxbow Young Rabbit Pet Food 5lb,FBALYB Amazon,0,0,0,8,0,0
,Oxi Clean,Oxi Clean,FBALYB Amazon,4,4,0,0,0,0
,Oxi Clean Detergen 275 Versatile Stain Remover,Oxi Clean Detergen 275 Versatile Stain Remover,FBALYB Amazon,39,38,1,29,1,0
,OXO Good Grips 3-Piece Airtight POP Round Canister Set,OXO Good Grips 3-Piece Airtight POP Round Canister Set,FBALYB Amazon,-82,-82,0,69,0,0
,Ozark 20oz Black,Ozark 20oz Black,FBALYB Amazon,-1,-1,0,0,0,0
,Ozark 20oz Hunter Green,Ozark 20oz Hunter Green,Default,0,0,0,0,0,1
,Ozark 20oz Light Blue,Ozark 20oz Light Blue,Default,0,0,0,0,0,1
,Ozark 20oz Light Blue,Ozark 20oz Light Blue,FBALYB Amazon,-8,-8,0,0,0,0
,Ozark 20oz Navy Blue,Ozark 20oz Navy Blue,FBALYB Amazon,-2,-2,0,10,0,0
,Ozark 20oz Orange,Ozark 20oz Orange,FBALYB Amazon,16,16,0,0,0,0
,Ozark 20oz Orange 2pk,Ozark 20oz Orange 2pk,FBALYB Amazon,4,4,0,0,0,0
,Ozark 20oz Red,Ozark 20oz Red,Default,0,0,0,0,0,4
,Ozark 20 oz set of 2,Set of 2 Ozark Trail 20-Ounce Double-Wall Vacuum-Sealed Tumblers,FBALYB Amazon,-60,-60,0,0,0,0
,Ozark 20oz Silver/ Steel,Ozark 20oz Silver/ Stainless Steel,FBALYB Amazon,-1,-1,0,0,0,0
,Ozark 30oz Black,Ozark 30oz Black,Default,0,0,0,0,0,13
,Ozark 30oz Black,Ozark 30oz Black,FBALYB Amazon,7,7,0,0,0,0
,Ozark 30oz Light Blue,Ozark 30oz Light Blue,Default,0,0,0,0,0,27
,Ozark 30oz Navy Blue,Ozark 30oz Navy Blue,Default,1,1,0,0,0,0
,Ozark 30oz Navy Blue,Ozark 30oz Navy Blue,FBALYB Amazon,-1,-1,0,0,0,0
,Ozark 30oz Navy Blue 2,Ozark 30oz Navy Blue 2,FBALYB Amazon,-1,-1,0,0,0,0
,Ozark 30oz Red,Ozark 30oz Red,FBALYB Amazon,18,18,0,0,0,0
,Ozark 30oz Red 2,Ozark 30oz Red 2,FBALYB Amazon,1,1,0,0,0,0
,Ozark 30 oz set of 2,"Ozark Double-Wall Insulated stainless steel tumblers - set of 2, 30 oz",FBALYB Amazon,-2,-2,0,0,0,0
,Ozark 30oz Silver/ Steel,Ozark 30oz Silver/ Stainless Steel,FBALYB Amazon,26,26,0,0,0,0
,Ozark 30oz Silver/ Steel 2pk,Ozark 30oz Silver/ Steel 2pk,FBALYB Amazon,8,8,0,0,0,0
,Ozium Air Freshener Original 6pk,Ozium Air Freshener Original 6pk,FBALYB Amazon,2,2,0,0,0,0
,Ozium Original 8 Oz Spray 3pk,Ozium Original 8 Oz Spray 3pk,FBALYB Amazon,-7,-12,5,1,5,0
,Ozium Original 8 Oz Spray 4pk,Ozium Original 8 Oz Spray 4pk,FBALYB Amazon,-6,-6,0,0,0,0
,Ozium Original 8 Oz Spray - Single Can,Ozium Original 8 Oz Spray - Single Can,Default,0,-3000,3000,0,0,0
,Ozium Original 8 Oz Spray - Single Can,Ozium Original 8 Oz Spray - Single Can,Default Ridgefield,20,20,0,0,0,0
,Ozium Original 8 Oz Spray - Single Can,Ozium Original 8 Oz Spray - Single Can,FBALYB Amazon,19,19,0,1,0,0
,Pacinos BEARD & FACE SCRUB,Pacinos BEARD & FACE SCRUB,FBALYB Amazon,1,1,0,0,0,0
,Pacinos - Beard Oil 2oz,Pacinos - Beard Oil 2oz,FBALYB Amazon,7,7,0,0,0,0
,Pacinos BLACK MASK,Pacinos BLACK MASK,FBALYB Amazon,-1,-1,0,0,0,0
,Pacinos - Creme 4oz,Pacinos - Creme 4oz,FBALYB Amazon,-5,-5,0,0,0,0
,Pacinos - Matte 4oz,Pacinos - Matte 4oz,FBALYB Amazon,-235,-235,0,0,0,0
,Pacinos - Pomade 4oz,Pacinos - Pomade 4oz,FBALYB Amazon,-3,-3,0,11,0,0
,Pacinos - Shave Gel 8oz,Pacinos - Shave Gel 8oz,FBALYB Amazon,0,0,0,1,0,0
,Pacinos STYLING GEL,Pacinos STYLING GEL,FBALYB Amazon,7,7,0,0,0,0
,Palmer's Cocoa Butter Body Lotion 8.5oz,Palmer's Cocoa Butter Body Lotion 8.5oz,Default Ridgefield,480,480,0,0,0,0
,Palmer's Cocoa Butter Body Lotion 8.5oz 2pk,Palmer's Cocoa Butter Body Lotion 8.5oz 2pk,FBALYB Amazon,-11,-11,0,7,0,0
,Palmer's Cocoa Butter Body Oil 8.5oz 3pk,Palmer's Cocoa Butter Body Oil 8.5oz 3pk,FBALYB Amazon,5,5,0,0,0,0
,Palmer's Cocoa Butter Cream 3.5 oz,Palmer's Cocoa Butter Cream 3.5 oz,Default,0,0,0,0,0,2
,Palmer's Cocoa Butter Cream 3.5 oz,Palmer's Cocoa Butter Cream 3.5 oz,FBALYB Amazon,-15,-15,0,18,0,0
,Palmer's Cocoa Butter Firming 10.6oz 2pk,Palmer's Cocoa Butter Firming 10.6oz 2pk,FBALYB Amazon,-52,-52,0,50,0,0
,Palmer's Cocoa Butter Foot Magic 2.1oz,Palmer's Cocoa Butter Foot Magic 2.1oz,Default,0,0,0,0,0,10
,Palmer's Cocoa Butter Foot Magic 2.1oz 2pk,Palmer's Cocoa Butter Foot Magic 2.1oz 2pk,FBALYB Amazon,-1,-1,0,1,0,0
,Palmer's Cocoa Butter Men's Lotion 13.5oz,Palmer's Cocoa Butter Men's Lotion 13.5oz,Default,0,0,0,0,0,3
,Palmer's Coconut Coditioning+Shampoo 2pk,Palmer's Coconut Coditioning+Shampoo 2pk,FBALYB Amazon,-5,-5,0,2,0,0
,"Palmer's Coconut Oil Body Lotion with Vitamin E, 8.5 oz","Palmer's Coconut Oil Body Lotion with Vitamin E, 8.5 oz",Default Ridgefield,660,660,0,0,0,0
,Palmer's Cream Jar 18.6oz,Palmer's Cream Jar 18.6oz,Default,0,-478,478,0,0,0
,Palmer's Cream Jar 18.6oz 2pk,Palmer's Cream Jar 18.6oz 2pk,FBALYB Amazon,132,119,13,23,13,0
,Palmer's Deep Radiance Gel 5.25oz,Palmer's Deep Radiance Gel 5.25oz,FBALYB Amazon,3,3,0,0,0,0
,Palmer's Face Oil & Cleansing Bundle,Palmer's Face Oil & Cleansing Bundle,FBALYB Amazon,4,4,0,1,0,0
,Palmer's Massage Stretch Marks 8.5oz,Palmer's Cocoa Butter Massage Lotion Stretch Marks 8.5 oz,Default,0,-2599,2599,0,0,0
,Palmer's Massage Stretch Marks 8.5oz,Palmer's Cocoa Butter Massage Lotion Stretch Marks 8.5 oz,Default Ridgefield,477,477,0,0,0,0
,Palmer's Massage Stretch Marks 8.5oz 2pk,Palmer's Massage Stretch Marks 8.5oz 2pk,FBALYB Amazon,-5,-6,1,0,1,0
,Palmer's Massage Stretch Marks 8.5oz 3pk,Palmer's Massage Stretch Marks 8.5oz 3pk,FBALYB Amazon,635,631,4,0,4,0
,Palmer's Massage Stretch Marks 8.5oz 3pk,Palmer's Massage Stretch Marks 8.5oz 3pk,WFS,-52,-52,0,0,0,0
,Palmer's Men's Lotion 13.5oz 3pk,Palmer's Cocoa Butter Men's Lotion 13.5oz 3pk,FBALYB Amazon,-1,-1,0,0,0,0
,Palmers Moisture Rich Night - Day Cream,Palmers Moisture Rich Night - Day Cream,FBALYB Amazon,0,-1,1,2,1,0
,Palmer's Moisturizing Day Cream SPF15 2.7oz,Palmer's Moisturizing Day Cream SPF15 2.7oz,Default Ridgefield,114,114,0,0,0,0
,Palmer's Moisturizing Gel Oil 7oz,Palmer's Moisturizing Gel Oil 7oz,FBALYB Amazon,-3,-3,0,4,0,0
,Palmer's Skin Success Soap Bar 3.5oz 2pk,Palmer's Skin Success Soap Bar 3.5oz 2pk,FBALYB Amazon,-2,-2,0,0,0,0
,Palmer's Skin Therapy Oil Rosehip 5.1oz 2pk,Palmer's Skin Therapy Oil Rosehip 5.1oz 2pk,FBALYB Amazon,-22,-22,0,20,0,0
,Palmer's Stretch Mark & Tummy Bundle,Palmer's Stretch Mark & Tummy Bundle,FBALYB Amazon,-62,-69,7,33,7,0
,Palmer's Tummy Butter 4.4oz,Palmer's Tummy Butter 4.4oz,Default,0,-709,709,0,0,0
,Palmer's Tummy Butter 4.4oz,Palmer's Tummy Butter 4.4oz,Default Ridgefield,36,36,0,0,0,0
,Palmer's Tummy Butter 4.4oz,Palmer's Tummy Butter 4.4oz,FBALYB Amazon,-1,-1,0,1,0,0
,Palm Leaf 10 inch Square Plates 10ct,Palm Leaf 10 inch Square Plates 10ct,Default Ridgefield,11,11,0,0,0,0
,Palm Naki 10 inch Plates,Palm Naki 10 inch Plates,Default,0,-12160,12160,0,0,0
,"Palm Naki 10"" Round Plate 40 ct","Palm Naki 10"" Round Plate 40 ct",FBALYB Amazon,41,41,0,0,0,0
,"Palm Naki 12"" Round 4 Compartment Areca Stealth plates 40 ct","Palm Naki 12"" Round 4 Compartment Areca Stealth plates 40 ct",Default Ridgefield,0,0,0,0,0,25
,"Palm Naki 12"" Round 4 Compartment Areca Stealth plates 40 ct","Palm Naki 12"" Round 4 Compartment Areca Stealth plates 40 ct",FBALYB Amazon,2,2,0,1,0,0
,"Palm Naki 12"" Round Plate 40 ct","Palm Naki 12"" Round Plate 40 ct",FBALYB Amazon,7,7,0,20,0,0
,"Palm Naki 3.5"" Round Bowl 40 ct","Palm Naki 3.5"" Round Bowl 40 ct",Default Ridgefield,46,46,0,0,0,0
,"Palm Naki 3.5"" Round Bowl 40 ct","Palm Naki 3.5"" Round Bowl 40 ct",FBALYB Amazon,5,5,0,5,0,0
,"Palm Naki 3"" Deep Square Plate 40 ct","Palm Naki 3"" Deep Square Plate 40 ct",FBALYB Amazon,-6,-6,0,0,0,0
,"Palm Naki 4.5"" Round Bowl 40 ct","Palm Naki 4.5"" Round Bowl 40 ct",Default Ridgefield,0,0,0,0,0,48
,"Palm Naki 4.5"" Round Bowl 40 ct","Palm Naki 4.5"" Round Bowl 40 ct",FBALYB Amazon,-17,-17,0,0,0,0
,"Palm Naki 4"" Round Bowl 40 ct","Palm Naki 4"" Round Bowl 40 ct",FBALYB Amazon,3,3,0,2,0,0
,"Palm Naki 4"" Round Bowl 40 ct","Palm Naki 4"" Round Bowl 40 ct",FBALYB Canada,19,19,0,0,0,0
,"Palm Naki 4"" Square Plate 40 ct","Palm Naki 4"" Square Plate 40 ct",Default Ridgefield,188,188,0,0,0,0
,"Palm Naki 4"" Square Plate 40 ct","Palm Naki 4"" Square Plate 40 ct",FBALYB Amazon,-80,-88,8,1,8,0
,"Palm Naki 4"" Square Plate 40 ct","Palm Naki 4"" Square Plate 40 ct",FBALYB Canada,18,18,0,20,0,0
,"Palm Naki 5"" Round Bowl 40 ct","Palm Naki 5"" Round Bowl 40 ct",Default,0,-78,78,0,0,0
,"Palm Naki 5"" Round Bowl 40 ct","Palm Naki 5"" Round Bowl 40 ct",Default Ridgefield,10,10,0,0,0,0
,"Palm Naki 5"" Round Bowl 40 ct","Palm Naki 5"" Round Bowl 40 ct",FBALYB Amazon,-7,-7,0,1,0,0
,"Palm Naki 5"" X 7"" Oval Areca Stealth plates 40 ct","Palm Naki 5"" X 7"" Oval Areca Stealth plates 40 ct",FBALYB Amazon,99,99,0,24,0,0
,"Palm Naki 6.5"" Heart Areca Stealth plates 40 ct","Palm Naki 6.5"" Heart Areca Stealth plates 40 ct",Default Ridgefield,68,68,0,0,0,0
,"Palm Naki 6.5"" Heart Areca Stealth plates 40 ct","Palm Naki 6.5"" Heart Areca Stealth plates 40 ct",FBALYB Amazon,117,117,0,0,0,0
,"Palm Naki 6"" Bamboo Plates 40Ct","Palm Naki 6"" Bamboo Plates 40Ct",Default Oxford,709,709,0,0,0,0
,"Palm Naki 6"" Bamboo Plates 40Ct","Palm Naki 6"" Bamboo Plates 40Ct",FBALYB Amazon,-21,-21,0,68,0,0
,Palm Naki 6 inch Plates,Palm Naki 6 inch Plates,Default,0,-4640,4640,0,0,0
,Palm Naki 6 inch Plates,Palm Naki 6 inch Plates,Default Ridgefield,0,-16000,16000,0,0,0
,"Palm Naki 6"" Round Plate 40 ct","Palm Naki 6"" Round Plate 40 ct",Default Ridgefield,1,1,0,0,0,498
,"Palm Naki 6"" Round Plate 40 ct","Palm Naki 6"" Round Plate 40 ct",FBALYB Amazon,3,3,0,8,0,0
,"Palm Naki 6""x4"" Rectangle Plate 40 ct","Palm Naki 6""x4"" Rectangle Plate 40 ct",Default Oxford,2,2,0,0,0,0
,"Palm Naki 6""x4"" Rectangle Plate 40 ct","Palm Naki 6""x4"" Rectangle Plate 40 ct",Default Ridgefield,0,0,0,0,0,393
,"Palm Naki 6""x4"" Rectangle Plate 40 ct","Palm Naki 6""x4"" Rectangle Plate 40 ct",FBALYB Amazon,2,2,0,77,0,0
,"Palm Naki 6""x4"" Rectangle Plate 40 ct","Palm Naki 6""x4"" Rectangle Plate 40 ct",FBALYB Canada,10,10,0,0,0,0
,"Palm Naki 7"" Round Plate 40 ct","Palm Naki 7"" Round Plate 40 ct",Default Ridgefield,4,4,0,0,0,498
,"Palm Naki 7"" Round Plate 40 ct","Palm Naki 7"" Round Plate 40 ct",FBALYB Amazon,-4,-4,0,1,0,0
,"Palm Naki 7"" Square Plate 40 ct","Palm Naki 7"" Square Plate 40 ct",Default Ridgefield,492,492,0,0,0,498
,"Palm Naki 7"" Square Plate 40 ct","Palm Naki 7"" Square Plate 40 ct",FBAFBA LYB AUSTRALIA,0,0,0,20,0,0
,"Palm Naki 7"" Square Plate 40 ct","Palm Naki 7"" Square Plate 40 ct",FBALYB Amazon,-68,-72,4,0,4,0
,"Palm Naki 7"" Square Plate 40 ct","Palm Naki 7"" Square Plate 40 ct",FBALYB Canada,-6,-6,0,0,0,0
,"Palm Naki 7"" Square Plate 40 ct","Palm Naki 7"" Square Plate 40 ct",FBALYB Dubai,14,14,0,0,0,0
,"Palm Naki 8 "" Plates 40 ct","Palm Naki 8 "" Plates 40 ct",Default,0,-200,200,0,0,0
,"Palm Naki 8 "" Plates 40 ct","Palm Naki 8 "" Plates 40 ct",Default Oxford,201,201,0,0,0,0
,"Palm Naki 8 "" Plates 40 ct","Palm Naki 8 "" Plates 40 ct",FBALYB Amazon,-47,-47,0,13,0,0
,"Palm Naki 8"" Round Plate 40 ct","Palm Naki 8"" Round Plate 40 ct",Default Ridgefield,199,199,0,0,0,0
,"Palm Naki 9"" Round Plate 40 ct","Palm Naki 9"" Round Plate 40 ct",FBALYB Amazon,19,19,0,5,0,0
,"Palm Naki 9"" Square Plate 40 ct","Palm Naki 9"" Square Plate 40 ct",Default Ridgefield,104,88,16,0,0,377
,"Palm Naki 9"" Square Plate 40 ct","Palm Naki 9"" Square Plate 40 ct",FBALYB Amazon,-19,-20,1,17,1,0
,"Palm Naki 9"" Square Plate 40 ct","Palm Naki 9"" Square Plate 40 ct",FBALYB Canada,0,0,0,10,0,0
,"Palm Naki 9""x6"" Rectangle Plate 40 ct","Palm Naki 9""x6"" Rectangle Plate 40 ct",Default Ridgefield,0,0,0,0,0,94
,"Palm Naki 9""x6"" Rectangle Plate 40 ct","Palm Naki 9""x6"" Rectangle Plate 40 ct",FBALYB Amazon,-53,-56,3,27,3,0
,Palm Naki Bamboo Plates 40 ct,"Palm Naki 10"" Bamboo Plates 40 ct",FBALYB Amazon,-16,-16,0,12,0,0
,Palm Naki Bundle,Palm Naki Bundle,FBALYB Amazon,44,44,0,0,0,0
,Palm Naki Forks 40 ct,Palm Naki Forks 40 ct,Default Ridgefield,3,3,0,0,0,0
,Palm Naki Forks 40 ct,Palm Naki Forks 40 ct,FBALYB Amazon,107,107,0,1,0,0
,Palm Naki Knives 40 ct,Palm Naki Knives 40 ct,Default Ridgefield,161,161,0,0,0,0
,Palm Naki Knives 40 ct,Palm Naki Knives 40 ct,FBALYB Amazon,122,119,3,100,3,0
,Palm Naki Platter Big Areca Stealth plates,Palm Naki Platter Big Areca Stealth plates,FBALYB Amazon,114,114,0,4,0,0
,Palm Naki Spoons 40 ct,Palm Naki Spoons 40 ct,FBALYB Amazon,82,76,6,100,6,0
,Palm Naki Spoons 40 ct,Palm Naki Spoons 40 ct,FBALYB Canada,20,20,0,0,0,0
,Palmolive Original Dish Soap 3.8L,Palmolive Original Dish Soap 3.8L,Default Ridgefield,3353,3353,0,0,0,0
,Palmolive Original Dish Soap 3.8L,Palmolive Original Dish Soap 3.8L,FBALYB Amazon,327,275,52,7,52,0
,Palmolive Original Dish Soap 5L,Palmolive Original Dish Soap 5L,Default,0,-128,128,0,0,0
,Palmolive Original Dish Soap 5L,Palmolive Original Dish Soap 5L,Default Ridgefield,2461,2461,0,0,0,0
,Palmolive Original Dish Soap 5L,Palmolive Original Dish Soap 5L,FBALYB Amazon,-28,-36,8,400,8,0
,Pamelas Bkng & Pncke Mix 24oz 3 pack,Pamelas Bkng & Pncke Mix 24oz 3 pack,FBALYB Amazon,5,0,5,0,5,0
,Pamelas Bkng & Pncke Mix 4lb 3 PK,Pamelas Bkng & Pncke Mix 4lb 3 PK,FBALYB Amazon,287,285,2,0,2,0
,Pamelas Cinnamon Grahams GF 6pk,Pamelas Cinnamon Grahams GF 6pk,FBALYB Amazon,19,17,2,0,2,0
,Pamelas cornbrd & muffin mx 6pack,Pamelas cornbrd & muffin mx 6pack,FBALYB Amazon,45,43,2,1,2,0
,Pamelas cornbread and muffin mix 12 oz 3pk,Pamelas cornbread and muffin mix 12 oz 3pk,FBALYB Amazon,37,33,4,0,4,0
,Pamelas Honey Grahams GF 2pk,Pamelas Honey Grahams GF 2pk,FBALYB Amazon,299,292,7,0,7,0
,Pamelas Organic Tiger Nut Flour 14 oz 6 pack,Pamelas Organic Tiger Nut Flour 14 oz 6 pack,FBALYB Amazon,6,6,0,0,0,0
,Pamelas Org Cassava Flour 14oz 6pack,Pamelas Org Cassava Flour 14oz 6pack,FBALYB Amazon,18,17,1,0,1,0
,Pamelas Whenever Bars Oat/Blueberry/Lemon Gluten Free 6pk,Pamelas Whenever Bars Oat/Blueberry/Lemon Gluten Free 6pk,FBALYB Amazon,43,39,4,0,4,0
,Pamelas Whenever Bars Oat/Chocolate Chip/Coconut Gluten Free 3 pack,Pamelas Whenever Bars Oat/Chocolate Chip/Coconut Gluten Free 3 pack,FBALYB Amazon,120,113,7,0,7,0
,Pamelas Whenever Bars Oat/Peanut Butter/Chocolate Chip Gluten Free 5ct 3pk,Pamelas Whenever Bars Oat/Peanut Butter/Chocolate Chip Gluten Free 5ct 3pk,FBALYB Amazon,0,-1,1,0,1,0
,Pamelas Wnvr Bar GF Oat/Rs/Wln/Sp 6pk,Pamelas Wnvr Bar GF Oat/Rs/Wln/Sp 6pk,FBALYB Amazon,188,188,0,1,0,0
,Pantene 900 ML Shampoo + 855 ML Conditioner,Pantene 900 ML Shampoo + 855 ML Conditioner,Default Ridgefield,43,43,0,0,0,0
,Pantene 900 ML Shampoo + 855 ML Conditioner,Pantene 900 ML Shampoo + 855 ML Conditioner,FBALYB Amazon,83,60,23,1,23,0
,Pantene 900 ML Shampoo + 855 ML Conditioner,Pantene 900 ML Shampoo + 855 ML Conditioner,FBALYB Canada,9,9,0,5,0,0
,Pantene Advanced Shampoo 38.2oz,Pantene Advanced Shampoo 38.2oz,Default,0,0,0,0,0,5
,Pantene Pro-V Conditioner 12oz 2pk,Pantene Pro-V Conditioner 12oz 2pk,FBALYB Amazon,2,2,0,0,0,0
,Pantene Shampoo & Conditioner,Pantene Shampoo & Conditioner,FBALYB Amazon,2,2,0,0,0,0
,"PARDUE, DROP PT GRIP, AXS,STUD 551BKOD-S30V Griptilian Olive","PARDUE, DROP PT GRIP, AXS,STUD 551BKOD-S30V Griptilian Olive",Default,0,0,0,0,0,10
,"PARDUE, DROP PT GRIP, AXS,STUD 551BKOD-S30V Griptilian Olive","PARDUE, DROP PT GRIP, AXS,STUD 551BKOD-S30V Griptilian Olive",FBALYB Amazon,-4,-5,1,1,1,0
,"PARDUE, DROP PT GRIP, AXS,STUD, 551BK-S30V","PARDUE, DROP PT GRIP, AXS,STUD, 551BK-S30V",Default Ridgefield,1,1,0,0,0,0
,"PARDUE, DROP PT GRIP, AXS,STUD, 551BK-S30V","PARDUE, DROP PT GRIP, AXS,STUD, 551BK-S30V",FBALYB Amazon,-44,-45,1,0,1,0
,"PARDUE, DROP PT, GRIP,AXS,STUD 551-S30V","PARDUE, DROP PT, GRIP,AXS,STUD 551-S30V",Default Ridgefield,64,64,0,0,0,0
,"PARDUE, DROP PT, GRIP,AXS,STUD 551-S30V","PARDUE, DROP PT, GRIP,AXS,STUD 551-S30V",FBALYB Amazon,26,5,21,0,21,0
,"PARDUE, DROP PT GRIP, AXS,STUD 551SBK-S30V","PARDUE, DROP PT GRIP, AXS,STUD 551SBK-S30V",FBALYB Amazon,34,34,0,1,0,0
,"PARDUE, DROP PT GRIP, AXS,STUD 551SBKSN-S30V","PARDUE, DROP PT GRIP, AXS,STUD 551SBKSN-S30V",Default Ridgefield,4,4,0,0,0,0
,"PARDUE, DROP PT GRIP, AXS,STUD 551SBKSN-S30V","PARDUE, DROP PT GRIP, AXS,STUD 551SBKSN-S30V",FBALYB Amazon,6,6,0,0,0,0
,"PARDUE, MINI DPT GRIP,AXS,STUD 556-S30V","PARDUE, MINI DPT GRIP,AXS,STUD 556-S30V",Default Ridgefield,6,6,0,0,0,0
,"PARDUE, MINI DPT GRIP,AXS,STUD 556-S30V","PARDUE, MINI DPT GRIP,AXS,STUD 556-S30V",FBALYB Amazon,-25,-52,27,1,27,0
,Paris Mercury Hexagon Candle,Paris Mercury Hexagon Candle,Avrami - Ebay,4,4,0,0,0,0
,Paris Mercury Hexagon Candle,Paris Mercury Hexagon Candle,Default,0,-125,125,0,0,0
,Paris Mercury Hexagon Candle,Paris Mercury Hexagon Candle,Default Ridgefield,55,45,10,0,0,0
,Paris Mercury Hexagon Candle,Paris Mercury Hexagon Candle,FBALYB Amazon,261,261,0,0,0,0
,Patra Square 6 inch Palm Plates 25ct,Patra Square 6 inch Palm Plates 25ct,Default Ridgefield,157,157,0,0,0,0
,PBfit Peanut Butter Powder,PBfit Peanut Butter Powder ,FBALYB Amazon,1,1,0,0,0,0
,Pears amber transparent bar soap 12 pk,Pears amber transparent bar soap 12 pk,FBALYB Amazon,-7,-8,1,1,1,0
,Pears amber transparent bar soap 24 pk,Pears amber transparent bar soap 24 pk,FBALYB Amazon,-3,-3,0,1,0,0
,PEDIGREE 3.5 oz 30 Pouchs,PEDIGREE Choice Cuts Variety Pack Beef and Grilled Chicken Wet Dog Food 3.5 oz 30 Pouch Variety Pack.,Default,0,0,0,0,0,71
,PEDIGREE 3.5 oz 30 Pouchs,PEDIGREE Choice Cuts Variety Pack Beef and Grilled Chicken Wet Dog Food 3.5 oz 30 Pouch Variety Pack.,FBALYB Amazon,149,149,0,7,0,0
,Pedigree Dentastix 51 ct,"Pedigree Dentastix, Variety Pack ‑ 51 count box",FBALYB Amazon,9,9,0,1,0,0
,Pedigree Dentastix 55ct,Pedigree Dentastix 55ct,FBALYB Amazon,-4,-4,0,7,0,0
,Penaten Medicated Cream 3pk,Penaten Medicated Cream 3pk,FBALYB Amazon,55,55,0,0,0,0
,Penn-plax Silent Air Battery Air Pump,Penn-plax Silent Air Battery Air Pump,FBALYB Amazon,-1,-1,0,0,0,0
,Penn Tennis Balls 3ct,Penn Tennis Balls 3ct,Default,0,-3476,3476,0,0,0
,Penn Tennis Balls 3ct 12pk,Penn Tennis Balls 3ct 12pk,FBALYB Amazon,1,1,0,1,0,0
,Penn Tennis Balls 3ct 16pk,Penn Tennis Balls 3ct 16pk,FBALYB Amazon,0,0,0,1,0,0
,Penn Tennis Balls 3ct 20pk,Penn Tennis Balls 3ct 20pk,FBALYB Amazon,-40,-40,0,0,0,0
,Penn Tennis Balls 3ct 24pk,Penn Tennis Balls 3ct 24pk,FBALYB Amazon,40,40,0,0,0,0
,Penn Tennis Balls 3ct 4pk,Penn Tennis Balls 3ct 4pk,FBALYB Amazon,-1,-1,0,0,0,0
,Penn Tennis Balls 3ct 6pk,Penn Tennis Balls 3ct 6pk,Default,-240,-240,0,0,0,0
,Penn Tennis Balls 3ct 6pk,Penn Tennis Balls 3ct 6pk,FBALYB Amazon,1,1,0,0,0,0
,Penn Tennis Balls 3ct 9pk,Penn Tennis Balls 3ct 9pk,FBALYB Amazon,-2,-2,0,0,0,0
,Pepcid 100 ct,"Pepcid AC Acid Reducer Maximum Strength Tablets, 100 ct",Default,0,0,0,0,0,12
,Pepcid 100 ct,"Pepcid AC Acid Reducer Maximum Strength Tablets, 100 ct",FBALYB Amazon,49,49,0,0,0,0
,Pepcid Complete Berry 100ct,Pepcid Complete Berry 100ct,Default,0,0,0,0,0,50
,Pepcid Complete Berry 100ct,Pepcid Complete Berry 100ct,FBALYB Amazon,-86,-86,0,36,0,0
,Pepperidge Farm Goldfish Baked Snack Crackers 30ct,Pepperidge Farm Goldfish Baked Snack Crackers 30ct,Default,0,-1,1,0,0,0
,Pepperidge Farm Goldfish Baked Snack Crackers 30ct,Pepperidge Farm Goldfish Baked Snack Crackers 30ct,FBALYB Amazon,19,19,0,0,0,0
,"Pepperidge Farm Goldfish, Cheddar 58oz","Pepperidge Farm Goldfish, Cheddar 58oz",FBALYB Amazon,2,2,0,0,0,0
,"Pepper Spray, Key Ring, Pink, .54 oz HC-14-PK-US","Pepper Spray, Key Ring, Pink, .54 oz HC-14-PK-US",Avrami - Ebay,397,397,0,0,0,0
,"Pepper Spray, Key Ring, Pink, .54 oz HC-14-PK-US","Pepper Spray, Key Ring, Pink, .54 oz HC-14-PK-US",Default Ridgefield,124,124,0,0,0,0
,"Pepper Spray, Key Ring, Pink, .54 oz HC-14-PK-US","Pepper Spray, Key Ring, Pink, .54 oz HC-14-PK-US",FBALYB Amazon,1977,1954,23,2,23,0
,"Pepper Spray, Key Ring, Pink, .54 oz HC-14-PK-US","Pepper Spray, Key Ring, Pink, .54 oz HC-14-PK-US",WFS,-97,-97,0,0,0,0
,Pepto Bismol 48 tablets,Pepto Bismol 48 tablets,FBALYB Amazon,3,3,0,0,0,0
,Persil Powder 8.45KG Universal Pulver,Persil Powder 8.45KG Universal Pulver,Default Ridgefield,548,515,33,0,0,0
,Persil Powder 8.45KG Universal Pulver,Persil Powder 8.45KG Universal Pulver,FBALYB Amazon,176,169,7,2,7,0
,Persil Powder 8.45KG Universal Pulver,Persil Powder 8.45KG Universal Pulver,FBALYB Canada,5,2,3,0,3,0
,Persil Pro10 Premium 170 Detergent,Persil Pro10 Premium 170 Detergent,FBALYB Amazon,29,29,0,0,0,0
,PetAg Esbilac Liquid 11oz 6pk,PetAg Esbilac Liquid 11oz 6pk,FBALYB Amazon,2,2,0,0,0,0
,PetAg KMR Liquid 8oz,PetAg KMR Liquid 8oz,Default,0,0,0,0,0,8
,PetAg KMR Liquid 8oz 12pk,PetAg KMR Liquid 8oz 12pk,FBALYB Amazon,-1,-1,0,0,0,0
,Petcare Playset,Petcare Playset,FBALYB Amazon,-5,-5,0,1,0,0
,PETCUREAN 25lb for dogs,"PETCUREAN 152359 Go Sensitivity and Shine Salmon for Dog, 12-Pound",FBALYB Amazon,17,17,0,0,0,0
,Peter's Apple Slices 1oz 3pk,Peter's Apple Slices 1oz 3pk,FBALYB Amazon,17,17,0,1,0,0
,Peter's Woven Grass Pet Bed,Peter's Woven Grass Pet Bed,FBALYB Amazon,1,1,0,0,0,0
,Petite Press Portable Mini Iron,Petite Press Portable Mini Iron,FBALYB Amazon,-2,-2,0,0,0,0
,Petmate Cafe Feeder Pearl White 1.5 Gal,Petmate Cafe Feeder Pearl White 1.5 Gal,Default,0,0,0,0,0,2
,Petmate Cafe Feeder Pearl White 1.5 Gal,Petmate Cafe Feeder Pearl White 1.5 Gal,FBALYB Amazon,-1,-1,0,0,0,0
,"Petmate Food Scoop, 2 Cup","Petmate Food Scoop, 2 Cup",FBALYB Amazon,-1,-1,0,1,0,0
,"Petmate Food Scoop, 2 Cup 2pk","Petmate Food Scoop, 2 Cup 2pk",FBALYB Amazon,-2,-2,0,0,0,0
,Petmate Litter Pan Medium,"Petmate Litter Pan, Blue Mesa/Mouse Grey, Medium",FBALYB Amazon,-2,-2,0,0,0,0
,Petmate Litter Pan - Small,Petmate Litter Pan - Small,FBALYB Amazon,0,-2,2,0,2,0
,"Petmate Pet Waterer, Pearl Tan","Petmate Pet Waterer, Pearl Tan",FBALYB Amazon,0,0,0,1,0,0
,Pet Mini Training Duck & Bacon 4oz 2pk,Pet Mini Training Duck & Bacon 4oz 2pk,Default,-30,-30,0,0,0,0
,"Pet 'n Shape Chicken Hide Twists Treats, 1lb 3pk","Pet 'n Shape Chicken Hide Twists Treats, 1lb 3pk",Default,-7,-7,0,0,0,0
,"Pet 'n Shape Chicken Hide Twists Treats, 1lb 3pk","Pet 'n Shape Chicken Hide Twists Treats, 1lb 3pk",FBALYB Amazon,6,6,0,0,0,0
,Petrodex Natural Toothpaste Dog -2PK,Petrodex Natural Toothpaste Dog -2PK,FBALYB Amazon,-1,-1,0,0,0,0
,Petstages Dental Health Chews Cat Toy,Petstages Dental Health Chews Cat Toy,FBALYB Amazon,0,0,0,1,0,0
,PG Tips 240,PG Tips 240,Avrami - Ebay,54,54,0,0,0,0
,PG Tips 240,PG Tips 240,Chicago,0,-420,420,0,0,0
,PG Tips 240,PG Tips 240,Default,0,-4621,4621,0,0,1076
,PG Tips 240,PG Tips 240,Default Ridgefield,3971,3971,0,0,0,0
,PG Tips 240,PG Tips 240,FBALYB Amazon,8085,7864,221,3139,221,0
,PG Tips 240,PG Tips 240,WFS,188,188,0,0,0,0
,PG Tips 240 4pk 960,PG Tips 240 4pk 960,Default Ridgefield,1,0,1,0,0,0
,PG Tips 240 4pk 960,PG Tips 240 4pk 960,FBALYB Amazon,108,103,5,21,5,0
,PG Tips 240 Bags 3 Pack,PG Tips 240 Bags 3 Pack,FBALYB Amazon,248,233,15,142,15,0
,PG Tips Decaf 180's,PG Tips Decaf 180's,FBALYB Amazon,186,182,4,0,4,0
,PG Tips Decaf 70 ct,PG Tips Decaf 70 ct,Avrami - Ebay,864,864,0,0,0,0
,PG Tips Decaf 70 ct,PG Tips Decaf 70 ct,Default CT,0,-1,1,0,0,0
,PG Tips Decaf 70 ct,PG Tips Decaf 70 ct,Default Ridgefield,5778,5778,0,0,0,0
,PG Tips Decaf 70 ct,PG Tips Decaf 70 ct,FBALYB Amazon,291,285,6,0,6,0
,PG Tips Decaf 70 ct,PG Tips Decaf 70 ct,FBALYB Canada,3,2,1,42,1,0
,PG Tips Decaf 70 ct,PG Tips Decaf 70 ct,WFS,-30,-30,0,0,0,0
,PG Tips Decaf 70 ct 2pk,PG Tips Decaf 70 ct 2pk,Default,0,-5,5,0,0,0
,PG Tips Decaf 70 ct 2pk,PG Tips Decaf 70 ct 2pk,FBALYB Amazon,1443,1345,98,53,98,0
,PG Tips Decaf 70 ct 2pk,PG Tips Decaf 70 ct 2pk,FBALYB Canada,1,1,0,15,0,0
,PG Tips Decaf 70 ct 3pk,PG Tips Decaf 70 ct 3pk,FBALYB Amazon,1479,1438,41,9,41,0
,PG Tips Decaf 70 ct 3pk,PG Tips Decaf 70 ct 3pk,FBALYB Canada,18,18,0,0,0,0
,PG Tips Decaf 70 ct 4pk,PG Tips Decaf 70 ct 4pk,FBALYB Amazon,-99,-112,13,300,13,0
,PG Tips Decaf 70 ct 6pk,PG Tips Decaf 70 ct 6pk,FBALYB Amazon,257,248,9,0,9,0
,PG Tips Decaf 70 ct 6pk,PG Tips Decaf 70 ct 6pk,WFS,-20,-21,1,0,1,0
,Pg Tips Tea Bags 240ct 2pk,Pg Tips Tea Bags 240ct 2pk,Chicago,-210,-210,0,0,0,0
,Pg Tips Tea Bags 240ct 2pk,Pg Tips Tea Bags 240ct 2pk,Default,0,-560,560,0,0,0
,Pg Tips Tea Bags 240ct 2pk,Pg Tips Tea Bags 240ct 2pk,Default Ridgefield,66,66,0,0,0,0
,Pg Tips Tea Bags 240ct 2pk,Pg Tips Tea Bags 240ct 2pk,FBALYB Amazon,3672,3424,248,1996,248,0
,Philips - Hue White Ambiance A19 LED Starter Kit,Philips - Hue White Ambiance A19 LED Starter Kit,FBALYB Amazon,-10,-10,0,0,0,0
,Philips Hue White and Color A19 Starter Kit,Philips - Hue White and Color Ambiance A19 LED Starter Kit,Default,0,0,0,0,0,73
,Philips Hue White and Color A19 Starter Kit,Philips - Hue White and Color Ambiance A19 LED Starter Kit,FBALYB Amazon,0,0,0,1,0,0
,Philips HX9392 Rose Gold,Philips Sonicare DiamondClean HX9392 Toothbrush Rose Gold,Default,0,0,0,0,0,1
,Philips LED Smart Light,Philips - Hue Lightstrip Plus Dimmable LED Smart Light - Multicolor,FBALYB Amazon,-2,-2,0,0,0,0
,Philips Sonicare 2-Pack HX6253/83,Philips Sonicare 2-Pack HX6253/83,FBAAP Amazon,2,2,0,0,0,0
,Philips Sonicare DiamondClean,Philips Sonicare DiamondClean Smart HX9903 Toothbrush BLACK,FBALYB Amazon,-2,-2,0,0,0,0
,Philips Sonicare Flexcare Toothbrush Kit HX6964,Philips Sonicare Flexcare Toothbrush Kit HX6964 ,FBALYB Amazon,1,1,0,0,0,0
,Philips Sonicare HX9332 White,Philips Sonicare DiamondClean HX9332 Toothbrush White,Default,0,0,0,0,0,5
,Philips Sonicare HX9903 Pink,Philips Sonicare HX9903 Pink,FBALYB Amazon,-2,-2,0,0,0,0
,Philips Sonicare HX9903 White,Philips Sonicare HX9903 White,Default,0,0,0,0,0,3
,Phillips Bright light Alarm Clock,Phillips Bright light Alarm Clock,Avrami - Ebay,20,20,0,0,0,0
,Phillips Bright light Alarm Clock,Phillips Bright light Alarm Clock,Default,5,5,0,0,0,0
,Phillips Bright light Alarm Clock,Phillips Bright light Alarm Clock,Default Ridgefield,421,421,0,0,0,0
,Phillips Bright light Alarm Clock,Phillips Bright light Alarm Clock,FBALYB Amazon,79,72,7,0,7,0
,Phillips Bright light Alarm Clock,Phillips Bright light Alarm Clock,WFS,-13,-13,0,0,0,0
,Philosophy Amazing Grace Ballet Rose Edt 2oz,Philosophy Amazing Grace Ballet Rose Edt 2oz ,FBALYB Amazon,1,1,0,0,0,0
,Philosophy Amazing Grace Ballet Rose Firming Body Emulsion 16oz,Philosophy Amazing Grace Ballet Rose Firming Body Emulsion 16oz ,FBALYB Amazon,1,1,0,0,0,0
,Philosophy Amazing Grace Dry Shampoo 4.3oz,Philosophy Amazing Grace Dry Shampoo 4.3oz,FBALYB Amazon,250,250,0,0,0,0
,Philosophy Amazing Grace Magnolia EDT 2oz,Philosophy Amazing Grace Magnolia EDT 2oz ,FBALYB Amazon,-60,-60,0,60,0,0
,Philosophy Amazing Grace Perfumed Firming Body Emulsion 16oz,Philosophy Amazing Grace Perfumed Firming Body Emulsion 16oz,FBALYB Amazon,0,0,0,44,0,0
,Philosophy Amazing Grace Shimmering Body Lotion 8oz,Philosophy Amazing Grace Shimmering Body Lotion 8oz ,FBALYB Amazon,158,158,0,0,0,0
,Philosophy Amazing Grace Whipped Body Creme 8oz,Philosophy Amazing Grace Whipped Body Creme 8oz ,Default Ridgefield,18,18,0,0,0,0
,Philosophy Amazing Grace Whipped Body Creme 8oz,Philosophy Amazing Grace Whipped Body Creme 8oz ,FBALYB Amazon,499,499,0,0,0,0
,Philosophy Amazing Grace Whipped Body Creme 8oz,Philosophy Amazing Grace Whipped Body Creme 8oz ,WFS,-4,-4,0,0,0,0
,Philosophy Hands of Hope Hand & Cuticle Cream 4oz,Philosophy Hands of Hope Hand & Cuticle Cream 4oz,FBALYB Amazon,-1,-1,0,1,0,0
,Philosophy Help me Retinol Night Treatment 1oz,Philosophy Help me Retinol Night Treatment 1oz,FBALYB Amazon,63,63,0,0,0,0
,Philosophy Hope in a Jar Original Formula Moisturizer 4oz,Philosophy Hope in a Jar Original Formula Moisturizer 4oz,FBALYB Amazon,-2,-2,0,0,0,0
,Philosophy Hope in a Tube High-Density Eye and Lip Firming Cream .5oz tube,Philosophy Hope in a Tube High-Density Eye and Lip Firming Cream .5oz tube,FBALYB Amazon,1,1,0,0,0,0
,Philosophy Microdelivery Exfoliating Wash 8oz,Philosophy Microdelivery Exfoliating Wash 8oz,FBALYB Amazon,-2,-2,0,0,0,0
,Philosophy Purity Made Simple Eye Gello .5oz,Philosophy Purity Made Simple Eye Gello .5oz,FBALYB Amazon,77,77,0,0,0,0
,Philosophy Purity Made Simple Eye Gello .5oz,Philosophy Purity Made Simple Eye Gello .5oz,WFS,-10,-10,0,0,0,0
,Philosophy Purity Made Simple Foaming 3-in-1 Cleansing Gel for Face and Eyes 7.5oz,Philosophy Purity Made Simple Foaming 3-in-1 Cleansing Gel for Face and Eyes 7.5oz,FBALYB Amazon,1,1,0,0,0,0
,Philosophy Purity Made Simple One-Step Facial Cleanser 16oz,Philosophy Purity Made Simple One-Step Facial Cleanser 16oz,FBALYB Amazon,-70,-71,1,78,1,0
,Philosophy Purity Made Simple One-Step Facial Cleanser 8oz,Philosophy Purity Made Simple One-Step Facial Cleanser 8oz,FBALYB Amazon,3,3,0,1,0,0
,Philosophy Purity Made Simple One-Step Facial Cleansing Cloths 30ct,Philosophy Purity Made Simple One-Step Facial Cleansing Cloths 30ct,FBALYB Amazon,94,94,0,0,0,0
,Philosophy Purity Made Simple Pore Extractor Exfoliating Clay Mask 2.5oz,Philosophy Purity Made Simple Pore Extractor Exfoliating Clay Mask 2.5oz ,FBALYB Amazon,-3,-3,0,3,0,0
,Philosophy Purity Ultra Light Moisturizer 4.7oz,Philosophy Purity Ultra Light Moisturizer 4.7oz ,FBALYB Amazon,-3,-3,0,0,0,0
,Philosophy Renewed Hope in a Jar Overnight Recharging & Refining Moisturizer 2oz,Philosophy Renewed Hope in a Jar Overnight Recharging & Refining Moisturizer 2oz,FBALYB Amazon,194,194,0,1,0,0
,Philosophy Renewed Hope in a Jar Refreshing & Refining Moisturizer 2oz,Philosophy Renewed Hope in a Jar Refreshing & Refining Moisturizer 2oz,FBALYB Amazon,49,49,0,3,0,0
,Philosophy Renewed Hope in a Jar Skin Tint spf20 1oz - Shade 3.5 Sand,Philosophy Renewed Hope in a Jar Skin Tint spf20 1oz - Shade 3.5 Sand,FBALYB Amazon,32,32,0,0,0,0
,Philosophy Renewed Hope in a Jar Skin Tint spf20 1oz - Shade 5.5 Beige,Philosophy Renewed Hope in a Jar Skin Tint spf20 1oz - Shade 5.5 Beige,FBALYB Amazon,-5,-5,0,0,0,0
,Philosophy Take a Deep Breath Oil-Free Oxygenating Gel Cream 2oz,Philosophy Take a Deep Breath Oil-Free Oxygenating Gel Cream 2oz,FBALYB Amazon,-1,-1,0,0,0,0
,Philosophy The Microdelivery In-Home Vitamin C/Peptide Peel,Philosophy The Microdelivery In-Home Vitamin C/Peptide Peel,FBALYB Amazon,150,150,0,0,0,0
,Philosophy The Present Invisible Skin Perfector & Oil-Free Makeup Primer 2oz,Philosophy The Present Invisible Skin Perfector & Oil-Free Makeup Primer 2oz,FBALYB Amazon,70,70,0,0,0,0
,Philosophy Turbo Booster C Powder A.M. Topical Vitamin 0.25oz,Philosophy Turbo Booster C Powder A.M. Topical Vitamin 0.25oz,FBALYB Amazon,12,12,0,1,0,0
,Philosophy Ultimate Miracle Worker Multi-Rejuvenating Cream Broad Spectrum spf30 2oz,Philosophy Ultimate Miracle Worker Multi-Rejuvenating Cream Broad Spectrum spf30 2oz,FBALYB Amazon,199,199,0,0,0,0
,Philosophy Ultimate Miracle Worker Multi-Rejuvenating Retinol+Superfood Oil Pads 60ct,Philosophy Ultimate Miracle Worker Multi-Rejuvenating Retinol+Superfood Oil Pads 60ct,FBALYB Amazon,69,69,0,0,0,0
,Philosophy Ultimate Miracle Worker Multi-Rejuvenating Retinol+Superfood Oil Pads 60ct,Philosophy Ultimate Miracle Worker Multi-Rejuvenating Retinol+Superfood Oil Pads 60ct,WFS,-25,-25,0,0,0,0
,Philosophy Unconditional Love EDT 2oz,Philosophy Unconditional Love EDT 2oz ,FBALYB Amazon,69,69,0,0,0,0
,"Philosophy You're Amazing Set -8oz Amazing Grace Shower Gel, 4oz Amazing Grace Body Creme","Philosophy You're Amazing Set -8oz Amazing Grace Shower Gel, 4oz Amazing Grace Body Creme",FBALYB Amazon,699,699,0,0,0,0
,Phiosophy Hope in a Jar Original Formula Moisturizer 2oz,Phiosophy Hope in a Jar Original Formula Moisturizer 2oz,FBALYB Amazon,300,300,0,0,0,0
,Phiosophy Hope in a Jar Original Formula Moisturizer 2oz,Phiosophy Hope in a Jar Original Formula Moisturizer 2oz,WFS,-55,-55,0,0,0,0
,Phytomer-Douceur Marine Velvety Soothing Cream 50ML,Phytomer-Douceur Marine Velvety Soothing Cream 50ML,Default,0,-88,88,0,0,0
,Phytomer-Douceur Marine Velvety Soothing Cream 50ML,Phytomer-Douceur Marine Velvety Soothing Cream 50ML,FBALYB Amazon,32,32,0,0,0,0
,Phytomer-Doux Visage Velvet Cleansing Cream 150ML,Phytomer-Doux Visage Velvet Cleansing Cream 150ML,FBALYB Amazon,67,67,0,0,0,0
,Phytomer-Hydracontinue 12H Moisturizing Flash Gel 30 ML,Phytomer-Hydracontinue 12H Moisturizing Flash Gel 30 ML,FBALYB Amazon,-3,-3,0,4,0,0
,Phytomer-Hydra Original Thirst-Relief Melting Cream 100ML,Phytomer-Hydra Original Thirst-Relief Melting Cream 100ML,FBALYB Amazon,1,1,0,1,0,0
,Phytomer-Night Recharge Youth Enhancing Cream 50ML,Phytomer-Night Recharge Youth Enhancing Cream 50ML,FBALYB Amazon,1,1,0,0,0,0
,Phytomer-Oligopur Blemish Target Gel 30ML,Phytomer-Oligopur Blemish Target Gel 30ML,FBALYB Amazon,-1,-1,0,0,0,0
,Phytomer-Oligopur Purifying Cleansing Gel 150 ML,Phytomer-Oligopur Purifying Cleansing Gel 150 ML,FBALYB Amazon,-1,-1,0,5,0,0
,Phytomer-Perfect Visage Gentle Cleansing Milk 250ML,Phytomer-Perfect Visage Gentle Cleansing Milk 250ML,Default Ridgefield,60,60,0,0,0,0
,Phytomer-Perfect Visage Gentle Cleansing Milk 250ML,Phytomer-Perfect Visage Gentle Cleansing Milk 250ML,FBALYB Amazon,1,1,0,0,0,0
,Phytomer-Rosee Visage Toning Cleansing Lotion 250ML,Phytomer-Rosee Visage Toning Cleansing Lotion 250ML,Default Ridgefield,21,21,0,0,0,0
,Phytomer-Rosee Visage Toning Cleansing Lotion 250ML,Phytomer-Rosee Visage Toning Cleansing Lotion 250ML,FBALYB Amazon,2,2,0,0,0,0
,Phytomer-Souffle Marin Cleansing Foaming Cream 150ML,Phytomer-Souffle Marin Cleansing Foaming Cream 150ML,FBALYB Amazon,3,3,0,0,0,0
,Phytomer-Souffle Marin Energizing Oxygenating Serum 30ML,Phytomer-Souffle Marin Energizing Oxygenating Serum 30ML,FBALYB Amazon,-7,-7,0,7,0,0
,Phytomer-Structuriste Firming Lift Cream 50ML,Phytomer-Structuriste Firming Lift Cream 50ML,Default Ridgefield,68,68,0,0,0,0
,Phytomer-Structuriste Firming Lift Cream 50ML,Phytomer-Structuriste Firming Lift Cream 50ML,FBALYB Amazon,89,89,0,0,0,0
,Phytomer-Vegetal Exfoliant With Natural Enzymes 50ML,Phytomer-Vegetal Exfoliant With Natural Enzymes 50ML,FBALYB Amazon,-3,-3,0,3,0,0
,Pie Face board Game,Pie Face board Game,FBALYB Amazon,-2,-2,0,1,0,0
,Pie Face Showdown,Pie Face Showdown,FBALYB Amazon,-9,-10,1,13,1,0
,Pink Packing Cubes Set + vaccum bag,Pink Packing Cubes Set + vaccum bag,FBALYB Amazon,-1,-1,0,0,0,0
,Pink Rotating Toothpaste squeezer,Pink Rotating Toothpaste squeezer,Default,0,-1003,1003,0,0,0
,Pink Rotating Toothpaste squeezer,Pink Rotating Toothpaste squeezer,Default Ridgefield,0,-200,200,0,0,0
,Pink Stuff Cream 2pack,Pink Stuff Cream 2pack,FBALYB Amazon,166,158,8,5,8,0
,Pink Stuff Cream + Foam Cleaner,Pink Stuff Cream + Foam Cleaner,FBALYB Amazon,108,96,12,0,12,0
,Pink Stuff Cream + Foam Cleaner,Pink Stuff Cream + Foam Cleaner,FBALYB Canada,0,0,0,50,0,0
,Pink Stuff Cream + Multi Cleaner,Pink Stuff Cream + Multi Cleaner,FBALYB Amazon,222,213,9,0,9,0
,Pink Stuff Paste  + Foam Cleaner,Pink Stuff Paste  + Foam Cleaner,FBALYB Amazon,1835,1767,68,13,68,0
,Pink Stuff Paste x2 + Multi Cleaner 750 ml,Pink Stuff Paste x2 + Multi Cleaner 750 ml,Default Ridgefield,2,2,0,0,0,0
,Pink Stuff Paste x2 + Multi Cleaner 750 ml,Pink Stuff Paste x2 + Multi Cleaner 750 ml,FBALYB Amazon,3148,2992,156,290,156,0
,Pioneer Pet - Fountain Filter,Pioneer Pet - Fountain Filter,Default,0,-800,800,0,0,0
,Pioneer Pet - Fountain Filter 3ct,Pioneer Pet - Fountain Filter 3ct,Default Ridgefield,599,599,0,0,0,0
,Pioneer Pet - Fountain Filter 3ct 2pk,Pioneer Pet - Fountain Filter 3ct 2pk,FBALYB Amazon,-18,-18,0,1,0,0
,Pioneer Pet - Swan Fountain,Pioneer Pet - Swan Fountain,Default Ridgefield,875,875,0,0,0,0
,Pioneer Pet - Swan Fountain,Pioneer Pet - Swan Fountain,FBALYB Amazon,293,293,0,0,0,0
,Pioneer Pet - Swan Fountain,Pioneer Pet - Swan Fountain,FBALYB Canada,7,7,0,0,0,0
,Pizzelle Waffle Cookie Vanilla - 20oz,Pizzelle Italian Waffle Cookie Vanilla - 20oz,FBALYB Amazon,-1,-1,0,0,0,0
,Pjilips HD9621/96 Air Fryer,Philips HD9621/96 AirFryer,Default,0,0,0,0,0,4
,Pjilips HD9621/96 Air Fryer,Philips HD9621/96 AirFryer,FBALYB Amazon,-1,-1,0,6,0,0
,PJ Masks 9 Piece Set,PJ Masks 9 Piece Set,Default,0,-1,1,0,0,0
,PJ Masks 9 Piece Set,PJ Masks 9 Piece Set,FBALYB Amazon,20,17,3,10,3,0
,PL Acacia Wood Cutting Board,PL Acacia Wood Cutting Board,Default Ridgefield,149,148,1,0,0,0
,PL Acacia Wood Cutting Board,PL Acacia Wood Cutting Board,FBALYB Amazon,151,151,0,0,0,0
,PL Acovado 1 Gallon Pure Avocado Oil,PL Acovado 1 Gallon Pure Avocado Oil,Default Ridgefield,268,268,0,0,0,0
,PL Acovado 1 Gallon Pure Avocado Oil,PL Acovado 1 Gallon Pure Avocado Oil,FBALYB Amazon,122,122,0,0,0,0
,PL Activated Charcoal Face Scrub 200gm,PL Activated Charcoal Face Scrub 200gm,Default Ridgefield,1514,1514,0,0,0,0
,PL Activated Charcoal Face Scrub 200gm,PL Activated Charcoal Face Scrub 200gm,FBALYB Amazon,250,250,0,0,0,0
,Planters Salted Peanuts ‑ 56 oz,Planters Salted Peanuts ‑ 56 oz,FBALYB Amazon,2,2,0,0,0,0
,Planters whole cashews 8.5 oz 2 pack,"Planters Deluxe Whole Cashews, 8.5-Ounce (Pack of 3)",FBALYB Amazon,1,1,0,0,0,0
,Plant Food All Purp 8oz,Plant Food All Purp 8oz,FBALYB Amazon,5,5,0,0,0,0
,Play-Doh Fun Pack 50 set,Play-Doh Fun Pack 50 set,Default,0,0,0,0,0,6
,Play‑Doh Ice Cream Treats Set,Play‑Doh Ice Cream Treats Set,FBALYB Amazon,1,1,0,0,0,0
,Play-Doh Kitchen Creations Playset,Play-Doh Kitchen Creations Playset,FBALYB Amazon,61,61,0,4,0,0
,Play-Doh Kitchen Creations Playset,Play-Doh Kitchen Creations Playset,WFS,-2,-2,0,0,0,0
,PlayGo My City Car Park,PlayGo My City Car Park,FBALYB Amazon,5,5,0,0,0,0
,PlayStation 4 1Tb Battlefront II Bundle,PlayStation 4 - PlayStation 4 1Tb Star Wars Battlefront II Bundle,Default,0,0,0,0,0,12
,PlayStation Gold Wireless Gaming Headset,PlayStation Gold Wireless Gaming Headset,Default,0,0,0,0,0,2
,Playtex Gentle Glide 360 Super 80ct,"Playtex Gentle Glide 360 Unscented Tampon, Super Absorbency (80 count)",Default,0,-8,8,0,0,0
,Playtex Sport 80ct,Playtex Sport regular unscented 80ct,FBALYB Amazon,148,146,2,53,2,0
,Playtex Sport Unscented 96ct,Playtex Sport Unscented 96ct,FBALYB Amazon,159,159,0,10,0,0
,Playtex Super Sport 96,Playtex Super Sport 96,Avrami - Ebay,180,180,0,0,0,0
,Playtex Super Sport 96,Playtex Super Sport 96,FBALYB Amazon,3,3,0,0,0,0
,Playtex Super Sport 96,Playtex Super Sport 96,WFS,-27,-27,0,0,0,0
,PL Bamboo 30 spice rack,PL Bamboo 30 spice rack,Default Ridgefield,256,256,0,0,0,0
,PL Bamboo 30 spice rack,PL Bamboo 30 spice rack,FBALYB Amazon,42,42,0,0,0,0
,PL Bamboo Bathtub Caddy,PL Bamboo Bathtub Caddy,Default Ridgefield,399,399,0,0,0,0
,PL Bamboo Bathtub Caddy,PL Bamboo Bathtub Caddy,FBALYB Amazon,72,64,8,0,8,0
,PL Bamboo Cheese Board,PL Bamboo Cheese Board,Default Ridgefield,300,300,0,0,0,0
,PL Bamboo Cheese Board,PL Bamboo Cheese Board,FBALYB Amazon,202,202,0,1,0,0
,PL Bamboo Tray with Laser Logo,PL Bamboo Tray with Laser Logo,FBALYB Amazon,69,68,1,0,1,0
,PL Bentonite Clay Powder (Multani Mitti / Fuller's Earth) (454 Gram * 1000 White Jar Container),PL Bentonite Clay Powder (Multani Mitti / Fuller's Earth) (454 Gram * 1000 White Jar Container),Default Ridgefield,800,800,0,0,0,0
,PL Bentonite Clay Powder (Multani Mitti / Fuller's Earth) (454 Gram * 1000 White Jar Container),PL Bentonite Clay Powder (Multani Mitti / Fuller's Earth) (454 Gram * 1000 White Jar Container),FBALYB Amazon,189,189,0,0,0,0
,PL Black and White Marble Shave Bowl,PL Black and White Marble Shave Bowl,Default,0,0,0,0,0,1
,PL Black and White Marble Shave Bowl,PL Black and White Marble Shave Bowl,FBALYB Amazon,-1,-1,0,0,0,0
,PL Black and White Marble Shave Bowl,PL Black and White Marble Shave Bowl,FBALYB Canada,8,8,0,0,0,0
,PL Black Bread Slicer,PL Black Bread Slicer,Default Ridgefield,788,788,0,0,0,0
,PL Black Bread Slicer,PL Black Bread Slicer,FBALYB Amazon,98,96,2,0,2,0
,PL Black Bread Slicer,PL Black Bread Slicer,FBALYB Canada,-20,-20,0,20,0,0
,PL Black Granite Shave Bowl,PL Black Granite Shave Bowl,Default,0,0,0,0,0,9
,PL Black Granite Shave Bowl,PL Black Granite Shave Bowl,Default Ridgefield,1008,1008,0,0,0,0
,PL Black Granite Shave Bowl,PL Black Granite Shave Bowl,FBALYB Amazon,41,41,0,0,0,0
,PL Blue Bread Slicer,PL Blue Bread Slicer,Default Ridgefield,92,92,0,0,0,0
,PL Blue Bread Slicer,PL Blue Bread Slicer,FBALYB Amazon,168,165,3,0,3,0
,PL Blue Bread Slicer,PL Blue Bread Slicer,FBALYB Canada,12,12,0,0,0,0
,PL Brown Marble Shave Bowl,PL Brown Marble Shave Bowl,Default,0,0,0,0,0,1
,PL Brown Marble Shave Bowl,PL Brown Marble Shave Bowl,FBALYB Amazon,82,82,0,0,0,0
,PL Buddy's Best 16oz Shampoo Conditioner OG Coconut Vanilla,PL Buddy's Best 16oz Shampoo Conditioner OG Coconut Vanilla,Default Ridgefield,6743,6743,0,0,0,0
,PL Buddy's Best 16oz Shampoo Conditioner OG Coconut Vanilla,PL Buddy's Best 16oz Shampoo Conditioner OG Coconut Vanilla,FBALYB Amazon,608,593,15,0,15,0
,PL Buddy's Best 16oz Shampoo Conditioner OG Coconut Vanilla,PL Buddy's Best 16oz Shampoo Conditioner OG Coconut Vanilla,FBALYB Canada,17,17,0,0,0,0
,PL Buddy's Best All in One Dog Shampoo 1 Gal,PL Buddy's Best All in One Dog Shampoo 1 Gal,Default Ridgefield,192,192,0,0,0,0
,PL Buddy's Best All in One Dog Shampoo 1 Gal,PL Buddy's Best All in One Dog Shampoo 1 Gal,FBALYB Amazon,111,111,0,3,0,0
,PL BUDDY'S BEST ALL-IN-ONE DOG SHAMPOO 32OZ (WHITE  BULLET/WHITE CAP/SEALED) LB-BB32-2N1,PL BUDDY'S BEST ALL-IN-ONE DOG SHAMPOO 32OZ (WHITE  BULLET/WHITE CAP/SEALED) LB-BB32-2N1,Default,0,0,0,0,0,804
,PL Buddy's Best Citrus Fresh Shampoo & Conditioner 16Oz,PL Buddy's Best Citrus Fresh Shampoo & Conditioner 16Oz,Default Ridgefield,1020,1020,0,0,0,0
,PL Buddy's Best Citrus Fresh Shampoo & Conditioner 16Oz,PL Buddy's Best Citrus Fresh Shampoo & Conditioner 16Oz,FBALYB Amazon,259,259,0,0,0,0
,PL Buddy's Best Hemp Oil for Dogs 1oz Bottle 2pk,PL Buddy's Best Hemp Oil for Dogs 1oz Bottle 2pk,FBALYB Amazon,182,179,3,0,3,0
,PL Buddy's Best Hypo/Bright Shampoo & Conditioner 16Oz,PL Buddy's Best Hypo/Bright Shampoo & Conditioner 16Oz,Default Ridgefield,600,600,0,0,0,0
,PL Buddy's Best Hypo/Bright Shampoo & Conditioner 16Oz,PL Buddy's Best Hypo/Bright Shampoo & Conditioner 16Oz,FBALYB Amazon,207,206,1,8,1,0
,PL Buddy's Best Lavender Shampoo & Conditioner 16Oz,PL Buddy's Best Lavender Shampoo & Conditioner 16Oz,Default Ridgefield,1324,1324,0,0,0,0
,PL Buddy's Best Lavender Shampoo & Conditioner 16Oz,PL Buddy's Best Lavender Shampoo & Conditioner 16Oz,FBALYB Amazon,209,207,2,112,2,0
,PL Buddy's Best Ripe Melon 16 oz,PL Buddy's Best Ripe Melon 16 oz,Default Ridgefield,2202,2202,0,0,0,0
,PL Buddy's Best Ripe Melon 16 oz,PL Buddy's Best Ripe Melon 16 oz,FBALYB Amazon,122,117,5,0,5,0
,PL Buddy's Best Tooth Brushing Gel,PL Buddy's Best Tooth Brushing Gel,Default Ridgefield,4600,4600,0,0,0,0
,PL Buddy's Best Tooth Brushing Gel,PL Buddy's Best Tooth Brushing Gel,FBALYB Amazon,400,400,0,0,0,0
,PL CD Holder,PL CD Holder,Default Ridgefield,22,22,0,0,0,0
,PL CD Holder,PL CD Holder,FBAFBA LYB AUSTRALIA,0,0,0,20,0,0
,PL CD Holder,PL CD Holder,FBALYB Amazon,240,205,35,0,35,0
,PL CD Holder,PL CD Holder,FBALYB Canada,20,20,0,0,0,0
,PL Coir Garden Basket,PL Coir Garden Basket,Default,0,0,0,0,0,1000
,PL Coir Garden Pot,PL Coir Garden Pot,Default,0,0,0,0,0,1000
,PL Coir Garden Pot Conical,PL Coir Garden Pot Conical,Default,0,0,0,0,0,400
,PL Coir Garden Pot Iron Stand,PL Coir Garden Pot Iron Stand,Default,0,0,0,0,0,200
,PL Coir Garden Pot Mat,PL Coir Garden Pot Mat,Default,0,0,0,0,0,1000
,PL Coir Garden Pot Seeding Cup,PL Coir Garden Pot Seeding Cup,Default,0,0,0,0,0,200
,PL Coir Garden Pot Spanish Cup,PL Coir Garden Pot Spanish Cup,Default,0,0,0,0,0,200
,PL Coir Garden Pot Spanish Pot,PL Coir Garden Pot Spanish Pot,Default,0,0,0,0,0,200
,PL Coir Garden Pot With Iron Stand,PL Coir Garden Pot With Iron Stand,Default,0,0,0,0,0,1200
,PL Coir Garden Pot With Iron Stand 3 In,PL Coir Garden Pot With Iron Stand 3 In,Default,0,0,0,0,0,200
,PL Coir Garden Pot XL,PL Coir Garden Pot XL,Default,0,0,0,0,0,200
,PL Coir Garden Wall Basket,PL Coir Garden Wall Basket,Default,0,0,0,0,0,200
,PL Coir Garden Wall Hanger Basket,PL Coir Garden Wall Hanger Basket,Default,0,0,0,0,0,200
,PL Coir Support,PL Coir Support,Default,0,0,0,0,0,1000
,PL COTTON TOTE BAGS 12ct,"PL 100% COTTON TOTE BAG 15""x16"" 1330 Kgs 12ct",Default Ridgefield,1136,1136,0,0,0,0
,PL COTTON TOTE BAGS 5ct,"PL 100% COTTON TOTE BAG 15""x16"" 1330 Kgs 5ct",Default Ridgefield,1120,1120,0,0,0,0
,PL Eyelashes Growth Serum,PL Eyelashes Growth Serum,Default Ridgefield,984,984,0,0,0,0
,PL Factory high quality soft baby bamboo toothbrush,PL Factory high quality soft baby bamboo toothbrush,Default,0,0,0,0,0,4300
,PL Factory high quality soft baby bamboo toothbrush,PL Factory high quality soft baby bamboo toothbrush,Default Ridgefield,1200,1200,0,0,0,0
,PL Factory high quality soft baby bamboo toothbrush 10pk,PL Factory high quality soft baby bamboo toothbrush 10pk,FBALYB Amazon,182,182,0,0,0,0
,PL Grape Seed Face Scrub 200gm,PL Grape Seed Face Scrub 200gm,Default Ridgefield,1766,1766,0,0,0,0
,PL Green Bread Slicer,PL Green Bread Slicer,Default Ridgefield,72,72,0,0,0,0
,PL Green Bread Slicer,PL Green Bread Slicer,FBALYB Amazon,67,61,6,0,6,0
,PL Green Granite Shave Bowl,PL Green Granite Shave Bowl,Default,0,0,0,0,0,2
,PL Green Granite Shave Bowl,PL Green Granite Shave Bowl,FBALYB Amazon,69,69,0,0,0,0
,PL Green Marble Shave Bowl,PL Green Marble Shave Bowl,Default Ridgefield,100,100,0,0,0,0
,PL Grey Bread Slicer,PL Grey Bread Slicer,Default Ridgefield,92,92,0,0,0,0
,PL Grey Bread Slicer,PL Grey Bread Slicer,FBALYB Amazon,147,145,2,0,2,0
,PL Grey Bread Slicer,PL Grey Bread Slicer,FBALYB Canada,4,3,1,0,1,0
,PL Grey Granite Shave Bowl,PL Grey Granite Shave Bowl,Default,0,0,0,0,0,1
,PL Grey Granite Shave Bowl,PL Grey Granite Shave Bowl,FBALYB Amazon,92,91,1,0,1,0
,PL Hair Cream Anti Dandruff 200ml,PL Hair Cream Anti Dandruff 200ml,Default Ridgefield,1008,1008,0,0,0,0
,PL Hyaluranic Acid face serum 50ml,PL Hyaluranic Acid face serum 50ml,Default Ridgefield,2500,2500,0,0,0,0
,PL Hyaluranic Acid face serum 50ml,PL Hyaluranic Acid face serum 50ml,FBALYB Amazon,250,250,0,0,0,0
,PL Iron Lion Blue Mountain Coffee Ground Medium Roast 8 oz,PL Iron Lion Blue Mountain Coffee Ground Medium Roast 8 oz,Default Ridgefield,6,6,0,0,0,0
,PL Iron Lion Blue Mountain Coffee Ground Medium Roast 8 oz,PL Iron Lion Blue Mountain Coffee Ground Medium Roast 8 oz,FBALYB Amazon,101,99,2,0,2,0
,PL Iron Lion Blue Mountain Coffee Whole Beans Medium Roast 8 oz,PL Iron Lion Blue Mountain Coffee Whole Beans Medium Roast 8 oz,Default Ridgefield,1600,1600,0,0,0,0
,PL Iron Lion Blue Mountain Coffee Whole Beans Medium Roast 8 oz,PL Iron Lion Blue Mountain Coffee Whole Beans Medium Roast 8 oz,FBALYB Amazon,91,85,6,0,6,0
,PL Light Grey Marble Shave Bowl,PL Light Grey Marble Shave Bowl,Default,0,0,0,0,0,1
,PL Light Grey Marble Shave Bowl,PL Light Grey Marble Shave Bowl,Default Ridgefield,36,36,0,0,0,0
,PL Light Grey Marble Shave Bowl,PL Light Grey Marble Shave Bowl,FBALYB Amazon,34,34,0,0,0,0
,PL Magnetic Eyeliner and Eyelashes M5 AD811 Diamond,PL Magnetic Eyeliner and Eyelashes M5 AD811 Diamond,Default Ridgefield,219,219,0,0,0,0
,PL Mini Cookie Cutter Set 24 pc,PL Mini Cookie Cutter Set 24 pc,Default Ridgefield,197,197,0,0,0,0
,PL Moroccan Argan prem. Hair serum 100ml,PL Moroccan Argan prem. Hair serum 100ml,Default Ridgefield,1026,1026,0,0,0,0
,PL New design Customized logo bamboo toothbrush electric toothbrush,PL New design Customized logo bamboo toothbrush electric toothbrush,Default,0,0,0,0,0,1
,PL Onion Hair Oil 200ml,PL Onion Hair Oil 200ml,Default Ridgefield,748,748,0,0,0,0
,PL Onion Hair Oil 200ml,PL Onion Hair Oil 200ml,FBALYB Amazon,248,248,0,0,0,0
,PL Palm Naki 10 Inch Round Shallow 40 ct,PL Palm Naki 10 Inch Round Shallow 40 ct,Default,0,0,0,0,0,350
,PL Palm Naki 10 Inch Round Shallow 40 ct,PL Palm Naki 10 Inch Round Shallow 40 ct,Default Ridgefield,150,150,0,0,0,0
,PL Palm Naki 10 Inch Square 40 ct,PL Palm Naki 10 Inch Square 40 ct,Default Ridgefield,537,537,0,0,0,991
,PL Palm Naki 10 Inch Square 40 ct,PL Palm Naki 10 Inch Square 40 ct,FBALYB Amazon,-6,-10,4,2,4,0
,PL Palm Naki 10 Inch Square 40 ct,PL Palm Naki 10 Inch Square 40 ct,FBALYB Canada,10,4,6,0,6,0
,"PL Palm Naki 10"" Round 3Cp 40 ct","PL Palm Naki 10"" Round 3Cp 40 ct",Default Ridgefield,487,487,0,0,0,0
,"PL Palm Naki 10"" Round Plate","PL Palm Naki 10"" Round Plate 40ct",Default Ridgefield,355,355,0,0,0,991
,"PL Palm Naki 10"" Round Plate","PL Palm Naki 10"" Round Plate 40ct",FBALYB Amazon,558,548,10,21,10,0
,"PL Palm Naki 10"" Round Plate","PL Palm Naki 10"" Round Plate 40ct",FBALYB Canada,0,0,0,11,0,0
,"PL Palm Naki 10"" Square 3Cp 40 ct","PL Palm Naki 10"" Square 3Cp 40 ct",Default Ridgefield,469,469,0,0,0,0
,"PL Palm Naki 11"" Boat Shape 40 ct","PL Palm Naki 11"" Boat Shape 40 ct",Default Ridgefield,180,180,0,0,0,0
,PL Palm Naki 12 Inch Round 40 ct,PL Palm Naki 12 Inch Round 40 ct,Default,0,0,0,0,0,3
,PL Palm Naki 12 Inch Round 40 ct,PL Palm Naki 12 Inch Round 40 ct,Default Ridgefield,133,133,0,0,0,0
,PL Palm Naki 12 Inch Round 40 ct,PL Palm Naki 12 Inch Round 40 ct,FBALYB Amazon,342,342,0,0,0,0
,"PL Palm Naki 12"" Rectangle 5Cp 40 ct","PL Palm Naki 12"" Rectangle 5Cp 40 ct",Default Ridgefield,178,178,0,0,0,0
,"PL Palm Naki 12"" Round Deep 40 ct","PL Palm Naki 12"" Round Deep 40 ct",Default Ridgefield,298,298,0,0,0,75
,"PL Palm Naki 3"" Deep Square Plate 40 ct","PL Palm Naki 3"" Deep Square Plate 40 ct",Default Ridgefield,260,260,0,0,0,0
,PL Palm Naki 4 Inch Square Bowl 40 ct,PL Palm Naki 4 Inch Square Bowl 40 ct,Default Ridgefield,1408,1408,0,0,0,0
,"PL Palm Naki 4"" Round Plate 40 ct","PL Palm Naki 4"" Round Plate 40 ct",Default Ridgefield,370,370,0,0,0,48
,"PL Palm Naki 4"" Square Plate 40 ct","PL Palm Naki 4"" Square Plate 40 ct",Default,0,0,0,0,0,3
,"PL Palm Naki 4"" Square Plate 40 ct","PL Palm Naki 4"" Square Plate 40 ct",Default Ridgefield,266,266,0,0,0,452
,"PL Palm Naki 5"" Heart Areca Stealth plates 40 ct","PL Palm Naki 5"" Heart Areca Stealth plates 40 ct",Default Ridgefield,2,2,0,0,0,0
,"PL Palm Naki 5"" Round Bowl 40 ct","PL Palm Naki 5"" Round Bowl 40 ct",Default Ridgefield,463,463,0,0,0,102
,"PL Palm Naki 5"" Round Bowl 40 ct","PL Palm Naki 5"" Round Bowl 40 ct",FBALYB Canada,16,16,0,0,0,0
,PL Palm Naki 6 Inch Square 40 ct,PL Palm Naki 6 Inch Square 40 ct,Default,0,0,0,0,0,10
,PL Palm Naki 6 Inch Square 40 ct,PL Palm Naki 6 Inch Square 40 ct,Default Ridgefield,32,32,0,0,0,0
,PL Palm Naki 6 Inch Square 40 ct,PL Palm Naki 6 Inch Square 40 ct,FBALYB Amazon,11,1,10,0,10,0
,PL Palm Naki 6 Inch Square 40 ct,PL Palm Naki 6 Inch Square 40 ct,FBALYB Canada,10,10,0,0,0,0
,"PL Palm Naki 6 "" Pyramid 40 ct","PL Palm Naki 6 "" Pyramid 40 ct",Default Ridgefield,300,300,0,0,0,0
,"PL Palm Naki 6"" Round Deep 40 ct","PL Palm Naki 6"" Round Deep 40 ct",Default Ridgefield,493,493,0,0,0,0
,"PL Palm Naki 6"" Square Plate 40 ct","PL Palm Naki 6"" Square Plate 40 ct",Default Ridgefield,1781,1781,0,0,0,496
,PL Palm Naki 6x9 Inch Plate 40 ct,PL Palm Naki 6x9 Inch Plate 40 ct,Default,0,0,0,0,0,12
,PL Palm Naki 6x9 Inch Plate 40 ct,PL Palm Naki 6x9 Inch Plate 40 ct,Default Ridgefield,1371,1371,0,0,0,0
,"PL Palm Naki 7"" Round Deep 40 ct","PL Palm Naki 7"" Round Deep 40 ct",Default Ridgefield,200,200,0,0,0,0
,PL Palm Naki 8 Inch Round Shallow 40 ct,PL Palm Naki 8 Inch Round Shallow 40 ct,Default,0,0,0,0,0,266
,PL Palm Naki 8 Inch Round Shallow 40 ct,PL Palm Naki 8 Inch Round Shallow 40 ct,Default Ridgefield,40,40,0,0,0,986
,PL Palm Naki 8 Inch Round Shallow 40 ct,PL Palm Naki 8 Inch Round Shallow 40 ct,FBALYB Amazon,172,171,1,0,1,0
,PL Palm Naki 8 Inch Square 40 ct,PL Palm Naki 8 Inch Square 40 ct,Default,0,0,0,0,0,38
,PL Palm Naki 8 Inch Square 40 ct,PL Palm Naki 8 Inch Square 40 ct,Default Ridgefield,114,114,0,0,0,890
,PL Palm Naki 8 Inch Square 40 ct,PL Palm Naki 8 Inch Square 40 ct,FBAFBA LYB AUSTRALIA,0,0,0,15,0,0
,PL Palm Naki 8 Inch Square 40 ct,PL Palm Naki 8 Inch Square 40 ct,FBALYB Amazon,36,30,6,15,6,0
,PL Palm Naki 8 Inch Square 40 ct,PL Palm Naki 8 Inch Square 40 ct,FBALYB Canada,-3,-3,0,0,0,0
,"PL Palm Naki 8"" Round Deep 40 ct","PL Palm Naki 8"" Round Deep 40 ct",Default Ridgefield,192,192,0,0,0,0
,"PL Palm Naki 8"" Square Bowl 40 ct","PL Palm Naki 8"" Square Bowl 40 ct",Default Ridgefield,304,304,0,0,0,0
,"PL Palm Naki 9"" Boat Shape 40 ct","PL Palm Naki 9"" Boat Shape 40 ct",Default Ridgefield,135,135,0,0,0,0
,PL Palm Naki Fork 40 ct,PL Palm Naki Fork 40 ct,Default Ridgefield,503,503,0,0,0,207
,PL Palm Naki Fork 40 ct,PL Palm Naki Fork 40 ct,FBALYB Amazon,182,170,12,0,12,0
,PL Palm Naki Knife 40 ct,PL Palm Naki Knife 40 ct,Default Ridgefield,1000,1000,0,0,0,164
,PL Palm Naki Oval 13 x 10 inch Platter 40 ct,PL Palm Naki Oval 13 x 10 inch Platter 40 ct,Default Ridgefield,10,10,0,0,0,0
,PL Palm Naki Spoon 40 ct,PL Palm Naki Spoon 40 ct,Default Ridgefield,1028,1028,0,0,0,164
,PL Papaya & Honey Face Scrub 200gm,PL Papaya & Honey Face Scrub 200gm,Default Ridgefield,1500,1500,0,0,0,0
,PL Papaya & Honey Face Scrub 200gm,PL Papaya & Honey Face Scrub 200gm,FBALYB Amazon,250,250,0,0,0,0
,PL Paraffin 4 Liter,PL Paraffin 4 Liter,Default Ridgefield,285,285,0,0,0,0
,PL Paraffin 4 Liter,PL Paraffin 4 Liter,FBALYB Amazon,114,102,12,0,12,0
,PL Paraffin 4 Liter,PL Paraffin 4 Liter,FBALYB Canada,0,0,0,25,0,0
,PL Paraffin Gal,PL Paraffin Gal,Default Ridgefield,600,600,0,0,0,0
,PL Pink Bread Slicer,PL Pink Bread Slicer,Default Ridgefield,92,92,0,0,0,0
,PL Pink Bread Slicer,PL Pink Bread Slicer,FBALYB Amazon,157,156,1,0,1,0
,PL Pink Bread Slicer,PL Pink Bread Slicer,FBALYB Canada,11,11,0,0,0,0
,PL Pink Marble Shave Bowl,PL Pink Marble Shave Bowl,Default,0,0,0,0,0,1
,PL Pink Marble Shave Bowl,PL Pink Marble Shave Bowl,FBALYB Amazon,83,83,0,0,0,0
,PL Red Bread Slicer,PL Red Bread Slicer,Default Ridgefield,808,808,0,0,0,0
,PL Red Bread Slicer,PL Red Bread Slicer,FBALYB Amazon,142,136,6,0,6,0
,PL Red Bread Slicer,PL Red Bread Slicer,FBALYB Canada,-43,-44,1,0,1,0
,PL Retinol Face Serum 50ml,PL Retinol Face Serum 50ml,Default Ridgefield,2750,2750,0,0,0,0
,PL Stock Eco Friendly Plastic Toothpaste Squeezer BLUE,PL Stock Eco Friendly Plastic Toothpaste Squeezer BLUE,Default Ridgefield,2199,2199,0,0,0,0
,PL Stock Eco Friendly Plastic Toothpaste Squeezer RED,PL Stock Eco Friendly Plastic Toothpaste Squeezer RED,Default Ridgefield,1398,1398,0,0,0,0
,PL Trickonometry Bd wdge pllw LGry,PL Trickonometry Bed wedge pillow Light Grey,Default,0,0,0,0,0,300
,PL Trickonometry Bed wdge plw Blue,PL Trickonometry Bed wedge pillow Blue,Default,0,0,0,0,0,100
,PL Trickonometry Bed wdge plw Brn,PL Trickonometry Bed wedge pillow Brown,FBALYB Amazon,100,100,0,0,0,0
,PL Trickonometry Bed wdge plw Pnk,PL Trickonometry Bed wedge pillow Pink,Default,0,0,0,0,0,100
,PL Trickonometry Bed wedge plw Blk,PL Trickonometry Bed wedge pillow Black,Default,0,0,0,0,0,8
,PL Trickonometry Bed wedge plw Blk,PL Trickonometry Bed wedge pillow Black,FBALYB Amazon,92,92,0,0,0,0
,PL Trickonometry Bed wedge plw Wte,PL Trickonometry Bed wedge pillow White,Default,0,0,0,0,0,28
,PL Trickonometry Bed wedge plw Wte,PL Trickonometry Bed wedge pillow White,Default Ridgefield,8,8,0,0,0,0
,PL Trickonometry Bed wedge plw Wte,PL Trickonometry Bed wedge pillow White,FBALYB Amazon,64,63,1,0,1,0
,PL Trickonometry Cling lmbr plw Bk,PL Trickonometry Cooling gel lumber pillow Black,Default,0,0,0,0,0,200
,PL Trickonometry Cling lmbr plw Gr,PL Trickonometry Cooling gel lumber pillow Grey,Default,0,0,0,0,0,200
,PL Trickonometry Cling lmbr plw Nv,PL Trickonometry Cooling gel lumber pillow Navy Blue,Default,0,0,0,0,0,200
,PL Trickonometry Donut Seat Blk,PL Trickonometry Donut Seat Cushion Black,Default,0,0,0,0,0,400
,PL Trickonometry Donut Seat Brgndy,PL Trickonometry Donut Seat Cushion Burgundy,Default,0,0,0,0,0,400
,PL Trickonometry Donut Seat Gry,PL Trickonometry Donut Seat Cushion Grey,Default,0,0,0,0,0,400
,PL Trickonometry Donut Seat Nvy,PL Trickonometry Donut Seat Cushion Navy Blue,Default,0,0,0,0,0,400
,PL Trickonometry Donut Seat Wte,PL Trickonometry Donut Seat Cushion White,Default,0,0,0,0,0,400
,PL Trickonometry D Pillow Black,PL Trickonometry D Shape Pillow Black,Default,0,0,0,0,0,300
,PL Trickonometry D Pillow Brgundy,PL Trickonometry D Shape Pillow Burgundy,Default,0,0,0,0,0,300
,PL Trickonometry D Pillow Grey,PL Trickonometry D Shape Pillow Grey,Default,0,0,0,0,0,300
,PL Trickonometry D Pillow Nvy Blue,PL Trickonometry D Shape Pillow Navy Blue,Default,0,0,0,0,0,300
,PL Trickonometry D Pillow White,PL Trickonometry D Shape Pillow White,Default,0,0,0,0,0,300
,PL Trickonometry Leg Rst Pillw Nvy,PL Trickonometry Leg Rest Pillow Navy Blue,Default Ridgefield,100,100,0,0,0,0
,PL Trickonometry Leg Rst Pillw Nvy,PL Trickonometry Leg Rest Pillow Navy Blue,FBALYB Amazon,200,200,0,0,0,0
,PL Trickonometry Leg Rst Plw Bgndy,PL Trickonometry Leg Rest Pillow Burgundy,Default Ridgefield,100,100,0,0,0,0
,PL Trickonometry Leg Rst Plw Bgndy,PL Trickonometry Leg Rest Pillow Burgundy,FBALYB Amazon,200,200,0,0,0,0
,PL Trickonometry Leg Rst Plw Gry,PL Trickonometry Leg Rest Pillow Grey,Default Ridgefield,100,100,0,0,0,0
,PL Trickonometry Leg Rst Plw Gry,PL Trickonometry Leg Rest Pillow Grey,FBALYB Amazon,200,200,0,0,0,0
,PL Trickonometry Leg Rst Plw Wte,PL Trickonometry Leg Rest Pillow White,Default Ridgefield,100,100,0,0,0,0
,PL Trickonometry Leg Rst Plw Wte,PL Trickonometry Leg Rest Pillow White,FBALYB Amazon,200,200,0,0,0,0
,PL Trickonometry Lmbr sprt plw Blk,PL Trickonometry Lumbar support pillow Black,Default,0,0,0,0,0,600
,PL Trickonometry Lmbr sprt plw Gry,PL Trickonometry Lumbar support pillow Grey,Default,0,0,0,0,0,600
,PL Trickonometry Rding Pillow Gry,PL Trickonometry Reading Pillow Grey,Default,0,0,0,0,0,4
,PL Trickonometry Rding Pillow Gry,PL Trickonometry Reading Pillow Grey,FBALYB Amazon,196,196,0,0,0,0
,PL Trickonometry Rding Plw Brgndy,PL Trickonometry Reading Pillow Burgundy,Default,0,0,0,0,0,4
,PL Trickonometry Rding Plw Brgndy,PL Trickonometry Reading Pillow Burgundy,Default Ridgefield,4,4,0,0,0,0
,PL Trickonometry Rding Plw Brgndy,PL Trickonometry Reading Pillow Burgundy,FBALYB Amazon,190,190,0,2,0,0
,PL Trickonometry Rding Plw Nvy,PL Trickonometry Reading Pillow Navy Blue,FBALYB Amazon,200,200,0,0,0,0
,PL Trickonometry U Preg Pillow Gry,PL Trickonometry U Shaped Pregnancy Pillow Grey,Default Ridgefield,2,2,0,0,0,0
,PL Trickonometry U Preg Pillow Gry,PL Trickonometry U Shaped Pregnancy Pillow Grey,FBALYB Amazon,198,198,0,0,0,0
,PL Trickonometry U Preg Pillow Wte,PL Trickonometry U Shaped Pregnancy Pillow White,FBALYB Amazon,200,200,0,0,0,0
,PL Vitamin C face serum 50ml,PL Vitamin C face serum 50ml,Default Ridgefield,2427,2427,0,0,0,0
,PL Vitamin C face serum 50ml,PL Vitamin C face serum 50ml,FBALYB Amazon,250,250,0,0,0,0
,PL White Bread Slicer,PL White Bread Slicer,Default Ridgefield,92,92,0,0,0,0
,PL White Bread Slicer,PL White Bread Slicer,FBALYB Amazon,177,177,0,0,0,0
,PL White Bread Slicer,PL White Bread Slicer,FBALYB Canada,12,12,0,0,0,0
,PL White Marble Shave Bowl,PL White Marble Shave Bowl,Default Ridgefield,630,630,0,0,0,0
,PL White Marble Shave Bowl,PL White Marble Shave Bowl,FBALYB Amazon,169,169,0,0,0,0
,PL WOODEN COOKING SPOON SET OF 5 800 Kgs,PL WOODEN COOKING SPOON SET OF 5 800 Kgs,Default Ridgefield,1920,1920,0,0,0,0
,PL Yellow Bread Slicer,PL Yellow Bread Slicer,Default Ridgefield,92,92,0,0,0,0
,PL Yellow Bread Slicer,PL Yellow Bread Slicer,FBALYB Amazon,170,169,1,0,1,0
,PL Yellow Bread Slicer,PL Yellow Bread Slicer,FBALYB Canada,14,14,0,0,0,0
,Poise Pads Discreet Bladder Protection - Long Length 60ct,Poise Pads Discreet Bladder Protection - Long Length 60ct,Default Ridgefield,5,5,0,0,0,0
,Poise Pads Discrete Bladder Protection 45ct Ultimate Long,Poise Pads Discrete Bladder Protection 45ct Ultimate Long,Default Ridgefield,1,1,0,0,0,0
,Polaroid bar bjs,"Polk Audio SB225 Universal Bluetooth SoundBar, 31""",FBALYB Amazon,1,1,0,0,0,0
,Polychromos box of 60 Watercolour pencil,Polychromos box of 60 Watercolour pencil,FBALYB Amazon,-16,-20,4,5,4,0
,Polysporin Complete Heal Twin 1 oz pk,Polysporin Complete Heal Twin 1 oz pk,FBALYB Amazon,0,0,0,1,0,0
,Polysporin Ointment 30g 2ct,Polysporin Ointment 30g 2ct,Default,0,0,0,0,0,3
,Polysporin Ointment 30g 2ct,Polysporin Ointment 30g 2ct,FBALYB Amazon,-3,-3,0,1,0,0
,PondCare Algae Fix Treatment 32oz,PondCare Algae Fix Treatment 32oz,Default,0,0,0,0,0,12
,PondCare Algae Fix Treatment 32oz,PondCare Algae Fix Treatment 32oz,FBALYB Amazon,2,2,0,0,0,0
,PondCare Stress Coat 16 oz,PondCare Stress Coat 16 oz,FBALYB Amazon,-28,-28,0,0,0,0
,Poo-Pour Original Citrus 2oz 2pk,Poo-Pour Original Citrus 2oz 2pk,FBALYB Amazon,423,302,121,367,121,0
,Poo-Pour Original Citrus 2oz 2pk,Poo-Pour Original Citrus 2oz 2pk,FBALYB Canada,20,20,0,0,0,0
,Poo Pourri - 1.04oz Lavender Vanilla,Poo Pourri - 1.04oz Lavender Vanilla,Default,0,-10000,10000,0,0,0
,Poo Pourri - 1.4oz Original Citrus,Poo Pourri - 1.4oz Original Citrus,Default Ridgefield,480,480,0,0,0,0
,Poo Pourri - 2oz Original Citrus,Poo Pourri - 2oz Original Citrus,Default Ridgefield,0,0,0,0,0,3000
,Poo Pourri - 2oz Original Citrus,Poo Pourri - 2oz Original Citrus,FBALYB Amazon,700,576,124,23,124,0
,Poo Pourri - 2oz Original Citrus,Poo Pourri - 2oz Original Citrus,FBALYB Canada,236,233,3,0,3,0
,Poo-Pourri Bathroom Deodorizer Set of 3,Poo-Pourri Bathroom Deodorizer Set of 3,FBALYB Amazon,136,136,0,3,0,0
,Poo-Pourri Bathroom Spray 4oz 2pk,Poo-Pourri Bathroom Spray 4oz 2pk,FBALYB Amazon,3907,3774,133,86,133,0
,"Poo Pourri Citrus, Ship, Hibiscus 2 oz variety pack","Poo Pourri Citrus, Ship, Hibiscus 2 oz variety pack",FBALYB Amazon,-3,-3,0,0,0,0
,Poo Pourri - Deja Poo 2oz,Poo Pourri - Deja Poo 2oz,Default,0,0,0,0,0,4
,Poo Pourri - Deja Poo 2oz,Poo Pourri - Deja Poo 2oz,Default Ridgefield,844,844,0,0,0,0
,Poo Pourri - Deja Poo 2oz 2pk,Poo Pourri - Deja Poo 2oz 2pk,FBALYB Amazon,85,85,0,0,0,0
,Poo Pourri - Deja Poo 4Oz,Poo Pourri - Deja Poo 4Oz,Default Ridgefield,1210,1210,0,0,0,0
,Poo Pourri - Deja Poo 4Oz,Poo Pourri - Deja Poo 4Oz,FBALYB Amazon,765,740,25,0,25,0
,Poo Pourri - Deja Poo 4Oz,Poo Pourri - Deja Poo 4Oz,FBALYB Canada,20,20,0,30,0,0
,Poo Pourri - Deja Poo 4Oz 2pk,Poo Pourri - Deja Poo 4Oz 2pk,FBALYB Amazon,205,197,8,0,8,0
,Poo-Pourri Lavender 2oz&4oz Set,Poo-Pourri Lavender 2oz&4oz Set,FBALYB Amazon,209,202,7,51,7,0
,Poo Pourri - Lavender Vanilla 10mL Pocket-Sized,Poo Pourri - Lavender Vanilla 10mL Pocket-Sized,Default Ridgefield,609,609,0,0,0,0
,Poo-Pourri Lavender Vanilla 1.4oz 2pk,Poo-Pourri Lavender Vanilla 1.4oz 2pk,FBALYB Amazon,-4,-4,0,0,0,0
,Poo Pourri - Lavender Vanilla 16oz Refill,Poo Pourri - Lavender Vanilla 16oz Refill,Default Ridgefield,18,18,0,0,0,2500
,Poo Pourri - Lavender Vanilla 16oz Refill,Poo Pourri - Lavender Vanilla 16oz Refill,FBALYB Amazon,29,-7,36,44,36,0
,Poo Pourri - Lavender Vanilla 16oz Refill,Poo Pourri - Lavender Vanilla 16oz Refill,FBALYB Canada,78,78,0,0,0,0
,Poo Pourri - Lavender Vanilla 2oz,Poo Pourri - Lavender Vanilla 2oz,Avrami - Ebay,40,40,0,0,0,0
,Poo Pourri - Lavender Vanilla 2oz,Poo Pourri - Lavender Vanilla 2oz,Default Ridgefield,0,0,0,0,0,1200
,Poo Pourri - Lavender Vanilla 2oz,Poo Pourri - Lavender Vanilla 2oz,FBALYB Amazon,2904,2771,133,104,133,0
,PooPourri Lavender Vanilla 2oz 2pk,PooPourri Lavender Vanilla 2oz 2pk,Default Ridgefield,153,153,0,0,0,0
,PooPourri Lavender Vanilla 2oz 2pk,PooPourri Lavender Vanilla 2oz 2pk,FBALYB Amazon,854,823,31,38,31,0
,Poo Pourri - Lavender Vanilla 4Oz,Poo Pourri - Lavender Vanilla 4Oz,Default Ridgefield,226,226,0,0,0,1200
,Poo Pourri - Lavender Vanilla 4Oz,Poo Pourri - Lavender Vanilla 4Oz,FBALYB Amazon,1034,949,85,69,85,0
,Poo Pourri - Lavender Vanilla 4Oz,Poo Pourri - Lavender Vanilla 4Oz,FBALYB Canada,-1,-1,0,0,0,0
,Poo Pourri - Lavender Vanilla 4Oz 2pk,Poo Pourri - Lavender Vanilla 4Oz 2pk,FBALYB Amazon,1710,1614,96,6,96,0
,Poo-Pourri Original Citrus 10ml 5pk,Poo-Pourri Original Citrus 10ml 5pk,FBALYB Amazon,6,3,3,0,3,0
,Poo Pourri - Original Citrus 10mL Pocket-Sized,Poo Pourri - Original Citrus 10mL Pocket-Sized,Default Ridgefield,520,520,0,0,0,0
,Poo Pourri - Original Citrus 16oz Refill,Poo Pourri - Original Citrus 16oz Refill,Default Ridgefield,0,0,0,0,0,2500
,Poo Pourri - Original Citrus 16oz Refill,Poo Pourri - Original Citrus 16oz Refill,FBALYB Amazon,-1001,-1087,86,1234,86,0
,Poo Pourri - Original Citrus 16oz Refill,Poo Pourri - Original Citrus 16oz Refill,FBALYB Canada,40,40,0,0,0,0
,Poo Pourri Original Citrus 2oz & 4oz Bottles Set,Poo Pourri Original Citrus 2oz & 4oz Bottles Set,FBALYB Amazon,10,7,3,0,3,0
,Poo Pourri - Original Citrus 4Oz,Poo Pourri - Original Citrus 4Oz,Default Ridgefield,4076,4076,0,0,0,2400
,Poo Pourri - Original Citrus 4Oz,Poo Pourri - Original Citrus 4Oz,FBALYB Amazon,6825,6582,243,390,243,0
,Poo Pourri - Original Citrus 4Oz,Poo Pourri - Original Citrus 4Oz,FBALYB Canada,192,187,5,50,5,0
,Poo Pourri - Original Citrus 8Oz,Poo Pourri - Original Citrus 8Oz,Default Ridgefield,1060,1060,0,0,0,0
,Poo Pourri - Original Citrus 8Oz,Poo Pourri - Original Citrus 8Oz,FBALYB Amazon,1189,1132,57,0,57,0
,"Poo Pourri Original Citrus, Lavender Vanilla, and Tropical Hibiscus 4oz Set","Poo Pourri Original Citrus, Lavender Vanilla, and Tropical Hibiscus 4oz Set",FBALYB Amazon,240,231,9,0,9,0
,Poo Pourri - Original Citrus Tester,Poo Pourri - Original Citrus Tester,Default Ridgefield,960,960,0,0,0,0
,"Poo Pourri Original Citrus, Vanilla Mint and Royal Flush 4 oz Set","Poo Pourri Original Citrus, Vanilla Mint and Royal Flush 4 oz Set",FBALYB Amazon,-3,-3,0,0,0,0
,Poo-Pourri Royal Flush 2oz,Poo-Pourri Royal Flush 2oz,Default,0,0,0,0,0,9
,Poo-Pourri Royal Flush 2oz,Poo-Pourri Royal Flush 2oz,Default Ridgefield,379,379,0,0,0,360
,Poo-Pourri Royal Flush 2oz,Poo-Pourri Royal Flush 2oz,FBALYB Amazon,387,358,29,77,29,0
,Poo-Pourri Royal Flush 2oz,Poo-Pourri Royal Flush 2oz,FBALYB Canada,18,18,0,0,0,0
,Poo-Pourri Royal Flush 2oz 2pk,Poo-Pourri Royal Flush 2oz 2pk,FBALYB Amazon,1476,1467,9,4,9,0
,Poo-Pourri Royal Flush 4oz,Poo-Pourri Royal Flush 4oz ,Default Ridgefield,165,165,0,0,0,360
,Poo-Pourri Royal Flush 4oz,Poo-Pourri Royal Flush 4oz ,FBALYB Amazon,1013,993,20,50,20,0
,Poo Pourri Royal Flush 4oz 2pk,Poo Pourri Royal Flush 4oz 2pk,FBALYB Amazon,621,594,27,1,27,0
,Poo-Pourri Royal Flush Scent 1.4oz 2pk,Poo-Pourri Royal Flush Scent 1.4oz 2pk,FBALYB Amazon,187,186,1,0,1,0
,Poo Pourri - Secret Santa 2oz,Poo Pourri - Secret Santa 2oz,Default Ridgefield,968,968,0,0,0,0
,Poo Pourri - Secret Santa 2oz,Poo Pourri - Secret Santa 2oz,FBALYB Amazon,3,3,0,0,0,0
,Poo Pourri - Secret Santa 2oz 2pk,Poo Pourri - Secret Santa 2oz 2pk,FBALYB Amazon,179,179,0,0,0,0
,Poo Pourri - Secret Santa 4oz,Poo Pourri - Secret Santa 4oz,Default Ridgefield,41,41,0,0,0,0
,Poo Pourri - Secret Santa 4oz,Poo Pourri - Secret Santa 4oz,FBALYB Amazon,12,7,5,36,5,0
,Poo Pourri Ship Happens 2oz 2pk,Poo Pourri Ship Happens 2oz 2pk,FBALYB Amazon,134,131,3,0,3,0
,Poo Pourri Ship Happens 2oz Cus bottle,Poo Pourri Ship Happens 2oz Cus bottle,Default,0,0,0,0,0,12
,Poo Pourri Ship Happens 2oz Cus bottle,Poo Pourri Ship Happens 2oz Cus bottle,Default Ridgefield,4653,4653,0,0,0,0
,Poo Pourri Ship Happens 2oz Cus bottle,Poo Pourri Ship Happens 2oz Cus bottle,FBALYB Amazon,408,394,14,0,14,0
,Poo Pourri Ship Happens 2oz Cus bottle,Poo Pourri Ship Happens 2oz Cus bottle,FBALYB Canada,20,20,0,0,0,0
,Poo Pourri - Ship Happens 4oz,Poo Pourri - Ship Happens 4oz,Default Ridgefield,1393,1393,0,0,0,0
,Poo Pourri - Ship Happens 4oz,Poo Pourri - Ship Happens 4oz,FBALYB Amazon,638,584,54,1,54,0
,Poo Pourri - Ship Happens 4oz,Poo Pourri - Ship Happens 4oz,FBALYB Canada,0,0,0,50,0,0
,Poo Pourri - Shoe~Pourri 4oz,Poo Pourri - Shoe~Pourri 4oz,Default Ridgefield,146,146,0,0,0,0
,Poo Pourri - Shoe~Pourri 4oz,Poo Pourri - Shoe~Pourri 4oz,FBALYB Amazon,84,80,4,1,4,0
,Poo-Pourri Spray Lavender Vanilla Set,Poo-Pourri Spray Lavender Vanilla Set,FBALYB Amazon,283,282,1,0,1,0
,Poo-Pourri Toilet Spray Original 2pk,Poo-Pourri Toilet Spray Original 2pk,FBALYB Amazon,-9,-13,4,95,4,0
,Poo-Pourri Toilet Spray Set,Poo-Pourri Toilet Spray Set,FBALYB Amazon,494,493,1,6,1,0
,Poo Pourri - Trap-A-Crap 2Oz,Poo Pourri - Trap-A-Crap 2Oz,Default Ridgefield,3566,3566,0,0,0,0
,Poo Pourri - Trap-A-Crap 2Oz,Poo Pourri - Trap-A-Crap 2Oz,FBALYB Amazon,456,445,11,0,11,0
,Poo Pourri - Trap-A-Crap 2Oz,Poo Pourri - Trap-A-Crap 2Oz,FBALYB Canada,0,0,0,50,0,0
,Poo Pourri - Trap-A-Crap 2Oz 2pack,Poo Pourri - Trap-A-Crap 2Oz 2pack,FBALYB Amazon,43,42,1,0,1,0
,Poo Pourri - Trap-A-Crap 4Oz,Poo Pourri - Trap-A-Crap 4Oz,Default Ridgefield,3726,3726,0,0,0,0
,Poo Pourri - Trap-A-Crap 4Oz,Poo Pourri - Trap-A-Crap 4Oz,FBALYB Amazon,654,632,22,0,22,0
,Poo Pourri - Trap-A-Crap 4Oz,Poo Pourri - Trap-A-Crap 4Oz,FBALYB Canada,18,18,0,0,0,0
,Poo Pourri - Trap-A-Crap 4Oz 2PK,Poo Pourri - Trap-A-Crap 4Oz 2PK,FBALYB Amazon,277,273,4,0,4,0
,Poo-Pourri Tropical Hibiscus 10mL Pocket Sized,Poo-Pourri Tropical Hibiscus 10mL Pocket Sized,Default Ridgefield,13,13,0,0,0,0
,Poo-Pourri Tropical Hibiscus 10mL Pocket Sized,Poo-Pourri Tropical Hibiscus 10mL Pocket Sized,FBALYB Amazon,54,43,11,8,11,0
,Poo-Pourri Tropical Hibiscus 10mL Pocket Sized 5pk,Poo-Pourri Tropical Hibiscus 10mL Pocket Sized 5pk,Default Ridgefield,0,-40,40,0,0,0
,Poo-Pourri Tropical Hibiscus 10mL Pocket Sized 5pk,Poo-Pourri Tropical Hibiscus 10mL Pocket Sized 5pk,FBALYB Amazon,-1,-1,0,0,0,0
,Poo Pourri - Tropical Hibiscus 16oz Refill,Poo Pourri - Tropical Hibiscus 16oz Refill,Default Ridgefield,5,5,0,0,0,0
,Poo Pourri - Tropical Hibiscus 16oz Refill,Poo Pourri - Tropical Hibiscus 16oz Refill,FBALYB Amazon,1293,1255,38,1,38,0
,Poo Pourri - Tropical Hibiscus 2Oz,Poo Pourri - Tropical Hibiscus 2Oz,Default Ridgefield,10435,9675,760,0,0,360
,Poo Pourri - Tropical Hibiscus 2Oz,Poo Pourri - Tropical Hibiscus 2Oz,FBALYB Amazon,399,383,16,0,16,0
,Poo Pourri - Tropical Hibiscus 2Oz,Poo Pourri - Tropical Hibiscus 2Oz,FBALYB Canada,0,0,0,50,0,0
,Poo Pourri Tropical Hibiscus 2oz 2pk,Poo Pourri Tropical Hibiscus 2oz 2pk,Default Ridgefield,59,-321,380,0,0,0
,Poo Pourri Tropical Hibiscus 2oz 2pk,Poo Pourri Tropical Hibiscus 2oz 2pk,FBALYB Amazon,1233,1230,3,96,3,0
,Poo Pourri - Tropical Hibiscus 4oz,Poo Pourri - Tropical Hibiscus 4oz,Default Ridgefield,718,718,0,0,0,360
,Poo Pourri - Tropical Hibiscus 4oz,Poo Pourri - Tropical Hibiscus 4oz,FBALYB Amazon,792,754,38,1,38,0
,Poo Pourri - Tropical Hibiscus 4oz,Poo Pourri - Tropical Hibiscus 4oz,FBALYB Canada,14,13,1,0,1,0
,"Poo Pourri Tropical, Original, Lavendar 2oz variety","Poo Pourri Tropical, Original, Lavendar 2oz variety",FBALYB Amazon,58,58,0,0,0,0
,Poo Pourri - Vanilla Mint 10mL Pocket-Sized,Poo Pourri - Vanilla Mint 10mL Pocket-Sized,Default Ridgefield,312,312,0,0,0,0
,Poo Pourri - Vanilla Mint 2Oz,Poo Pourri - Vanilla Mint 2Oz,Default Ridgefield,16305,16305,0,0,0,1200
,Poo Pourri - Vanilla Mint 2Oz,Poo Pourri - Vanilla Mint 2Oz,FBALYB Amazon,566,564,2,138,2,0
,Poo Pourri - Vanilla Mint 2Oz,Poo Pourri - Vanilla Mint 2Oz,FBALYB Canada,0,0,0,50,0,0
,Poo Pourri - Vanilla Mint 4Oz,Poo Pourri - Vanilla Mint 4Oz,Default Ridgefield,10592,10592,0,0,0,1200
,Poo Pourri - Vanilla Mint 4Oz,Poo Pourri - Vanilla Mint 4Oz,FBALYB Amazon,1301,1251,50,1,50,0
,Poo Pourri Vanilla Mint Spray 2oz 2pk,Poo Pourri Vanilla Mint Spray 2oz 2pk,Default,0,-200,200,0,0,0
,Poo-Pourri Variety Pack 4 oz,Poo-Pourri Variety Pack 4 oz,FBALYB Amazon,310,306,4,3,4,0
,POO-PURRI CLOUD BERRY + DAISY + VANILLA 10ML POCKET SIZE,POO-PURRI CLOUD BERRY + DAISY + VANILLA 10ML POCKET SIZE,Default Ridgefield,156,156,0,0,0,0
,"Pop Secret Butter Popcorn, 30 ct","Pop Secret Butter Popcorn, 30 ct",Default Oxford,4,4,0,0,0,0
,"Pop Secret Butter Popcorn, 30 ct","Pop Secret Butter Popcorn, 30 ct",Default Ridgefield,50,50,0,0,0,0
,"Pop Secret Butter Popcorn, 30 ct","Pop Secret Butter Popcorn, 30 ct",FBALYB Amazon,814,799,15,142,15,0
,"Pop Secret Butter Popcorn, 30 ct 2pk","Pop Secret Butter Popcorn, 30 ct 2pk",FBALYB Amazon,4,1,3,4,3,0
,Pop Secret HomeStyle Popcorn,Pop Secret HomeStyle Popcorn,Default Ridgefield,196,196,0,0,0,0
,Pop Secret HomeStyle Popcorn,Pop Secret HomeStyle Popcorn,FBALYB Amazon,947,935,12,34,12,0
,Post Great Grains 40.5 oz.,"Post Great Grains Raisins, Dates and Pecans, 40.5 oz.",FBALYB Amazon,25,25,0,0,0,0
,Potato Head C.A. and Hawkeye,"Mr. Potato Head Mixable, Mashable Heroes Captain America and Hawkeye",FBALYB Amazon,-1,-1,0,0,0,0
,Potato Head Hulk and Wolverine,Mr. Potato Head Marvel Mixable Mashable Heroes as Hulk and Wolverine,FBALYB Amazon,-2,-2,0,2,0,0
,Potty Time with Elmo,Potty Time with Elmo (Liittle Sound Book),FBAAP Amazon,-1,-1,0,0,0,0
,"Pourri LavenderVanilla 4oz, 2oz Spritz","Pourri LavenderVanilla 4oz, 2oz Spritz",FBALYB Amazon,2,-3,5,0,5,0
,"Power Air Fryer XL 5.3QT, 752356812638","Power Air Fryer XL (5.3 QT, Black)",FBALYB Amazon,-15,-15,0,3,0,0
,Power Rangers Mega Mighties Black,Power Rangers Mega Mighties Black,Default Ridgefield,394,394,0,0,0,0
,Power Rangers Mega Mighties Black,Power Rangers Mega Mighties Black,FBALYB Amazon,283,279,4,0,4,0
,Power Rangers Mega Mighties Green,Power Rangers Mega Mighties Green,Default Ridgefield,475,475,0,0,0,0
,Power Rangers Mega Mighties Green,Power Rangers Mega Mighties Green,FBALYB Amazon,293,274,19,0,19,0
,Power Rangers Mega Mighties Red,Power Rangers Mega Mighties Red,Default Ridgefield,553,553,0,0,0,0
,Power Rangers Mega Mighties Red,Power Rangers Mega Mighties Red,FBALYB Amazon,199,199,0,0,0,0
,Power Up Mega Omega Trail Mix,Power Up Mega Omega Trail Mix,FBALYB Amazon,-3,-3,0,0,0,0
,Prana Deluxe Chocolate Mix Kilimanjaro,Prana Deluxe Chocolate Mix Kilimanjaro,Default,1,1,0,0,0,0
,Prana Deluxe Chocolate Mix Kilimanjaro,Prana Deluxe Chocolate Mix Kilimanjaro,FBALYB Amazon,-2,-2,0,0,0,0
,Pravana Color Protect Cleanse 11.1 oz,Pravana Color Protect Cleanse 11.1 oz,Default CT,0,-150,150,0,0,0
,Pravana Color Protect Cleanse 11.1 oz + Color Protect Condition 11.1 oz Bundle,Pravana Color Protect Cleanse 11.1 oz + Color Protect Condition 11.1 oz Bundle,FBALYB Amazon,14,12,2,0,2,0
,Pravana Color Protect Cleanse Liter,Pravana Color Protect Cleanse Liter,Default Ridgefield,105,105,0,0,0,0
,Pravana Color Protect Cleanse Liter,Pravana Color Protect Cleanse Liter,FBALYB Amazon,59,59,0,0,0,0
,Pravana Color Protect Condition 11.1 oz,Pravana Color Protect Condition 11.1 oz,Default CT,6,-144,150,0,0,0
,Pravana Full Volume,Pravana Full Volume,Default Ridgefield,204,204,0,0,0,0
,Pravana Full Volume,Pravana Full Volume,FBALYB Amazon,18,16,2,0,2,0
,Pravana Full Volume,Pravana Full Volume,FBALYB Canada,-1,-7,6,0,6,0
,Pravana Intense Therapy leave in 10.1 oz,Pravana Intense Therapy leave in 10.1 oz,Default CT,2,2,0,0,0,0
,Pravana Intense Therapy leave in 10.1oz 2pk,Pravana Intense Therapy leave in 10.1oz 2pk,FBALYB Amazon,164,145,19,0,19,0
,Pravana Polish & Reunite,Pravana Polish & Reunite,Default Ridgefield,204,204,0,0,0,0
,Pravana Super Shape 10.6,Pravana Super Shape 10.6,Default CT,300,300,0,0,0,0
,Pravana Super Shape 10.6,Pravana Super Shape 10.6,FBALYB Amazon,65,65,0,0,0,0
,Pravana Super Shape 10.6 2pk,Pravana Super Shape 10.6 2pk,Default Ridgefield,0,-128,128,0,0,0
,Pravana Super Shape 10.6 2pk,Pravana Super Shape 10.6 2pk,FBALYB Amazon,128,128,0,0,0,0
,Pravana The Perfect Blonde Conditioner 11.1oz,Pravana The Perfect Blonde Conditioner 11.1oz,Default CT,216,216,0,0,0,0
,Pravana The Perfect Blonde Conditioner 11.1oz,Pravana The Perfect Blonde Conditioner 11.1oz,FBALYB Amazon,-1,-2,1,0,1,0
,Pravana The Perfect Blonde Conditioner 33oz,Pravana The Perfect Blonde Conditioner 33oz,Default CT,404,404,0,0,0,0
,Pravana The Perfect Blonde Conditioner 33oz,Pravana The Perfect Blonde Conditioner 33oz,Default Ridgefield,804,804,0,0,0,0
,Pravana The Perfect Blonde Conditioner 33oz,Pravana The Perfect Blonde Conditioner 33oz,FBALYB Amazon,146,144,2,0,2,0
,Pravana The Perfect Blonde Leave-In 10.1oz,Pravana The Perfect Blonde Leave-In 10.1oz,FBALYB Amazon,-1,-1,0,0,0,0
,Pravana The Perfect Blonde Masque 5oz,Pravana The Perfect Blonde Masque 5oz,Default CT,82,82,0,0,0,0
,Pravana The Perfect Blonde Masque 5oz,Pravana The Perfect Blonde Masque 5oz,Default Ridgefield,501,501,0,0,0,0
,Pravana The Perfect Blonde Masque 5oz,Pravana The Perfect Blonde Masque 5oz,FBALYB Amazon,38,7,31,0,31,0
,Pravana The Perfect Blonde Masque 5oz,Pravana The Perfect Blonde Masque 5oz,FBALYB Canada,7,7,0,0,0,0
,Pravana The Perfect Blonde Shampoo 11.1oz,Pravana The Perfect Blonde Shampoo 11.1oz,Default CT,84,84,0,0,0,0
,Pravana The Perfect Blonde Shampoo 11.1oz,Pravana The Perfect Blonde Shampoo 11.1oz,FBALYB Amazon,41,25,16,0,16,0
,Pravana The Perfect Blonde Shampoo 11.1oz +  The Perfect Blonde Conditioner 11.1oz Bundle,Pravana The Perfect Blonde Shampoo 11.1oz +  The Perfect Blonde Conditioner 11.1oz Bundle,FBALYB Amazon,17,16,1,0,1,0
,Pravana The Perfect Blonde Shampoo 33oz,Pravana The Perfect Blonde Shampoo 33oz,Default CT,12,12,0,0,0,0
,Pravana The Perfect Blonde Shampoo 33oz,Pravana The Perfect Blonde Shampoo 33oz,FBALYB Amazon,18,17,1,0,1,0
,Pravana The Perfect Blonde Shampoo 33oz + Conditioner 33oz Bundle,Pravana The Perfect Blonde Shampoo 33oz + Conditioner 33oz Bundle,FBALYB Amazon,114,114,0,0,0,0
,PRD4516 Polaroid600 Impossible B&W,"Impossible PRD4516 Polaroid 600 and Instant Lab Film, Black/White",FBALYB Amazon,-80,-80,0,0,0,0
,Precious Cat Ultra Litter Attractant 20oz,Precious Cat Ultra Litter Attractant 20oz,FBALYB Amazon,0,-2,2,1,2,0
,Precious Cat Ultra Litter Attractant 20oz 2pk,Precious Cat Ultra Litter Attractant 20oz 2pk,FBALYB Amazon,-9,-9,0,3,0,0
,Premium Crispy Trail Mix Crackers,Premium Crispy Trail Mix Crackers ,FBALYB Amazon,-242,-242,0,242,0,0
,Premium STEM Toys for Boys,Premium STEM Toys for Boys,Default Ridgefield,15,15,0,0,0,0
,Premium STEM Toys for Boys,Premium STEM Toys for Boys,FBALYB Amazon,106,106,0,0,0,0
,Preparation H Medicated Wipes 48,Preparation H Medicated Wipes 48,Default,0,0,0,0,0,5
,Preparation H Medicated Wipes 48 2pk,Preparation H Medicated Wipes 48 2pk,FBALYB Amazon,-1,-1,0,0,0,0
,Preparation H Medicated Wipes 48 3pk,Preparation H Medicated Wipes 48 3pk,FBALYB Amazon,1,1,0,0,0,0
,Preservision AREDS 210ct,Preservision AREDS 210ct,Default,0,0,0,0,0,3
,Preservision AREDS 210ct,Preservision AREDS 210ct,FBALYB Amazon,6,6,0,0,0,0
,Pressure Cooker XL 6-Qt,Power Pressure Cooker XL 6 Quart - Silver,FBALYB Amazon,0,0,0,52,0,0
,Pretty Pets Premium Headgehog Food 3LB,Pretty Pets Premium Headgehog Food 3LB,Default,0,0,0,0,0,12
,Prevue Pet Birdie Basics Wood Ladder 9-Rung,Prevue Pet Birdie Basics Wood Ladder 9-Rung,FBALYB Amazon,5,5,0,0,0,0
,Prevue Pet Small Wire Patio Sundeck,Prevue Pet Small Wire Patio Sundeck,FBALYB Amazon,-1,-1,0,0,0,0
,Primal Beef Liver Munchies,Primal Beef Liver Munchies,FBALYB Amazon,-2,-2,0,0,0,0
,Primal Duck Formula Nuggets,Primal Duck Formula Nuggets,FBALYB Amazon,1,1,0,0,0,0
,"Prime HD+ Aqua Fixture, Black","Prime HD+ Aqua Illumination Aquarium LED Compact Fixture, Black",FBALYB Amazon,-1,-1,0,0,0,0
,Prime Wireless Indoor Remote Outlet,Prime Wireless Indoor Remote Outlet,FBALYB Amazon,3,3,0,0,0,0
,Pringles Cheddar Cheese 14pk,Pringles Cheddar Cheese 14pk,FBALYB Amazon,3,3,0,0,0,0
,Pringles Salt and Vinegar 4pk,Pringles Salt and Vinegar 4pk,FBALYB Amazon,5,5,0,0,0,0
,Pringles Salt and Vinegar Chips,Pringles Salt and Vinegar Chips,Default,2,2,0,0,0,0
,Printed Travel  Tin Volcano - Capri Blue Signature Collection,Printed Travel  Tin Volcano - Capri Blue Signature Collection,Default,0,-1200,1200,0,0,0
,Printed Travel  Tin Volcano - Capri Blue Signature Collection,Printed Travel  Tin Volcano - Capri Blue Signature Collection,FBALYB Amazon,307,307,0,0,0,0
,Printed Travel Tin Volcano - Capri Blue Signature Collection 4pk,Printed Travel Tin Volcano - Capri Blue Signature Collection 4pk,FBALYB Amazon,-1,-1,0,0,0,0
,Project 7 Gum Spearmint (12 pack),Project 7 Gum Spearmint (12 pack),FBALYB Amazon,321,316,5,0,5,0
,Proper Toppers Fish/Chicken 5.5oz Variety,Proper Toppers Fish/Chicken 5.5oz Variety,FBALYB Amazon,5,5,0,0,0,0
,Prozap Garden & Poultry Dust,Prozap Garden & Poultry Dust,FBALYB Amazon,24,24,0,0,0,0
,Prpl UA70020-70005 64oz,64oz Playmaker Jug Planet Purple,Default Ridgefield,50,50,0,0,0,0
,Ps4 dualshock,PowerA DualShock 4 Controller Charging Station for PlayStation 4 [PlayStation 4],Default,0,0,0,0,0,1
,Ps4 duals hockey controller,DualShock 4 Wireless Controller for PlayStation 4 - Jet Black (CUH-ZCT2) [Pla...,Default,0,0,0,0,0,1
,Ps4 slim unchartered,PlayStation 4 Slim 500GB Console - Uncharted 4 Bundle [PlayStation 4],Default,1,1,0,0,0,1
,Ps4 slim unchartered,PlayStation 4 Slim 500GB Console - Uncharted 4 Bundle [PlayStation 4],FBALYB Amazon,-1,-1,0,0,0,0
,Puma 19300003 IGNITE FASTEN8 Puma White/ Puma Silver High Rise Size 10,Puma 19300003 IGNITE FASTEN8 Puma White/ Puma Silver High Rise Size 10,FBALYB Amazon,-1,-1,0,0,0,0
,Puma 19300003 IGNITE FASTEN8 Puma White/ Puma Silver High Rise Size 10.5,Puma 19300003 IGNITE FASTEN8 Puma White/ Puma Silver High Rise Size 10.5,FBALYB Amazon,-1,-1,0,0,0,0
,Puma 19300003 IGNITE FASTEN8 Puma White/ Puma Silver High Rise Size 11,Puma 19300003 IGNITE FASTEN8 Puma White/ Puma Silver High Rise Size 11,FBALYB Amazon,2,2,0,0,0,0
,Puma 19300003 IGNITE FASTEN8 Puma White/ Puma Silver High Rise Size 11.5,Puma 19300003 IGNITE FASTEN8 Puma White/ Puma Silver High Rise Size 11.5,Default Ridgefield,3,3,0,0,0,0
,Puma 19300003 IGNITE FASTEN8 Puma White/ Puma Silver High Rise Size 11.5,Puma 19300003 IGNITE FASTEN8 Puma White/ Puma Silver High Rise Size 11.5,FBALYB Amazon,-1,-1,0,0,0,0
,Puma 19300003 IGNITE FASTEN8 Puma White/ Puma Silver High Rise Size 12,Puma 19300003 IGNITE FASTEN8 Puma White/ Puma Silver High Rise Size 12,FBALYB Amazon,-1,-1,0,0,0,0
,Puma 19300003 IGNITE FASTEN8 Puma White/ Puma Silver High Rise Size 8,Puma 19300003 IGNITE FASTEN8 Puma White/ Puma Silver High Rise Size 8,FBALYB Amazon,5,5,0,0,0,0
,Puma 19300003 IGNITE FASTEN8 Puma White/ Puma Silver High Rise Size 8.5,Puma 19300003 IGNITE FASTEN8 Puma White/ Puma Silver High Rise Size 8.5,FBALYB Amazon,2,2,0,0,0,0
,Puma 19300003 IGNITE FASTEN8 Puma White/ Puma Silver High Rise Size 9,Puma 19300003 IGNITE FASTEN8 Puma White/ Puma Silver High Rise Size 9,FBALYB Amazon,-1,-1,0,0,0,0
,Puma 19300003 IGNITE FASTEN8 Puma White/ Puma Silver High Rise Size 9.5,Puma 19300003 IGNITE FASTEN8 Puma White/ Puma Silver High Rise Size 9.5,FBALYB Amazon,1,1,0,0,0,0
,Puma 19300005 IGNITE FASTEN8 Quarry/ Puma Silver/ Navy Blazer Size 10,Puma 19300005 IGNITE FASTEN8 Quarry/ Puma Silver/ Navy Blazer Size 10,FBALYB Amazon,12,12,0,0,0,0
,Puma 19300005 IGNITE FASTEN8 Quarry/ Puma Silver/ Navy Blazer Size 10.5,Puma 19300005 IGNITE FASTEN8 Quarry/ Puma Silver/ Navy Blazer Size 10.5,FBALYB Amazon,9,9,0,0,0,0
,Puma 19300005 IGNITE FASTEN8 Quarry/ Puma Silver/ Navy Blazer Size 11,Puma 19300005 IGNITE FASTEN8 Quarry/ Puma Silver/ Navy Blazer Size 11,FBALYB Amazon,11,11,0,0,0,0
,Puma 19300005 IGNITE FASTEN8 Quarry/ Puma Silver/ Navy Blazer Size 11.5,Puma 19300005 IGNITE FASTEN8 Quarry/ Puma Silver/ Navy Blazer Size 11.5,FBALYB Amazon,7,7,0,0,0,0
,Puma 19300005 IGNITE FASTEN8 Quarry/ Puma Silver/ Navy Blazer Size 12,Puma 19300005 IGNITE FASTEN8 Quarry/ Puma Silver/ Navy Blazer Size 12,FBALYB Amazon,5,5,0,0,0,0
,Puma 19300005 IGNITE FASTEN8 Quarry/ Puma Silver/ Navy Blazer Size 8,Puma 19300005 IGNITE FASTEN8 Quarry/ Puma Silver/ Navy Blazer Size 8,FBALYB Amazon,4,4,0,0,0,0
,Puma 19300005 IGNITE FASTEN8 Quarry/ Puma Silver/ Navy Blazer Size 8.5,Puma 19300005 IGNITE FASTEN8 Quarry/ Puma Silver/ Navy Blazer Size 8.5,FBALYB Amazon,7,7,0,0,0,0
,Puma 19300005 IGNITE FASTEN8 Quarry/ Puma Silver/ Navy Blazer Size 9,Puma 19300005 IGNITE FASTEN8 Quarry/ Puma Silver/ Navy Blazer Size 9,FBALYB Amazon,-1,-2,1,0,1,0
,Puma 19300005 IGNITE FASTEN8 Quarry/ Puma Silver/ Navy Blazer Size 9.5,Puma 19300005 IGNITE FASTEN8 Quarry/ Puma Silver/ Navy Blazer Size 9.5,FBALYB Amazon,11,11,0,0,0,0
,Puma Black/Red Men 8 ct,Puma Black/Red Men 8 ct,Default Ridgefield,1485,1485,0,0,0,0
,Puma Black/Red Men 8 ct,Puma Black/Red Men 8 ct,FBALYB Amazon,210,200,10,1,10,0
,Puma Black/Red Men 8 ct,Puma Black/Red Men 8 ct,FBALYB Canada,-1,-1,0,10,0,0
,Puma Black/Red Men 8 ct,Puma Black/Red Men 8 ct,WFS,-28,-28,0,0,0,0
,Puma IGNITE FASTEN8 19300001 Quite Shade Gold/ Puma Black Size 10,Puma IGNITE FASTEN8 19300001 Quite Shade Gold/ Puma Black Size 10,FBALYB Amazon,1,1,0,0,0,0
,Puma IGNITE FASTEN8 19300001 Quite Shade Gold/ Puma Black Size 10.5,Puma IGNITE FASTEN8 19300001 Quite Shade Gold/ Puma Black Size 10.5,FBALYB Amazon,-3,-3,0,0,0,0
,Puma IGNITE FASTEN8 19300001 Quite Shade Gold/ Puma Black Size 11,Puma IGNITE FASTEN8 19300001 Quite Shade Gold/ Puma Black Size 11,FBALYB Amazon,11,11,0,0,0,0
,Puma IGNITE FASTEN8 19300001 Quite Shade Gold/ Puma Black Size 11.5,Puma IGNITE FASTEN8 19300001 Quite Shade Gold/ Puma Black Size 11.5,FBALYB Amazon,1,1,0,0,0,0
,Puma IGNITE FASTEN8 19300001 Quite Shade Gold/ Puma Black Size 12,Puma IGNITE FASTEN8 19300001 Quite Shade Gold/ Puma Black Size 12,FBALYB Amazon,-2,-2,0,0,0,0
,Puma IGNITE FASTEN8 19300001 Quite Shade Gold/ Puma Black Size 8,Puma IGNITE FASTEN8 19300001 Quite Shade Gold/ Puma Black Size 8,Default Ridgefield,6,6,0,0,0,0
,Puma IGNITE FASTEN8 19300001 Quite Shade Gold/ Puma Black Size 8.5,Puma IGNITE FASTEN8 19300001 Quite Shade Gold/ Puma Black Size 8.5,FBALYB Amazon,-1,-1,0,0,0,0
,Puma IGNITE FASTEN8 19300001 Quite Shade Gold/ Puma Black Size 9,Puma IGNITE FASTEN8 19300001 Quite Shade Gold/ Puma Black Size 9,FBALYB Amazon,-1,-1,0,0,0,0
,Puma IGNITE FASTEN8 19300001 Quite Shade Gold/ Puma Black Size 9.5,Puma IGNITE FASTEN8 19300001 Quite Shade Gold/ Puma Black Size 9.5,FBALYB Amazon,10,10,0,0,0,0
,Puma IGNITE FASTEN8 19300002 Puma Black/ Puma Silver Size 10,Puma IGNITE FASTEN8 19300002 Puma Black/ Puma Silver Size 10,FBALYB Amazon,8,8,0,0,0,0
,Puma IGNITE FASTEN8 19300002 Puma Black/ Puma Silver Size 10.5,Puma IGNITE FASTEN8 19300002 Puma Black/ Puma Silver Size 10.5,FBALYB Amazon,-1,-1,0,0,0,0
,Puma IGNITE FASTEN8 19300002 Puma Black/ Puma Silver Size 11,Puma IGNITE FASTEN8 19300002 Puma Black/ Puma Silver Size 11,FBALYB Amazon,4,4,0,0,0,0
,Puma IGNITE FASTEN8 19300002 Puma Black/ Puma Silver Size 11.5,Puma IGNITE FASTEN8 19300002 Puma Black/ Puma Silver Size 11.5,FBALYB Amazon,1,1,0,0,0,0
,Puma IGNITE FASTEN8 19300002 Puma Black/ Puma Silver Size 12,Puma IGNITE FASTEN8 19300002 Puma Black/ Puma Silver Size 12,FBALYB Amazon,7,7,0,0,0,0
,Puma IGNITE FASTEN8 19300002 Puma Black/ Puma Silver Size 8,Puma IGNITE FASTEN8 19300002 Puma Black/ Puma Silver Size 8,FBALYB Amazon,4,4,0,0,0,0
,Puma IGNITE FASTEN8 19300002 Puma Black/ Puma Silver Size 8.5,Puma IGNITE FASTEN8 19300002 Puma Black/ Puma Silver Size 8.5,FBALYB Amazon,6,6,0,0,0,0
,Puma IGNITE FASTEN8 19300002 Puma Black/ Puma Silver Size 9,Puma IGNITE FASTEN8 19300002 Puma Black/ Puma Silver Size 9,Default Ridgefield,1,1,0,0,0,0
,Puma IGNITE FASTEN8 19300002 Puma Black/ Puma Silver Size 9.5,Puma IGNITE FASTEN8 19300002 Puma Black/ Puma Silver Size 9.5,FBALYB Amazon,7,7,0,0,0,0
,Puma IGNITE Fasten8 Golf Shoes - High Rise/Puma Silver/Quiet Shade 19300006 US Size 10,Puma IGNITE Fasten8 Golf Shoes - High Rise/Puma Silver/Quiet Shade 19300006 US Size 10,Default Ridgefield,6,6,0,0,0,0
,Puma IGNITE Fasten8 Golf Shoes - High Rise/Puma Silver/Quiet Shade 19300006 US Size 10,Puma IGNITE Fasten8 Golf Shoes - High Rise/Puma Silver/Quiet Shade 19300006 US Size 10,FBALYB Amazon,5,4,1,0,1,0
,Puma IGNITE Fasten8 Golf Shoes - High Rise/Puma Silver/Quiet Shade 19300006 US Size 10.5,Puma IGNITE Fasten8 Golf Shoes - High Rise/Puma Silver/Quiet Shade 19300006 US Size 10.5,Default Ridgefield,6,6,0,0,0,0
,Puma IGNITE Fasten8 Golf Shoes - High Rise/Puma Silver/Quiet Shade 19300006 US Size 10.5,Puma IGNITE Fasten8 Golf Shoes - High Rise/Puma Silver/Quiet Shade 19300006 US Size 10.5,FBALYB Amazon,6,6,0,0,0,0
,Puma IGNITE Fasten8 Golf Shoes - High Rise/Puma Silver/Quiet Shade 19300006 US Size 11,Puma IGNITE Fasten8 Golf Shoes - High Rise/Puma Silver/Quiet Shade 19300006 US Size 11,Default Ridgefield,6,6,0,0,0,0
,Puma IGNITE Fasten8 Golf Shoes - High Rise/Puma Silver/Quiet Shade 19300006 US Size 11,Puma IGNITE Fasten8 Golf Shoes - High Rise/Puma Silver/Quiet Shade 19300006 US Size 11,FBALYB Amazon,6,6,0,0,0,0
,Puma IGNITE Fasten8 Golf Shoes - High Rise/Puma Silver/Quiet Shade 19300006 US Size 11.5,Puma IGNITE Fasten8 Golf Shoes - High Rise/Puma Silver/Quiet Shade 19300006 US Size 11.5,FBALYB Amazon,5,5,0,0,0,0
,Puma IGNITE Fasten8 Golf Shoes - High Rise/Puma Silver/Quiet Shade 19300006 US Size 12,Puma IGNITE Fasten8 Golf Shoes - High Rise/Puma Silver/Quiet Shade 19300006 US Size 12,FBALYB Amazon,5,5,0,0,0,0
,Puma IGNITE Fasten8 Golf Shoes - High Rise/Puma Silver/Quiet Shade 19300006 US Size 8,Puma IGNITE Fasten8 Golf Shoes - High Rise/Puma Silver/Quiet Shade 19300006 US Size 8,FBALYB Amazon,6,6,0,0,0,0
,Puma IGNITE Fasten8 Golf Shoes - High Rise/Puma Silver/Quiet Shade 19300006 US Size 8.5,Puma IGNITE Fasten8 Golf Shoes - High Rise/Puma Silver/Quiet Shade 19300006 US Size 8.5,FBALYB Amazon,6,6,0,0,0,0
,Puma IGNITE Fasten8 Golf Shoes - High Rise/Puma Silver/Quiet Shade 19300006 US Size 9,Puma IGNITE Fasten8 Golf Shoes - High Rise/Puma Silver/Quiet Shade 19300006 US Size 9,FBALYB Amazon,5,5,0,0,0,0
,Puma IGNITE Fasten8 Golf Shoes - High Rise/Puma Silver/Quiet Shade 19300006 US Size 9.5,Puma IGNITE Fasten8 Golf Shoes - High Rise/Puma Silver/Quiet Shade 19300006 US Size 9.5,Default Ridgefield,6,6,0,0,0,0
,Puma IGNITE Fasten8 Golf Shoes - High Rise/Puma Silver/Quiet Shade 19300006 US Size 9.5,Puma IGNITE Fasten8 Golf Shoes - High Rise/Puma Silver/Quiet Shade 19300006 US Size 9.5,FBALYB Amazon,5,5,0,0,0,0
,Puma IGNITE Fasten8 Golf Shoes - Navy Blazer/Puma Silver/Quiet Shade 19300004 US Size 10,Puma IGNITE Fasten8 Golf Shoes - Navy Blazer/Puma Silver/Quiet Shade 19300004 US Size 10,Default Ridgefield,10,10,0,0,0,0
,Puma IGNITE Fasten8 Golf Shoes - Navy Blazer/Puma Silver/Quiet Shade 19300004 US Size 10,Puma IGNITE Fasten8 Golf Shoes - Navy Blazer/Puma Silver/Quiet Shade 19300004 US Size 10,FBALYB Amazon,2,2,0,0,0,0
,Puma IGNITE Fasten8 Golf Shoes - Navy Blazer/Puma Silver/Quiet Shade 19300004 US Size 10.5,Puma IGNITE Fasten8 Golf Shoes - Navy Blazer/Puma Silver/Quiet Shade 19300004 US Size 10.5,Default Ridgefield,10,10,0,0,0,0
,Puma IGNITE Fasten8 Golf Shoes - Navy Blazer/Puma Silver/Quiet Shade 19300004 US Size 10.5,Puma IGNITE Fasten8 Golf Shoes - Navy Blazer/Puma Silver/Quiet Shade 19300004 US Size 10.5,FBALYB Amazon,5,5,0,0,0,0
,Puma IGNITE Fasten8 Golf Shoes - Navy Blazer/Puma Silver/Quiet Shade 19300004 US Size 11,Puma IGNITE Fasten8 Golf Shoes - Navy Blazer/Puma Silver/Quiet Shade 19300004 US Size 11,FBALYB Amazon,0,0,0,6,0,0
,Puma IGNITE Fasten8 Golf Shoes - Navy Blazer/Puma Silver/Quiet Shade 19300004 US Size 11.5,Puma IGNITE Fasten8 Golf Shoes - Navy Blazer/Puma Silver/Quiet Shade 19300004 US Size 11.5,FBALYB Amazon,6,6,0,0,0,0
,Puma IGNITE Fasten8 Golf Shoes - Navy Blazer/Puma Silver/Quiet Shade 19300004 US Size 12,Puma IGNITE Fasten8 Golf Shoes - Navy Blazer/Puma Silver/Quiet Shade 19300004 US Size 12,Default Ridgefield,6,6,0,0,0,0
,Puma IGNITE Fasten8 Golf Shoes - Navy Blazer/Puma Silver/Quiet Shade 19300004 US Size 12,Puma IGNITE Fasten8 Golf Shoes - Navy Blazer/Puma Silver/Quiet Shade 19300004 US Size 12,FBALYB Amazon,2,1,1,0,1,0
,Puma IGNITE Fasten8 Golf Shoes - Navy Blazer/Puma Silver/Quiet Shade 19300004 US Size 8,Puma IGNITE Fasten8 Golf Shoes - Navy Blazer/Puma Silver/Quiet Shade 19300004 US Size 8,FBALYB Amazon,2,2,0,0,0,0
,Puma IGNITE Fasten8 Golf Shoes - Navy Blazer/Puma Silver/Quiet Shade 19300004 US Size 8.5,Puma IGNITE Fasten8 Golf Shoes - Navy Blazer/Puma Silver/Quiet Shade 19300004 US Size 8.5,FBALYB Amazon,6,6,0,0,0,0
,Puma IGNITE Fasten8 Golf Shoes - Navy Blazer/Puma Silver/Quiet Shade 19300004 US Size 9,Puma IGNITE Fasten8 Golf Shoes - Navy Blazer/Puma Silver/Quiet Shade 19300004 US Size 9,FBALYB Amazon,6,6,0,0,0,0
,Puma IGNITE Fasten8 Golf Shoes - Navy Blazer/Puma Silver/Quiet Shade 19300004 US Size 9.5,Puma IGNITE Fasten8 Golf Shoes - Navy Blazer/Puma Silver/Quiet Shade 19300004 US Size 9.5,FBALYB Amazon,13,13,0,0,0,0
,Puma IGNITE PWRADAPT CAGED DISC 19223605 White/Silver/Peacoat Size 10,Puma IGNITE PWRADAPT CAGED DISC 19223605 White/Silver/Peacoat Size 10,FBALYB Amazon,5,5,0,0,0,0
,Puma IGNITE PWRADAPT CAGED DISC 19223605 White/Silver/Peacoat Size 10.5,Puma IGNITE PWRADAPT CAGED DISC 19223605 White/Silver/Peacoat Size 10.5,Default Ridgefield,7,7,0,0,0,0
,Puma IGNITE PWRADAPT CAGED DISC 19223605 White/Silver/Peacoat Size 10.5,Puma IGNITE PWRADAPT CAGED DISC 19223605 White/Silver/Peacoat Size 10.5,FBALYB Amazon,3,3,0,0,0,0
,Puma IGNITE PWRADAPT CAGED DISC 19223605 White/Silver/Peacoat Size 11,Puma IGNITE PWRADAPT CAGED DISC 19223605 White/Silver/Peacoat Size 11,FBALYB Amazon,9,9,0,0,0,0
,Puma IGNITE PWRADAPT CAGED DISC 19223605 White/Silver/Peacoat Size 11.5,Puma IGNITE PWRADAPT CAGED DISC 19223605 White/Silver/Peacoat Size 11.5,FBALYB Amazon,5,5,0,0,0,0
,Puma IGNITE PWRADAPT CAGED DISC 19223605 White/Silver/Peacoat Size 12,Puma IGNITE PWRADAPT CAGED DISC 19223605 White/Silver/Peacoat Size 12,FBALYB Amazon,9,9,0,0,0,0
,Puma IGNITE PWRADAPT CAGED DISC 19223605 White/Silver/Peacoat Size 8,Puma IGNITE PWRADAPT CAGED DISC 19223605 White/Silver/Peacoat Size 8,FBALYB Amazon,1,1,0,0,0,0
,Puma IGNITE PWRADAPT CAGED DISC 19223605 White/Silver/Peacoat Size 8.5,Puma IGNITE PWRADAPT CAGED DISC 19223605 White/Silver/Peacoat Size 8.5,FBALYB Amazon,9,9,0,0,0,0
,Puma IGNITE PWRADAPT CAGED DISC 19223605 White/Silver/Peacoat Size 9,Puma IGNITE PWRADAPT CAGED DISC 19223605 White/Silver/Peacoat Size 9,Default Ridgefield,1,1,0,0,0,0
,Puma IGNITE PWRADAPT CAGED DISC 19223605 White/Silver/Peacoat Size 9,Puma IGNITE PWRADAPT CAGED DISC 19223605 White/Silver/Peacoat Size 9,FBALYB Amazon,-2,-2,0,0,0,0
,Puma IGNITE PWRADAPT CAGED DISC 19223605 White/Silver/Peacoat Size 9.5,Puma IGNITE PWRADAPT CAGED DISC 19223605 White/Silver/Peacoat Size 9.5,FBALYB Amazon,14,14,0,0,0,0
,PUMA Ignite Pwradapt Caged Disc Golf Shoes Sneakers Black 19223602 US Size 10,PUMA Ignite Pwradapt Caged Disc Golf Shoes Sneakers Black 19223602 US Size 10,Default Ridgefield,36,36,0,0,0,0
,PUMA Ignite Pwradapt Caged Disc Golf Shoes Sneakers Black 19223602 US Size 10,PUMA Ignite Pwradapt Caged Disc Golf Shoes Sneakers Black 19223602 US Size 10,FBALYB Amazon,11,11,0,0,0,0
,PUMA Ignite Pwradapt Caged Disc Golf Shoes Sneakers Black 19223602 US Size 10.5,PUMA Ignite Pwradapt Caged Disc Golf Shoes Sneakers Black 19223602 US Size 10.5,Default Ridgefield,34,34,0,0,0,0
,PUMA Ignite Pwradapt Caged Disc Golf Shoes Sneakers Black 19223602 US Size 10.5,PUMA Ignite Pwradapt Caged Disc Golf Shoes Sneakers Black 19223602 US Size 10.5,FBALYB Amazon,11,11,0,0,0,0
,PUMA Ignite Pwradapt Caged Disc Golf Shoes Sneakers Black 19223602 US Size 11,PUMA Ignite Pwradapt Caged Disc Golf Shoes Sneakers Black 19223602 US Size 11,Default Ridgefield,32,32,0,0,0,0
,PUMA Ignite Pwradapt Caged Disc Golf Shoes Sneakers Black 19223602 US Size 11,PUMA Ignite Pwradapt Caged Disc Golf Shoes Sneakers Black 19223602 US Size 11,FBALYB Amazon,15,15,0,0,0,0
,PUMA Ignite Pwradapt Caged Disc Golf Shoes Sneakers Black 19223602 US Size 11.5,PUMA Ignite Pwradapt Caged Disc Golf Shoes Sneakers Black 19223602 US Size 11.5,Default Ridgefield,8,8,0,0,0,0
,PUMA Ignite Pwradapt Caged Disc Golf Shoes Sneakers Black 19223602 US Size 11.5,PUMA Ignite Pwradapt Caged Disc Golf Shoes Sneakers Black 19223602 US Size 11.5,FBALYB Amazon,14,14,0,0,0,0
,PUMA Ignite Pwradapt Caged Disc Golf Shoes Sneakers Black 19223602 US Size 12,PUMA Ignite Pwradapt Caged Disc Golf Shoes Sneakers Black 19223602 US Size 12,Default Ridgefield,24,24,0,0,0,0
,PUMA Ignite Pwradapt Caged Disc Golf Shoes Sneakers Black 19223602 US Size 12,PUMA Ignite Pwradapt Caged Disc Golf Shoes Sneakers Black 19223602 US Size 12,FBALYB Amazon,10,9,1,0,1,0
,PUMA Ignite Pwradapt Caged Disc Golf Shoes Sneakers Black 19223602 US Size 8,PUMA Ignite Pwradapt Caged Disc Golf Shoes Sneakers Black 19223602 US Size 8,Default Ridgefield,6,6,0,0,0,0
,PUMA Ignite Pwradapt Caged Disc Golf Shoes Sneakers Black 19223602 US Size 8,PUMA Ignite Pwradapt Caged Disc Golf Shoes Sneakers Black 19223602 US Size 8,FBALYB Amazon,6,6,0,0,0,0
,PUMA Ignite Pwradapt Caged Disc Golf Shoes Sneakers Black 19223602 US Size 8.5,PUMA Ignite Pwradapt Caged Disc Golf Shoes Sneakers Black 19223602 US Size 8.5,Default Ridgefield,8,8,0,0,0,0
,PUMA Ignite Pwradapt Caged Disc Golf Shoes Sneakers Black 19223602 US Size 8.5,PUMA Ignite Pwradapt Caged Disc Golf Shoes Sneakers Black 19223602 US Size 8.5,FBALYB Amazon,15,15,0,0,0,0
,PUMA Ignite Pwradapt Caged Disc Golf Shoes Sneakers Black 19223602 US Size 9,PUMA Ignite Pwradapt Caged Disc Golf Shoes Sneakers Black 19223602 US Size 9,Default Ridgefield,6,6,0,0,0,0
,PUMA Ignite Pwradapt Caged Disc Golf Shoes Sneakers Black 19223602 US Size 9,PUMA Ignite Pwradapt Caged Disc Golf Shoes Sneakers Black 19223602 US Size 9,FBALYB Amazon,15,15,0,0,0,0
,PUMA Ignite Pwradapt Caged Disc Golf Shoes Sneakers Black 19223602 US Size 9.5,PUMA Ignite Pwradapt Caged Disc Golf Shoes Sneakers Black 19223602 US Size 9.5,Default Ridgefield,33,33,0,0,0,0
,PUMA Ignite Pwradapt Caged Disc Golf Shoes Sneakers Black 19223602 US Size 9.5,PUMA Ignite Pwradapt Caged Disc Golf Shoes Sneakers Black 19223602 US Size 9.5,FBALYB Amazon,13,13,0,0,0,0
,Puma Ignite PWRAdapt Caged Disc Mens Golf Shoes Peacoat/Silver 19223604 US Size 10,Puma Ignite PWRAdapt Caged Disc Mens Golf Shoes Peacoat/Silver 19223604 US Size 10,FBALYB Amazon,9,9,0,0,0,0
,Puma Ignite PWRAdapt Caged Disc Mens Golf Shoes Peacoat/Silver 19223604 US Size 10.5,Puma Ignite PWRAdapt Caged Disc Mens Golf Shoes Peacoat/Silver 19223604 US Size 10.5,Default Ridgefield,6,6,0,0,0,0
,Puma Ignite PWRAdapt Caged Disc Mens Golf Shoes Peacoat/Silver 19223604 US Size 10.5,Puma Ignite PWRAdapt Caged Disc Mens Golf Shoes Peacoat/Silver 19223604 US Size 10.5,FBALYB Amazon,7,7,0,0,0,0
,Puma Ignite PWRAdapt Caged Disc Mens Golf Shoes Peacoat/Silver 19223604 US Size 11,Puma Ignite PWRAdapt Caged Disc Mens Golf Shoes Peacoat/Silver 19223604 US Size 11,FBALYB Amazon,11,11,0,0,0,0
,Puma Ignite PWRAdapt Caged Disc Mens Golf Shoes Peacoat/Silver 19223604 US Size 11.5,Puma Ignite PWRAdapt Caged Disc Mens Golf Shoes Peacoat/Silver 19223604 US Size 11.5,Default Ridgefield,1,1,0,0,0,0
,Puma Ignite PWRAdapt Caged Disc Mens Golf Shoes Peacoat/Silver 19223604 US Size 11.5,Puma Ignite PWRAdapt Caged Disc Mens Golf Shoes Peacoat/Silver 19223604 US Size 11.5,FBALYB Amazon,4,4,0,0,0,0
,Puma Ignite PWRAdapt Caged Disc Mens Golf Shoes Peacoat/Silver 19223604 US Size 12,Puma Ignite PWRAdapt Caged Disc Mens Golf Shoes Peacoat/Silver 19223604 US Size 12,Default Ridgefield,6,6,0,0,0,0
,Puma Ignite PWRAdapt Caged Disc Mens Golf Shoes Peacoat/Silver 19223604 US Size 12,Puma Ignite PWRAdapt Caged Disc Mens Golf Shoes Peacoat/Silver 19223604 US Size 12,FBALYB Amazon,5,5,0,0,0,0
,Puma Ignite PWRAdapt Caged Disc Mens Golf Shoes Peacoat/Silver 19223604 US Size 8,Puma Ignite PWRAdapt Caged Disc Mens Golf Shoes Peacoat/Silver 19223604 US Size 8,FBALYB Amazon,6,6,0,0,0,0
,Puma Ignite PWRAdapt Caged Disc Mens Golf Shoes Peacoat/Silver 19223604 US Size 8.5,Puma Ignite PWRAdapt Caged Disc Mens Golf Shoes Peacoat/Silver 19223604 US Size 8.5,Default Ridgefield,1,1,0,0,0,0
,Puma Ignite PWRAdapt Caged Disc Mens Golf Shoes Peacoat/Silver 19223604 US Size 8.5,Puma Ignite PWRAdapt Caged Disc Mens Golf Shoes Peacoat/Silver 19223604 US Size 8.5,FBALYB Amazon,6,6,0,0,0,0
,Puma Ignite PWRAdapt Caged Disc Mens Golf Shoes Peacoat/Silver 19223604 US Size 9,Puma Ignite PWRAdapt Caged Disc Mens Golf Shoes Peacoat/Silver 19223604 US Size 9,Default Ridgefield,8,8,0,0,0,0
,Puma Ignite PWRAdapt Caged Disc Mens Golf Shoes Peacoat/Silver 19223604 US Size 9.5,Puma Ignite PWRAdapt Caged Disc Mens Golf Shoes Peacoat/Silver 19223604 US Size 9.5,FBALYB Amazon,13,13,0,0,0,0
,Puma Ignite PWRAdapt Caged Disc Mens Golf Shoes Quiet Shade/Bronze 19223603 US Size 10,Puma Ignite PWRAdapt Caged Disc Mens Golf Shoes Quiet Shade/Bronze 19223603 US Size 10,Default Ridgefield,4,4,0,0,0,0
,Puma Ignite PWRAdapt Caged Disc Mens Golf Shoes Quiet Shade/Bronze 19223603 US Size 10,Puma Ignite PWRAdapt Caged Disc Mens Golf Shoes Quiet Shade/Bronze 19223603 US Size 10,FBALYB Amazon,24,24,0,0,0,0
,Puma Ignite PWRAdapt Caged Disc Mens Golf Shoes Quiet Shade/Bronze 19223603 US Size 10.5,Puma Ignite PWRAdapt Caged Disc Mens Golf Shoes Quiet Shade/Bronze 19223603 US Size 10.5,Default Ridgefield,4,4,0,0,0,0
,Puma Ignite PWRAdapt Caged Disc Mens Golf Shoes Quiet Shade/Bronze 19223603 US Size 10.5,Puma Ignite PWRAdapt Caged Disc Mens Golf Shoes Quiet Shade/Bronze 19223603 US Size 10.5,FBALYB Amazon,22,22,0,0,0,0
,Puma Ignite PWRAdapt Caged Disc Mens Golf Shoes Quiet Shade/Bronze 19223603 US Size 11,Puma Ignite PWRAdapt Caged Disc Mens Golf Shoes Quiet Shade/Bronze 19223603 US Size 11,Default Ridgefield,20,20,0,0,0,0
,Puma Ignite PWRAdapt Caged Disc Mens Golf Shoes Quiet Shade/Bronze 19223603 US Size 11,Puma Ignite PWRAdapt Caged Disc Mens Golf Shoes Quiet Shade/Bronze 19223603 US Size 11,FBALYB Amazon,8,8,0,0,0,0
,Puma Ignite PWRAdapt Caged Disc Mens Golf Shoes Quiet Shade/Bronze 19223603 US Size 11.5,Puma Ignite PWRAdapt Caged Disc Mens Golf Shoes Quiet Shade/Bronze 19223603 US Size 11.5,Default Ridgefield,7,7,0,0,0,0
,Puma Ignite PWRAdapt Caged Disc Mens Golf Shoes Quiet Shade/Bronze 19223603 US Size 11.5,Puma Ignite PWRAdapt Caged Disc Mens Golf Shoes Quiet Shade/Bronze 19223603 US Size 11.5,FBALYB Amazon,8,8,0,0,0,0
,Puma Ignite PWRAdapt Caged Disc Mens Golf Shoes Quiet Shade/Bronze 19223603 US Size 12,Puma Ignite PWRAdapt Caged Disc Mens Golf Shoes Quiet Shade/Bronze 19223603 US Size 12,Default Ridgefield,4,4,0,0,0,0
,Puma Ignite PWRAdapt Caged Disc Mens Golf Shoes Quiet Shade/Bronze 19223603 US Size 12,Puma Ignite PWRAdapt Caged Disc Mens Golf Shoes Quiet Shade/Bronze 19223603 US Size 12,FBALYB Amazon,17,17,0,0,0,0
,Puma Ignite PWRAdapt Caged Disc Mens Golf Shoes Quiet Shade/Bronze 19223603 US Size 8,Puma Ignite PWRAdapt Caged Disc Mens Golf Shoes Quiet Shade/Bronze 19223603 US Size 8,Default Ridgefield,1,1,0,0,0,0
,Puma Ignite PWRAdapt Caged Disc Mens Golf Shoes Quiet Shade/Bronze 19223603 US Size 8,Puma Ignite PWRAdapt Caged Disc Mens Golf Shoes Quiet Shade/Bronze 19223603 US Size 8,FBALYB Amazon,4,4,0,0,0,0
,Puma Ignite PWRAdapt Caged Disc Mens Golf Shoes Quiet Shade/Bronze 19223603 US Size 8.5,Puma Ignite PWRAdapt Caged Disc Mens Golf Shoes Quiet Shade/Bronze 19223603 US Size 8.5,Default Ridgefield,10,10,0,0,0,0
,Puma Ignite PWRAdapt Caged Disc Mens Golf Shoes Quiet Shade/Bronze 19223603 US Size 8.5,Puma Ignite PWRAdapt Caged Disc Mens Golf Shoes Quiet Shade/Bronze 19223603 US Size 8.5,FBALYB Amazon,4,4,0,0,0,0
,Puma Ignite PWRAdapt Caged Disc Mens Golf Shoes Quiet Shade/Bronze 19223603 US Size 9,Puma Ignite PWRAdapt Caged Disc Mens Golf Shoes Quiet Shade/Bronze 19223603 US Size 9,Default Ridgefield,6,6,0,0,0,0
,Puma Ignite PWRAdapt Caged Disc Mens Golf Shoes Quiet Shade/Bronze 19223603 US Size 9,Puma Ignite PWRAdapt Caged Disc Mens Golf Shoes Quiet Shade/Bronze 19223603 US Size 9,FBALYB Amazon,7,7,0,0,0,0
,Puma Ignite PWRAdapt Caged Disc Mens Golf Shoes Quiet Shade/Bronze 19223603 US Size 9.5,Puma Ignite PWRAdapt Caged Disc Mens Golf Shoes Quiet Shade/Bronze 19223603 US Size 9.5,Default Ridgefield,20,20,0,0,0,0
,Puma Ignite PWRAdapt Caged Disc Mens Golf Shoes Quiet Shade/Bronze 19223603 US Size 9.5,Puma Ignite PWRAdapt Caged Disc Mens Golf Shoes Quiet Shade/Bronze 19223603 US Size 9.5,FBALYB Amazon,10,10,0,0,0,0
,Puma Ignite Pwrasdapt Caged Mens Sliver/White 19223601 US Size 10,Puma Ignite Pwrasdapt Caged Mens Sliver/White 19223601 US Size 10,Default Ridgefield,8,8,0,0,0,0
,Puma Ignite Pwrasdapt Caged Mens Sliver/White 19223601 US Size 10,Puma Ignite Pwrasdapt Caged Mens Sliver/White 19223601 US Size 10,FBALYB Amazon,23,23,0,0,0,0
,Puma Ignite Pwrasdapt Caged Mens Sliver/White 19223601 US Size 10.5,Puma Ignite Pwrasdapt Caged Mens Sliver/White 19223601 US Size 10.5,Default Ridgefield,8,8,0,0,0,0
,Puma Ignite Pwrasdapt Caged Mens Sliver/White 19223601 US Size 10.5,Puma Ignite Pwrasdapt Caged Mens Sliver/White 19223601 US Size 10.5,FBALYB Amazon,23,23,0,0,0,0
,Puma Ignite Pwrasdapt Caged Mens Sliver/White 19223601 US Size 11,Puma Ignite Pwrasdapt Caged Mens Sliver/White 19223601 US Size 11,Default Ridgefield,8,8,0,0,0,0
,Puma Ignite Pwrasdapt Caged Mens Sliver/White 19223601 US Size 11,Puma Ignite Pwrasdapt Caged Mens Sliver/White 19223601 US Size 11,FBALYB Amazon,23,23,0,0,0,0
,Puma Ignite Pwrasdapt Caged Mens Sliver/White 19223601 US Size 11.5,Puma Ignite Pwrasdapt Caged Mens Sliver/White 19223601 US Size 11.5,Default Ridgefield,8,8,0,0,0,0
,Puma Ignite Pwrasdapt Caged Mens Sliver/White 19223601 US Size 11.5,Puma Ignite Pwrasdapt Caged Mens Sliver/White 19223601 US Size 11.5,FBALYB Amazon,7,7,0,0,0,0
,Puma Ignite Pwrasdapt Caged Mens Sliver/White 19223601 US Size 12,Puma Ignite Pwrasdapt Caged Mens Sliver/White 19223601 US Size 12,Default Ridgefield,8,8,0,0,0,0
,Puma Ignite Pwrasdapt Caged Mens Sliver/White 19223601 US Size 12,Puma Ignite Pwrasdapt Caged Mens Sliver/White 19223601 US Size 12,FBALYB Amazon,15,15,0,0,0,0
,Puma Ignite Pwrasdapt Caged Mens Sliver/White 19223601 US Size 8,Puma Ignite Pwrasdapt Caged Mens Sliver/White 19223601 US Size 8,Default Ridgefield,2,2,0,0,0,0
,Puma Ignite Pwrasdapt Caged Mens Sliver/White 19223601 US Size 8,Puma Ignite Pwrasdapt Caged Mens Sliver/White 19223601 US Size 8,FBALYB Amazon,6,6,0,0,0,0
,Puma Ignite Pwrasdapt Caged Mens Sliver/White 19223601 US Size 8.5,Puma Ignite Pwrasdapt Caged Mens Sliver/White 19223601 US Size 8.5,Default Ridgefield,8,8,0,0,0,0
,Puma Ignite Pwrasdapt Caged Mens Sliver/White 19223601 US Size 8.5,Puma Ignite Pwrasdapt Caged Mens Sliver/White 19223601 US Size 8.5,FBALYB Amazon,6,6,0,0,0,0
,Puma Ignite Pwrasdapt Caged Mens Sliver/White 19223601 US Size 9,Puma Ignite Pwrasdapt Caged Mens Sliver/White 19223601 US Size 9,Default Ridgefield,7,7,0,0,0,0
,Puma Ignite Pwrasdapt Caged Mens Sliver/White 19223601 US Size 9,Puma Ignite Pwrasdapt Caged Mens Sliver/White 19223601 US Size 9,FBALYB Amazon,7,7,0,0,0,0
,Puma Ignite Pwrasdapt Caged Mens Sliver/White 19223601 US Size 9.5,Puma Ignite Pwrasdapt Caged Mens Sliver/White 19223601 US Size 9.5,Default Ridgefield,26,26,0,0,0,0
,Puma Ignite Pwrasdapt Caged Mens Sliver/White 19223601 US Size 9.5,Puma Ignite Pwrasdapt Caged Mens Sliver/White 19223601 US Size 9.5,FBALYB Amazon,6,6,0,0,0,0
,Puma Ladies Socks Master Kit,Puma Ladies Socks Master Kit,Default,0,-1800,1800,0,0,0
,Puma LAGUNA SPORT 19299904 Rosewater/ Puma White Size 10,Puma LAGUNA SPORT 19299904 Rosewater/ Puma White Size 10,FBALYB Amazon,5,5,0,0,0,0
,Puma LAGUNA SPORT 19299904 Rosewater/ Puma White Size 10.5,Puma LAGUNA SPORT 19299904 Rosewater/ Puma White Size 10.5,Default Ridgefield,6,6,0,0,0,0
,Puma LAGUNA SPORT 19299904 Rosewater/ Puma White Size 6,Puma LAGUNA SPORT 19299904 Rosewater/ Puma White Size 6,FBALYB Amazon,2,2,0,0,0,0
,Puma LAGUNA SPORT 19299904 Rosewater/ Puma White Size 6.5,Puma LAGUNA SPORT 19299904 Rosewater/ Puma White Size 6.5,FBALYB Amazon,6,6,0,0,0,0
,Puma LAGUNA SPORT 19299904 Rosewater/ Puma White Size 7,Puma LAGUNA SPORT 19299904 Rosewater/ Puma White Size 7,FBALYB Amazon,13,13,0,0,0,0
,Puma LAGUNA SPORT 19299904 Rosewater/ Puma White Size 7.5,Puma LAGUNA SPORT 19299904 Rosewater/ Puma White Size 7.5,FBALYB Amazon,14,14,0,0,0,0
,Puma LAGUNA SPORT 19299904 Rosewater/ Puma White Size 8,Puma LAGUNA SPORT 19299904 Rosewater/ Puma White Size 8,FBALYB Amazon,8,8,0,0,0,0
,Puma LAGUNA SPORT 19299904 Rosewater/ Puma White Size 8.5,Puma LAGUNA SPORT 19299904 Rosewater/ Puma White Size 8.5,FBALYB Amazon,2,2,0,0,0,0
,Puma LAGUNA SPORT 19299904 Rosewater/ Puma White Size 9,Puma LAGUNA SPORT 19299904 Rosewater/ Puma White Size 9,FBALYB Amazon,5,5,0,0,0,0
,Puma LAGUNA SPORT 19299904 Rosewater/ Puma White Size 9.5,Puma LAGUNA SPORT 19299904 Rosewater/ Puma White Size 9.5,FBALYB Amazon,6,6,0,0,0,0
,Puma Mens Black Socks 8ct,Puma Mens Black Socks 8ct,FBALYB Amazon,-5,-5,0,1,0,0
,Puma Mens Black Socks 8 ct,Puma Mens Black Socks 8 ct,FBALYB Amazon,-283,-340,57,4,57,0
,Puma Mens Black Socks 8 ct,Puma Mens Black Socks 8 ct,FBALYB Canada,0,0,0,20,0,0
,Puma Men's Low Cut White Socks 8ct,Puma Men's Low Cut White Socks 8ct ,FBALYB Amazon,764,713,51,0,51,0
,Puma Mens Socks 8 Ct White,Puma Mens Socks 8 Ct White,FBALYB Amazon,-5,-5,0,12,0,0
,Puma Mens White Socks 8ct,Puma Mens White Socks 8ct,Default,0,-21,21,0,0,0
,Puma Mens White Socks 8ct,Puma Mens White Socks 8ct,Default Ridgefield,-3,-3,0,0,0,0
,Puma Mens White Socks 8ct,Puma Mens White Socks 8ct,FBALYB Amazon,218,218,0,212,0,0
,Puma Mens White Socks 8ct,Puma Mens White Socks 8ct,WFS,-71,-71,0,0,0,0
,Puma MONOLITE CAT ENGINEERED MESH 19298802 Puma Black/ Rapture Rose Size 10,Puma MONOLITE CAT ENGINEERED MESH 19298802 Puma Black/ Rapture Rose Size 10,FBALYB Amazon,5,5,0,0,0,0
,Puma MONOLITE CAT ENGINEERED MESH 19298802 Puma Black/ Rapture Rose Size 10.5,Puma MONOLITE CAT ENGINEERED MESH 19298802 Puma Black/ Rapture Rose Size 10.5,Default Ridgefield,7,7,0,0,0,0
,Puma MONOLITE CAT ENGINEERED MESH 19298802 Puma Black/ Rapture Rose Size 6,Puma MONOLITE CAT ENGINEERED MESH 19298802 Puma Black/ Rapture Rose Size 6,FBALYB Amazon,3,3,0,0,0,0
,Puma MONOLITE CAT ENGINEERED MESH 19298802 Puma Black/ Rapture Rose Size 6.5,Puma MONOLITE CAT ENGINEERED MESH 19298802 Puma Black/ Rapture Rose Size 6.5,FBALYB Amazon,7,7,0,0,0,0
,Puma MONOLITE CAT ENGINEERED MESH 19298802 Puma Black/ Rapture Rose Size 7,Puma MONOLITE CAT ENGINEERED MESH 19298802 Puma Black/ Rapture Rose Size 7,FBALYB Amazon,9,8,1,0,1,0
,Puma MONOLITE CAT ENGINEERED MESH 19298802 Puma Black/ Rapture Rose Size 7.5,Puma MONOLITE CAT ENGINEERED MESH 19298802 Puma Black/ Rapture Rose Size 7.5,FBALYB Amazon,6,6,0,0,0,0
,Puma MONOLITE CAT ENGINEERED MESH 19298802 Puma Black/ Rapture Rose Size 8,Puma MONOLITE CAT ENGINEERED MESH 19298802 Puma Black/ Rapture Rose Size 8,FBALYB Amazon,5,5,0,0,0,0
,Puma MONOLITE CAT ENGINEERED MESH 19298802 Puma Black/ Rapture Rose Size 9,Puma MONOLITE CAT ENGINEERED MESH 19298802 Puma Black/ Rapture Rose Size 9,FBALYB Amazon,-1,-1,0,0,0,0
,Puma MONOLITE CAT ENGINEERED MESH 19298802 Puma Black/ Rapture Rose Size 9.5,Puma MONOLITE CAT ENGINEERED MESH 19298802 Puma Black/ Rapture Rose Size 9.5,FBALYB Amazon,5,5,0,0,0,0
,Puma MONOLITE CAT ENGINEERED MESH 19298803 Rosewater/ Rapture Rose Size 6.5,Puma MONOLITE CAT ENGINEERED MESH 19298803 Rosewater/ Rapture Rose Size 6.5,Default Ridgefield,3,3,0,0,0,0
,Puma MONOLITE CAT ENGINEERED MESH 19298803 Rosewater/ Rapture Rose Size 6.5,Puma MONOLITE CAT ENGINEERED MESH 19298803 Rosewater/ Rapture Rose Size 6.5,FBALYB Amazon,5,5,0,0,0,0
,Puma MONOLITE CAT ENGINEERED MESH 19298803 Rosewater/ Rapture Rose Size 7,Puma MONOLITE CAT ENGINEERED MESH 19298803 Rosewater/ Rapture Rose Size 7,FBALYB Amazon,2,2,0,0,0,0
,Puma MONOLITE CAT ENGINEERED MESH 19298803 Rosewater/ Rapture Rose Size 7.5,Puma MONOLITE CAT ENGINEERED MESH 19298803 Rosewater/ Rapture Rose Size 7.5,FBALYB Amazon,5,5,0,0,0,0
,Puma MONOLITE CAT ENGINEERED MESH 19298803 Rosewater/ Rapture Rose Size 8,Puma MONOLITE CAT ENGINEERED MESH 19298803 Rosewater/ Rapture Rose Size 8,Default Ridgefield,8,8,0,0,0,0
,Puma MONOLITE CAT ENGINEERED MESH 19298803 Rosewater/ Rapture Rose Size 8.5,Puma MONOLITE CAT ENGINEERED MESH 19298803 Rosewater/ Rapture Rose Size 8.5,FBALYB Amazon,3,3,0,0,0,0
,Puma MONOLITE CAT ENGINEERED MESH 19298803 Rosewater/ Rapture Rose Size 9,Puma MONOLITE CAT ENGINEERED MESH 19298803 Rosewater/ Rapture Rose Size 9,FBALYB Amazon,1,1,0,0,0,0
,Puma MONOLITE CAT ENGINEERED MESH 19298803 Rosewater/ Rapture Rose Size 9.5,Puma MONOLITE CAT ENGINEERED MESH 19298803 Rosewater/ Rapture Rose Size 9.5,FBALYB Amazon,-2,-2,0,0,0,0
,Puma MONOLITE CAT ENGINEERED MESH 19298805 Peacoat/ Mist Green Size 10,Puma MONOLITE CAT ENGINEERED MESH 19298805 Peacoat/ Mist Green Size 10,Default Ridgefield,6,6,0,0,0,0
,Puma MONOLITE CAT ENGINEERED MESH 19298805 Peacoat/ Mist Green Size 6.5,Puma MONOLITE CAT ENGINEERED MESH 19298805 Peacoat/ Mist Green Size 6.5,Default Ridgefield,8,8,0,0,0,0
,Puma MONOLITE CAT ENGINEERED MESH 19298805 Peacoat/ Mist Green Size 7,Puma MONOLITE CAT ENGINEERED MESH 19298805 Peacoat/ Mist Green Size 7,FBALYB Amazon,9,9,0,0,0,0
,Puma MONOLITE CAT ENGINEERED MESH 19298805 Peacoat/ Mist Green Size 7.5,Puma MONOLITE CAT ENGINEERED MESH 19298805 Peacoat/ Mist Green Size 7.5,FBALYB Amazon,6,5,1,0,1,0
,Puma MONOLITE CAT ENGINEERED MESH 19298805 Peacoat/ Mist Green Size 8,Puma MONOLITE CAT ENGINEERED MESH 19298805 Peacoat/ Mist Green Size 8,FBALYB Amazon,-1,-1,0,0,0,0
,Puma MONOLITE CAT ENGINEERED MESH 19298805 Peacoat/ Mist Green Size 9,Puma MONOLITE CAT ENGINEERED MESH 19298805 Peacoat/ Mist Green Size 9,FBALYB Amazon,2,2,0,0,0,0
,Puma MONOLITE CAT ENGINEERED MESH 19298805 Peacoat/ Mist Green Size 9.5,Puma MONOLITE CAT ENGINEERED MESH 19298805 Peacoat/ Mist Green Size 9.5,Default Ridgefield,8,8,0,0,0,0
,Puma Socks 1,Puma Socks 1,FBALYB Amazon,-49,-50,1,90,1,0
,Puma Socks 2,Puma Socks 2,FBALYB Amazon,-67,-67,0,60,0,0
,Puma Socks Black,Puma Socks Black ,FBALYB Amazon,-1,-1,0,0,0,0
,Puma Socks Gray,Puma Socks Gray,FBALYB Amazon,320,320,0,0,0,0
,Puma socks Men Master Kit 3/18,Puma socks Men Master Kit 3/18,FBALYB Amazon,631,631,0,0,0,0
,Puma Womens Laguna Fusion Sport Golf Shoes - Black/White 19299902 US Size 10,Puma Womens Laguna Fusion Sport Golf Shoes - Black/White 19299902 US Size 10,Default Ridgefield,16,16,0,0,0,0
,Puma Womens Laguna Fusion Sport Golf Shoes - Black/White 19299902 US Size 10.5,Puma Womens Laguna Fusion Sport Golf Shoes - Black/White 19299902 US Size 10.5,Default Ridgefield,8,8,0,0,0,0
,Puma Womens Laguna Fusion Sport Golf Shoes - Black/White 19299902 US Size 6,Puma Womens Laguna Fusion Sport Golf Shoes - Black/White 19299902 US Size 6,Default Ridgefield,8,8,0,0,0,0
,Puma Womens Laguna Fusion Sport Golf Shoes - Black/White 19299902 US Size 6.5,Puma Womens Laguna Fusion Sport Golf Shoes - Black/White 19299902 US Size 6.5,Default Ridgefield,16,16,0,0,0,0
,Puma Womens Laguna Fusion Sport Golf Shoes - Black/White 19299902 US Size 7,Puma Womens Laguna Fusion Sport Golf Shoes - Black/White 19299902 US Size 7,Default Ridgefield,31,31,0,0,0,0
,Puma Womens Laguna Fusion Sport Golf Shoes - Black/White 19299902 US Size 7.5,Puma Womens Laguna Fusion Sport Golf Shoes - Black/White 19299902 US Size 7.5,Default Ridgefield,31,31,0,0,0,0
,Puma Womens Laguna Fusion Sport Golf Shoes - Black/White 19299902 US Size 8,Puma Womens Laguna Fusion Sport Golf Shoes - Black/White 19299902 US Size 8,Default Ridgefield,31,31,0,0,0,0
,Puma Womens Laguna Fusion Sport Golf Shoes - Black/White 19299902 US Size 8.5,Puma Womens Laguna Fusion Sport Golf Shoes - Black/White 19299902 US Size 8.5,Default Ridgefield,16,16,0,0,0,0
,Puma Womens Laguna Fusion Sport Golf Shoes - Black/White 19299902 US Size 9,Puma Womens Laguna Fusion Sport Golf Shoes - Black/White 19299902 US Size 9,Default Ridgefield,16,16,0,0,0,0
,Puma Womens Laguna Fusion Sport Golf Shoes - Black/White 19299902 US Size 9.5,Puma Womens Laguna Fusion Sport Golf Shoes - Black/White 19299902 US Size 9.5,Default Ridgefield,16,16,0,0,0,0
,Puma Womens Laguna Fusion Sport Golf Shoes - High Rise/White 19299903 US Size 10,Puma Womens Laguna Fusion Sport Golf Shoes - High Rise/White 19299903 US Size 10,Default Ridgefield,12,12,0,0,0,0
,Puma Womens Laguna Fusion Sport Golf Shoes - High Rise/White 19299903 US Size 10.5,Puma Womens Laguna Fusion Sport Golf Shoes - High Rise/White 19299903 US Size 10.5,Default Ridgefield,8,8,0,0,0,0
,Puma Womens Laguna Fusion Sport Golf Shoes - High Rise/White 19299903 US Size 6,Puma Womens Laguna Fusion Sport Golf Shoes - High Rise/White 19299903 US Size 6,Default Ridgefield,8,8,0,0,0,0
,Puma Womens Laguna Fusion Sport Golf Shoes - High Rise/White 19299903 US Size 6.5,Puma Womens Laguna Fusion Sport Golf Shoes - High Rise/White 19299903 US Size 6.5,Default Ridgefield,13,13,0,0,0,0
,Puma Womens Laguna Fusion Sport Golf Shoes - High Rise/White 19299903 US Size 7,Puma Womens Laguna Fusion Sport Golf Shoes - High Rise/White 19299903 US Size 7,Default Ridgefield,23,23,0,0,0,0
,Puma Womens Laguna Fusion Sport Golf Shoes - High Rise/White 19299903 US Size 7.5,Puma Womens Laguna Fusion Sport Golf Shoes - High Rise/White 19299903 US Size 7.5,Default Ridgefield,23,23,0,0,0,0
,Puma Womens Laguna Fusion Sport Golf Shoes - High Rise/White 19299903 US Size 8,Puma Womens Laguna Fusion Sport Golf Shoes - High Rise/White 19299903 US Size 8,Default Ridgefield,23,23,0,0,0,0
,Puma Womens Laguna Fusion Sport Golf Shoes - High Rise/White 19299903 US Size 8.5,Puma Womens Laguna Fusion Sport Golf Shoes - High Rise/White 19299903 US Size 8.5,Default Ridgefield,13,13,0,0,0,0
,Puma Womens Laguna Fusion Sport Golf Shoes - High Rise/White 19299903 US Size 9,Puma Womens Laguna Fusion Sport Golf Shoes - High Rise/White 19299903 US Size 9,Default Ridgefield,13,13,0,0,0,0
,Puma Womens Laguna Fusion Sport Golf Shoes - High Rise/White 19299903 US Size 9.5,Puma Womens Laguna Fusion Sport Golf Shoes - High Rise/White 19299903 US Size 9.5,Default Ridgefield,13,13,0,0,0,0
,PUMA Womens Laguna Fusion Sport Golf Shoes - Light Lavender/Silver/White 19299909 US Size 10,PUMA Womens Laguna Fusion Sport Golf Shoes - Light Lavender/Silver/White 19299909 US Size 10,Default Ridgefield,8,8,0,0,0,0
,PUMA Womens Laguna Fusion Sport Golf Shoes - Light Lavender/Silver/White 19299909 US Size 10.5,PUMA Womens Laguna Fusion Sport Golf Shoes - Light Lavender/Silver/White 19299909 US Size 10.5,Default Ridgefield,6,6,0,0,0,0
,PUMA Womens Laguna Fusion Sport Golf Shoes - Light Lavender/Silver/White 19299909 US Size 6,PUMA Womens Laguna Fusion Sport Golf Shoes - Light Lavender/Silver/White 19299909 US Size 6,Default Ridgefield,6,6,0,0,0,0
,PUMA Womens Laguna Fusion Sport Golf Shoes - Light Lavender/Silver/White 19299909 US Size 6.5,PUMA Womens Laguna Fusion Sport Golf Shoes - Light Lavender/Silver/White 19299909 US Size 6.5,Default Ridgefield,8,8,0,0,0,0
,PUMA Womens Laguna Fusion Sport Golf Shoes - Light Lavender/Silver/White 19299909 US Size 7,PUMA Womens Laguna Fusion Sport Golf Shoes - Light Lavender/Silver/White 19299909 US Size 7,Default Ridgefield,16,16,0,0,0,0
,PUMA Womens Laguna Fusion Sport Golf Shoes - Light Lavender/Silver/White 19299909 US Size 7.5,PUMA Womens Laguna Fusion Sport Golf Shoes - Light Lavender/Silver/White 19299909 US Size 7.5,Default Ridgefield,16,16,0,0,0,0
,PUMA Womens Laguna Fusion Sport Golf Shoes - Light Lavender/Silver/White 19299909 US Size 8,PUMA Womens Laguna Fusion Sport Golf Shoes - Light Lavender/Silver/White 19299909 US Size 8,Default Ridgefield,16,16,0,0,0,0
,PUMA Womens Laguna Fusion Sport Golf Shoes - Light Lavender/Silver/White 19299909 US Size 8.5,PUMA Womens Laguna Fusion Sport Golf Shoes - Light Lavender/Silver/White 19299909 US Size 8.5,Default Ridgefield,8,8,0,0,0,0
,PUMA Womens Laguna Fusion Sport Golf Shoes - Light Lavender/Silver/White 19299909 US Size 9,PUMA Womens Laguna Fusion Sport Golf Shoes - Light Lavender/Silver/White 19299909 US Size 9,Default Ridgefield,8,8,0,0,0,0
,PUMA Womens Laguna Fusion Sport Golf Shoes - Light Lavender/Silver/White 19299909 US Size 9.5,PUMA Womens Laguna Fusion Sport Golf Shoes - Light Lavender/Silver/White 19299909 US Size 9.5,Default Ridgefield,8,8,0,0,0,0
,Puma Womens Laguna Fusion Sport Golf Shoes - Peacoat/White 19299908 US Size 10,Puma Womens Laguna Fusion Sport Golf Shoes - Peacoat/White 19299908 US Size 10,Default Ridgefield,8,8,0,0,0,0
,Puma Womens Laguna Fusion Sport Golf Shoes - Peacoat/White 19299908 US Size 10.5,Puma Womens Laguna Fusion Sport Golf Shoes - Peacoat/White 19299908 US Size 10.5,Default Ridgefield,6,6,0,0,0,0
,Puma Womens Laguna Fusion Sport Golf Shoes - Peacoat/White 19299908 US Size 6,Puma Womens Laguna Fusion Sport Golf Shoes - Peacoat/White 19299908 US Size 6,Default Ridgefield,6,6,0,0,0,0
,Puma Womens Laguna Fusion Sport Golf Shoes - Peacoat/White 19299908 US Size 6.5,Puma Womens Laguna Fusion Sport Golf Shoes - Peacoat/White 19299908 US Size 6.5,Default Ridgefield,8,8,0,0,0,0
,Puma Womens Laguna Fusion Sport Golf Shoes - Peacoat/White 19299908 US Size 7,Puma Womens Laguna Fusion Sport Golf Shoes - Peacoat/White 19299908 US Size 7,Default Ridgefield,16,16,0,0,0,0
,Puma Womens Laguna Fusion Sport Golf Shoes - Peacoat/White 19299908 US Size 7.5,Puma Womens Laguna Fusion Sport Golf Shoes - Peacoat/White 19299908 US Size 7.5,Default Ridgefield,16,16,0,0,0,0
,Puma Womens Laguna Fusion Sport Golf Shoes - Peacoat/White 19299908 US Size 8,Puma Womens Laguna Fusion Sport Golf Shoes - Peacoat/White 19299908 US Size 8,Default Ridgefield,16,16,0,0,0,0
,Puma Womens Laguna Fusion Sport Golf Shoes - Peacoat/White 19299908 US Size 8.5,Puma Womens Laguna Fusion Sport Golf Shoes - Peacoat/White 19299908 US Size 8.5,Default Ridgefield,8,8,0,0,0,0
,Puma Womens Laguna Fusion Sport Golf Shoes - Peacoat/White 19299908 US Size 9,Puma Womens Laguna Fusion Sport Golf Shoes - Peacoat/White 19299908 US Size 9,Default Ridgefield,8,8,0,0,0,0
,Puma Womens Laguna Fusion Sport Golf Shoes - Peacoat/White 19299908 US Size 9.5,Puma Womens Laguna Fusion Sport Golf Shoes - Peacoat/White 19299908 US Size 9.5,Default Ridgefield,8,8,0,0,0,0
,Puma Womens Laguna Fusion Sport Golf Shoes White/White 19299901 US Size 10,Puma Womens Laguna Fusion Sport Golf Shoes White/White 19299901 US Size 10,Default Ridgefield,6,6,0,0,0,0
,Puma Womens Laguna Fusion Sport Golf Shoes White/White 19299901 US Size 10.5,Puma Womens Laguna Fusion Sport Golf Shoes White/White 19299901 US Size 10.5,Default Ridgefield,6,6,0,0,0,0
,Puma Womens Laguna Fusion Sport Golf Shoes White/White 19299901 US Size 6,Puma Womens Laguna Fusion Sport Golf Shoes White/White 19299901 US Size 6,Default Ridgefield,6,6,0,0,0,0
,Puma Womens Laguna Fusion Sport Golf Shoes White/White 19299901 US Size 6.5,Puma Womens Laguna Fusion Sport Golf Shoes White/White 19299901 US Size 6.5,Default Ridgefield,8,8,0,0,0,0
,Puma Womens Laguna Fusion Sport Golf Shoes White/White 19299901 US Size 7,Puma Womens Laguna Fusion Sport Golf Shoes White/White 19299901 US Size 7,Default Ridgefield,10,10,0,0,0,0
,Puma Womens Laguna Fusion Sport Golf Shoes White/White 19299901 US Size 7.5,Puma Womens Laguna Fusion Sport Golf Shoes White/White 19299901 US Size 7.5,Default Ridgefield,10,10,0,0,0,0
,Puma Womens Laguna Fusion Sport Golf Shoes White/White 19299901 US Size 8,Puma Womens Laguna Fusion Sport Golf Shoes White/White 19299901 US Size 8,Default Ridgefield,10,10,0,0,0,0
,Puma Womens Laguna Fusion Sport Golf Shoes White/White 19299901 US Size 8.5,Puma Womens Laguna Fusion Sport Golf Shoes White/White 19299901 US Size 8.5,Default Ridgefield,8,8,0,0,0,0
,Puma Womens Laguna Fusion Sport Golf Shoes White/White 19299901 US Size 9,Puma Womens Laguna Fusion Sport Golf Shoes White/White 19299901 US Size 9,Default Ridgefield,8,8,0,0,0,0
,Puma Womens Laguna Fusion Sport Golf Shoes White/White 19299901 US Size 9.5,Puma Womens Laguna Fusion Sport Golf Shoes White/White 19299901 US Size 9.5,Default Ridgefield,8,8,0,0,0,0
,Puma Women's Low Cut Grey Socks 8ct (SINGLE),Puma Women's Low Cut Grey Socks 8ct (SINGLE),Default Ridgefield,16,16,0,0,0,0
,Puma Women Socks Black,Puma Women Socks Black ,FBALYB Amazon,-198,-198,0,93,0,0
,Puma Women Socks Gray,Puma Women Socks Gray,FBALYB Amazon,-858,-874,16,612,16,0
,PUMA Women's Seamless Sports Bra 2pk Pink/Grey L,PUMA Women's Seamless Sports Bra 2pk Pink/Grey L  ,FBALYB Amazon,1,1,0,0,0,0
,PUMA Women's Seamless Sports Bra 2pk Pink/Grey M,PUMA Women's Seamless Sports Bra 2pk Pink/Grey M  ,FBALYB Amazon,-2,-2,0,0,0,0
,PUMA Women's Seamless Sports Bra 2pk Pink/Grey S,PUMA Women's Seamless Sports Bra 2pk Pink/Grey S ,FBALYB Amazon,160,160,0,12,0,0
,PUMA Women's Seamless Sports Bra 2pk Pink/Grey XL,PUMA Women's Seamless Sports Bra 2pk Pink/Grey XL  ,FBALYB Amazon,-1,-1,0,0,0,0
,PUMA Women's Seamless Sports Bra 2pk Pink/Grey XS,PUMA Women's Seamless Sports Bra 2pk Pink/Grey XS ,FBALYB Amazon,127,127,0,12,0,0
,PUMA Women's Seamless Sports Bra 2pk White/Black L,PUMA Women's Seamless Sports Bra 2pk White/Black L ,FBALYB Amazon,-2,-2,0,0,0,0
,PUMA Women's Seamless Sports Bra 2pk White Black M,PUMA Women's Seamless Sports Bra 2pk White Black M ,FBALYB Amazon,29,29,0,0,0,0
,PUMA Women's Seamless Sports Bra 2pk White/Black S,PUMA Women's Seamless Sports Bra 2pk White/Black S  ,Default Ridgefield,202,191,11,0,0,0
,PUMA Women's Seamless Sports Bra 2pk White/Black S,PUMA Women's Seamless Sports Bra 2pk White/Black S  ,FBALYB Amazon,185,185,0,0,0,0
,PUMA Women's Seamless Sports Bra 2pk White/Black XL,PUMA Women's Seamless Sports Bra 2pk White/Black XL  ,FBALYB Amazon,-5,-5,0,0,0,0
,PUMA Women's Seamless Sports Bra 2pk White/Black XS,PUMA Women's Seamless Sports Bra 2pk White/Black XS ,Default Ridgefield,75,75,0,0,0,0
,PUMA Women's Seamless Sports Bra 2pk White/Black XS,PUMA Women's Seamless Sports Bra 2pk White/Black XS ,FBALYB Amazon,-5,-5,0,200,0,0
,Pup-Peroni Original Beef 50oz,Pup-Peroni Original Beef 50oz,FBALYB Amazon,-312,-312,0,295,0,0
,Pure Alaska Omega Salmon Oil,Pure Alaska Omega 100% Wild Salmon Oil 1000mg 180 Softgels,FBALYB Amazon,-1,-1,0,0,0,0
,"Pure Grace EDT Set - 2oz Pure Grace EDT, 8oz Pure Grace Shower Gel &  8oz Pure Grace Body Emulsion","Pure Grace EDT Set - 2oz Pure Grace EDT, 8oz Pure Grace Shower Gel &  8oz Pure Grace Body Emulsion ",FBALYB Amazon,-31,-31,0,118,0,0
,"Pure Grace EDT Set - 2oz Pure Grace EDT, 8oz Pure Grace Shower Gel &  8oz Pure Grace Body Emulsion","Pure Grace EDT Set - 2oz Pure Grace EDT, 8oz Pure Grace Shower Gel &  8oz Pure Grace Body Emulsion ",WFS,-11,-11,0,0,0,0
,Pure Organic Fruit Bar 24ct,Pure Organic Fruit Bar 24ct,FBALYB Amazon,0,0,0,2,0,0
,Pure Organic Fruit Bar 24ct 2pk,Pure Organic Fruit Bar 24ct 2pk,FBALYB Amazon,2,2,0,0,0,0
,Puretr 789026 0.49 oz PureBite,Puretr 789026 0.49 oz PureBite,FBALYB Amazon,150,150,0,0,0,0
,Pure Vita Hip & Joint 3 Pack,Pure Vita Hip & Joint 3 Pack,FBALYB Amazon,1,1,0,1,0,0
,Purex 200 After the Rain,Purex 200 After the Rain,FBALYB Amazon,7,7,0,0,0,0
,Purex Baby Soft 5.98L 130 Loads,Purex Baby Soft 5.98L 130 Loads,FBALYB Amazon,8,8,0,0,0,0
,Purex Cold Water 200 Alpine Fresh,Purex Cold Water 200 Alpine Fresh,FBALYB Amazon,3,3,0,0,0,0
,PUR Faucet Mount Replacement Filter 5 ct,PUR Faucet Mount Replacement Filter 5 ct,FBALYB Amazon,-571,-571,0,560,0,0
,Purina Beggin' Strips Bacon 80oz 2pk,Purina Beggin' Strips Bacon 80oz 2pk,FBALYB Amazon,1,1,0,0,0,0
,Purina Busy Bone 10 ct,Purina Busy Bone Small/Medium Dog Treats 35 Oz. Bag 10 ct,FBALYB Amazon,-20,-20,0,32,0,0
,"Purina Deli Cat Food, 14 lbs.","Purina Deli Cat Food, 14 lbs.",FBALYB Amazon,-79,-79,0,0,0,0
,Purina Focus 3 Oz Chicken/Beef/White Fish UT 24 ct,Purina Focus 3 Oz Chicken/Beef/White Fish UT 24 ct,FBALYB Amazon,3,3,0,0,0,0
,Purina Focus UT Beef/Chicken 3oz,Purina Focus UT Beef/Chicken 3oz,Default,0,-1280,1280,0,0,0
,Purina Focus UT Beef/Chicken 3oz 24ct,Purina Focus UT Beef/Chicken 3oz 24ct,FBALYB Amazon,-29,-29,0,0,0,0
,Purina Focus UT Chicken/Gravy 3oz,Purina Focus UT Chicken/Gravy 3oz,Default,0,-1280,1280,0,0,0
,Purina Focus UT Chicken/Gravy 3oz 24ct,Purina Focus UT Chicken/Gravy 3oz 24ct,FBALYB Amazon,-6,-6,0,39,0,0
,Purina Focus UT Ocean Whitefish 3oz,Purina Focus UT Ocean Whitefish 3oz,Default,0,-32,32,0,0,0
,Purina Focus UT Turkey/Giblets 3oz,Purina Focus UT Turkey/Giblets 3oz,Default,0,0,0,0,0,321
,Purina Friskies Mariner's Catch 5.5oz,Purina Friskies Mariner's Catch 5.5oz,Default,0,0,0,0,0,2016
,Purina Friskies Mariner's Catch 5.5oz 24pk,Purina Friskies Mariner's Catch 5.5oz 24pk,FBALYB Amazon,60,60,0,0,0,0
,Purina Muse Infused Chicken 3oz,Purina Muse Infused Chicken 3oz,Default,0,0,0,0,0,9
,Purina Muse Infused Chicken/Tuna 3oz,Purina Muse Infused Chicken/Tuna 3oz,Default,0,0,0,0,0,9
,Purina Muse Infused Salmon 3oz,Purina Muse Infused Salmon 3oz,Default,0,0,0,0,0,9
,Purina Muse Infused Whitefish 3oz,Purina Muse Infused Whitefish 3oz,Default,0,0,0,0,0,9
,Purina Muse Natural Chicken/Carrot 3oz,Purina Muse Natural Chicken/Carrot 3oz,Default,0,0,0,0,0,528
,Purina Muse Natural Salmon/Shrimp 3oz,Purina Muse Natural Salmon/Shrimp 3oz,Default,0,0,0,0,0,528
,Purina Muse Natural Whitefish/Mackerel 3oz,Purina Muse Natural Whitefish/Mackerel 3oz,Default,0,0,0,0,0,528
,"Purina Pet Care Fancy Feast Gourmet Filet Mignon, 16-Ounce","Purina Pet Care Fancy Feast Gourmet Filet Mignon, 16-Ounce",Default Ridgefield,4,4,0,0,0,0
,Purina Savor Beef/Cheese/Gravy 3oz 24pk,Purina Savor Beef/Cheese/Gravy 3oz 24pk,FBALYB Amazon,2,2,0,0,0,0
,Purina Savor Beef/Lamb 5.5oz,Purina Savor Beef/Lamb 5.5oz,Default,0,-984,984,0,0,0
,Purina Savor Beef/Lamb 5.5oz 24pk,Purina Savor Beef/Lamb 5.5oz 24pk,FBALYB Amazon,29,29,0,0,0,0
,Purina Savor Beef/Pea 13oz,Purina Savor Beef/Pea 13oz,Default,0,0,0,0,0,2
,Purina Savor Chicken/Carrot 5.5oz,Purina Savor Chicken/Carrot 5.5oz,Default,0,0,0,0,0,1680
,Purina Savor Chicken/Carrot 5.5oz 24pk,Purina Savor Chicken/Carrot 5.5oz 24pk,FBALYB Amazon,2,2,0,0,0,0
,Purina Savor Chicken/Cheese/Gravy 3oz 24pk,Purina Savor Chicken/Cheese/Gravy 3oz 24pk,FBALYB Amazon,-14,-14,0,15,0,0
,Purina Savor Salmon/Cheese/Sauce 3oz 24pk,Purina Savor Salmon/Cheese/Sauce 3oz 24pk,FBALYB Amazon,-20,-20,0,28,0,0
,Purina Savor Turkey/Cheese/Gravy 3oz 24pk,Purina Savor Turkey/Cheese/Gravy 3oz 24pk,FBALYB Amazon,2,2,0,0,0,0
,Purina Savor Turkey/SPotato 13oz,Purina Savor Turkey/SPotato 13oz,Default,0,0,0,0,0,2
,Purina Small/Medium 15 ct.,"Purina Busy Rollhide Small/Medium Dog Treats, 15 ct.",FBALYB Amazon,-162,-169,7,182,7,0
,Purina True Nature Beef/Giblets 3oz,Purina True Nature Beef/Giblets 3oz,Default,0,0,0,0,0,20
,Purina True Nature Chicken/Liver 3oz,Purina True Nature Chicken/Liver 3oz,Default,0,0,0,0,0,20
,Purina True Nature Trout/Salmon 3oz,Purina True Nature Trout/Salmon 3oz,Default,0,0,0,0,0,20
,Purina True Nature Turkey/Chicken 3oz 24pk,Purina True Nature Turkey/Chicken 3oz 24pk,FBALYB Amazon,9,9,0,0,0,0
,Purina True Nature Whitefish/Salmon 3oz,Purina True Nature Whitefish/Salmon 3oz,Default,0,0,0,0,0,6
,Purina True Nature Whitefish/Salmon 3oz 24pk,Purina True Nature Whitefish/Salmon 3oz 24pk,FBALYB Amazon,1,1,0,0,0,0
,Purine Pro Plan chkn carrots 12pk,Purine Pro Plan chkn carrots 12pk,FBALYB Amazon,1,1,0,0,0,0
,PUR MAXION PITCHER FILTER 4PK,PUR MAXION PITCHER FILTER 4PK,FBALYB Amazon,-5,-11,6,0,6,0
,Pyrex 24‑pc. Storage Set,"Pyrex 24‑pc. Storage Set with Color Lids, Multicolor",FBALYB Amazon,1,1,0,0,0,0
,Pyrex Multi color lid mixing bowls 8 ct,Pyrex Multi color lid mixing bowls 8 ct,Default,0,0,0,0,0,1
,Pyrex Multi color lid mixing bowls 8 ct,Pyrex Multi color lid mixing bowls 8 ct,Default Ridgefield,-2,-2,0,0,0,0
,Pyrex Multi color lid mixing bowls 8 ct,Pyrex Multi color lid mixing bowls 8 ct,FBALYB Amazon,60,58,2,2,2,0
,Q/Tips Guaze,Q/Tips Guaze,FBALYB Amazon,1,1,0,0,0,0
,Quaker Chewy Bars 60 ct,"Quaker Chewy Granola Bars, Variety Pack (60 ct.)",FBALYB Amazon,7,7,0,0,0,0
,Quaker Chewy Chocolate Chip Bars 48 Bars,Quaker Chewy Chocolate Chip Bars 48 Bars,FBALYB Amazon,2,1,1,0,1,0
,Quaker chocolate chip 24 ct,"Quaker Chewy Chocolate Chip Granola Bars, 0.84 Oz, 24 Count",FBALYB Amazon,-1,-1,0,0,0,0
,"Quaker Instant Oatmeal Variety, 52 ct","Quaker Instant Oatmeal Variety, 52 ct",Default,0,0,0,0,0,1
,"Quaker Instant Oatmeal Variety, 52 ct","Quaker Instant Oatmeal Variety, 52 ct",FBALYB Amazon,2,2,0,0,0,0
,Quaker Life Cereal 62 oz,"Quaker Life Cereal, Original, 62 oz",FBALYB Amazon,5,5,0,0,0,0
,Quaker Natural Granola 69OZ,Quaker Natural Granola 69OZ,FBALYB Amazon,4,4,0,0,0,0
,Quick Cure 16oz,Quick Cure 16oz,FBALYB Amazon,19,18,1,0,1,0
,Qunol CoQ10 100mg 20oz,Qunol CoQ10 100mg 20oz,FBALYB Amazon,25,25,0,0,0,0
,Qunol Liquid Turmeric 30oz,Qunol Liquid Turmeric 30oz,FBALYB Amazon,388,388,0,16,0,0
,R6250 BOB ROSS WHITE GESSO,R6250 BOB ROSS WHITE GESSO ,Default Ridgefield,689,689,0,0,0,0
,R6250 BOB ROSS WHITE GESSO,R6250 BOB ROSS WHITE GESSO ,FBALYB Amazon,229,228,1,0,1,0
,R6262 BOB ROSS BLACK GESSO-PINT,R6262 BOB ROSS BLACK GESSO-PINT ,Default Ridgefield,64,64,0,0,0,0
,R6262 BOB ROSS BLACK GESSO-PINT,R6262 BOB ROSS BLACK GESSO-PINT ,FBALYB Amazon,187,185,2,0,2,0
,R6305 Bob Ross #5 PAINTING KNIFE,"R6305 Bob Ross #5 PAINTING KNIFE	",Default,0,-200,200,0,0,0
,R6305 Bob Ross #5 PAINTING KNIFE,"R6305 Bob Ross #5 PAINTING KNIFE	",Default Ridgefield,1052,1052,0,0,0,0
,R6305 Bob Ross #5 PAINTING KNIFE,"R6305 Bob Ross #5 PAINTING KNIFE	",FBALYB Amazon,-202,-203,1,200,1,0
,R6310 Bob Ross #10 PAINTING KNIFE,R6310 Bob Ross #10 PAINTING KNIFE ,Default,0,-200,200,0,0,0
,R6310 Bob Ross #10 PAINTING KNIFE,R6310 Bob Ross #10 PAINTING KNIFE ,Default Ridgefield,995,995,0,0,0,0
,R6310 Bob Ross #10 PAINTING KNIFE,R6310 Bob Ross #10 PAINTING KNIFE ,FBALYB Amazon,-4,-4,0,2,0,0
,"r6401 Bob Ross 1"" Landscape Brush","r6401 Bob Ross 1"" Landscape Brush",Default Ridgefield,2801,2801,0,0,0,0
,"r6401 Bob Ross 1"" Landscape Brush","r6401 Bob Ross 1"" Landscape Brush",FBALYB Amazon,-3,-3,0,0,0,0
,R6422 Bob Ross Landscape Script-Liner 2,R6422 Bob Ross Landscape Script-Liner 2,Default Ridgefield,1024,1024,0,0,0,0
,R6431 Bob Ross OVAL BRISTLE BRUSH,R6431 Bob Ross OVAL BRISTLE BRUSH,Default,0,0,0,0,0,740
,R6431 Bob Ross OVAL BRISTLE BRUSH,R6431 Bob Ross OVAL BRISTLE BRUSH,Default Ridgefield,424,424,0,0,0,0
,R6431 Bob Ross OVAL BRISTLE BRUSH,R6431 Bob Ross OVAL BRISTLE BRUSH,FBALYB Amazon,-2,-2,0,0,0,0
,"R6438 Bob Ross Landscape Round Foliage 1""","R6438 Bob Ross Landscape Round Foliage 1""",Default Ridgefield,1184,1184,0,0,0,0
,R6440 Bob Ross 1/2  ROUND BRUSH,R6440 Bob Ross 1/2  ROUND BRUSH,Default,0,0,0,0,0,33
,R6440 Bob Ross 1/2  ROUND BRUSH,R6440 Bob Ross 1/2  ROUND BRUSH,Default Ridgefield,1166,1166,0,0,0,0
,R6440 Bob Ross 1/2  ROUND BRUSH,R6440 Bob Ross 1/2  ROUND BRUSH,FBALYB Amazon,-1,-1,0,0,0,0
,R6510 Bob Ross Master Oil Paint Set,R6510 Bob Ross Master Oil Paint Set,Avrami - Ebay,210,210,0,0,0,0
,R6510 Bob Ross Master Oil Paint Set,R6510 Bob Ross Master Oil Paint Set,Default,0,0,0,0,0,1
,R6510 Bob Ross Master Oil Paint Set,R6510 Bob Ross Master Oil Paint Set,Default Ridgefield,2120,2120,0,0,0,0
,R6510 Bob Ross Master Oil Paint Set,R6510 Bob Ross Master Oil Paint Set,FBALYB Amazon,1495,1492,3,10,3,0
,R6510 Bob Ross Master Oil Paint Set,R6510 Bob Ross Master Oil Paint Set,WFS,-68,-68,0,0,0,0
,R75001 6505 Bob Ross Basic Paint Set,R75001 6505 Bob Ross Basic Paint Set,Default,0,0,0,0,0,50
,R75001 6505 Bob Ross Basic Paint Set,R75001 6505 Bob Ross Basic Paint Set,Default Ridgefield,373,373,0,0,0,0
,R75001 6505 Bob Ross Basic Paint Set,R75001 6505 Bob Ross Basic Paint Set,FBALYB Amazon,198,195,3,0,3,0
,Rabbit Gray Farmhoppers,Rabbit Gray Farmhoppers,FBALYB Amazon,1,1,0,0,0,0
,"Ragu Traditional Spaghetti Sauce, 3 ct./45 oz.","Ragu Traditional Spaghetti Sauce, 3 ct./45 oz.",FBALYB Amazon,-5,-5,0,7,0,0
,Ratchet 100 oz Graphite/Black,Ratchet 100 oz Graphite/Black,FBALYB Amazon,4,4,0,0,0,0
,Rawhide Express Lennox 1lb Vanilla Chips,Rawhide Express Lennox 1lb Vanilla Chips,FBALYB Amazon,1,1,0,0,0,0
,Razer Wireless headphones - Black,Razer - Razer ManO’War Wireless gaming 7.1 virtual surround sound over the head headphones - Black,FBALYB Amazon,-3,-3,0,0,0,0
,RCA Galileo Pro 11.5 Black,"RCA Galileo Pro 11.5"" 32GB Touchscreen Tablet Computer with Keyboard Black",Default,0,-3,3,0,0,1
,RCA Galileo Pro 11.5 Black,"RCA Galileo Pro 11.5"" 32GB Touchscreen Tablet Computer with Keyboard Black",FBALYB Amazon,-1,-1,0,0,0,0
,RCA Galileo Pro 11.5 Blue,"RCA Galileo Pro 11.5"" 32GB 2-in-1 Tablet with Keyboard Case Blue",Default,0,-3,3,0,0,1
,RCA Galileo Pro 11.5 Blue,"RCA Galileo Pro 11.5"" 32GB 2-in-1 Tablet with Keyboard Case Blue",FBALYB Amazon,-1,-1,0,0,0,0
,RCA Galileo Pro 11.5 Pink,"RCA Galileo Pro 11.5"" 32GB Tablet with Keyboard Case Android 6.0 PINK",FBALYB Amazon,0,0,0,3,0,0
,RCA Viking Pro 10 Purple,RCA Viking Pro Purple Edition 10.1 Touchscreen 2 In 1 Tablet w/ Detachable Keyboard,FBALYB Amazon,1,1,0,0,0,0
,RCA Voyager Pro 7 Black,RCA Voyager Pro ‑ Wi‑Fi ‑ 16 GB ‑ Black ‑ with Keyboard Case,FBALYB Amazon,-2,-2,0,0,0,0
,RCA Voyager Pro 7 Purple,"RCA Voyager Pro - Wi-Fi - 16 GB - Purple - Android 6.0 - with Keyboard and Case - 7""",FBALYB Amazon,-1,-1,0,0,0,0
,RD-FL0E-1MD3,Community Coffee & Chicory Box of 80 K-cups,FBALYB Amazon,1,1,0,0,0,0
,Redbarn Beef Roll 4lb 2pk,Redbarn Beef Roll 4lb 2pk,FBALYB Amazon,2,2,0,0,0,0
,Redbarn Beef Roll 4lb 4pk,Redbarn Beef Roll 4lb 4pk,FBALYB Amazon,2,2,0,0,0,0
,Redbarn Filled Hooves Peanut Butter 25ct 2pk,Redbarn Filled Hooves Peanut Butter 25ct 2pk,FBALYB Amazon,0,-2,2,0,2,0
,Redbarn French Toast Bully Slices 9oz,Redbarn French Toast Bully Slices 9oz,FBALYB Amazon,1,1,0,0,0,0
,Red Bird 54oz 290 2PK,Red Bird 54oz 290 2PK,FBALYB Amazon,-45,-45,0,3,0,0
,Red Bird Peppermint Puffs 320ct,Red Bird Peppermint Puffs 320ct,Default Ridgefield,20,20,0,0,0,0
,Red Bird Peppermint Puffs 320ct,Red Bird Peppermint Puffs 320ct,FBALYB Amazon,-270,-270,0,322,0,0
,Red Bird Peppermint Puffs 320ct 2pk,Red Bird Peppermint Puffs 320ct 2pk,FBALYB Amazon,6,1,5,0,5,0
,"Red Bird Soft Peppermint Puff Tub, 54 Oz","Red Bird Soft Peppermint Puff Tub, 54 Oz",FBALYB Amazon,-8,-10,2,68,2,0
,Red go Go Bird,Red go Go Bird,Default,4,4,0,0,0,0
,Red go Go Bird,Red go Go Bird,FBALYB Amazon,-32,-32,0,27,0,0
,Red Sea 225 Micron Felt Filter Bag,Red Sea 225 Micron Felt Filter Bag,Default,0,0,0,0,0,2
,Red Sea 225 Micron Felt Filter Bag 3pk,Red Sea 225 Micron Felt Filter Bag 3pk,FBALYB Amazon,-1,-1,0,0,0,0
,Red Sea MCP Nitrate/Nitrite Test Kit,Red Sea MCP Nitrate/Nitrite Test Kit,Default,0,0,0,0,0,30
,Red Sea NO3:PO4-X Reducer 1L,Red Sea NO3:PO4-X Reducer 1L,Default,0,0,0,0,0,5
,Red Sea NO3:PO4-X Reducer 1L,Red Sea NO3:PO4-X Reducer 1L,FBALYB Amazon,2,2,0,0,0,0
,Red Sea Reef Energy A Supplement 500ml,Red Sea Reef Energy A Supplement 500ml,Default,0,0,0,0,0,2
,Red Sea Reef Foundation A Supplement,Red Sea Reef Foundation A Supplement,FBALYB Amazon,1,1,0,0,0,0
,Red Sea Seawater Refractometer,Red Sea Seawater Refractometer,Default Ridgefield,1,1,0,0,0,0
,Red Sea Seawater Refractometer,Red Sea Seawater Refractometer,FBALYB Amazon,-3,-3,0,0,0,0
,Red Tortilla Warmer 2 Pack, Red Tortilla Warmer 2 Pack,FBALYB Amazon,13,13,0,0,0,0
,Red UA70170-20002 24oz,Under Armour UA70170-20002 Red Dominate 24oz,FBALYB Amazon,44,44,0,1,0,0
,Reduce Cold1 Blue/Grey,Reduce Cold1 Blue/Grey,FBALYB Amazon,-1,-1,0,0,0,0
,Reduced Sugar Craisins 43oz,Reduced Sugar Craisins 43oz,FBALYB Amazon,14,14,0,0,0,0
,Reebok Black Size 12,Reebok Black Size 12 ,FBALYB Amazon,-2,-2,0,0,0,0
,Reebok CXT Black Size 10,Reebok CXT Black Size 10,FBALYB Amazon,-1,-1,0,0,0,0
,Reebok CXT Black Size 10.5,Reebok CXT Black Size 10.5,FBALYB Amazon,-2,-2,0,0,0,0
,Reebok CXT Black Size 11,Reebok CXT Black Size 11,FBALYB Amazon,-3,-3,0,0,0,0
,Reebok CXT Black Size 8,Reebok CXT Black Size 8,Default,0,-1,1,0,0,0
,Reebok CXT Black Size 9,Reebok CXT Black Size 9,FBALYB Amazon,1,1,0,0,0,0
,Reebok CXT White Size 10,Reebok CXT White Size 10,Default Ridgefield,8,8,0,0,0,0
,Reebok CXT White Size 10.5,Reebok CXT White Size 10.5,Default,0,0,0,0,0,1
,Reebok CXT White Size 10.5,Reebok CXT White Size 10.5,Default Ridgefield,11,11,0,0,0,0
,Reebok CXT White Size 11,Reebok CXT White Size 11,Default,0,-5,5,0,0,0
,Reebok CXT White Size 8,Reebok CXT White Size 8,Default Ridgefield,2,2,0,0,0,0
,Reebok CXT White Size 9,Reebok CXT White Size 9,Default,0,0,0,0,0,1
,Reebok CXT White Size 9,Reebok CXT White Size 9,Default Ridgefield,3,3,0,0,0,0
,Reebok CXT White Size 9.5,Reebok CXT White Size 9.5,Default,0,0,0,0,0,1
,Reebok CXT White Size 9.5,Reebok CXT White Size 9.5,Default Ridgefield,5,5,0,0,0,0
,Reebok White Size 12,Reebok White Size 12,Default Ridgefield,10,10,0,0,0,0
,Reed Diffuser  - Volcano - Capri Blue Signature Collection -,Reed Diffuser  - Volcano - Capri Blue Signature Collection -,FBALYB Amazon,-1,-1,0,2,0,0
,Reef BLISS NIGHTS - BLACK REE-RF0A2U1JBLA US Size 10,Reef BLISS NIGHTS - BLACK REE-RF0A2U1JBLA US Size 10,Default Ridgefield,460,460,0,0,0,0
,Reef BLISS NIGHTS - BLACK REE-RF0A2U1JBLA US Size 10,Reef BLISS NIGHTS - BLACK REE-RF0A2U1JBLA US Size 10,FBALYB Amazon,128,127,1,0,1,0
,Reef BLISS NIGHTS - BLACK REE-RF0A2U1JBLA US Size 11,Reef BLISS NIGHTS - BLACK REE-RF0A2U1JBLA US Size 11,Default Ridgefield,110,110,0,0,0,0
,Reef BLISS NIGHTS - BLACK REE-RF0A2U1JBLA US Size 11,Reef BLISS NIGHTS - BLACK REE-RF0A2U1JBLA US Size 11,FBALYB Amazon,48,48,0,0,0,0
,Reef BLISS NIGHTS - BLACK REE-RF0A2U1JBLA US Size 6,Reef BLISS NIGHTS - BLACK REE-RF0A2U1JBLA US Size 6,Default Ridgefield,254,254,0,0,0,0
,Reef BLISS NIGHTS - BLACK REE-RF0A2U1JBLA US Size 6,Reef BLISS NIGHTS - BLACK REE-RF0A2U1JBLA US Size 6,FBALYB Amazon,71,71,0,0,0,0
,Reef BLISS NIGHTS - BLACK REE-RF0A2U1JBLA US Size 7,Reef BLISS NIGHTS - BLACK REE-RF0A2U1JBLA US Size 7,Default Ridgefield,673,673,0,0,0,0
,Reef BLISS NIGHTS - BLACK REE-RF0A2U1JBLA US Size 7,Reef BLISS NIGHTS - BLACK REE-RF0A2U1JBLA US Size 7,FBALYB Amazon,142,141,1,2,1,0
,Reef BLISS NIGHTS - BLACK REE-RF0A2U1JBLA US Size 8,Reef BLISS NIGHTS - BLACK REE-RF0A2U1JBLA US Size 8,Default Ridgefield,339,339,0,0,0,0
,Reef BLISS NIGHTS - BLACK REE-RF0A2U1JBLA US Size 8,Reef BLISS NIGHTS - BLACK REE-RF0A2U1JBLA US Size 8,FBALYB Amazon,325,319,6,0,6,0
,Reef BLISS NIGHTS - BLACK REE-RF0A2U1JBLA US Size 9,Reef BLISS NIGHTS - BLACK REE-RF0A2U1JBLA US Size 9,Default Ridgefield,861,861,0,0,0,0
,Reef BLISS NIGHTS - BLACK REE-RF0A2U1JBLA US Size 9,Reef BLISS NIGHTS - BLACK REE-RF0A2U1JBLA US Size 9,FBALYB Amazon,219,218,1,0,1,0
,Reef BLISS NIGHTS - TAN/CHAMPAGNE REE-RF0A2U1JTAH US Size 10,Reef BLISS NIGHTS - TAN/CHAMPAGNE REE-RF0A2U1JTAH US Size 10,Default Ridgefield,48,48,0,0,0,0
,Reef BLISS NIGHTS - TAN/CHAMPAGNE REE-RF0A2U1JTAH US Size 10,Reef BLISS NIGHTS - TAN/CHAMPAGNE REE-RF0A2U1JTAH US Size 10,FBALYB Amazon,25,24,1,0,1,0
,Reef BLISS NIGHTS - TAN/CHAMPAGNE REE-RF0A2U1JTAH US Size 11,Reef BLISS NIGHTS - TAN/CHAMPAGNE REE-RF0A2U1JTAH US Size 11,Default Ridgefield,13,13,0,0,0,0
,Reef BLISS NIGHTS - TAN/CHAMPAGNE REE-RF0A2U1JTAH US Size 11,Reef BLISS NIGHTS - TAN/CHAMPAGNE REE-RF0A2U1JTAH US Size 11,FBALYB Amazon,18,18,0,0,0,0
,Reef BLISS NIGHTS - TAN/CHAMPAGNE REE-RF0A2U1JTAH US Size 6,Reef BLISS NIGHTS - TAN/CHAMPAGNE REE-RF0A2U1JTAH US Size 6,Default Ridgefield,25,25,0,0,0,0
,Reef BLISS NIGHTS - TAN/CHAMPAGNE REE-RF0A2U1JTAH US Size 7,Reef BLISS NIGHTS - TAN/CHAMPAGNE REE-RF0A2U1JTAH US Size 7,Default Ridgefield,70,70,0,0,0,0
,Reef BLISS NIGHTS - TAN/CHAMPAGNE REE-RF0A2U1JTAH US Size 7,Reef BLISS NIGHTS - TAN/CHAMPAGNE REE-RF0A2U1JTAH US Size 7,FBALYB Amazon,16,16,0,0,0,0
,Reef BLISS NIGHTS - TAN/CHAMPAGNE REE-RF0A2U1JTAH US Size 8,Reef BLISS NIGHTS - TAN/CHAMPAGNE REE-RF0A2U1JTAH US Size 8,Default Ridgefield,71,71,0,0,0,0
,Reef BLISS NIGHTS - TAN/CHAMPAGNE REE-RF0A2U1JTAH US Size 8,Reef BLISS NIGHTS - TAN/CHAMPAGNE REE-RF0A2U1JTAH US Size 8,FBALYB Amazon,3,3,0,0,0,0
,Reef BLISS NIGHTS - TAN/CHAMPAGNE REE-RF0A2U1JTAH US Size 9,Reef BLISS NIGHTS - TAN/CHAMPAGNE REE-RF0A2U1JTAH US Size 9,Default Ridgefield,86,86,0,0,0,0
,Reef BLISS NIGHTS - TAN/CHAMPAGNE REE-RF0A2U1JTAH US Size 9,Reef BLISS NIGHTS - TAN/CHAMPAGNE REE-RF0A2U1JTAH US Size 9,FBALYB Amazon,3,2,1,0,1,0
,Reef CUSHION COURT - BLACK REE-RF0A3FDSBLA US Size 10,Reef CUSHION COURT - BLACK REE-RF0A3FDSBLA US Size 10,FBALYB Amazon,-18,-18,0,0,0,0
,Reef CUSHION COURT - BLACK REE-RF0A3FDSBLA US Size 11,Reef CUSHION COURT - BLACK REE-RF0A3FDSBLA US Size 11,Default Ridgefield,18,18,0,0,0,0
,Reef CUSHION COURT - BLACK REE-RF0A3FDSBLA US Size 6,Reef CUSHION COURT - BLACK REE-RF0A3FDSBLA US Size 6,FBALYB Amazon,-10,-12,2,0,2,0
,Reef CUSHION COURT - BLACK REE-RF0A3FDSBLA US Size 7,Reef CUSHION COURT - BLACK REE-RF0A3FDSBLA US Size 7,FBALYB Amazon,-10,-11,1,0,1,0
,Reef CUSHION COURT - BLACK REE-RF0A3FDSBLA US Size 8,Reef CUSHION COURT - BLACK REE-RF0A3FDSBLA US Size 8,FBALYB Amazon,-28,-28,0,0,0,0
,Reef CUSHION COURT - BLACK REE-RF0A3FDSBLA US Size 9,Reef CUSHION COURT - BLACK REE-RF0A3FDSBLA US Size 9,FBALYB Amazon,-40,-40,0,0,0,0
,Reef CUSHION COURT - CLOUD REE-RF0A3FDSCLD US Size 10,Reef CUSHION COURT - CLOUD REE-RF0A3FDSCLD US Size 10,Default Ridgefield,1,1,0,0,0,0
,Reef CUSHION COURT - CLOUD REE-RF0A3FDSCLD US Size 10,Reef CUSHION COURT - CLOUD REE-RF0A3FDSCLD US Size 10,FBALYB Amazon,-5,-5,0,0,0,0
,Reef CUSHION COURT - CLOUD REE-RF0A3FDSCLD US Size 11,Reef CUSHION COURT - CLOUD REE-RF0A3FDSCLD US Size 11,FBALYB Amazon,1,0,1,0,1,0
,Reef CUSHION COURT - CLOUD REE-RF0A3FDSCLD US Size 6,Reef CUSHION COURT - CLOUD REE-RF0A3FDSCLD US Size 6,FBALYB Amazon,-5,-5,0,0,0,0
,Reef CUSHION COURT - CLOUD REE-RF0A3FDSCLD US Size 7,Reef CUSHION COURT - CLOUD REE-RF0A3FDSCLD US Size 7,Default Ridgefield,2,2,0,0,0,0
,Reef CUSHION COURT - CLOUD REE-RF0A3FDSCLD US Size 7,Reef CUSHION COURT - CLOUD REE-RF0A3FDSCLD US Size 7,FBALYB Amazon,22,20,2,0,2,0
,Reef CUSHION COURT - CLOUD REE-RF0A3FDSCLD US Size 8,Reef CUSHION COURT - CLOUD REE-RF0A3FDSCLD US Size 8,Default Ridgefield,60,60,0,0,0,0
,Reef CUSHION COURT - CLOUD REE-RF0A3FDSCLD US Size 8,Reef CUSHION COURT - CLOUD REE-RF0A3FDSCLD US Size 8,FBALYB Amazon,1,1,0,0,0,0
,Reef CUSHION COURT - CLOUD REE-RF0A3FDSCLD US Size 9,Reef CUSHION COURT - CLOUD REE-RF0A3FDSCLD US Size 9,Default Ridgefield,35,35,0,0,0,0
,Reef CUSHION COURT - CLOUD REE-RF0A3FDSCLD US Size 9,Reef CUSHION COURT - CLOUD REE-RF0A3FDSCLD US Size 9,FBALYB Amazon,-28,-31,3,0,3,0
,Reef CUSHION COURT - ROSE GOLD REE-RF0A3FDSRGL Size 10,Reef CUSHION COURT - ROSE GOLD REE-RF0A3FDSRGL Size 10,FBALYB Amazon,-25,-30,5,0,5,0
,Reef CUSHION COURT - ROSE GOLD REE-RF0A3FDSRGL Size 11,Reef CUSHION COURT - ROSE GOLD REE-RF0A3FDSRGL Size 11,FBALYB Amazon,14,14,0,0,0,0
,Reef CUSHION COURT - ROSE GOLD REE-RF0A3FDSRGL Size 6,Reef CUSHION COURT - ROSE GOLD REE-RF0A3FDSRGL Size 6,Default Ridgefield,16,16,0,0,0,0
,Reef CUSHION COURT - ROSE GOLD REE-RF0A3FDSRGL Size 6,Reef CUSHION COURT - ROSE GOLD REE-RF0A3FDSRGL Size 6,FBALYB Amazon,-11,-12,1,0,1,0
,Reef CUSHION COURT - ROSE GOLD REE-RF0A3FDSRGL Size 7,Reef CUSHION COURT - ROSE GOLD REE-RF0A3FDSRGL Size 7,FBALYB Amazon,-27,-28,1,0,1,0
,Reef CUSHION COURT - ROSE GOLD REE-RF0A3FDSRGL Size 8,Reef CUSHION COURT - ROSE GOLD REE-RF0A3FDSRGL Size 8,Default Ridgefield,41,41,0,0,0,0
,Reef CUSHION COURT - ROSE GOLD REE-RF0A3FDSRGL Size 8,Reef CUSHION COURT - ROSE GOLD REE-RF0A3FDSRGL Size 8,FBALYB Amazon,-13,-16,3,0,3,0
,Reef CUSHION COURT - ROSE GOLD REE-RF0A3FDSRGL Size 9,Reef CUSHION COURT - ROSE GOLD REE-RF0A3FDSRGL Size 9,Default Ridgefield,56,56,0,0,0,0
,Reef CUSHION COURT - ROSE GOLD REE-RF0A3FDSRGL Size 9,Reef CUSHION COURT - ROSE GOLD REE-RF0A3FDSRGL Size 9,FBALYB Amazon,-16,-18,2,0,2,0
,Reef CUSHION COURT - TAN/CHAMPAGNE REE-RF0A3FDSTAH US Size 10,Reef CUSHION COURT - TAN/CHAMPAGNE REE-RF0A3FDSTAH US Size 10,FBALYB Amazon,-3,-3,0,0,0,0
,Reef CUSHION COURT - TAN/CHAMPAGNE REE-RF0A3FDSTAH US Size 11,Reef CUSHION COURT - TAN/CHAMPAGNE REE-RF0A3FDSTAH US Size 11,FBALYB Amazon,0,0,0,18,0,0
,Reef CUSHION COURT - TAN/CHAMPAGNE REE-RF0A3FDSTAH US Size 6,Reef CUSHION COURT - TAN/CHAMPAGNE REE-RF0A3FDSTAH US Size 6,FBALYB Amazon,-10,-10,0,0,0,0
,Reef CUSHION COURT - TAN/CHAMPAGNE REE-RF0A3FDSTAH US Size 7,Reef CUSHION COURT - TAN/CHAMPAGNE REE-RF0A3FDSTAH US Size 7,FBALYB Amazon,-5,-5,0,0,0,0
,Reef CUSHION COURT - TAN/CHAMPAGNE REE-RF0A3FDSTAH US Size 8,Reef CUSHION COURT - TAN/CHAMPAGNE REE-RF0A3FDSTAH US Size 8,FBALYB Amazon,-6,-6,0,0,0,0
,Reef CUSHION COURT - TAN/CHAMPAGNE REE-RF0A3FDSTAH US Size 9,Reef CUSHION COURT - TAN/CHAMPAGNE REE-RF0A3FDSTAH US Size 9,FBALYB Amazon,-6,-6,0,0,0,0
,Reef CUSHION PHANTOM - BLACK REE-RF0A3FDIBLA US Size 10,Reef CUSHION PHANTOM - BLACK REE-RF0A3FDIBLA US Size 10,Default Ridgefield,34,34,0,0,0,0
,Reef CUSHION PHANTOM - BLACK REE-RF0A3FDIBLA US Size 10,Reef CUSHION PHANTOM - BLACK REE-RF0A3FDIBLA US Size 10,FBALYB Amazon,9,9,0,0,0,0
,Reef CUSHION PHANTOM - BLACK REE-RF0A3FDIBLA US Size 11,Reef CUSHION PHANTOM - BLACK REE-RF0A3FDIBLA US Size 11,Default Ridgefield,36,36,0,0,0,0
,Reef CUSHION PHANTOM - BLACK REE-RF0A3FDIBLA US Size 12,Reef CUSHION PHANTOM - BLACK REE-RF0A3FDIBLA US Size 12,Default Ridgefield,13,13,0,0,0,0
,Reef CUSHION PHANTOM - BLACK REE-RF0A3FDIBLA US Size 12,Reef CUSHION PHANTOM - BLACK REE-RF0A3FDIBLA US Size 12,FBALYB Amazon,-3,-3,0,0,0,0
,Reef CUSHION PHANTOM - BLACK REE-RF0A3FDIBLA US Size 13,Reef CUSHION PHANTOM - BLACK REE-RF0A3FDIBLA US Size 13,Default Ridgefield,1,1,0,0,0,0
,Reef CUSHION PHANTOM - BLACK REE-RF0A3FDIBLA US Size 13,Reef CUSHION PHANTOM - BLACK REE-RF0A3FDIBLA US Size 13,FBALYB Amazon,-2,-2,0,0,0,0
,Reef CUSHION PHANTOM - BLACK REE-RF0A3FDIBLA US Size 8,Reef CUSHION PHANTOM - BLACK REE-RF0A3FDIBLA US Size 8,FBALYB Amazon,-1,-1,0,0,0,0
,Reef CUSHION PHANTOM - BLACK REE-RF0A3FDIBLA US Size 9,Reef CUSHION PHANTOM - BLACK REE-RF0A3FDIBLA US Size 9,Default Ridgefield,10,10,0,0,0,0
,Reef CUSHION PHANTOM - BLACK REE-RF0A3FDIBLA US Size 9,Reef CUSHION PHANTOM - BLACK REE-RF0A3FDIBLA US Size 9,FBALYB Amazon,-6,-7,1,0,1,0
,Reef CUSHION PHANTOM - BROWN/TAN REE-RF0A3FDIBTN US size 10,Reef CUSHION PHANTOM - BROWN/TAN REE-RF0A3FDIBTN US size 10,Default Ridgefield,19,19,0,0,0,0
,Reef CUSHION PHANTOM - BROWN/TAN REE-RF0A3FDIBTN US size 10,Reef CUSHION PHANTOM - BROWN/TAN REE-RF0A3FDIBTN US size 10,FBALYB Amazon,-2,-2,0,0,0,0
,Reef CUSHION PHANTOM - BROWN/TAN REE-RF0A3FDIBTN US size 11,Reef CUSHION PHANTOM - BROWN/TAN REE-RF0A3FDIBTN US size 11,Default Ridgefield,14,14,0,0,0,0
,Reef CUSHION PHANTOM - BROWN/TAN REE-RF0A3FDIBTN US size 11,Reef CUSHION PHANTOM - BROWN/TAN REE-RF0A3FDIBTN US size 11,FBALYB Amazon,1,1,0,0,0,0
,Reef CUSHION PHANTOM - BROWN/TAN REE-RF0A3FDIBTN US size 12,Reef CUSHION PHANTOM - BROWN/TAN REE-RF0A3FDIBTN US size 12,Default Ridgefield,2,2,0,0,0,0
,Reef CUSHION PHANTOM - BROWN/TAN REE-RF0A3FDIBTN US size 12,Reef CUSHION PHANTOM - BROWN/TAN REE-RF0A3FDIBTN US size 12,FBALYB Amazon,4,4,0,0,0,0
,Reef CUSHION PHANTOM - BROWN/TAN REE-RF0A3FDIBTN US size 8,Reef CUSHION PHANTOM - BROWN/TAN REE-RF0A3FDIBTN US size 8,FBALYB Amazon,5,3,2,0,2,0
,Reef CUSHION PHANTOM - BROWN/TAN REE-RF0A3FDIBTN US size 9,Reef CUSHION PHANTOM - BROWN/TAN REE-RF0A3FDIBTN US size 9,Default Ridgefield,8,8,0,0,0,0
,Reef CUSHION PHANTOM - BROWN/TAN REE-RF0A3FDIBTN US size 9,Reef CUSHION PHANTOM - BROWN/TAN REE-RF0A3FDIBTN US size 9,FBALYB Amazon,-3,-3,0,0,0,0
,Reef CUSHION SLIM - BLACK RF0A39U6BLA US Size 10,Reef CUSHION SLIM - BLACK RF0A39U6BLA US Size 10,Default Ridgefield,56,56,0,0,0,0
,Reef CUSHION SLIM - BLACK RF0A39U6BLA US Size 10,Reef CUSHION SLIM - BLACK RF0A39U6BLA US Size 10,FBALYB Amazon,33,33,0,0,0,0
,Reef CUSHION SLIM - BLACK RF0A39U6BLA US Size 11,Reef CUSHION SLIM - BLACK RF0A39U6BLA US Size 11,Default Ridgefield,15,15,0,0,0,0
,Reef CUSHION SLIM - BLACK RF0A39U6BLA US Size 11,Reef CUSHION SLIM - BLACK RF0A39U6BLA US Size 11,FBALYB Amazon,13,13,0,0,0,0
,Reef CUSHION SLIM - BLACK RF0A39U6BLA US Size 6,Reef CUSHION SLIM - BLACK RF0A39U6BLA US Size 6,Default Ridgefield,30,30,0,0,0,0
,Reef CUSHION SLIM - BLACK RF0A39U6BLA US Size 6,Reef CUSHION SLIM - BLACK RF0A39U6BLA US Size 6,FBALYB Amazon,10,10,0,0,0,0
,Reef CUSHION SLIM - BLACK RF0A39U6BLA US Size 7,Reef CUSHION SLIM - BLACK RF0A39U6BLA US Size 7,Default Ridgefield,82,82,0,0,0,0
,Reef CUSHION SLIM - BLACK RF0A39U6BLA US Size 7,Reef CUSHION SLIM - BLACK RF0A39U6BLA US Size 7,FBALYB Amazon,42,42,0,0,0,0
,Reef CUSHION SLIM - BLACK RF0A39U6BLA US Size 8,Reef CUSHION SLIM - BLACK RF0A39U6BLA US Size 8,Default Ridgefield,34,34,0,0,0,0
,Reef CUSHION SLIM - BLACK RF0A39U6BLA US Size 8,Reef CUSHION SLIM - BLACK RF0A39U6BLA US Size 8,FBALYB Amazon,107,107,0,0,0,0
,Reef CUSHION SLIM - BLACK RF0A39U6BLA US Size 9,Reef CUSHION SLIM - BLACK RF0A39U6BLA US Size 9,Default Ridgefield,109,109,0,0,0,0
,Reef CUSHION SLIM - BLACK RF0A39U6BLA US Size 9,Reef CUSHION SLIM - BLACK RF0A39U6BLA US Size 9,FBALYB Amazon,60,60,0,0,0,0
,Reef CUSHION SLIM - NUDE RF0A39U6NUD US Size 10,Reef CUSHION SLIM - NUDE RF0A39U6NUD US Size 10,Default Ridgefield,10,10,0,0,0,0
,Reef CUSHION SLIM - NUDE RF0A39U6NUD US Size 10,Reef CUSHION SLIM - NUDE RF0A39U6NUD US Size 10,FBALYB Amazon,9,9,0,0,0,0
,Reef CUSHION SLIM - NUDE RF0A39U6NUD US Size 11,Reef CUSHION SLIM - NUDE RF0A39U6NUD US Size 11,Default Ridgefield,4,4,0,0,0,0
,Reef CUSHION SLIM - NUDE RF0A39U6NUD US Size 11,Reef CUSHION SLIM - NUDE RF0A39U6NUD US Size 11,FBALYB Amazon,15,15,0,0,0,0
,Reef CUSHION SLIM - NUDE RF0A39U6NUD US Size 6,Reef CUSHION SLIM - NUDE RF0A39U6NUD US Size 6,Default Ridgefield,9,9,0,0,0,0
,Reef CUSHION SLIM - NUDE RF0A39U6NUD US Size 6,Reef CUSHION SLIM - NUDE RF0A39U6NUD US Size 6,FBALYB Amazon,12,12,0,0,0,0
,Reef CUSHION SLIM - NUDE RF0A39U6NUD US Size 7,Reef CUSHION SLIM - NUDE RF0A39U6NUD US Size 7,Default Ridgefield,24,24,0,0,0,0
,Reef CUSHION SLIM - NUDE RF0A39U6NUD US Size 8,Reef CUSHION SLIM - NUDE RF0A39U6NUD US Size 8,Default Ridgefield,25,25,0,0,0,0
,Reef CUSHION SLIM - NUDE RF0A39U6NUD US Size 8,Reef CUSHION SLIM - NUDE RF0A39U6NUD US Size 8,FBALYB Amazon,9,9,0,0,0,0
,Reef CUSHION SLIM - NUDE RF0A39U6NUD US Size 9,Reef CUSHION SLIM - NUDE RF0A39U6NUD US Size 9,Default Ridgefield,31,31,0,0,0,0
,Reef CUSHION SLIM - NUDE RF0A39U6NUD US Size 9,Reef CUSHION SLIM - NUDE RF0A39U6NUD US Size 9,FBALYB Amazon,22,21,1,0,1,0
,Reef CUSHION SOL - NATURAL REE-RF0A3YNFNAT Size 10,Reef CUSHION SOL - NATURAL REE-RF0A3YNFNAT Size 10,FBALYB Amazon,-4,-4,0,0,0,0
,Reef CUSHION SOL - NATURAL REE-RF0A3YNFNAT Size 11,Reef CUSHION SOL - NATURAL REE-RF0A3YNFNAT Size 11,FBALYB Amazon,15,15,0,0,0,0
,Reef CUSHION SOL - NATURAL REE-RF0A3YNFNAT Size 6,Reef CUSHION SOL - NATURAL REE-RF0A3YNFNAT Size 6,FBALYB Amazon,9,8,1,0,1,0
,Reef CUSHION SOL - NATURAL REE-RF0A3YNFNAT Size 7,Reef CUSHION SOL - NATURAL REE-RF0A3YNFNAT Size 7,FBALYB Amazon,-4,-4,0,0,0,0
,Reef CUSHION SOL - NATURAL REE-RF0A3YNFNAT Size 9,Reef CUSHION SOL - NATURAL REE-RF0A3YNFNAT Size 9,FBALYB Amazon,-2,-2,0,0,0,0
,Reef CUSHION SOL - WHITE/SNAKE REE-RF0A3YNFWSN Size 10,Reef CUSHION SOL - WHITE/SNAKE REE-RF0A3YNFWSN Size 10,FBALYB Amazon,15,14,1,0,1,0
,Reef CUSHION SOL - WHITE/SNAKE REE-RF0A3YNFWSN Size 11,Reef CUSHION SOL - WHITE/SNAKE REE-RF0A3YNFWSN Size 11,FBALYB Amazon,16,16,0,0,0,0
,Reef CUSHION SOL - WHITE/SNAKE REE-RF0A3YNFWSN Size 6,Reef CUSHION SOL - WHITE/SNAKE REE-RF0A3YNFWSN Size 6,FBALYB Amazon,9,9,0,0,0,0
,Reef CUSHION SOL - WHITE/SNAKE REE-RF0A3YNFWSN Size 7,Reef CUSHION SOL - WHITE/SNAKE REE-RF0A3YNFWSN Size 7,FBALYB Amazon,4,3,1,0,1,0
,Reef CUSHION STARGAZER - BLACK/BRONZE REE-RF0A3FDNBBZ US Size 10,Reef CUSHION STARGAZER - BLACK/BRONZE REE-RF0A3FDNBBZ US Size 10,Default Ridgefield,38,38,0,0,0,0
,Reef CUSHION STARGAZER - BLACK/BRONZE REE-RF0A3FDNBBZ US Size 11,Reef CUSHION STARGAZER - BLACK/BRONZE REE-RF0A3FDNBBZ US Size 11,Default Ridgefield,23,23,0,0,0,0
,Reef CUSHION STARGAZER - BLACK/BRONZE REE-RF0A3FDNBBZ US Size 6,Reef CUSHION STARGAZER - BLACK/BRONZE REE-RF0A3FDNBBZ US Size 6,Default Ridgefield,11,11,0,0,0,0
,Reef CUSHION STARGAZER - BLACK/BRONZE REE-RF0A3FDNBBZ US Size 6,Reef CUSHION STARGAZER - BLACK/BRONZE REE-RF0A3FDNBBZ US Size 6,FBALYB Amazon,14,14,0,0,0,0
,Reef CUSHION STARGAZER - BLACK/BRONZE REE-RF0A3FDNBBZ US Size 7,Reef CUSHION STARGAZER - BLACK/BRONZE REE-RF0A3FDNBBZ US Size 7,Default Ridgefield,46,46,0,0,0,0
,Reef CUSHION STARGAZER - BLACK/BRONZE REE-RF0A3FDNBBZ US Size 8,Reef CUSHION STARGAZER - BLACK/BRONZE REE-RF0A3FDNBBZ US Size 8,Default Ridgefield,66,66,0,0,0,0
,Reef CUSHION STARGAZER - BLACK/BRONZE REE-RF0A3FDNBBZ US Size 9,Reef CUSHION STARGAZER - BLACK/BRONZE REE-RF0A3FDNBBZ US Size 9,Default Ridgefield,75,75,0,0,0,0
,Reef CUSHION STARGAZER - BLACK REE-RF0A3FDNBLA US Size 10,Reef CUSHION STARGAZER - BLACK REE-RF0A3FDNBLA US Size 10,Default Ridgefield,77,77,0,0,0,0
,Reef CUSHION STARGAZER - BLACK REE-RF0A3FDNBLA US Size 10,Reef CUSHION STARGAZER - BLACK REE-RF0A3FDNBLA US Size 10,FBALYB Amazon,-4,-5,1,0,1,0
,Reef CUSHION STARGAZER - BLACK REE-RF0A3FDNBLA US Size 11,Reef CUSHION STARGAZER - BLACK REE-RF0A3FDNBLA US Size 11,FBALYB Amazon,22,21,1,0,1,0
,Reef CUSHION STARGAZER - BLACK REE-RF0A3FDNBLA US Size 6,Reef CUSHION STARGAZER - BLACK REE-RF0A3FDNBLA US Size 6,Default Ridgefield,12,12,0,0,0,0
,Reef CUSHION STARGAZER - BLACK REE-RF0A3FDNBLA US Size 6,Reef CUSHION STARGAZER - BLACK REE-RF0A3FDNBLA US Size 6,FBALYB Amazon,27,26,1,0,1,0
,Reef CUSHION STARGAZER - BLACK REE-RF0A3FDNBLA US Size 7,Reef CUSHION STARGAZER - BLACK REE-RF0A3FDNBLA US Size 7,Default Ridgefield,94,94,0,0,0,0
,Reef CUSHION STARGAZER - BLACK REE-RF0A3FDNBLA US Size 7,Reef CUSHION STARGAZER - BLACK REE-RF0A3FDNBLA US Size 7,FBALYB Amazon,30,30,0,0,0,0
,Reef CUSHION STARGAZER - BLACK REE-RF0A3FDNBLA US Size 8,Reef CUSHION STARGAZER - BLACK REE-RF0A3FDNBLA US Size 8,Default Ridgefield,8,8,0,0,0,0
,Reef CUSHION STARGAZER - BLACK REE-RF0A3FDNBLA US Size 8,Reef CUSHION STARGAZER - BLACK REE-RF0A3FDNBLA US Size 8,FBALYB Amazon,71,68,3,0,3,0
,Reef CUSHION STARGAZER - BLACK REE-RF0A3FDNBLA US Size 9,Reef CUSHION STARGAZER - BLACK REE-RF0A3FDNBLA US Size 9,Default Ridgefield,150,150,0,0,0,0
,Reef CUSHION STARGAZER - BLACK REE-RF0A3FDNBLA US Size 9,Reef CUSHION STARGAZER - BLACK REE-RF0A3FDNBLA US Size 9,FBALYB Amazon,21,21,0,0,0,0
,Reef CUSHION STARGAZER - CLOUD REE-RF0A3FDNCLD US Size 10,Reef CUSHION STARGAZER - CLOUD REE-RF0A3FDNCLD US Size 10,Default Ridgefield,28,28,0,0,0,0
,Reef CUSHION STARGAZER - CLOUD REE-RF0A3FDNCLD US Size 10,Reef CUSHION STARGAZER - CLOUD REE-RF0A3FDNCLD US Size 10,FBALYB Amazon,17,17,0,0,0,0
,Reef CUSHION STARGAZER - CLOUD REE-RF0A3FDNCLD US Size 11,Reef CUSHION STARGAZER - CLOUD REE-RF0A3FDNCLD US Size 11,Default Ridgefield,8,8,0,0,0,0
,Reef CUSHION STARGAZER - CLOUD REE-RF0A3FDNCLD US Size 11,Reef CUSHION STARGAZER - CLOUD REE-RF0A3FDNCLD US Size 11,FBALYB Amazon,15,15,0,0,0,0
,Reef CUSHION STARGAZER - CLOUD REE-RF0A3FDNCLD US Size 6,Reef CUSHION STARGAZER - CLOUD REE-RF0A3FDNCLD US Size 6,Default Ridgefield,15,15,0,0,0,0
,Reef CUSHION STARGAZER - CLOUD REE-RF0A3FDNCLD US Size 6,Reef CUSHION STARGAZER - CLOUD REE-RF0A3FDNCLD US Size 6,FBALYB Amazon,10,10,0,0,0,0
,Reef CUSHION STARGAZER - CLOUD REE-RF0A3FDNCLD US Size 7,Reef CUSHION STARGAZER - CLOUD REE-RF0A3FDNCLD US Size 7,Default Ridgefield,36,36,0,0,0,0
,Reef CUSHION STARGAZER - CLOUD REE-RF0A3FDNCLD US Size 8,Reef CUSHION STARGAZER - CLOUD REE-RF0A3FDNCLD US Size 8,Default Ridgefield,44,44,0,0,0,0
,Reef CUSHION STARGAZER - CLOUD REE-RF0A3FDNCLD US Size 8,Reef CUSHION STARGAZER - CLOUD REE-RF0A3FDNCLD US Size 8,FBALYB Amazon,26,26,0,0,0,0
,Reef CUSHION STARGAZER - CLOUD REE-RF0A3FDNCLD US Size 9,Reef CUSHION STARGAZER - CLOUD REE-RF0A3FDNCLD US Size 9,Default Ridgefield,50,50,0,0,0,0
,Reef CUSHION STARGAZER - CLOUD REE-RF0A3FDNCLD US Size 9,Reef CUSHION STARGAZER - CLOUD REE-RF0A3FDNCLD US Size 9,FBALYB Amazon,32,32,0,0,0,0
,Reef CUSHION VISTA - BLACK/NATURAL RF0A3OKSBLN US Size 11,Reef CUSHION VISTA - BLACK/NATURAL RF0A3OKSBLN US Size 11,FBALYB Amazon,-2,-2,0,0,0,0
,Reef CUSHION VISTA - BLACK/NATURAL RF0A3OKSBLN US Size 6,Reef CUSHION VISTA - BLACK/NATURAL RF0A3OKSBLN US Size 6,Default Ridgefield,18,18,0,0,0,0
,Reef CUSHION VISTA - BLACK/NATURAL RF0A3OKSBLN US Size 7,Reef CUSHION VISTA - BLACK/NATURAL RF0A3OKSBLN US Size 7,FBALYB Amazon,-1,-1,0,0,0,0
,Reef CUSHION VISTA - BLACK/NATURAL RF0A3OKSBLN US Size 8,Reef CUSHION VISTA - BLACK/NATURAL RF0A3OKSBLN US Size 8,FBALYB Amazon,-2,-2,0,0,0,0
,Reef CUSHION VISTA - BLACK/NATURAL RF0A3OKSBLN US Size 9,Reef CUSHION VISTA - BLACK/NATURAL RF0A3OKSBLN US Size 9,FBALYB Amazon,-2,-2,0,0,0,0
,Reef CUSHION VISTA BRAID - NATURAL RF0A52OANAT US Size 10,Reef CUSHION VISTA BRAID - NATURAL RF0A52OANAT US Size 10,Default Ridgefield,1,1,0,0,0,0
,Reef CUSHION VISTA BRAID - NATURAL RF0A52OANAT US Size 10,Reef CUSHION VISTA BRAID - NATURAL RF0A52OANAT US Size 10,FBALYB Amazon,12,12,0,0,0,0
,Reef CUSHION VISTA BRAID - NATURAL RF0A52OANAT US Size 11,Reef CUSHION VISTA BRAID - NATURAL RF0A52OANAT US Size 11,FBALYB Amazon,13,13,0,0,0,0
,Reef CUSHION VISTA BRAID - NATURAL RF0A52OANAT US Size 6,Reef CUSHION VISTA BRAID - NATURAL RF0A52OANAT US Size 6,FBALYB Amazon,16,16,0,0,0,0
,Reef CUSHION VISTA BRAID - NATURAL RF0A52OANAT US Size 7,Reef CUSHION VISTA BRAID - NATURAL RF0A52OANAT US Size 7,FBALYB Amazon,11,11,0,0,0,0
,Reef CUSHION VISTA BRAID - NATURAL RF0A52OANAT US Size 8,Reef CUSHION VISTA BRAID - NATURAL RF0A52OANAT US Size 8,FBALYB Amazon,20,20,0,0,0,0
,Reef CUSHION VISTA BRAID - NATURAL RF0A52OANAT US Size 9,Reef CUSHION VISTA BRAID - NATURAL RF0A52OANAT US Size 9,FBALYB Amazon,10,9,1,0,1,0
,Reef CUSHION VISTA - NATURAL RF0A3OKSNAT US Size 10,Reef CUSHION VISTA - NATURAL RF0A3OKSNAT US Size 10,FBALYB Amazon,34,33,1,0,1,0
,Reef CUSHION VISTA - NATURAL RF0A3OKSNAT US Size 11,Reef CUSHION VISTA - NATURAL RF0A3OKSNAT US Size 11,Default Ridgefield,11,11,0,0,0,0
,Reef CUSHION VISTA - NATURAL RF0A3OKSNAT US Size 11,Reef CUSHION VISTA - NATURAL RF0A3OKSNAT US Size 11,FBALYB Amazon,5,5,0,0,0,0
,Reef CUSHION VISTA - NATURAL RF0A3OKSNAT US Size 6,Reef CUSHION VISTA - NATURAL RF0A3OKSNAT US Size 6,FBALYB Amazon,16,16,0,0,0,0
,Reef CUSHION VISTA - NATURAL RF0A3OKSNAT US Size 7,Reef CUSHION VISTA - NATURAL RF0A3OKSNAT US Size 7,Default Ridgefield,46,46,0,0,0,0
,Reef CUSHION VISTA - NATURAL RF0A3OKSNAT US Size 7,Reef CUSHION VISTA - NATURAL RF0A3OKSNAT US Size 7,FBALYB Amazon,-2,-3,1,0,1,0
,Reef CUSHION VISTA - NATURAL RF0A3OKSNAT US Size 8,Reef CUSHION VISTA - NATURAL RF0A3OKSNAT US Size 8,Default Ridgefield,48,48,0,0,0,0
,Reef CUSHION VISTA - NATURAL RF0A3OKSNAT US Size 8,Reef CUSHION VISTA - NATURAL RF0A3OKSNAT US Size 8,FBALYB Amazon,-1,-2,1,0,1,0
,Reef CUSHION VISTA - NATURAL RF0A3OKSNAT US Size 9,Reef CUSHION VISTA - NATURAL RF0A3OKSNAT US Size 9,Default Ridgefield,52,52,0,0,0,0
,Reef CUSHION VISTA - NATURAL RF0A3OKSNAT US Size 9,Reef CUSHION VISTA - NATURAL RF0A3OKSNAT US Size 9,FBALYB Amazon,12,11,1,0,1,0
,Reef FANNING BLACK/GREY RF001626BLG US SIze 10,Reef FANNING BLACK/GREY RF001626BLG US SIze 10,FBALYB Amazon,119,119,0,0,0,0
,Reef FANNING BLACK/GREY RF001626BLG US SIze 11,Reef FANNING BLACK/GREY RF001626BLG US SIze 11,FBALYB Amazon,29,29,0,1,0,0
,Reef FANNING BLACK/GREY RF001626BLG US SIze 6,Reef FANNING BLACK/GREY RF001626BLG US SIze 6,FBALYB Amazon,61,60,1,0,1,0
,Reef FANNING BLACK/GREY RF001626BLG US SIze 7,Reef FANNING BLACK/GREY RF001626BLG US SIze 7,FBALYB Amazon,179,179,0,0,0,0
,Reef FANNING BLACK/GREY RF001626BLG US SIze 8,Reef FANNING BLACK/GREY RF001626BLG US SIze 8,Default Ridgefield,205,205,0,0,0,0
,Reef FANNING BLACK/GREY RF001626BLG US SIze 8,Reef FANNING BLACK/GREY RF001626BLG US SIze 8,FBALYB Amazon,6,6,0,0,0,0
,Reef FANNING BLACK/GREY RF001626BLG US SIze 9,Reef FANNING BLACK/GREY RF001626BLG US SIze 9,Default Ridgefield,126,126,0,0,0,0
,Reef FANNING BLACK/GREY RF001626BLG US SIze 9,Reef FANNING BLACK/GREY RF001626BLG US SIze 9,FBALYB Amazon,137,135,2,0,2,0
,Reef GIRLS SLAP 3 - BLACK/BLACK/AQUA RF001084BKQ US Size 10,Reef GIRLS SLAP 3 - BLACK/BLACK/AQUA RF001084BKQ US Size 10,Default Ridgefield,185,185,0,0,0,0
,Reef GIRLS SLAP 3 - BLACK/BLACK/AQUA RF001084BKQ US Size 10,Reef GIRLS SLAP 3 - BLACK/BLACK/AQUA RF001084BKQ US Size 10,FBALYB Amazon,55,55,0,0,0,0
,Reef GIRLS SLAP 3 - BLACK/BLACK/AQUA RF001084BKQ US Size 11,Reef GIRLS SLAP 3 - BLACK/BLACK/AQUA RF001084BKQ US Size 11,FBALYB Amazon,54,54,0,0,0,0
,Reef GIRLS SLAP 3 - BLACK/BLACK/AQUA RF001084BKQ US Size 6,Reef GIRLS SLAP 3 - BLACK/BLACK/AQUA RF001084BKQ US Size 6,Default Ridgefield,97,97,0,0,0,0
,Reef GIRLS SLAP 3 - BLACK/BLACK/AQUA RF001084BKQ US Size 6,Reef GIRLS SLAP 3 - BLACK/BLACK/AQUA RF001084BKQ US Size 6,FBALYB Amazon,40,40,0,0,0,0
,Reef GIRLS SLAP 3 - BLACK/BLACK/AQUA RF001084BKQ US Size 7,Reef GIRLS SLAP 3 - BLACK/BLACK/AQUA RF001084BKQ US Size 7,Default Ridgefield,219,219,0,0,0,0
,Reef GIRLS SLAP 3 - BLACK/BLACK/AQUA RF001084BKQ US Size 7,Reef GIRLS SLAP 3 - BLACK/BLACK/AQUA RF001084BKQ US Size 7,FBALYB Amazon,92,91,1,0,1,0
,Reef GIRLS SLAP 3 - BLACK/BLACK/AQUA RF001084BKQ US Size 8,Reef GIRLS SLAP 3 - BLACK/BLACK/AQUA RF001084BKQ US Size 8,Default Ridgefield,1,1,0,0,0,0
,Reef GIRLS SLAP 3 - BLACK/BLACK/AQUA RF001084BKQ US Size 8,Reef GIRLS SLAP 3 - BLACK/BLACK/AQUA RF001084BKQ US Size 8,FBALYB Amazon,123,120,3,144,3,0
,Reef GIRLS SLAP 3 - BLACK/BLACK/AQUA RF001084BKQ US Size 9,Reef GIRLS SLAP 3 - BLACK/BLACK/AQUA RF001084BKQ US Size 9,Default Ridgefield,359,359,0,0,0,0
,Reef GIRLS SLAP 3 - BLACK/BLACK/AQUA RF001084BKQ US Size 9,Reef GIRLS SLAP 3 - BLACK/BLACK/AQUA RF001084BKQ US Size 9,FBALYB Amazon,148,148,0,0,0,0
,Reef LEATHER FANNING - BRONZE RF002156BRZ US Size 10,Reef LEATHER FANNING - BRONZE RF002156BRZ US Size 10,Default Ridgefield,54,54,0,0,0,0
,Reef LEATHER FANNING - BRONZE RF002156BRZ US Size 10,Reef LEATHER FANNING - BRONZE RF002156BRZ US Size 10,FBALYB Amazon,20,19,1,0,1,0
,Reef LEATHER FANNING - BRONZE RF002156BRZ US Size 11,Reef LEATHER FANNING - BRONZE RF002156BRZ US Size 11,Default Ridgefield,58,58,0,0,0,0
,Reef LEATHER FANNING - BRONZE RF002156BRZ US Size 11,Reef LEATHER FANNING - BRONZE RF002156BRZ US Size 11,FBALYB Amazon,26,25,1,0,1,0
,Reef LEATHER FANNING - BRONZE RF002156BRZ US Size 12,Reef LEATHER FANNING - BRONZE RF002156BRZ US Size 12,Default Ridgefield,33,33,0,0,0,0
,Reef LEATHER FANNING - BRONZE RF002156BRZ US Size 12,Reef LEATHER FANNING - BRONZE RF002156BRZ US Size 12,FBALYB Amazon,13,12,1,0,1,0
,Reef LEATHER FANNING - BRONZE RF002156BRZ US Size 13,Reef LEATHER FANNING - BRONZE RF002156BRZ US Size 13,Default Ridgefield,17,17,0,0,0,0
,Reef LEATHER FANNING - BRONZE RF002156BRZ US Size 13,Reef LEATHER FANNING - BRONZE RF002156BRZ US Size 13,FBALYB Amazon,5,2,3,0,3,0
,Reef LEATHER FANNING - BRONZE RF002156BRZ US Size 8,Reef LEATHER FANNING - BRONZE RF002156BRZ US Size 8,Default Ridgefield,18,18,0,0,0,0
,Reef LEATHER FANNING - BRONZE RF002156BRZ US Size 8,Reef LEATHER FANNING - BRONZE RF002156BRZ US Size 8,FBALYB Amazon,4,4,0,0,0,0
,Reef LEATHER FANNING - BRONZE RF002156BRZ US Size 9,Reef LEATHER FANNING - BRONZE RF002156BRZ US Size 9,Default Ridgefield,27,27,0,0,0,0
,Reef LEATHER FANNING - BRONZE RF002156BRZ US Size 9,Reef LEATHER FANNING - BRONZE RF002156BRZ US Size 9,FBALYB Amazon,17,17,0,0,0,0
,Reef LEATHER ORTHO-COAST - BROWN RF0A3YKRBRO US Size 10,Reef LEATHER ORTHO-COAST - BROWN RF0A3YKRBRO US Size 10,Default Ridgefield,32,32,0,0,0,0
,Reef LEATHER ORTHO-COAST - BROWN RF0A3YKRBRO US Size 10,Reef LEATHER ORTHO-COAST - BROWN RF0A3YKRBRO US Size 10,FBALYB Amazon,38,38,0,0,0,0
,Reef LEATHER ORTHO-COAST - BROWN RF0A3YKRBRO US Size 11,Reef LEATHER ORTHO-COAST - BROWN RF0A3YKRBRO US Size 11,Default Ridgefield,37,37,0,0,0,0
,Reef LEATHER ORTHO-COAST - BROWN RF0A3YKRBRO US Size 11,Reef LEATHER ORTHO-COAST - BROWN RF0A3YKRBRO US Size 11,FBALYB Amazon,26,26,0,0,0,0
,Reef LEATHER ORTHO-COAST - BROWN RF0A3YKRBRO US Size 12,Reef LEATHER ORTHO-COAST - BROWN RF0A3YKRBRO US Size 12,Default Ridgefield,15,15,0,0,0,0
,Reef LEATHER ORTHO-COAST - BROWN RF0A3YKRBRO US Size 12,Reef LEATHER ORTHO-COAST - BROWN RF0A3YKRBRO US Size 12,FBALYB Amazon,34,33,1,0,1,0
,Reef LEATHER ORTHO-COAST - BROWN RF0A3YKRBRO US Size 13,Reef LEATHER ORTHO-COAST - BROWN RF0A3YKRBRO US Size 13,Default Ridgefield,1,1,0,0,0,0
,Reef LEATHER ORTHO-COAST - BROWN RF0A3YKRBRO US Size 13,Reef LEATHER ORTHO-COAST - BROWN RF0A3YKRBRO US Size 13,FBALYB Amazon,19,18,1,0,1,0
,Reef LEATHER ORTHO-COAST - BROWN RF0A3YKRBRO US Size 8,Reef LEATHER ORTHO-COAST - BROWN RF0A3YKRBRO US Size 8,Default Ridgefield,30,30,0,0,0,0
,Reef LEATHER ORTHO-COAST - BROWN RF0A3YKRBRO US Size 9,Reef LEATHER ORTHO-COAST - BROWN RF0A3YKRBRO US Size 9,Default Ridgefield,85,85,0,0,0,0
,Reef LEATHER ORTHO-SPRING - BROWN RF0A3YKTBRO US Size 10,Reef LEATHER ORTHO-SPRING - BROWN RF0A3YKTBRO US Size 10,Default Ridgefield,44,44,0,0,0,0
,Reef LEATHER ORTHO-SPRING - BROWN RF0A3YKTBRO US Size 10,Reef LEATHER ORTHO-SPRING - BROWN RF0A3YKTBRO US Size 10,FBALYB Amazon,30,30,0,0,0,0
,Reef LEATHER ORTHO-SPRING - BROWN RF0A3YKTBRO US Size 11,Reef LEATHER ORTHO-SPRING - BROWN RF0A3YKTBRO US Size 11,Default Ridgefield,46,46,0,0,0,0
,Reef LEATHER ORTHO-SPRING - BROWN RF0A3YKTBRO US Size 11,Reef LEATHER ORTHO-SPRING - BROWN RF0A3YKTBRO US Size 11,FBALYB Amazon,25,25,0,0,0,0
,Reef LEATHER ORTHO-SPRING - BROWN RF0A3YKTBRO US Size 12,Reef LEATHER ORTHO-SPRING - BROWN RF0A3YKTBRO US Size 12,Default Ridgefield,32,32,0,0,0,0
,Reef LEATHER ORTHO-SPRING - BROWN RF0A3YKTBRO US Size 12,Reef LEATHER ORTHO-SPRING - BROWN RF0A3YKTBRO US Size 12,FBALYB Amazon,17,17,0,0,0,0
,Reef LEATHER ORTHO-SPRING - BROWN RF0A3YKTBRO US Size 13,Reef LEATHER ORTHO-SPRING - BROWN RF0A3YKTBRO US Size 13,Default Ridgefield,18,18,0,0,0,0
,Reef LEATHER ORTHO-SPRING - BROWN RF0A3YKTBRO US Size 13,Reef LEATHER ORTHO-SPRING - BROWN RF0A3YKTBRO US Size 13,FBALYB Amazon,10,10,0,0,0,0
,Reef LEATHER ORTHO-SPRING - BROWN RF0A3YKTBRO US Size 8,Reef LEATHER ORTHO-SPRING - BROWN RF0A3YKTBRO US Size 8,Default Ridgefield,18,18,0,0,0,0
,Reef LEATHER ORTHO-SPRING - BROWN RF0A3YKTBRO US Size 8,Reef LEATHER ORTHO-SPRING - BROWN RF0A3YKTBRO US Size 8,FBALYB Amazon,5,5,0,0,0,0
,Reef LEATHER ORTHO-SPRING - BROWN RF0A3YKTBRO US Size 9,Reef LEATHER ORTHO-SPRING - BROWN RF0A3YKTBRO US Size 9,Default Ridgefield,50,50,0,0,0,0
,Reef LEATHER SMOOTHY - BRONZE BROWN RF000232BZB US Size 10,Reef LEATHER SMOOTHY - BRONZE BROWN RF000232BZB US Size 10,Default Ridgefield,37,37,0,0,0,0
,Reef LEATHER SMOOTHY - BRONZE BROWN RF000232BZB US Size 10,Reef LEATHER SMOOTHY - BRONZE BROWN RF000232BZB US Size 10,FBALYB Amazon,-4,-4,0,0,0,0
,Reef LEATHER SMOOTHY - BRONZE BROWN RF000232BZB US Size 11,Reef LEATHER SMOOTHY - BRONZE BROWN RF000232BZB US Size 11,Default Ridgefield,80,80,0,0,0,0
,Reef LEATHER SMOOTHY - BRONZE BROWN RF000232BZB US Size 12,Reef LEATHER SMOOTHY - BRONZE BROWN RF000232BZB US Size 12,Default Ridgefield,24,24,0,0,0,0
,Reef LEATHER SMOOTHY - BRONZE BROWN RF000232BZB US Size 12,Reef LEATHER SMOOTHY - BRONZE BROWN RF000232BZB US Size 12,FBALYB Amazon,8,8,0,0,0,0
,Reef LEATHER SMOOTHY - BRONZE BROWN RF000232BZB US Size 13,Reef LEATHER SMOOTHY - BRONZE BROWN RF000232BZB US Size 13,Default Ridgefield,29,29,0,0,0,0
,Reef LEATHER SMOOTHY - BRONZE BROWN RF000232BZB US Size 8,Reef LEATHER SMOOTHY - BRONZE BROWN RF000232BZB US Size 8,Default Ridgefield,8,8,0,0,0,0
,Reef LEATHER SMOOTHY - BRONZE BROWN RF000232BZB US Size 8,Reef LEATHER SMOOTHY - BRONZE BROWN RF000232BZB US Size 8,FBALYB Amazon,16,16,0,0,0,0
,Reef LEATHER SMOOTHY - BRONZE BROWN RF000232BZB US Size 9,Reef LEATHER SMOOTHY - BRONZE BROWN RF000232BZB US Size 9,Default Ridgefield,48,48,0,0,0,0
,Reef REEF ANCHOR - BROWN RF0A3YMIBRO US Size 10,Reef REEF ANCHOR - BROWN RF0A3YMIBRO US Size 10,Default Ridgefield,27,27,0,0,0,0
,Reef REEF ANCHOR - BROWN RF0A3YMIBRO US Size 10,Reef REEF ANCHOR - BROWN RF0A3YMIBRO US Size 10,FBALYB Amazon,16,16,0,0,0,0
,Reef REEF ANCHOR - BROWN RF0A3YMIBRO US Size 11,Reef REEF ANCHOR - BROWN RF0A3YMIBRO US Size 11,Default Ridgefield,29,29,0,0,0,0
,Reef REEF ANCHOR - BROWN RF0A3YMIBRO US Size 11,Reef REEF ANCHOR - BROWN RF0A3YMIBRO US Size 11,FBALYB Amazon,2,2,0,0,0,0
,Reef REEF ANCHOR - BROWN RF0A3YMIBRO US Size 12,Reef REEF ANCHOR - BROWN RF0A3YMIBRO US Size 12,Default Ridgefield,20,20,0,0,0,0
,Reef REEF ANCHOR - BROWN RF0A3YMIBRO US Size 12,Reef REEF ANCHOR - BROWN RF0A3YMIBRO US Size 12,FBALYB Amazon,13,13,0,0,0,0
,Reef REEF ANCHOR - BROWN RF0A3YMIBRO US Size 13,Reef REEF ANCHOR - BROWN RF0A3YMIBRO US Size 13,FBALYB Amazon,12,12,0,0,0,0
,Reef REEF ANCHOR - BROWN RF0A3YMIBRO US Size 8,Reef REEF ANCHOR - BROWN RF0A3YMIBRO US Size 8,Default Ridgefield,9,9,0,0,0,0
,Reef REEF ANCHOR - BROWN RF0A3YMIBRO US Size 8,Reef REEF ANCHOR - BROWN RF0A3YMIBRO US Size 8,FBALYB Amazon,9,9,0,0,0,0
,Reef REEF ANCHOR - BROWN RF0A3YMIBRO US Size 9,Reef REEF ANCHOR - BROWN RF0A3YMIBRO US Size 9,Default Ridgefield,20,20,0,0,0,0
,Reef REEF ANCHOR - BROWN RF0A3YMIBRO US Size 9,Reef REEF ANCHOR - BROWN RF0A3YMIBRO US Size 9,FBALYB Amazon,12,12,0,0,0,0
,Reef REEF ANCHOR - GREY/BLUE RF0A3YMIGBL US Size 10,Reef REEF ANCHOR - GREY/BLUE RF0A3YMIGBL US Size 10,Default Ridgefield,80,80,0,0,0,0
,Reef REEF ANCHOR - GREY/BLUE RF0A3YMIGBL US Size 10,Reef REEF ANCHOR - GREY/BLUE RF0A3YMIGBL US Size 10,FBALYB Amazon,33,33,0,0,0,0
,Reef REEF ANCHOR - GREY/BLUE RF0A3YMIGBL US Size 11,Reef REEF ANCHOR - GREY/BLUE RF0A3YMIGBL US Size 11,Default Ridgefield,47,47,0,0,0,0
,Reef REEF ANCHOR - GREY/BLUE RF0A3YMIGBL US Size 11,Reef REEF ANCHOR - GREY/BLUE RF0A3YMIGBL US Size 11,FBALYB Amazon,71,71,0,0,0,0
,Reef REEF ANCHOR - GREY/BLUE RF0A3YMIGBL US Size 12,Reef REEF ANCHOR - GREY/BLUE RF0A3YMIGBL US Size 12,Default Ridgefield,36,36,0,0,0,0
,Reef REEF ANCHOR - GREY/BLUE RF0A3YMIGBL US Size 12,Reef REEF ANCHOR - GREY/BLUE RF0A3YMIGBL US Size 12,FBALYB Amazon,33,28,5,0,5,0
,Reef REEF ANCHOR - GREY/BLUE RF0A3YMIGBL US Size 13,Reef REEF ANCHOR - GREY/BLUE RF0A3YMIGBL US Size 13,Default Ridgefield,8,8,0,0,0,0
,Reef REEF ANCHOR - GREY/BLUE RF0A3YMIGBL US Size 13,Reef REEF ANCHOR - GREY/BLUE RF0A3YMIGBL US Size 13,FBALYB Amazon,15,14,1,0,1,0
,Reef REEF ANCHOR - GREY/BLUE RF0A3YMIGBL US Size 8,Reef REEF ANCHOR - GREY/BLUE RF0A3YMIGBL US Size 8,FBALYB Amazon,26,25,1,0,1,0
,Reef REEF ANCHOR - GREY/BLUE RF0A3YMIGBL US Size 9,Reef REEF ANCHOR - GREY/BLUE RF0A3YMIGBL US Size 9,Default Ridgefield,63,63,0,0,0,0
,Reef REEF ANCHOR - GREY/BLUE RF0A3YMIGBL US Size 9,Reef REEF ANCHOR - GREY/BLUE RF0A3YMIGBL US Size 9,FBALYB Amazon,8,8,0,0,0,0
,Reef REEF CUSHION BREEZE - BLACK/BLACK REE-RF001454BK2 US Size 10,Reef REEF CUSHION BREEZE - BLACK/BLACK REE-RF001454BK2 US Size 10,Default Ridgefield,385,385,0,0,0,0
,Reef REEF CUSHION BREEZE - BLACK/BLACK REE-RF001454BK2 US Size 10,Reef REEF CUSHION BREEZE - BLACK/BLACK REE-RF001454BK2 US Size 10,FBALYB Amazon,114,114,0,0,0,0
,Reef REEF CUSHION BREEZE - BLACK/BLACK REE-RF001454BK2 US Size 11,Reef REEF CUSHION BREEZE - BLACK/BLACK REE-RF001454BK2 US Size 11,Default Ridgefield,54,54,0,0,0,0
,Reef REEF CUSHION BREEZE - BLACK/BLACK REE-RF001454BK2 US Size 11,Reef REEF CUSHION BREEZE - BLACK/BLACK REE-RF001454BK2 US Size 11,FBALYB Amazon,71,64,7,0,7,0
,Reef REEF CUSHION BREEZE - BLACK/BLACK REE-RF001454BK2 US Size 6,Reef REEF CUSHION BREEZE - BLACK/BLACK REE-RF001454BK2 US Size 6,Default Ridgefield,106,106,0,0,0,0
,Reef REEF CUSHION BREEZE - BLACK/BLACK REE-RF001454BK2 US Size 6,Reef REEF CUSHION BREEZE - BLACK/BLACK REE-RF001454BK2 US Size 6,FBALYB Amazon,159,158,1,0,1,0
,Reef REEF CUSHION BREEZE - BLACK/BLACK REE-RF001454BK2 US Size 7,Reef REEF CUSHION BREEZE - BLACK/BLACK REE-RF001454BK2 US Size 7,Default Ridgefield,553,553,0,0,0,0
,Reef REEF CUSHION BREEZE - BLACK/BLACK REE-RF001454BK2 US Size 7,Reef REEF CUSHION BREEZE - BLACK/BLACK REE-RF001454BK2 US Size 7,FBALYB Amazon,200,199,1,0,1,0
,Reef REEF CUSHION BREEZE - BLACK/BLACK REE-RF001454BK2 US Size 8,Reef REEF CUSHION BREEZE - BLACK/BLACK REE-RF001454BK2 US Size 8,Default Ridgefield,607,607,0,0,0,0
,Reef REEF CUSHION BREEZE - BLACK/BLACK REE-RF001454BK2 US Size 8,Reef REEF CUSHION BREEZE - BLACK/BLACK REE-RF001454BK2 US Size 8,FBALYB Amazon,123,110,13,0,13,0
,Reef REEF CUSHION BREEZE - BLACK/BLACK REE-RF001454BK2 US Size 9,Reef REEF CUSHION BREEZE - BLACK/BLACK REE-RF001454BK2 US Size 9,Default Ridgefield,689,689,0,0,0,0
,Reef REEF CUSHION BREEZE - BLACK/BLACK REE-RF001454BK2 US Size 9,Reef REEF CUSHION BREEZE - BLACK/BLACK REE-RF001454BK2 US Size 9,FBALYB Amazon,221,212,9,0,9,0
,Reef REEF CUSHION BREEZE - CLOUD REE-RF001454CLD US Size 10,Reef REEF CUSHION BREEZE - CLOUD REE-RF001454CLD US Size 10,Default Ridgefield,296,296,0,0,0,0
,Reef REEF CUSHION BREEZE - CLOUD REE-RF001454CLD US Size 10,Reef REEF CUSHION BREEZE - CLOUD REE-RF001454CLD US Size 10,FBALYB Amazon,130,130,0,0,0,0
,Reef REEF CUSHION BREEZE - CLOUD REE-RF001454CLD US Size 11,Reef REEF CUSHION BREEZE - CLOUD REE-RF001454CLD US Size 11,Default Ridgefield,6,6,0,0,0,0
,Reef REEF CUSHION BREEZE - CLOUD REE-RF001454CLD US Size 11,Reef REEF CUSHION BREEZE - CLOUD REE-RF001454CLD US Size 11,FBALYB Amazon,98,96,2,0,2,0
,Reef REEF CUSHION BREEZE - CLOUD REE-RF001454CLD US Size 6,Reef REEF CUSHION BREEZE - CLOUD REE-RF001454CLD US Size 6,FBALYB Amazon,132,129,3,0,3,0
,Reef REEF CUSHION BREEZE - CLOUD REE-RF001454CLD US Size 7,Reef REEF CUSHION BREEZE - CLOUD REE-RF001454CLD US Size 7,Default Ridgefield,218,218,0,0,0,0
,Reef REEF CUSHION BREEZE - CLOUD REE-RF001454CLD US Size 7,Reef REEF CUSHION BREEZE - CLOUD REE-RF001454CLD US Size 7,FBALYB Amazon,192,185,7,0,7,0
,Reef REEF CUSHION BREEZE - CLOUD REE-RF001454CLD US Size 8,Reef REEF CUSHION BREEZE - CLOUD REE-RF001454CLD US Size 8,Default Ridgefield,237,237,0,0,0,0
,Reef REEF CUSHION BREEZE - CLOUD REE-RF001454CLD US Size 8,Reef REEF CUSHION BREEZE - CLOUD REE-RF001454CLD US Size 8,FBALYB Amazon,151,151,0,0,0,0
,Reef REEF CUSHION BREEZE - CLOUD REE-RF001454CLD US Size 9,Reef REEF CUSHION BREEZE - CLOUD REE-RF001454CLD US Size 9,Default Ridgefield,276,276,0,0,0,0
,Reef REEF CUSHION BREEZE - CLOUD REE-RF001454CLD US Size 9,Reef REEF CUSHION BREEZE - CLOUD REE-RF001454CLD US Size 9,FBALYB Amazon,289,288,1,0,1,0
,Reef REEF DECKHAND 3 - BLACK/WHITE RF0A3FE4BLW US Size 10,Reef REEF DECKHAND 3 - BLACK/WHITE RF0A3FE4BLW US Size 10,FBALYB Amazon,22,22,0,0,0,0
,Reef REEF DECKHAND 3 - BLACK/WHITE RF0A3FE4BLW US Size 11,Reef REEF DECKHAND 3 - BLACK/WHITE RF0A3FE4BLW US Size 11,FBALYB Amazon,28,28,0,0,0,0
,Reef REEF DECKHAND 3 - BLACK/WHITE RF0A3FE4BLW US Size 12,Reef REEF DECKHAND 3 - BLACK/WHITE RF0A3FE4BLW US Size 12,FBALYB Amazon,13,13,0,0,0,0
,Reef REEF DECKHAND 3 - BLACK/WHITE RF0A3FE4BLW US Size 13,Reef REEF DECKHAND 3 - BLACK/WHITE RF0A3FE4BLW US Size 13,FBALYB Amazon,1,1,0,0,0,0
,Reef REEF DECKHAND 3 - BLACK/WHITE RF0A3FE4BLW US Size 8,Reef REEF DECKHAND 3 - BLACK/WHITE RF0A3FE4BLW US Size 8,FBALYB Amazon,4,4,0,0,0,0
,Reef REEF DECKHAND 3 - BLACK/WHITE RF0A3FE4BLW US Size 9,Reef REEF DECKHAND 3 - BLACK/WHITE RF0A3FE4BLW US Size 9,FBALYB Amazon,18,18,0,0,0,0
,Reef REEF DECKHAND 3 - GREY/WHITE RF0A3FE4GRW US Size 10,Reef REEF DECKHAND 3 - GREY/WHITE RF0A3FE4GRW US Size 10,FBALYB Amazon,32,32,0,0,0,0
,Reef REEF DECKHAND 3 - GREY/WHITE RF0A3FE4GRW US Size 11,Reef REEF DECKHAND 3 - GREY/WHITE RF0A3FE4GRW US Size 11,FBALYB Amazon,39,39,0,0,0,0
,Reef REEF DECKHAND 3 - GREY/WHITE RF0A3FE4GRW US Size 12,Reef REEF DECKHAND 3 - GREY/WHITE RF0A3FE4GRW US Size 12,FBALYB Amazon,19,19,0,0,0,0
,Reef REEF DECKHAND 3 - GREY/WHITE RF0A3FE4GRW US Size 13,Reef REEF DECKHAND 3 - GREY/WHITE RF0A3FE4GRW US Size 13,FBALYB Amazon,5,5,0,0,0,0
,Reef REEF DECKHAND 3 - GREY/WHITE RF0A3FE4GRW US Size 8,Reef REEF DECKHAND 3 - GREY/WHITE RF0A3FE4GRW US Size 8,FBALYB Amazon,7,7,0,0,0,0
,Reef REEF DECKHAND 3 - GREY/WHITE RF0A3FE4GRW US Size 9,Reef REEF DECKHAND 3 - GREY/WHITE RF0A3FE4GRW US Size 9,FBALYB Amazon,24,24,0,0,0,0
,Reef REEF FLEX - BLACK/SILVER RF0A3YPDBLS US Size 10,Reef REEF FLEX - BLACK/SILVER RF0A3YPDBLS US Size 10,FBALYB Amazon,33,33,0,0,0,0
,Reef REEF FLEX - BLACK/SILVER RF0A3YPDBLS US Size 11,Reef REEF FLEX - BLACK/SILVER RF0A3YPDBLS US Size 11,FBALYB Amazon,37,37,0,0,0,0
,Reef REEF FLEX - BLACK/SILVER RF0A3YPDBLS US Size 12,Reef REEF FLEX - BLACK/SILVER RF0A3YPDBLS US Size 12,FBALYB Amazon,3,2,1,0,1,0
,Reef REEF FLEX - BLACK/SILVER RF0A3YPDBLS US Size 13,Reef REEF FLEX - BLACK/SILVER RF0A3YPDBLS US Size 13,FBALYB Amazon,7,7,0,0,0,0
,Reef REEF FLEX - BLACK/SILVER RF0A3YPDBLS US Size 8,Reef REEF FLEX - BLACK/SILVER RF0A3YPDBLS US Size 8,FBALYB Amazon,7,7,0,0,0,0
,Reef REEF FLEX - BLACK/SILVER RF0A3YPDBLS US Size 9,Reef REEF FLEX - BLACK/SILVER RF0A3YPDBLS US Size 9,FBALYB Amazon,24,24,0,0,0,0
,Reef REEF FLEX - DARK BROWN/TAN RF0A3YPDDBT US Size 10,Reef REEF FLEX - DARK BROWN/TAN RF0A3YPDDBT US Size 10,FBALYB Amazon,71,71,0,0,0,0
,Reef REEF FLEX - DARK BROWN/TAN RF0A3YPDDBT US Size 11,Reef REEF FLEX - DARK BROWN/TAN RF0A3YPDDBT US Size 11,FBALYB Amazon,61,61,0,0,0,0
,Reef REEF FLEX - DARK BROWN/TAN RF0A3YPDDBT US Size 12,Reef REEF FLEX - DARK BROWN/TAN RF0A3YPDDBT US Size 12,FBALYB Amazon,33,33,0,0,0,0
,Reef REEF FLEX - DARK BROWN/TAN RF0A3YPDDBT US Size 13,Reef REEF FLEX - DARK BROWN/TAN RF0A3YPDDBT US Size 13,FBALYB Amazon,18,18,0,0,0,0
,Reef REEF FLEX - DARK BROWN/TAN RF0A3YPDDBT US Size 8,Reef REEF FLEX - DARK BROWN/TAN RF0A3YPDDBT US Size 8,FBALYB Amazon,16,16,0,0,0,0
,Reef REEF FLEX - DARK BROWN/TAN RF0A3YPDDBT US Size 9,Reef REEF FLEX - DARK BROWN/TAN RF0A3YPDDBT US Size 9,FBALYB Amazon,44,44,0,0,0,0
,Reef REEF ONE - BLACK REE-RF0A3ONCBLA Size 10,Reef REEF ONE - BLACK REE-RF0A3ONCBLA Size 10,Default Ridgefield,1,1,0,0,0,0
,Reef REEF ONE - BLACK REE-RF0A3ONCBLA Size 10,Reef REEF ONE - BLACK REE-RF0A3ONCBLA Size 10,FBALYB Amazon,13,11,2,0,2,0
,Reef REEF ONE - BLACK REE-RF0A3ONCBLA Size 11,Reef REEF ONE - BLACK REE-RF0A3ONCBLA Size 11,Default Ridgefield,36,36,0,0,0,0
,Reef REEF ONE - BLACK REE-RF0A3ONCBLA Size 11,Reef REEF ONE - BLACK REE-RF0A3ONCBLA Size 11,FBALYB Amazon,-3,-3,0,0,0,0
,Reef REEF ONE - BLACK REE-RF0A3ONCBLA Size 12,Reef REEF ONE - BLACK REE-RF0A3ONCBLA Size 12,FBALYB Amazon,26,21,5,0,5,0
,Reef REEF ONE - BLACK REE-RF0A3ONCBLA Size 13,Reef REEF ONE - BLACK REE-RF0A3ONCBLA Size 13,Default Ridgefield,29,29,0,0,0,0
,Reef REEF ONE - BLACK REE-RF0A3ONCBLA Size 8,Reef REEF ONE - BLACK REE-RF0A3ONCBLA Size 8,Default Ridgefield,18,18,0,0,0,0
,Reef REEF ONE - BLACK REE-RF0A3ONCBLA Size 8,Reef REEF ONE - BLACK REE-RF0A3ONCBLA Size 8,FBALYB Amazon,-1,-1,0,0,0,0
,Reef REEF ONE - BLACK REE-RF0A3ONCBLA Size 9,Reef REEF ONE - BLACK REE-RF0A3ONCBLA Size 9,Default Ridgefield,18,18,0,0,0,0
,Reef REEF ONE - BLACK REE-RF0A3ONCBLA Size 9,Reef REEF ONE - BLACK REE-RF0A3ONCBLA Size 9,FBALYB Amazon,-1,-1,0,0,0,0
,Reef REEF ONE - BROWN REE-RF0A3ONCBRO Size 10,Reef REEF ONE - BROWN REE-RF0A3ONCBRO Size 10,FBALYB Amazon,22,21,1,0,1,0
,Reef REEF ONE - BROWN REE-RF0A3ONCBRO Size 11,Reef REEF ONE - BROWN REE-RF0A3ONCBRO Size 11,Default Ridgefield,36,36,0,0,0,0
,Reef REEF ONE - BROWN REE-RF0A3ONCBRO Size 11,Reef REEF ONE - BROWN REE-RF0A3ONCBRO Size 11,FBALYB Amazon,29,29,0,0,0,0
,Reef REEF ONE - BROWN REE-RF0A3ONCBRO Size 12,Reef REEF ONE - BROWN REE-RF0A3ONCBRO Size 12,Default Ridgefield,17,17,0,0,0,0
,Reef REEF ONE - BROWN REE-RF0A3ONCBRO Size 12,Reef REEF ONE - BROWN REE-RF0A3ONCBRO Size 12,FBALYB Amazon,16,16,0,0,0,0
,Reef REEF ONE - BROWN REE-RF0A3ONCBRO Size 13,Reef REEF ONE - BROWN REE-RF0A3ONCBRO Size 13,Default Ridgefield,29,28,1,0,0,0
,Reef REEF ONE - BROWN REE-RF0A3ONCBRO Size 8,Reef REEF ONE - BROWN REE-RF0A3ONCBRO Size 8,Default Ridgefield,26,26,0,0,0,0
,Reef REEF ONE - BROWN REE-RF0A3ONCBRO Size 9,Reef REEF ONE - BROWN REE-RF0A3ONCBRO Size 9,Default Ridgefield,30,30,0,0,0,0
,Reef REEF ONE - BROWN REE-RF0A3ONCBRO Size 9,Reef REEF ONE - BROWN REE-RF0A3ONCBRO Size 9,FBALYB Amazon,13,12,1,0,1,0
,Reef REEF ONE - GREY ORANGE REE-RF0A3ONCGOR US Size 10,Reef REEF ONE - GREY ORANGE REE-RF0A3ONCGOR US Size 10,Default Ridgefield,18,18,0,0,0,0
,Reef REEF ONE - GREY ORANGE REE-RF0A3ONCGOR US Size 10,Reef REEF ONE - GREY ORANGE REE-RF0A3ONCGOR US Size 10,FBALYB Amazon,-1,-1,0,0,0,0
,Reef REEF ONE - GREY ORANGE REE-RF0A3ONCGOR US Size 11,Reef REEF ONE - GREY ORANGE REE-RF0A3ONCGOR US Size 11,Default Ridgefield,30,30,0,0,0,0
,Reef REEF ONE - GREY ORANGE REE-RF0A3ONCGOR US Size 11,Reef REEF ONE - GREY ORANGE REE-RF0A3ONCGOR US Size 11,FBALYB Amazon,3,3,0,0,0,0
,Reef REEF ONE - GREY ORANGE REE-RF0A3ONCGOR US Size 12,Reef REEF ONE - GREY ORANGE REE-RF0A3ONCGOR US Size 12,Default Ridgefield,15,15,0,0,0,0
,Reef REEF ONE - GREY ORANGE REE-RF0A3ONCGOR US Size 12,Reef REEF ONE - GREY ORANGE REE-RF0A3ONCGOR US Size 12,FBALYB Amazon,0,-1,1,0,1,0
,Reef REEF ONE - GREY ORANGE REE-RF0A3ONCGOR US Size 13,Reef REEF ONE - GREY ORANGE REE-RF0A3ONCGOR US Size 13,Default Ridgefield,3,3,0,0,0,0
,Reef REEF ONE - GREY ORANGE REE-RF0A3ONCGOR US Size 13,Reef REEF ONE - GREY ORANGE REE-RF0A3ONCGOR US Size 13,FBALYB Amazon,5,3,2,0,2,0
,Reef REEF ONE - GREY ORANGE REE-RF0A3ONCGOR US Size 8,Reef REEF ONE - GREY ORANGE REE-RF0A3ONCGOR US Size 8,Default Ridgefield,18,18,0,0,0,0
,Reef REEF ONE - GREY ORANGE REE-RF0A3ONCGOR US Size 8,Reef REEF ONE - GREY ORANGE REE-RF0A3ONCGOR US Size 8,FBALYB Amazon,0,-1,1,0,1,0
,Reef REEF ONE - GREY ORANGE REE-RF0A3ONCGOR US Size 9,Reef REEF ONE - GREY ORANGE REE-RF0A3ONCGOR US Size 9,Default Ridgefield,20,20,0,0,0,0
,Reef REEF ONE - GREY ORANGE REE-RF0A3ONCGOR US Size 9,Reef REEF ONE - GREY ORANGE REE-RF0A3ONCGOR US Size 9,FBALYB Amazon,-1,-2,1,0,1,0
,Reef REEF ONE SLIDE - BLACK REE-RF0A3ONDBLA US Size 10,Reef REEF ONE SLIDE - BLACK REE-RF0A3ONDBLA US Size 10,FBALYB Amazon,-2,-7,5,0,5,0
,Reef REEF ONE SLIDE - BLACK REE-RF0A3ONDBLA US Size 11,Reef REEF ONE SLIDE - BLACK REE-RF0A3ONDBLA US Size 11,Default Ridgefield,54,54,0,0,0,0
,Reef REEF ONE SLIDE - BLACK REE-RF0A3ONDBLA US Size 11,Reef REEF ONE SLIDE - BLACK REE-RF0A3ONDBLA US Size 11,FBALYB Amazon,9,6,3,0,3,0
,Reef REEF ONE SLIDE - BLACK REE-RF0A3ONDBLA US Size 12,Reef REEF ONE SLIDE - BLACK REE-RF0A3ONDBLA US Size 12,FBALYB Amazon,-6,-8,2,0,2,0
,Reef REEF ONE SLIDE - BLACK REE-RF0A3ONDBLA US Size 13,Reef REEF ONE SLIDE - BLACK REE-RF0A3ONDBLA US Size 13,FBALYB Amazon,-4,-4,0,0,0,0
,Reef REEF ONE SLIDE - BLACK REE-RF0A3ONDBLA US Size 8,Reef REEF ONE SLIDE - BLACK REE-RF0A3ONDBLA US Size 8,FBALYB Amazon,-3,-3,0,0,0,0
,Reef REEF ONE SLIDE - BLACK REE-RF0A3ONDBLA US Size 9,Reef REEF ONE SLIDE - BLACK REE-RF0A3ONDBLA US Size 9,Default Ridgefield,27,27,0,0,0,0
,Reef REEF ONE SLIDE - BLACK REE-RF0A3ONDBLA US Size 9,Reef REEF ONE SLIDE - BLACK REE-RF0A3ONDBLA US Size 9,FBALYB Amazon,-3,-3,0,0,0,0
,Reef REEF ONE SLIDE - GREY/TAN REE-RF0A3ONDGTA US Size 10,Reef REEF ONE SLIDE - GREY/TAN REE-RF0A3ONDGTA US Size 10,Default Ridgefield,5,5,0,0,0,0
,Reef REEF ONE SLIDE - GREY/TAN REE-RF0A3ONDGTA US Size 11,Reef REEF ONE SLIDE - GREY/TAN REE-RF0A3ONDGTA US Size 11,FBALYB Amazon,-4,-4,0,0,0,0
,Reef REEF ONE SLIDE - GREY/TAN REE-RF0A3ONDGTA US Size 12,Reef REEF ONE SLIDE - GREY/TAN REE-RF0A3ONDGTA US Size 12,FBALYB Amazon,-4,-4,0,0,0,0
,Reef REEF ONE SLIDE - GREY/TAN REE-RF0A3ONDGTA US Size 13,Reef REEF ONE SLIDE - GREY/TAN REE-RF0A3ONDGTA US Size 13,FBALYB Amazon,0,-1,1,0,1,0
,Reef REEF ONE SLIDE - GREY/TAN REE-RF0A3ONDGTA US Size 8,Reef REEF ONE SLIDE - GREY/TAN REE-RF0A3ONDGTA US Size 8,Default Ridgefield,5,5,0,0,0,0
,Reef REEF ONE SLIDE - GREY/TAN REE-RF0A3ONDGTA US Size 8,Reef REEF ONE SLIDE - GREY/TAN REE-RF0A3ONDGTA US Size 8,FBALYB Amazon,1,1,0,0,0,0
,Reef REEF ONE SLIDE - GREY/TAN REE-RF0A3ONDGTA US Size 9,Reef REEF ONE SLIDE - GREY/TAN REE-RF0A3ONDGTA US Size 9,Default Ridgefield,1,1,0,0,0,0
,Reef REEF ONE SLIDE - GREY/TAN REE-RF0A3ONDGTA US Size 9,Reef REEF ONE SLIDE - GREY/TAN REE-RF0A3ONDGTA US Size 9,FBALYB Amazon,17,13,4,0,4,0
,Reef REEF ORTHO-SPRING - BLACK/BLACK GLITTER RF0A3VDXBBG US Size 10,Reef REEF ORTHO-SPRING - BLACK/BLACK GLITTER RF0A3VDXBBG US Size 10,Default Ridgefield,53,53,0,0,0,0
,Reef REEF ORTHO-SPRING - BLACK/BLACK GLITTER RF0A3VDXBBG US Size 10,Reef REEF ORTHO-SPRING - BLACK/BLACK GLITTER RF0A3VDXBBG US Size 10,FBALYB Amazon,18,18,0,0,0,0
,Reef REEF ORTHO-SPRING - BLACK/BLACK GLITTER RF0A3VDXBBG US Size 11,Reef REEF ORTHO-SPRING - BLACK/BLACK GLITTER RF0A3VDXBBG US Size 11,Default Ridgefield,21,21,0,0,0,0
,Reef REEF ORTHO-SPRING - BLACK/BLACK GLITTER RF0A3VDXBBG US Size 11,Reef REEF ORTHO-SPRING - BLACK/BLACK GLITTER RF0A3VDXBBG US Size 11,FBALYB Amazon,5,5,0,0,0,0
,Reef REEF ORTHO-SPRING - BLACK/BLACK GLITTER RF0A3VDXBBG US Size 6,Reef REEF ORTHO-SPRING - BLACK/BLACK GLITTER RF0A3VDXBBG US Size 6,Default Ridgefield,29,29,0,0,0,0
,Reef REEF ORTHO-SPRING - BLACK/BLACK GLITTER RF0A3VDXBBG US Size 6,Reef REEF ORTHO-SPRING - BLACK/BLACK GLITTER RF0A3VDXBBG US Size 6,FBALYB Amazon,13,13,0,0,0,0
,Reef REEF ORTHO-SPRING - BLACK/BLACK GLITTER RF0A3VDXBBG US Size 7,Reef REEF ORTHO-SPRING - BLACK/BLACK GLITTER RF0A3VDXBBG US Size 7,Default Ridgefield,77,77,0,0,0,0
,Reef REEF ORTHO-SPRING - BLACK/BLACK GLITTER RF0A3VDXBBG US Size 7,Reef REEF ORTHO-SPRING - BLACK/BLACK GLITTER RF0A3VDXBBG US Size 7,FBALYB Amazon,45,45,0,0,0,0
,Reef REEF ORTHO-SPRING - BLACK/BLACK GLITTER RF0A3VDXBBG US Size 8,Reef REEF ORTHO-SPRING - BLACK/BLACK GLITTER RF0A3VDXBBG US Size 8,Default Ridgefield,83,82,1,0,0,0
,Reef REEF ORTHO-SPRING - BLACK/BLACK GLITTER RF0A3VDXBBG US Size 8,Reef REEF ORTHO-SPRING - BLACK/BLACK GLITTER RF0A3VDXBBG US Size 8,FBALYB Amazon,36,36,0,0,0,0
,Reef REEF ORTHO-SPRING - BLACK/BLACK GLITTER RF0A3VDXBBG US Size 9,Reef REEF ORTHO-SPRING - BLACK/BLACK GLITTER RF0A3VDXBBG US Size 9,Default Ridgefield,102,102,0,0,0,0
,Reef REEF ORTHO-SPRING - BLACK/BLACK GLITTER RF0A3VDXBBG US Size 9,Reef REEF ORTHO-SPRING - BLACK/BLACK GLITTER RF0A3VDXBBG US Size 9,FBALYB Amazon,47,46,1,0,1,0
,Reef REEF ORTHO-SPRING - BROWN/WHITE RF0A3VDXBNW US Size 10,Reef REEF ORTHO-SPRING - BROWN/WHITE RF0A3VDXBNW US Size 10,Default Ridgefield,28,28,0,0,0,0
,Reef REEF ORTHO-SPRING - BROWN/WHITE RF0A3VDXBNW US Size 10,Reef REEF ORTHO-SPRING - BROWN/WHITE RF0A3VDXBNW US Size 10,FBALYB Amazon,9,9,0,0,0,0
,Reef REEF ORTHO-SPRING - BROWN/WHITE RF0A3VDXBNW US Size 11,Reef REEF ORTHO-SPRING - BROWN/WHITE RF0A3VDXBNW US Size 11,Default Ridgefield,8,8,0,0,0,0
,Reef REEF ORTHO-SPRING - BROWN/WHITE RF0A3VDXBNW US Size 11,Reef REEF ORTHO-SPRING - BROWN/WHITE RF0A3VDXBNW US Size 11,FBALYB Amazon,13,13,0,0,0,0
,Reef REEF ORTHO-SPRING - BROWN/WHITE RF0A3VDXBNW US Size 6,Reef REEF ORTHO-SPRING - BROWN/WHITE RF0A3VDXBNW US Size 6,Default Ridgefield,15,15,0,0,0,0
,Reef REEF ORTHO-SPRING - BROWN/WHITE RF0A3VDXBNW US Size 6,Reef REEF ORTHO-SPRING - BROWN/WHITE RF0A3VDXBNW US Size 6,FBALYB Amazon,14,13,1,0,1,0
,Reef REEF ORTHO-SPRING - BROWN/WHITE RF0A3VDXBNW US Size 7,Reef REEF ORTHO-SPRING - BROWN/WHITE RF0A3VDXBNW US Size 7,FBALYB Amazon,41,40,1,0,1,0
,Reef REEF ORTHO-SPRING - BROWN/WHITE RF0A3VDXBNW US Size 8,Reef REEF ORTHO-SPRING - BROWN/WHITE RF0A3VDXBNW US Size 8,FBALYB Amazon,45,45,0,0,0,0
,Reef REEF ORTHO-SPRING - BROWN/WHITE RF0A3VDXBNW US Size 9,Reef REEF ORTHO-SPRING - BROWN/WHITE RF0A3VDXBNW US Size 9,FBALYB Amazon,62,61,1,0,1,0
,Reef REEF ORTHO WOVEN - BLACK/WHITE RF0A3VDNBLW  US Size 10,Reef REEF ORTHO WOVEN - BLACK/WHITE RF0A3VDNBLW  US Size 10,FBALYB Amazon,-1,-1,0,17,0,0
,Reef REEF ORTHO WOVEN - BLACK/WHITE RF0A3VDNBLW  US Size 11,Reef REEF ORTHO WOVEN - BLACK/WHITE RF0A3VDNBLW  US Size 11,FBALYB Amazon,7,6,1,0,1,0
,Reef REEF ORTHO WOVEN - BLACK/WHITE RF0A3VDNBLW  US Size 6,Reef REEF ORTHO WOVEN - BLACK/WHITE RF0A3VDNBLW  US Size 6,FBALYB Amazon,13,13,0,0,0,0
,Reef REEF ORTHO WOVEN - BLACK/WHITE RF0A3VDNBLW  US Size 7,Reef REEF ORTHO WOVEN - BLACK/WHITE RF0A3VDNBLW  US Size 7,FBALYB Amazon,17,17,0,0,0,0
,Reef REEF ORTHO WOVEN - BLACK/WHITE RF0A3VDNBLW  US Size 8,Reef REEF ORTHO WOVEN - BLACK/WHITE RF0A3VDNBLW  US Size 8,FBALYB Amazon,4,1,3,0,3,0
,Reef REEF ORTHO WOVEN - BLACK/WHITE RF0A3VDNBLW  US Size 9,Reef REEF ORTHO WOVEN - BLACK/WHITE RF0A3VDNBLW  US Size 9,FBALYB Amazon,-4,-4,0,0,0,0
,Reef REEF STAR CUSHION - BLACK REE-RF001392BLA US Size 10,Reef REEF STAR CUSHION - BLACK REE-RF001392BLA US Size 10,Default,0,0,0,0,0,86
,Reef REEF STAR CUSHION - BLACK REE-RF001392BLA US Size 10,Reef REEF STAR CUSHION - BLACK REE-RF001392BLA US Size 10,FBALYB Amazon,-2,-2,0,0,0,0
,Reef REEF STAR CUSHION - BLACK REE-RF001392BLA US Size 11,Reef REEF STAR CUSHION - BLACK REE-RF001392BLA US Size 11,Default,0,0,0,0,0,23
,Reef REEF STAR CUSHION - BLACK REE-RF001392BLA US Size 11,Reef REEF STAR CUSHION - BLACK REE-RF001392BLA US Size 11,Default Ridgefield,18,18,0,0,0,0
,Reef REEF STAR CUSHION - BLACK REE-RF001392BLA US Size 6,Reef REEF STAR CUSHION - BLACK REE-RF001392BLA US Size 6,Default,0,0,0,0,0,46
,Reef REEF STAR CUSHION - BLACK REE-RF001392BLA US Size 6,Reef REEF STAR CUSHION - BLACK REE-RF001392BLA US Size 6,FBALYB Amazon,-4,-6,2,0,2,0
,Reef REEF STAR CUSHION - BLACK REE-RF001392BLA US Size 7,Reef REEF STAR CUSHION - BLACK REE-RF001392BLA US Size 7,Default,0,0,0,0,0,127
,Reef REEF STAR CUSHION - BLACK REE-RF001392BLA US Size 7,Reef REEF STAR CUSHION - BLACK REE-RF001392BLA US Size 7,FBALYB Amazon,-3,-4,1,0,1,0
,Reef REEF STAR CUSHION - BLACK REE-RF001392BLA US Size 8,Reef REEF STAR CUSHION - BLACK REE-RF001392BLA US Size 8,Default,0,0,0,0,0,136
,Reef REEF STAR CUSHION - BLACK REE-RF001392BLA US Size 8,Reef REEF STAR CUSHION - BLACK REE-RF001392BLA US Size 8,FBALYB Amazon,-13,-16,3,0,3,0
,Reef REEF STAR CUSHION - BLACK REE-RF001392BLA US Size 9,Reef REEF STAR CUSHION - BLACK REE-RF001392BLA US Size 9,Default,0,0,0,0,0,168
,Reef REEF STAR CUSHION - BLACK REE-RF001392BLA US Size 9,Reef REEF STAR CUSHION - BLACK REE-RF001392BLA US Size 9,Default Ridgefield,107,107,0,0,0,0
,Reef REEF STAR CUSHION SASSY - BLACK/SILVER RF001384BLS US Size 10,Reef REEF STAR CUSHION SASSY - BLACK/SILVER RF001384BLS US Size 10,Default,0,0,0,0,0,89
,Reef REEF STAR CUSHION SASSY - BLACK/SILVER RF001384BLS US Size 10,Reef REEF STAR CUSHION SASSY - BLACK/SILVER RF001384BLS US Size 10,Default Ridgefield,54,54,0,0,0,0
,Reef REEF STAR CUSHION SASSY - BLACK/SILVER RF001384BLS US Size 11,Reef REEF STAR CUSHION SASSY - BLACK/SILVER RF001384BLS US Size 11,Default,0,0,0,0,0,24
,Reef REEF STAR CUSHION SASSY - BLACK/SILVER RF001384BLS US Size 11,Reef REEF STAR CUSHION SASSY - BLACK/SILVER RF001384BLS US Size 11,Default Ridgefield,18,18,0,0,0,0
,Reef REEF STAR CUSHION SASSY - BLACK/SILVER RF001384BLS US Size 6,Reef REEF STAR CUSHION SASSY - BLACK/SILVER RF001384BLS US Size 6,Default,0,0,0,0,0,47
,Reef REEF STAR CUSHION SASSY - BLACK/SILVER RF001384BLS US Size 6,Reef REEF STAR CUSHION SASSY - BLACK/SILVER RF001384BLS US Size 6,FBALYB Amazon,8,8,0,0,0,0
,Reef REEF STAR CUSHION SASSY - BLACK/SILVER RF001384BLS US Size 7,Reef REEF STAR CUSHION SASSY - BLACK/SILVER RF001384BLS US Size 7,Default,0,0,0,0,0,131
,Reef REEF STAR CUSHION SASSY - BLACK/SILVER RF001384BLS US Size 7,Reef REEF STAR CUSHION SASSY - BLACK/SILVER RF001384BLS US Size 7,FBALYB Amazon,8,8,0,0,0,0
,Reef REEF STAR CUSHION SASSY - BLACK/SILVER RF001384BLS US Size 8,Reef REEF STAR CUSHION SASSY - BLACK/SILVER RF001384BLS US Size 8,Default,0,0,0,0,0,140
,Reef REEF STAR CUSHION SASSY - BLACK/SILVER RF001384BLS US Size 8,Reef REEF STAR CUSHION SASSY - BLACK/SILVER RF001384BLS US Size 8,FBALYB Amazon,-5,-5,0,0,0,0
,Reef REEF STAR CUSHION SASSY - BLACK/SILVER RF001384BLS US Size 9,Reef REEF STAR CUSHION SASSY - BLACK/SILVER RF001384BLS US Size 9,Default,0,0,0,0,0,173
,Reef REEF STAR CUSHION SASSY - BLACK/SILVER RF001384BLS US Size 9,Reef REEF STAR CUSHION SASSY - BLACK/SILVER RF001384BLS US Size 9,Default Ridgefield,108,108,0,0,0,0
,Reef REEF STAR CUSHION SASSY - BROWN/WHITE RF001384BNW US Size 10,Reef REEF STAR CUSHION SASSY - BROWN/WHITE RF001384BNW US Size 10,Default,0,0,0,0,0,122
,Reef REEF STAR CUSHION SASSY - BROWN/WHITE RF001384BNW US Size 10,Reef REEF STAR CUSHION SASSY - BROWN/WHITE RF001384BNW US Size 10,Default Ridgefield,72,72,0,0,0,0
,Reef REEF STAR CUSHION SASSY - BROWN/WHITE RF001384BNW US Size 11,Reef REEF STAR CUSHION SASSY - BROWN/WHITE RF001384BNW US Size 11,Default,0,0,0,0,0,32
,Reef REEF STAR CUSHION SASSY - BROWN/WHITE RF001384BNW US Size 11,Reef REEF STAR CUSHION SASSY - BROWN/WHITE RF001384BNW US Size 11,FBALYB Amazon,3,3,0,0,0,0
,Reef REEF STAR CUSHION SASSY - BROWN/WHITE RF001384BNW US Size 6,Reef REEF STAR CUSHION SASSY - BROWN/WHITE RF001384BNW US Size 6,Default,0,0,0,0,0,64
,Reef REEF STAR CUSHION SASSY - BROWN/WHITE RF001384BNW US Size 6,Reef REEF STAR CUSHION SASSY - BROWN/WHITE RF001384BNW US Size 6,FBALYB Amazon,17,17,0,0,0,0
,Reef REEF STAR CUSHION SASSY - BROWN/WHITE RF001384BNW US Size 7,Reef REEF STAR CUSHION SASSY - BROWN/WHITE RF001384BNW US Size 7,Default,0,0,0,0,0,179
,Reef REEF STAR CUSHION SASSY - BROWN/WHITE RF001384BNW US Size 7,Reef REEF STAR CUSHION SASSY - BROWN/WHITE RF001384BNW US Size 7,FBALYB Amazon,47,47,0,0,0,0
,Reef REEF STAR CUSHION SASSY - BROWN/WHITE RF001384BNW US Size 8,Reef REEF STAR CUSHION SASSY - BROWN/WHITE RF001384BNW US Size 8,Default,0,0,0,0,0,192
,Reef REEF STAR CUSHION SASSY - BROWN/WHITE RF001384BNW US Size 8,Reef REEF STAR CUSHION SASSY - BROWN/WHITE RF001384BNW US Size 8,FBALYB Amazon,47,44,3,0,3,0
,Reef REEF STAR CUSHION SASSY - BROWN/WHITE RF001384BNW US Size 9,Reef REEF STAR CUSHION SASSY - BROWN/WHITE RF001384BNW US Size 9,Default,0,0,0,0,0,236
,Reef REEF STAR CUSHION SASSY - BROWN/WHITE RF001384BNW US Size 9,Reef REEF STAR CUSHION SASSY - BROWN/WHITE RF001384BNW US Size 9,FBALYB Amazon,76,76,0,0,0,0
,Reef REEF TWINPIN - BROWN REE-RF002915BRO Size 10,Reef REEF TWINPIN - BROWN REE-RF002915BRO Size 10,Default Ridgefield,802,802,0,0,0,0
,Reef REEF TWINPIN - BROWN REE-RF002915BRO Size 10,Reef REEF TWINPIN - BROWN REE-RF002915BRO Size 10,FBALYB Amazon,398,395,3,0,3,0
,Reef REEF TWINPIN - BROWN REE-RF002915BRO Size 11,Reef REEF TWINPIN - BROWN REE-RF002915BRO Size 11,Default Ridgefield,873,873,0,0,0,0
,Reef REEF TWINPIN - BROWN REE-RF002915BRO Size 11,Reef REEF TWINPIN - BROWN REE-RF002915BRO Size 11,FBALYB Amazon,391,390,1,0,1,0
,Reef REEF TWINPIN - BROWN REE-RF002915BRO Size 12,Reef REEF TWINPIN - BROWN REE-RF002915BRO Size 12,Default Ridgefield,791,791,0,0,0,0
,Reef REEF TWINPIN - BROWN REE-RF002915BRO Size 12,Reef REEF TWINPIN - BROWN REE-RF002915BRO Size 12,FBALYB Amazon,88,88,0,0,0,0
,Reef REEF TWINPIN - BROWN REE-RF002915BRO Size 13,Reef REEF TWINPIN - BROWN REE-RF002915BRO Size 13,Default Ridgefield,324,324,0,0,0,0
,Reef REEF TWINPIN - BROWN REE-RF002915BRO Size 8,Reef REEF TWINPIN - BROWN REE-RF002915BRO Size 8,Default Ridgefield,60,60,0,0,0,0
,Reef REEF TWINPIN - BROWN REE-RF002915BRO Size 8,Reef REEF TWINPIN - BROWN REE-RF002915BRO Size 8,FBALYB Amazon,151,151,0,0,0,0
,Reef REEF TWINPIN - BROWN REE-RF002915BRO Size 9,Reef REEF TWINPIN - BROWN REE-RF002915BRO Size 9,Default Ridgefield,617,617,0,0,0,0
,Reef REEF TWINPIN - BROWN REE-RF002915BRO Size 9,Reef REEF TWINPIN - BROWN REE-RF002915BRO Size 9,FBALYB Amazon,226,224,2,0,2,0
,Reef REEF TWINPIN - GREY REE-RF002915GRE US Size 10,Reef REEF TWINPIN - GREY REE-RF002915GRE US Size 10,Default Ridgefield,83,83,0,0,0,0
,Reef REEF TWINPIN - GREY REE-RF002915GRE US Size 10,Reef REEF TWINPIN - GREY REE-RF002915GRE US Size 10,FBALYB Amazon,107,103,4,0,4,0
,Reef REEF TWINPIN - GREY REE-RF002915GRE US Size 11,Reef REEF TWINPIN - GREY REE-RF002915GRE US Size 11,Default Ridgefield,65,65,0,0,0,0
,Reef REEF TWINPIN - GREY REE-RF002915GRE US Size 11,Reef REEF TWINPIN - GREY REE-RF002915GRE US Size 11,FBALYB Amazon,99,96,3,0,3,0
,Reef REEF TWINPIN - GREY REE-RF002915GRE US Size 12,Reef REEF TWINPIN - GREY REE-RF002915GRE US Size 12,Default Ridgefield,45,45,0,0,0,0
,Reef REEF TWINPIN - GREY REE-RF002915GRE US Size 12,Reef REEF TWINPIN - GREY REE-RF002915GRE US Size 12,FBALYB Amazon,60,60,0,0,0,0
,Reef REEF TWINPIN - GREY REE-RF002915GRE US Size 13,Reef REEF TWINPIN - GREY REE-RF002915GRE US Size 13,Default Ridgefield,75,75,0,0,0,0
,Reef REEF TWINPIN - GREY REE-RF002915GRE US Size 8,Reef REEF TWINPIN - GREY REE-RF002915GRE US Size 8,Default Ridgefield,35,35,0,0,0,0
,Reef REEF TWINPIN - GREY REE-RF002915GRE US Size 9,Reef REEF TWINPIN - GREY REE-RF002915GRE US Size 9,Default Ridgefield,175,175,0,0,0,0
,Reef REEF VOYAGE LE - BROWN/BRONZE RF0A2YFRBWZ US Size 10,Reef REEF VOYAGE LE - BROWN/BRONZE RF0A2YFRBWZ US Size 10,FBALYB Amazon,69,69,0,0,0,0
,Reef REEF VOYAGE LE - BROWN/BRONZE RF0A2YFRBWZ US Size 11,Reef REEF VOYAGE LE - BROWN/BRONZE RF0A2YFRBWZ US Size 11,Default Ridgefield,79,79,0,0,0,0
,Reef REEF VOYAGE LE - BROWN/BRONZE RF0A2YFRBWZ US Size 12,Reef REEF VOYAGE LE - BROWN/BRONZE RF0A2YFRBWZ US Size 12,FBALYB Amazon,51,51,0,0,0,0
,Reef REEF VOYAGE LE - BROWN/BRONZE RF0A2YFRBWZ US Size 13,Reef REEF VOYAGE LE - BROWN/BRONZE RF0A2YFRBWZ US Size 13,FBALYB Amazon,15,15,0,1,0,0
,Reef REEF VOYAGE LE - BROWN/BRONZE RF0A2YFRBWZ US Size 8,Reef REEF VOYAGE LE - BROWN/BRONZE RF0A2YFRBWZ US Size 8,FBALYB Amazon,11,11,0,1,0,0
,Reef REEF VOYAGE LE - BROWN/BRONZE RF0A2YFRBWZ US Size 9,Reef REEF VOYAGE LE - BROWN/BRONZE RF0A2YFRBWZ US Size 9,Default Ridgefield,54,54,0,0,0,0
,Reef REEF VOYAGE LE - DARK BROWN RF0A2YFRDAB US Size 10,Reef REEF VOYAGE LE - DARK BROWN RF0A2YFRDAB US Size 10,Default Ridgefield,299,299,0,0,0,0
,Reef REEF VOYAGE LE - DARK BROWN RF0A2YFRDAB US Size 10,Reef REEF VOYAGE LE - DARK BROWN RF0A2YFRDAB US Size 10,FBALYB Amazon,128,128,0,0,0,0
,Reef REEF VOYAGE LE - DARK BROWN RF0A2YFRDAB US Size 11,Reef REEF VOYAGE LE - DARK BROWN RF0A2YFRDAB US Size 11,Default Ridgefield,118,118,0,0,0,0
,Reef REEF VOYAGE LE - DARK BROWN RF0A2YFRDAB US Size 11,Reef REEF VOYAGE LE - DARK BROWN RF0A2YFRDAB US Size 11,FBALYB Amazon,357,357,0,0,0,0
,Reef REEF VOYAGE LE - DARK BROWN RF0A2YFRDAB US Size 12,Reef REEF VOYAGE LE - DARK BROWN RF0A2YFRDAB US Size 12,Default Ridgefield,217,217,0,0,0,0
,Reef REEF VOYAGE LE - DARK BROWN RF0A2YFRDAB US Size 12,Reef REEF VOYAGE LE - DARK BROWN RF0A2YFRDAB US Size 12,FBALYB Amazon,41,41,0,0,0,0
,Reef REEF VOYAGE LE - DARK BROWN RF0A2YFRDAB US Size 13,Reef REEF VOYAGE LE - DARK BROWN RF0A2YFRDAB US Size 13,Default Ridgefield,82,82,0,0,0,0
,Reef REEF VOYAGE LE - DARK BROWN RF0A2YFRDAB US Size 13,Reef REEF VOYAGE LE - DARK BROWN RF0A2YFRDAB US Size 13,FBALYB Amazon,34,33,1,0,1,0
,Reef REEF VOYAGE LE - DARK BROWN RF0A2YFRDAB US Size 8,Reef REEF VOYAGE LE - DARK BROWN RF0A2YFRDAB US Size 8,Default Ridgefield,54,54,0,0,0,0
,Reef REEF VOYAGE LE - DARK BROWN RF0A2YFRDAB US Size 8,Reef REEF VOYAGE LE - DARK BROWN RF0A2YFRDAB US Size 8,FBALYB Amazon,28,28,0,0,0,0
,Reef REEF VOYAGE LE - DARK BROWN RF0A2YFRDAB US Size 9,Reef REEF VOYAGE LE - DARK BROWN RF0A2YFRDAB US Size 9,Default Ridgefield,217,217,0,0,0,0
,Reef REEF VOYAGE LE - DARK BROWN RF0A2YFRDAB US Size 9,Reef REEF VOYAGE LE - DARK BROWN RF0A2YFRDAB US Size 9,FBALYB Amazon,92,92,0,0,0,0
,Reef REEF ZEN LOVE - BLACK/BLACK RF001464BK2 US Size 10,Reef REEF ZEN LOVE - BLACK/BLACK RF001464BK2 US Size 10,Default Ridgefield,83,83,0,0,0,0
,Reef REEF ZEN LOVE - BLACK/BLACK RF001464BK2 US Size 10,Reef REEF ZEN LOVE - BLACK/BLACK RF001464BK2 US Size 10,FBALYB Amazon,45,45,0,0,0,0
,Reef REEF ZEN LOVE - BLACK/BLACK RF001464BK2 US Size 11,Reef REEF ZEN LOVE - BLACK/BLACK RF001464BK2 US Size 11,Default Ridgefield,22,22,0,0,0,0
,Reef REEF ZEN LOVE - BLACK/BLACK RF001464BK2 US Size 11,Reef REEF ZEN LOVE - BLACK/BLACK RF001464BK2 US Size 11,FBALYB Amazon,10,10,0,0,0,0
,Reef REEF ZEN LOVE - BLACK/BLACK RF001464BK2 US Size 6,Reef REEF ZEN LOVE - BLACK/BLACK RF001464BK2 US Size 6,Default Ridgefield,44,44,0,0,0,0
,Reef REEF ZEN LOVE - BLACK/BLACK RF001464BK2 US Size 6,Reef REEF ZEN LOVE - BLACK/BLACK RF001464BK2 US Size 6,FBALYB Amazon,28,28,0,0,0,0
,Reef REEF ZEN LOVE - BLACK/BLACK RF001464BK2 US Size 7,Reef REEF ZEN LOVE - BLACK/BLACK RF001464BK2 US Size 7,Default Ridgefield,124,124,0,0,0,0
,Reef REEF ZEN LOVE - BLACK/BLACK RF001464BK2 US Size 7,Reef REEF ZEN LOVE - BLACK/BLACK RF001464BK2 US Size 7,FBALYB Amazon,25,25,0,0,0,0
,Reef REEF ZEN LOVE - BLACK/BLACK RF001464BK2 US Size 8,Reef REEF ZEN LOVE - BLACK/BLACK RF001464BK2 US Size 8,Default Ridgefield,90,90,0,0,0,0
,Reef REEF ZEN LOVE - BLACK/BLACK RF001464BK2 US Size 8,Reef REEF ZEN LOVE - BLACK/BLACK RF001464BK2 US Size 8,FBALYB Amazon,20,19,1,0,1,0
,Reef REEF ZEN LOVE - BLACK/BLACK RF001464BK2 US Size 9,Reef REEF ZEN LOVE - BLACK/BLACK RF001464BK2 US Size 9,Default Ridgefield,161,161,0,0,0,0
,Reef REEF ZEN LOVE - BLACK/BLACK RF001464BK2 US Size 9,Reef REEF ZEN LOVE - BLACK/BLACK RF001464BK2 US Size 9,FBALYB Amazon,49,49,0,0,0,0
,Reef REEF ZEN LOVE - BROWN/TOBACCO RF001464WTO US Size 10,Reef REEF ZEN LOVE - BROWN/TOBACCO RF001464WTO US Size 10,Default Ridgefield,185,185,0,0,0,0
,Reef REEF ZEN LOVE - BROWN/TOBACCO RF001464WTO US Size 10,Reef REEF ZEN LOVE - BROWN/TOBACCO RF001464WTO US Size 10,FBALYB Amazon,98,98,0,0,0,0
,Reef REEF ZEN LOVE - BROWN/TOBACCO RF001464WTO US Size 11,Reef REEF ZEN LOVE - BROWN/TOBACCO RF001464WTO US Size 11,Default Ridgefield,49,49,0,0,0,0
,Reef REEF ZEN LOVE - BROWN/TOBACCO RF001464WTO US Size 11,Reef REEF ZEN LOVE - BROWN/TOBACCO RF001464WTO US Size 11,FBALYB Amazon,31,31,0,0,0,0
,Reef REEF ZEN LOVE - BROWN/TOBACCO RF001464WTO US Size 6,Reef REEF ZEN LOVE - BROWN/TOBACCO RF001464WTO US Size 6,Default Ridgefield,97,97,0,0,0,0
,Reef REEF ZEN LOVE - BROWN/TOBACCO RF001464WTO US Size 6,Reef REEF ZEN LOVE - BROWN/TOBACCO RF001464WTO US Size 6,FBALYB Amazon,46,46,0,0,0,0
,Reef REEF ZEN LOVE - BROWN/TOBACCO RF001464WTO US Size 7,Reef REEF ZEN LOVE - BROWN/TOBACCO RF001464WTO US Size 7,Default Ridgefield,272,272,0,0,0,0
,Reef REEF ZEN LOVE - BROWN/TOBACCO RF001464WTO US Size 7,Reef REEF ZEN LOVE - BROWN/TOBACCO RF001464WTO US Size 7,FBALYB Amazon,151,151,0,0,0,0
,Reef REEF ZEN LOVE - BROWN/TOBACCO RF001464WTO US Size 8,Reef REEF ZEN LOVE - BROWN/TOBACCO RF001464WTO US Size 8,Default Ridgefield,292,292,0,0,0,0
,Reef REEF ZEN LOVE - BROWN/TOBACCO RF001464WTO US Size 8,Reef REEF ZEN LOVE - BROWN/TOBACCO RF001464WTO US Size 8,FBALYB Amazon,164,164,0,0,0,0
,Reef REEF ZEN LOVE - BROWN/TOBACCO RF001464WTO US Size 9,Reef REEF ZEN LOVE - BROWN/TOBACCO RF001464WTO US Size 9,Default Ridgefield,360,360,0,0,0,0
,Reef REEF ZEN LOVE - BROWN/TOBACCO RF001464WTO US Size 9,Reef REEF ZEN LOVE - BROWN/TOBACCO RF001464WTO US Size 9,FBALYB Amazon,200,200,0,0,0,0
,Reef REEF ZEN LOVE - WHITE RF001464WHI US Size 10,Reef REEF ZEN LOVE - WHITE RF001464WHI US Size 10,Default Ridgefield,91,91,0,0,0,0
,Reef REEF ZEN LOVE - WHITE RF001464WHI US Size 10,Reef REEF ZEN LOVE - WHITE RF001464WHI US Size 10,FBALYB Amazon,46,46,0,0,0,0
,Reef REEF ZEN LOVE - WHITE RF001464WHI US Size 11,Reef REEF ZEN LOVE - WHITE RF001464WHI US Size 11,Default Ridgefield,24,24,0,0,0,0
,Reef REEF ZEN LOVE - WHITE RF001464WHI US Size 11,Reef REEF ZEN LOVE - WHITE RF001464WHI US Size 11,FBALYB Amazon,12,12,0,0,0,0
,Reef REEF ZEN LOVE - WHITE RF001464WHI US Size 6,Reef REEF ZEN LOVE - WHITE RF001464WHI US Size 6,Default Ridgefield,48,48,0,0,0,0
,Reef REEF ZEN LOVE - WHITE RF001464WHI US Size 6,Reef REEF ZEN LOVE - WHITE RF001464WHI US Size 6,FBALYB Amazon,31,31,0,0,0,0
,Reef REEF ZEN LOVE - WHITE RF001464WHI US Size 7,Reef REEF ZEN LOVE - WHITE RF001464WHI US Size 7,Default Ridgefield,134,134,0,0,0,0
,Reef REEF ZEN LOVE - WHITE RF001464WHI US Size 7,Reef REEF ZEN LOVE - WHITE RF001464WHI US Size 7,FBALYB Amazon,78,78,0,0,0,0
,Reef REEF ZEN LOVE - WHITE RF001464WHI US Size 8,Reef REEF ZEN LOVE - WHITE RF001464WHI US Size 8,Default Ridgefield,144,144,0,0,0,0
,Reef REEF ZEN LOVE - WHITE RF001464WHI US Size 8,Reef REEF ZEN LOVE - WHITE RF001464WHI US Size 8,FBALYB Amazon,73,73,0,0,0,0
,Reef REEF ZEN LOVE - WHITE RF001464WHI US Size 9,Reef REEF ZEN LOVE - WHITE RF001464WHI US Size 9,Default Ridgefield,177,177,0,0,0,0
,Reef REEF ZEN LOVE - WHITE RF001464WHI US Size 9,Reef REEF ZEN LOVE - WHITE RF001464WHI US Size 9,FBALYB Amazon,104,104,0,0,0,0
,Reef SMOOTHY - BLACK REE-RF000313BLA BLACK US Size 10,Reef SMOOTHY - BLACK REE-RF000313BLA BLACK US Size 10,Default Ridgefield,385,385,0,0,0,0
,Reef SMOOTHY - BLACK REE-RF000313BLA BLACK US Size 10,Reef SMOOTHY - BLACK REE-RF000313BLA BLACK US Size 10,FBALYB Amazon,165,165,0,8,0,0
,Reef SMOOTHY - BLACK REE-RF000313BLA BLACK US Size 11,Reef SMOOTHY - BLACK REE-RF000313BLA BLACK US Size 11,Default Ridgefield,408,408,0,0,0,0
,Reef SMOOTHY - BLACK REE-RF000313BLA BLACK US Size 11,Reef SMOOTHY - BLACK REE-RF000313BLA BLACK US Size 11,FBALYB Amazon,162,162,0,0,0,0
,Reef SMOOTHY - BLACK REE-RF000313BLA BLACK US Size 12,Reef SMOOTHY - BLACK REE-RF000313BLA BLACK US Size 12,Default Ridgefield,280,280,0,0,0,0
,Reef SMOOTHY - BLACK REE-RF000313BLA BLACK US Size 12,Reef SMOOTHY - BLACK REE-RF000313BLA BLACK US Size 12,FBALYB Amazon,143,143,0,1,0,0
,Reef SMOOTHY - BLACK REE-RF000313BLA BLACK US Size 13,Reef SMOOTHY - BLACK REE-RF000313BLA BLACK US Size 13,FBALYB Amazon,93,93,0,0,0,0
,Reef SMOOTHY - BLACK REE-RF000313BLA BLACK US Size 8,Reef SMOOTHY - BLACK REE-RF000313BLA BLACK US Size 8,Default Ridgefield,70,70,0,0,0,0
,Reef SMOOTHY - BLACK REE-RF000313BLA BLACK US Size 8,Reef SMOOTHY - BLACK REE-RF000313BLA BLACK US Size 8,FBALYB Amazon,20,20,0,0,0,0
,Reef SMOOTHY - BLACK REE-RF000313BLA BLACK US Size 9,Reef SMOOTHY - BLACK REE-RF000313BLA BLACK US Size 9,Default Ridgefield,280,280,0,0,0,0
,Reef SMOOTHY - BLACK REE-RF000313BLA BLACK US Size 9,Reef SMOOTHY - BLACK REE-RF000313BLA BLACK US Size 9,FBALYB Amazon,25,25,0,90,0,0
,Reef STARGAZER - BLACK/BLACK RF001949BK2 US Size 10,Reef STARGAZER - BLACK/BLACK RF001949BK2 US Size 10,Default Ridgefield,181,181,0,0,0,0
,Reef STARGAZER - BLACK/BLACK RF001949BK2 US Size 10,Reef STARGAZER - BLACK/BLACK RF001949BK2 US Size 10,FBALYB Amazon,94,93,1,0,1,0
,Reef STARGAZER - BLACK/BLACK RF001949BK2 US Size 11,Reef STARGAZER - BLACK/BLACK RF001949BK2 US Size 11,Default Ridgefield,49,49,0,0,0,0
,Reef STARGAZER - BLACK/BLACK RF001949BK2 US Size 11,Reef STARGAZER - BLACK/BLACK RF001949BK2 US Size 11,FBALYB Amazon,23,23,0,0,0,0
,Reef STARGAZER - BLACK/BLACK RF001949BK2 US Size 6,Reef STARGAZER - BLACK/BLACK RF001949BK2 US Size 6,Default Ridgefield,150,150,0,0,0,0
,Reef STARGAZER - BLACK/BLACK RF001949BK2 US Size 7,Reef STARGAZER - BLACK/BLACK RF001949BK2 US Size 7,Default Ridgefield,267,267,0,0,0,0
,Reef STARGAZER - BLACK/BLACK RF001949BK2 US Size 7,Reef STARGAZER - BLACK/BLACK RF001949BK2 US Size 7,FBALYB Amazon,134,134,0,0,0,0
,Reef STARGAZER - BLACK/BLACK RF001949BK2 US Size 8,Reef STARGAZER - BLACK/BLACK RF001949BK2 US Size 8,Default Ridgefield,466,466,0,0,0,0
,Reef STARGAZER - BLACK/BLACK RF001949BK2 US Size 9,Reef STARGAZER - BLACK/BLACK RF001949BK2 US Size 9,Default Ridgefield,353,353,0,0,0,0
,Reef STARGAZER - BLACK/BLACK RF001949BK2 US Size 9,Reef STARGAZER - BLACK/BLACK RF001949BK2 US Size 9,FBALYB Amazon,197,197,0,0,0,0
,Reef STARGAZER - GEMSTONE RF001949GEM US Size 10,Reef STARGAZER - GEMSTONE RF001949GEM US Size 10,Default Ridgefield,102,102,0,0,0,0
,Reef STARGAZER - GEMSTONE RF001949GEM US Size 11,Reef STARGAZER - GEMSTONE RF001949GEM US Size 11,Default Ridgefield,5,5,0,0,0,0
,Reef STARGAZER - GEMSTONE RF001949GEM US Size 11,Reef STARGAZER - GEMSTONE RF001949GEM US Size 11,FBALYB Amazon,11,11,0,8,0,0
,Reef STARGAZER - GEMSTONE RF001949GEM US Size 6,Reef STARGAZER - GEMSTONE RF001949GEM US Size 6,Default Ridgefield,52,52,0,0,0,0
,Reef STARGAZER - GEMSTONE RF001949GEM US Size 7,Reef STARGAZER - GEMSTONE RF001949GEM US Size 7,Default Ridgefield,88,88,0,0,0,0
,Reef STARGAZER - GEMSTONE RF001949GEM US Size 7,Reef STARGAZER - GEMSTONE RF001949GEM US Size 7,FBALYB Amazon,27,26,1,0,1,0
,Reef STARGAZER - GEMSTONE RF001949GEM US Size 8,Reef STARGAZER - GEMSTONE RF001949GEM US Size 8,Default Ridgefield,156,156,0,0,0,0
,Reef STARGAZER - GEMSTONE RF001949GEM US Size 9,Reef STARGAZER - GEMSTONE RF001949GEM US Size 9,Default Ridgefield,116,116,0,0,0,0
,Reef STARGAZER - GEMSTONE RF001949GEM US Size 9,Reef STARGAZER - GEMSTONE RF001949GEM US Size 9,FBALYB Amazon,73,73,0,0,0,0
,Reef STARGAZER - MERMAID RF001949MRD US Size 10,Reef STARGAZER - MERMAID RF001949MRD US Size 10,Default Ridgefield,37,37,0,0,0,0
,Reef STARGAZER - MERMAID RF001949MRD US Size 11,Reef STARGAZER - MERMAID RF001949MRD US Size 11,Default Ridgefield,18,18,0,0,0,0
,Reef STARGAZER - MERMAID RF001949MRD US Size 11,Reef STARGAZER - MERMAID RF001949MRD US Size 11,FBALYB Amazon,4,4,0,0,0,0
,Reef STARGAZER - MERMAID RF001949MRD US Size 6,Reef STARGAZER - MERMAID RF001949MRD US Size 6,Default Ridgefield,27,27,0,0,0,0
,Reef STARGAZER - MERMAID RF001949MRD US Size 7,Reef STARGAZER - MERMAID RF001949MRD US Size 7,Default Ridgefield,17,17,0,0,0,0
,Reef STARGAZER - MERMAID RF001949MRD US Size 7,Reef STARGAZER - MERMAID RF001949MRD US Size 7,FBALYB Amazon,5,5,0,0,0,0
,Reef STARGAZER - MERMAID RF001949MRD US Size 8,Reef STARGAZER - MERMAID RF001949MRD US Size 8,Default Ridgefield,48,48,0,0,0,0
,Reef STARGAZER - MERMAID RF001949MRD US Size 9,Reef STARGAZER - MERMAID RF001949MRD US Size 9,Default Ridgefield,18,18,0,0,0,0
,Reef STARGAZER - MERMAID RF001949MRD US Size 9,Reef STARGAZER - MERMAID RF001949MRD US Size 9,FBALYB Amazon,17,17,0,0,0,0
,Reflections Cutlery 160 pieces 2pk,Reflections Cutlery 160 pieces 2pk,FBALYB Amazon,1,1,0,0,0,0
,Refresh Eye Drops ‑ 100 ct,Refresh Plus Lubricant Single‑Use Eye Drops ‑ 100 ct,Default,0,0,0,0,0,3
,Refresh Eye Drops ‑ 100 ct,Refresh Plus Lubricant Single‑Use Eye Drops ‑ 100 ct,FBALYB Amazon,1,1,0,2,0,0
,Refresh Tears Lubricant Eye Drops Multi Pack,Refresh Tears Lubricant Eye Drops Multi Pack,Default Ridgefield,-1,-1,0,0,0,0
,Refresh Tears Lubricant Eye Drops Multi Pack,Refresh Tears Lubricant Eye Drops Multi Pack,FBALYB Amazon,94,94,0,9,0,0
,Ren - BODY WASH 300ml,Ren - BODY WASH 300ml,Avrami - Ebay,60,60,0,0,0,0
,Ren - BODY WASH 300ml,Ren - BODY WASH 300ml,WFS,-5,-5,0,0,0,0
,"Ren Evercalm, Gentle Cleansing Milk, 5.1 fl oz (150 ml)","Ren Evercalm, Gentle Cleansing Milk, 5.1 fl oz (150 ml)",Avrami - Ebay,100,100,0,0,0,0
,"Ren Evercalm, Gentle Cleansing Milk, 5.1 fl oz (150 ml)","Ren Evercalm, Gentle Cleansing Milk, 5.1 fl oz (150 ml)",WFS,-47,-47,0,0,0,0
,"Ren Evercalm, Global Protection Day Cream, 1.7 fl oz  (50 ml)","Ren Evercalm, Global Protection Day Cream, 1.7 fl oz  (50 ml)",Avrami - Ebay,100,100,0,0,0,0
,"Ren Evercalm, Global Protection Day Cream, 1.7 fl oz  (50 ml)","Ren Evercalm, Global Protection Day Cream, 1.7 fl oz  (50 ml)",WFS,-29,-29,0,0,0,0
,Ren - GENTLE CLEANSING GEL 150ml,Ren - GENTLE CLEANSING GEL 150ml,Avrami - Ebay,90,90,0,0,0,0
,Ren - GLYCOLACTIC RADIANCE RENEWAL MASK  50ml,Ren - GLYCOLACTIC RADIANCE RENEWAL MASK  50ml,Avrami - Ebay,100,100,0,0,0,0
,Ren - GLYCOLACTIC RADIANCE RENEWAL MASK  50ml,Ren - GLYCOLACTIC RADIANCE RENEWAL MASK  50ml,WFS,-11,-11,0,0,0,0
,Ren - INSTANT FIRMING BEAUTY SHOT 30ml,Ren - INSTANT FIRMING BEAUTY SHOT 30ml,Avrami - Ebay,40,40,0,0,0,0
,Ren - INSTANT FIRMING BEAUTY SHOT 30ml,Ren - INSTANT FIRMING BEAUTY SHOT 30ml,WFS,-22,-22,0,0,0,0
,Ren - READY STEADY GLOW DAILY AHA TONIC 250ml,Ren - READY STEADY GLOW DAILY AHA TONIC 250ml,Avrami - Ebay,150,150,0,0,0,0
,Ren - READY STEADY GLOW DAILY AHA TONIC 250ml,Ren - READY STEADY GLOW DAILY AHA TONIC 250ml,WFS,-89,-89,0,0,0,0
,Ren - SATIN PERFECTION BB CREAM SPF 15 50ml,Ren - SATIN PERFECTION BB CREAM SPF 15 50ml,Avrami - Ebay,18,18,0,0,0,0
,Ren - SATIN PERFECTION BB CREAM SPF 15 50ml,Ren - SATIN PERFECTION BB CREAM SPF 15 50ml,WFS,-2,-2,0,0,0,0
,Repack LR 4 50 oz Camelflage,Repack LR 4 50 oz Camelflage,Default Ridgefield,23,23,0,0,0,0
,Repack LR 4 50 oz Camelflage,Repack LR 4 50 oz Camelflage,FBALYB Amazon,-6,-6,0,0,0,0
,Replacement Impeller Model 12B Water Pum,Pondmaster Replacement Impeller Assembly for Model 12B Water Pumps,FBALYB Amazon,0,0,0,50,0,0
,"ReptoFilter Cartridges Replacements, 3ct 2pk","ReptoFilter Cartridges Replacements, 3ct 2pk",FBALYB Amazon,-4,-4,0,0,0,0
,"ReptoFilter Cartridges Replacements, 3ct 4pk","ReptoFilter Cartridges Replacements, 3ct 4pk",FBALYB Amazon,-4,-4,0,0,0,0
,Resolve Max (Spray 'N Wash) Trigger & Refill,Resolve Max (Spray 'N Wash) Trigger & Refill ,FBALYB Amazon,-3,-3,0,17,0,0
,Resolve Trigger and Refill Oxi-Clean,Resolve Trigger and Refill Oxi-Clean,Default Oxford,3,3,0,0,0,0
,Resolve Trigger and Refill Oxi-Clean,Resolve Trigger and Refill Oxi-Clean,Default Ridgefield,49,-111,160,0,0,0
,Resolve Trigger and Refill Oxi-Clean,Resolve Trigger and Refill Oxi-Clean,FBALYB Amazon,22,22,0,15,0,0
,Restricted 5s Straight Talk White,Apple iPhone 5S 16GB Silver LTE Cellular Straight Talk MN6T2LL/A,Default,0,0,0,0,0,4
,Restricted Apple Watch 42mm Grey Case,Apple 42mm Smart Watch - Space Grey Aluminum Case/Black Band,Default,0,0,0,0,0,1
,Restricted Apple Watch 42mm Grey Case,Apple 42mm Smart Watch - Space Grey Aluminum Case/Black Band,FBALYB Amazon,-5,-5,0,0,0,0
,(Restricted Best Buy) Apple Ipad Mini 4,"Apple iPad mini 4 (16GB, Wi-Fi, Silver)",FBALYB Amazon,-1,-1,0,0,0,0
,(Restricted Best Buy) Mini 4 MK6L2LL/A,"Apple iPad Mini 4 MK6L2LL/A 7.9-Inch, 16GB, Wi-Fi, iOS 9, Gold",FBALYB Amazon,-1,-1,0,0,0,0
,Restricted DuoClean Shark HV382,Shark Rocket with DuoClean (HV382),Default,0,0,0,0,0,1
,Restricted DuoClean Shark HV382,Shark Rocket with DuoClean (HV382),FBALYB Amazon,-8,-8,0,8,0,0
,Restricted - Keurig K15 Chili Red,"Keurig K15 Single Serve Compact K-Cup Pod Coffee Maker, Chili Red",FBALYB Amazon,-1,-1,0,0,0,0
,Restricted Keurig K475 Sandy Pearl,"Keurig 119301 K475 Coffee Maker, Sandy Pearl",FBALYB Amazon,-4,-4,0,0,0,0
,Restricted Nutri Ninja Duo Bowl NN102,Ninja Nutri Bowl DUO with Auto-iQ Boost (NN102),FBALYB Amazon,-1,-1,0,0,0,0
,Restricted Straight Talk 5s 16GB Black,"Apple Iphone 5s, 16GB - Space Grey (Straight Talk)",FBALYB Amazon,2,2,0,0,0,0
,Restricted Xbox One 500GB Name Your Game,Xbox One 500GB Console - Name Your Game Bundle [Xbox One],Default,0,0,0,0,0,10
,Revere 10pc Cookware Set,Revere 10pc Cookware Set,FBALYB Amazon,-1,-1,0,0,0,0
,"Revlon One-Step Hair Dryer And Volumizer Hot Air Brush,  Mint","Revlon One-Step Hair Dryer And Volumizer Hot Air Brush,  Mint",Avrami - Ebay,255,255,0,0,0,0
,"Revlon One-Step Hair Dryer And Volumizer Hot Air Brush,  Mint","Revlon One-Step Hair Dryer And Volumizer Hot Air Brush,  Mint",Default Ridgefield,6,6,0,0,0,0
,"Revlon One-Step Hair Dryer And Volumizer Hot Air Brush,  Mint","Revlon One-Step Hair Dryer And Volumizer Hot Air Brush,  Mint",FBALYB Amazon,-15,-15,0,5,0,0
,"Revlon One-Step Hair Dryer And Volumizer Hot Air Brush,  Mint","Revlon One-Step Hair Dryer And Volumizer Hot Air Brush,  Mint",WFS,-223,-223,0,0,0,0
,Revlon SALON ONE-STEP HAIR DRYER AND VOLUMIZER- Black,Revlon SALON ONE-STEP HAIR DRYER AND VOLUMIZER- Black,Default Ridgefield,6232,6232,0,0,0,0
,Revlon SALON ONE-STEP HAIR DRYER AND VOLUMIZER- Black,Revlon SALON ONE-STEP HAIR DRYER AND VOLUMIZER- Black,FBALYB Amazon,1727,1702,25,40,25,0
,Revlon SALON ONE-STEP HAIR DRYER AND VOLUMIZER- Black,Revlon SALON ONE-STEP HAIR DRYER AND VOLUMIZER- Black,FBALYB Canada,-1,-1,0,39,0,0
,Revlon SALON ONE-STEP HAIR DRYER AND VOLUMIZER- Black,Revlon SALON ONE-STEP HAIR DRYER AND VOLUMIZER- Black,WFS,138,138,0,0,0,0
,Revlon Super Lustrous Lipstick 006 Really Red,Revlon Super Lustrous Lipstick 006 Really Red,Default Ridgefield,933,933,0,0,0,0
,Revlon Super Lustrous Lipstick 006 Really Red,Revlon Super Lustrous Lipstick 006 Really Red,FBALYB Amazon,64,61,3,0,3,0
,"Reynolds Heavy Duty Foil 18""X150' 2ct","Reynolds Heavy Duty Foil 18"" X 150' Feet, 2-count",Default,0,0,0,0,0,16
,"Reynolds Heavy Duty Foil 18""X150' 2ct","Reynolds Heavy Duty Foil 18"" X 150' Feet, 2-count",FBALYB Amazon,-1,-1,0,0,0,0
,Reynolds Wrap ‑ 2 pack,"Reynolds Wrap Aluminum Foil, 250 sq ft ‑ 2 pack",Default,0,0,0,0,0,35
,"Reynolds Wrap Heavy Duty Foil, 2 ct./95 sq. ft.","Reynolds Wrap Heavy Duty Foil, 2 ct./95 sq. ft.",Default,0,0,0,0,0,1
,"Reynolds Wrap Heavy Duty Foil, 2 ct./95 sq. ft.","Reynolds Wrap Heavy Duty Foil, 2 ct./95 sq. ft.",FBALYB Amazon,55,55,0,1,0,0
,RF-LGSP-M2CT,"KRAFT Macaroni & Cheese Dinner Cup Easy Mac Original, 58 grams Cups (Pack of 12)",FBALYB Amazon,-1,-1,0,0,0,0
,Rice Krispie Treat 60 Chocolate,Rice Krispie Treat 60 Chocolate,FBALYB Amazon,-1,-1,0,2,0,0
,Ricola Lemon Mint 2 Bags,"Ricola Sugar Free Lemon Mint Drops, 2 Bags",FBALYB Amazon,3,3,0,0,0,0
,Ricola Original 2 bags, Ricola Original Natural Herb Cough Drops 2 Bags,FBALYB Amazon,3,3,0,1,0,0
,Riedel Accessories  - Byo Bag,Riedel Accessories  - Byo Bag,Default Ridgefield,64,64,0,0,0,0
,Riedel Cabernet/Merlot Pack of 8 - 1483692,Riedel Cabernet/Merlot Pack of 8 - 1483692,Default Ridgefield,1,1,0,0,0,0
,Riedel Cabernet/Merlot Pack of 8 - 1483692,Riedel Cabernet/Merlot Pack of 8 - 1483692,FBALYB Amazon,-2,-3,1,0,1,0
,Riedel Decanters  - Amadeo,Riedel Decanters  - Amadeo,FBALYB Amazon,-1,-1,0,0,0,0
,Riedel Decanters  - Black Tie Bliss,Riedel Decanters  - Black Tie Bliss,Default Ridgefield,1,1,0,0,0,0
,Riedel Decanters  - Cabernet,Riedel Decanters  - Cabernet,Default CT,320,320,0,0,0,0
,Riedel Decanters  - Cabernet,Riedel Decanters  - Cabernet,Default Oxford,24,24,0,0,0,0
,Riedel Decanters  - Cabernet,Riedel Decanters  - Cabernet,Default Ridgefield,2064,2042,22,0,0,0
,Riedel Decanters  - Cabernet,Riedel Decanters  - Cabernet,FBALYB Amazon,406,389,17,21,17,0
,Riedel Decanters  - Cabernet,Riedel Decanters  - Cabernet,FBALYB Canada,0,0,0,30,0,0
,Riedel Decanters  - Cabernet Magnum,Riedel Decanters  - Cabernet Magnum,Default,0,-27,27,0,0,0
,Riedel Decanters  - Merlot,Riedel Decanters  - Merlot,FBALYB Amazon,-9,-13,4,0,4,0
,Riedel Decanters  - Ultra Single,Riedel Decanters  - Ultra Single,FBALYB Amazon,1,0,1,0,1,0
,"Riedel Fire Whisky Set, Decanter W/Stopper + 2 Tumblers","Riedel Fire Whisky Set, Decanter W/Stopper + 2 Tumblers",Default Ridgefield,4,4,0,0,0,0
,"Riedel Fire Whisky Set, Decanter W/Stopper + 2 Tumblers","Riedel Fire Whisky Set, Decanter W/Stopper + 2 Tumblers",FBALYB Amazon,26,26,0,0,0,0
,Riedel H2O Water Glass,,Default Ridgefield,56,56,0,0,0,0
,Riedel H2O Water Glass,,FBALYB Amazon,-2,-2,0,0,0,0
,Riedel Heart To Heart  - Cabernet Sauvignon,Riedel Heart To Heart  - Cabernet Sauvignon,Default CT,800,800,0,0,0,0
,Riedel Heart To Heart  - Cabernet Sauvignon,Riedel Heart To Heart  - Cabernet Sauvignon,Default Ridgefield,2382,2376,6,0,0,0
,Riedel Heart To Heart  - Cabernet Sauvignon,Riedel Heart To Heart  - Cabernet Sauvignon,FBALYB Amazon,-126,-130,4,186,4,0
,Riedel Heart to Heart Cabernet Sauvignon Buy 3 get 4,Riedel Heart to Heart Cabernet Sauvignon Buy 3 get 4 ,Default Ridgefield,121,121,0,0,0,0
,Riedel Heart to Heart Cabernet Sauvignon Buy 3 get 4,Riedel Heart to Heart Cabernet Sauvignon Buy 3 get 4 ,FBALYB Amazon,50,50,0,10,0,0
,Riedel Heart To Heart  - Pinot Noir,Riedel Heart To Heart  - Pinot Noir,Default CT,20,20,0,0,0,0
,Riedel Heart To Heart  - Pinot Noir,Riedel Heart To Heart  - Pinot Noir,Default Ridgefield,721,721,0,0,0,0
,Riedel Heart To Heart  - Pinot Noir,Riedel Heart To Heart  - Pinot Noir,FBALYB Amazon,145,142,3,0,3,0
,"RIEDEL ""O"" BUY 8 PAY 6 CABERNET/MERLOT","RIEDEL ""O"" BUY 8 PAY 6 CABERNET/MERLOT",Default Ridgefield,247,247,0,0,0,0
,"RIEDEL ""O"" BUY 8 PAY 6 CABERNET/MERLOT","RIEDEL ""O"" BUY 8 PAY 6 CABERNET/MERLOT",FBALYB Amazon,33,33,0,2,0,0
,"RIEDEL ""O"" CABERNET/MERLOT","RIEDEL ""O"" CABERNET/MERLOT",Default,0,0,0,0,0,1
,"RIEDEL ""O"" CABERNET/MERLOT","RIEDEL ""O"" CABERNET/MERLOT",Default Ridgefield,167,167,0,0,0,0
,"RIEDEL ""O"" CABERNET/MERLOT","RIEDEL ""O"" CABERNET/MERLOT",FBAFBA LYB AUSTRALIA,0,0,0,10,0,0
,"RIEDEL ""O"" CABERNET/MERLOT","RIEDEL ""O"" CABERNET/MERLOT",FBALYB Amazon,96,94,2,43,2,0
,"RIEDEL ""O"" CABERNET/MERLOT","RIEDEL ""O"" CABERNET/MERLOT",FBALYB Canada,15,15,0,0,0,0
,"RIEDEL ""O"" CABERNET/MERLOT 2pk","RIEDEL ""O"" CABERNET/MERLOT 2pk",FBALYB Amazon,-4,-4,0,0,0,0
,"RIEDEL ""O"" CHAMPAGNE GLASS","RIEDEL ""O"" CHAMPAGNE GLASS",Default Oxford,1,1,0,0,0,0
,"RIEDEL ""O"" CHAMPAGNE GLASS","RIEDEL ""O"" CHAMPAGNE GLASS",Default Ridgefield,2,2,0,0,0,0
,"RIEDEL ""O"" CHAMPAGNE GLASS","RIEDEL ""O"" CHAMPAGNE GLASS",FBALYB Amazon,124,122,2,25,2,0
,"RIEDEL ""O"" CHAMPAGNE GLASS","RIEDEL ""O"" CHAMPAGNE GLASS",WFS,-11,-11,0,0,0,0
,Riedel O Riesling/Sauvignon Blanc Tumbler,,FBALYB Amazon,-1,-1,0,0,0,0
,"Riedel Ouverture Red Wine Glasses, Set Of 2","Riedel Ouverture Red Wine Glasses, Set Of 2",Default CT,304,304,0,0,0,0
,"Riedel Ouverture Red Wine Glasses, Set Of 2","Riedel Ouverture Red Wine Glasses, Set Of 2",Default Ridgefield,364,364,0,0,0,0
,"Riedel Ouverture Red Wine Glasses, Set Of 2","Riedel Ouverture Red Wine Glasses, Set Of 2",FBALYB Amazon,92,89,3,0,3,0
,"Riedel Ouverture White Wine Glasses, 6ct (3 sets of 2)","Riedel Ouverture White Wine Glasses, 6ct (3 sets of 2)",FBALYB Amazon,46,46,0,0,0,0
,"Riedel Ouverture White Wine Glasses, Set Of 2","Riedel Ouverture White Wine Glasses, Set Of 2",Default CT,1,1,0,0,0,0
,"Riedel Ouverture White Wine Glasses, Set Of 2","Riedel Ouverture White Wine Glasses, Set Of 2",Default Ridgefield,382,382,0,0,0,0
,"Riedel Ouverture White Wine Glasses, Set Of 2","Riedel Ouverture White Wine Glasses, Set Of 2",FBAFBA LYB AUSTRALIA,0,0,0,10,0,0
,"Riedel Ouverture White Wine Glasses, Set Of 2","Riedel Ouverture White Wine Glasses, Set Of 2",FBALYB Amazon,127,123,4,0,4,0
,"Riedel Ouverture White Wine Glasses, Set Of 2","Riedel Ouverture White Wine Glasses, Set Of 2",FBALYB Canada,6,6,0,0,0,0
,"Riedel Ouverture Wine Glass, Set Of 12, Red & White & Champagne","Riedel Ouverture Wine Glass, Set Of 12, Red & White & Champagne",Default Ridgefield,100,100,0,0,0,0
,"Riedel Ouverture Wine Glass, Set Of 12, Red & White & Champagne","Riedel Ouverture Wine Glass, Set Of 12, Red & White & Champagne",FBAFBA LYB AUSTRALIA,0,0,0,10,0,0
,"Riedel Ouverture Wine Glass, Set Of 12, Red & White & Champagne","Riedel Ouverture Wine Glass, Set Of 12, Red & White & Champagne",FBALYB Amazon,58,30,28,0,28,0
,"Riedel Ouverture Wine Glass, Set Of 12, Red & White & Champagne","Riedel Ouverture Wine Glass, Set Of 12, Red & White & Champagne",FBALYB Canada,20,20,0,0,0,0
,"RIEDEL ""O"" VIOGNIER/CHARDONNAY","RIEDEL ""O"" VIOGNIER/CHARDONNAY",Default Ridgefield,360,360,0,0,0,0
,"RIEDEL ""O"" VIOGNIER/CHARDONNAY","RIEDEL ""O"" VIOGNIER/CHARDONNAY",FBAFBA LYB AUSTRALIA,0,0,0,10,0,0
,"RIEDEL ""O"" VIOGNIER/CHARDONNAY","RIEDEL ""O"" VIOGNIER/CHARDONNAY",FBALYB Amazon,235,228,7,0,7,0
,"RIEDEL ""O"" VIOGNIER/CHARDONNAY","RIEDEL ""O"" VIOGNIER/CHARDONNAY",FBALYB Canada,20,20,0,0,0,0
,Riedel O Viognier/Chardonnay 2ct 4pk,Riedel O Viognier/Chardonnay 2ct 4pk,FBALYB Amazon,-70,-70,0,0,0,0
,RiedelO Wine Tumbler Champagne 2pk,RiedelO Wine Tumbler Champagne 2pk,FBALYB Amazon,-16,-16,0,211,0,0
,RiedelO Wine Tumbler Champagne 2pk,RiedelO Wine Tumbler Champagne 2pk,FBALYB Canada,8,8,0,0,0,0
,Riedel Riedel Bar - Brandy Vinum,Riedel Riedel Bar - Brandy Vinum,FBALYB Amazon,-2,-5,3,0,3,0
,Riedel Riedel Bar - Cognac Vinum,Riedel Riedel Bar - Cognac Vinum,Default Ridgefield,17,17,0,0,0,0
,Riedel Riedel Bar - Cognac Vinum,Riedel Riedel Bar - Cognac Vinum,FBALYB Amazon,-1,-2,1,0,1,0
,Riedel Riedel Veritas - Cabernet,Riedel Riedel Veritas - Cabernet,Default CT,280,280,0,0,0,0
,Riedel Riedel Veritas - Cabernet,Riedel Riedel Veritas - Cabernet,Default Ridgefield,512,504,8,0,0,0
,Riedel Riedel Veritas - Cabernet,Riedel Riedel Veritas - Cabernet,FBALYB Amazon,180,180,0,41,0,0
,Riedel Riedel Veritas - Champagne,Riedel Riedel Veritas - Champagne,Default Ridgefield,40,40,0,0,0,0
,Riedel Riedel Veritas - Moscato/Coupe,Riedel Riedel Veritas - Moscato/Coupe,Default,0,-24,24,0,0,0
,Riedel Riedel Veritas - Moscato/Coupe,Riedel Riedel Veritas - Moscato/Coupe,Default Ridgefield,24,24,0,0,0,0
,Riedel Riedel Veritas - Moscato/Coupe,Riedel Riedel Veritas - Moscato/Coupe,FBALYB Amazon,345,345,0,0,0,0
,Riedel Riedel Veritas - Moscato/Coupe,Riedel Riedel Veritas - Moscato/Coupe,WFS,-10,-10,0,0,0,0
,Riedel Riedel Veritas - New World Pinot Noir,Riedel Riedel Veritas - New World Pinot Noir,Default CT,282,282,0,0,0,0
,Riedel Riedel Veritas - New World Pinot Noir,Riedel Riedel Veritas - New World Pinot Noir,Default Ridgefield,0,-8,8,0,0,0
,Riedel Riedel Veritas - New World Pinot Noir,Riedel Riedel Veritas - New World Pinot Noir,FBALYB Amazon,-43,-43,0,288,0,0
,Riedel Riedel Veritas - New World Pinot Noir,Riedel Riedel Veritas - New World Pinot Noir,WFS,-34,-34,0,0,0,0
,Riedel RIEDEL VERITAS NW PINOT NOIR/NEBBIOLO/ROSÉ CHAMP,Riedel RIEDEL VERITAS NW PINOT NOIR/NEBBIOLO/ROSÉ CHAMP,Default Ridgefield,544,544,0,0,0,0
,Riedel Sommeliers - Bordeaux Grand Cru,Riedel Sommeliers - Bordeaux Grand Cru,Default Ridgefield,1,1,0,0,0,0
,Riedel Sommeliers - Bordeaux Grand Cru,Riedel Sommeliers - Bordeaux Grand Cru,FBALYB Amazon,17,17,0,0,0,0
,Riedel Sommeliers - Burgundy Grand Cru,Riedel Sommeliers - Burgundy Grand Cru,Default Ridgefield,20,20,0,0,0,0
,Riedel Sommeliers - Burgundy Grand Cru,Riedel Sommeliers - Burgundy Grand Cru,FBALYB Amazon,50,50,0,0,0,0
,Riedel Spey Whisky 0515/02S3,Riedel Spey Whisky 0515/02S3,Default,0,0,0,0,0,1
,Riedel Spey Whisky 0515/02S3,Riedel Spey Whisky 0515/02S3,Default Ridgefield,331,331,0,0,0,0
,Riedel Spey Whisky 0515/02S3,Riedel Spey Whisky 0515/02S3,FBALYB Amazon,538,537,1,0,1,0
,Riedel SWIRL RED WINE 2pk, Riedel SWIRL RED WINE 2pk ,FBALYB Amazon,75,73,2,0,2,0
,Riedel Tasting Set,9.00621E+12,Default Ridgefield,10,10,0,0,0,0
,Riedel Tasting Set,9.00621E+12,FBALYB Amazon,27,27,0,0,0,0
,Riedel The O Wine Tumbler - Whisky,Riedel The O Wine Tumbler - Whisky,Avrami - Ebay,6,6,0,0,0,0
,Riedel The O Wine Tumbler - Whisky,Riedel The O Wine Tumbler - Whisky,Default Ridgefield,305,305,0,0,0,0
,Riedel The O Wine Tumbler - Whisky,Riedel The O Wine Tumbler - Whisky,FBALYB Amazon,246,238,8,1,8,0
,Riedel VeritasCrystalChampagne Glass 4ct,Riedel VeritasCrystalChampagne Glass 4ct,FBALYB Amazon,21,21,0,0,0,0
,Riedel Vinum - Cabernet/Merlot (Bordeaux),Riedel Vinum - Cabernet/Merlot (Bordeaux),Default Ridgefield,5,5,0,0,0,0
,Riedel Vinum - Cabernet/Merlot (Bordeaux),Riedel Vinum - Cabernet/Merlot (Bordeaux),FBAFBA LYB AUSTRALIA,0,0,0,5,0,0
,Riedel Vinum - Cabernet/Merlot (Bordeaux),Riedel Vinum - Cabernet/Merlot (Bordeaux),FBALYB Amazon,98,97,1,0,1,0
,Riedel Vinum - Cabernet/Merlot (Bordeaux),Riedel Vinum - Cabernet/Merlot (Bordeaux),FBALYB Canada,19,19,0,0,0,0
,Riedel Vinum Cabernet Sauvignon/Merlot (Bordeaux) 2pcs,Riedel Vinum Cabernet Sauvignon/Merlot (Bordeaux) 2pcs,Default Ridgefield,192,192,0,0,0,0
,Riedel Vinum Cognac-Hennessy Glasses 6ct,Riedel Vinum Cognac-Hennessy Glasses 6ct,FBALYB Amazon,7,7,0,0,0,0
,Riedel Vinum - Cuveé Prestige,Riedel Vinum - Cuveé Prestige,Default Ridgefield,1,1,0,0,0,0
,Riedel Vinum - Cuveé Prestige,Riedel Vinum - Cuveé Prestige,FBALYB Amazon,1,1,0,0,0,0
,Riedel Vinum - Martini,Riedel Vinum - Martini,Default Ridgefield,257,257,0,0,0,0
,Riedel Vinum - Martini,Riedel Vinum - Martini,FBALYB Amazon,-31,-31,0,15,0,0
,Riedel Vinum - Pinot Noir (Burgundy Red),Riedel Vinum - Pinot Noir (Burgundy Red),Default,1,1,0,0,0,0
,Riedel Vinum - Pinot Noir (Burgundy Red),Riedel Vinum - Pinot Noir (Burgundy Red),FBALYB Amazon,-3,-6,3,0,3,0
,Riedel ViognierChardonnay WineGlass 4ct,Riedel ViognierChardonnay WineGlass 4ct,FBALYB Amazon,-59,-59,0,57,0,0
,"Riedel Whisky Glass Set of 2, 2 PACK","Riedel Whisky Glass Set of 2, 2 PACK",Default Ridgefield,3,0,3,0,0,0
,"Riedel Whisky Glass Set of 2, 2 PACK","Riedel Whisky Glass Set of 2, 2 PACK",FBALYB Amazon,13,13,0,0,0,0
,"Riedel Whisky Glass Set of 2, 2 PACK","Riedel Whisky Glass Set of 2, 2 PACK",FBALYB Canada,0,0,0,20,0,0
,"Riedel Whisky Glass Set of 2, 3 PACK","Riedel Whisky Glass Set of 2, 3 PACK",FBALYB Amazon,-1,-4,3,0,3,0
,Ring delucmxe bunfle,Ring Wi-Fi Enabled Video Doorbell (Venetian Bronze),Default,0,0,0,0,0,3
,Ring Vid Doorbell Satin Nickel,Ring Vid Doorbell Satin Nickel,Default,0,0,0,0,0,3
,Ring Video Doorbell 2 Satin Nickel,Ring Video Doorbell 2 Satin Nickel,Default,0,0,0,0,0,10
,Rite Size E Cartridge 2pk,Rite Size E Cartridge 2pk,FBALYB Amazon,120,119,1,2,1,0
,Rite Size E Cartridge 3-Pack,Rite Size E Cartridge 3-Pack,FBALYB Amazon,255,228,27,12,27,0
,Rite Size E Cartridge 3-Pack,Rite Size E Cartridge 3-Pack,FBALYB Canada,20,15,5,0,5,0
,Rite Size E Cartridge 4pk,Rite Size E Cartridge 4pk,FBALYB Amazon,40,40,0,0,0,0
,Rite-Size Filter Cartridge,Rite-Size Emperor Power Filter Cartridge Size E (4 Per Pack),Default,0,-432,432,0,0,72
,Rite-Size Filter Cartridge,Rite-Size Emperor Power Filter Cartridge Size E (4 Per Pack),Default Ridgefield,2922,2922,0,0,0,0
,Rite-Size Filter Cartridge,Rite-Size Emperor Power Filter Cartridge Size E (4 Per Pack),FBALYB Amazon,167,161,6,3,6,0
,Rite-Size Filter Cartridge 6pk,Rite-Size Filter Cartridge 6pk,Default,0,-2,2,0,0,0
,Rite-Size Filter Cartridge 6pk,Rite-Size Filter Cartridge 6pk,FBALYB Amazon,20,20,0,14,0,0
,"Rite-Size Filter Cartridge Size C, 6ct","Rite-Size Penguin Power Filter Cartridge Size C, 6-Pack",Default,0,-4073,4073,0,0,0
,"Rite-Size Filter Cartridge Size C, 6ct","Rite-Size Penguin Power Filter Cartridge Size C, 6-Pack",FBALYB Amazon,259,252,7,126,7,0
,"Rite-Size Filter Cartridge Size C, 6ct","Rite-Size Penguin Power Filter Cartridge Size C, 6-Pack",FBALYB Canada,0,-50,50,0,50,0
,"Rite-Size Filter Cartridge Size C, 6ct 2pk","Rite-Size Filter Cartridge Size C, 6ct 2pk",Default,0,-13,13,0,0,0
,"Rite-Size Filter Cartridge Size C, 6ct 2pk","Rite-Size Filter Cartridge Size C, 6ct 2pk",FBALYB Amazon,-28,-46,18,511,18,0
,"Rite-Size Filter Cartridge Size C, 6ct 2pk","Rite-Size Filter Cartridge Size C, 6ct 2pk",FBALYB Canada,9,8,1,0,1,0
,"Rite-Size Filter Cartridge Size C, 6ct 3pk","Rite-Size Filter Cartridge Size C, 6ct 3pk",Default,0,-20,20,0,0,0
,"Rite-Size Filter Cartridge Size C, 6ct 3pk","Rite-Size Filter Cartridge Size C, 6ct 3pk",FBALYB Amazon,27,26,1,5,1,0
,"Rite-Size Filter Cartridge Size C, 6ct 4pk","Rite-Size Filter Cartridge Size C, 6ct 4pk",Default,0,-1,1,0,0,0
,"Rite-Size Filter Cartridge Size C, 6ct 4pk","Rite-Size Filter Cartridge Size C, 6ct 4pk",FBALYB Amazon,232,229,3,1,3,0
,Rite-Size G Eclipse 1/System 12 3ct,Rite-Size G Eclipse 1/System 12 3ct,Default Oxford,15,15,0,0,0,0
,Rite-Size G Eclipse 1/System 12 3ct,Rite-Size G Eclipse 1/System 12 3ct,Default Ridgefield,584,584,0,0,0,0
,Rite-Size G Eclipse 1/System 12 3ct 4pk,Rite-Size G Eclipse 1/System 12 3ct 4pk,FBALYB Amazon,97,97,0,0,0,0
,Ritter Mini Chocolate 6 Varieties,Ritter Mini Chocolate 6 Varieties,FBALYB Amazon,4,3,1,0,1,0
,rm & Hammer Complete Care Plus Whitening Toothpaste,Arm & Hammer Complete Care Plus Whitening Toothpaste,Default Ridgefield,0,0,0,0,0,900
,ROC 2/.5OZ EYE CREAM,ROC 2/.5OZ EYE CREAM,Default Ridgefield,288,288,0,0,0,0
,ROC Day/Night Combo pk,ROC Day/Night Combo pk,Avrami - Ebay,20,20,0,0,0,0
,Rocket fish 8 outlet,Rocketfish - 8-Outlet Surge Protector - Black,Default,0,0,0,0,0,15
,RoC Retinol Correxion Eye Cream 2pk,RoC Retinol Correxion Eye Cream 2pk,FBALYB Amazon,-6,-6,0,2,0,0
,RoC Retinol Correxion Eye Cream 2pk,RoC Retinol Correxion Eye Cream 2pk,WFS,-11,-11,0,0,0,0
,Rodelle Baking Cocoa 700g,Rodelle Baking Cocoa 700g,Default,0,-1,1,0,0,16
,Rodelle Baking Cocoa 700g,Rodelle Baking Cocoa 700g,Default Ridgefield,54,-2,56,0,0,0
,Rodelle Baking Cocoa 700g,Rodelle Baking Cocoa 700g,FBALYB Amazon,57,57,0,1,0,0
,Rogue 85 oz Black/Graphite,Rogue 85 oz Black/Graphite,FBALYB Amazon,-9,-9,0,0,0,0
,Rogue 85 oz Lapis Blue/Atomic Blue,Rogue 85 oz Lapis Blue/Atomic Blue,Default Ridgefield,76,76,0,0,0,0
,Rogue 85 oz Lapis Blue/Atomic Blue,Rogue 85 oz Lapis Blue/Atomic Blue,FBALYB Amazon,-15,-15,0,2,0,0
,Rogue 85 oz Racing Red/Silver,Rogue 85 oz Racing Red/Silver,FBALYB Amazon,-9,-9,0,0,0,0
,Roku Express,Roku Express,FBALYB Amazon,-1,-1,0,0,0,0
,Roku Express - HD Streaming Player,Roku Express - HD Streaming Player,Default,0,0,0,0,0,1
,Roku Premiere Streaming Player,Roku Premiere Streaming Player 4K - Black (4620R),Default,0,0,0,0,0,1
,Roku Streaming Stick,Roku Streaming Stick,FBALYB Amazon,-3,-3,0,0,0,0
,Roku Ultra,Roku Ultra,FBALYB Amazon,1,0,1,0,1,0
,roller pen refill M63 M black,roller pen refill M63 M black,Default Ridgefield,3335,3335,0,0,0,0
,roller pen refill M63 M black,roller pen refill M63 M black,FBALYB Amazon,59,59,0,0,0,0
,roller pen refill M63 M black 3pk,roller pen refill M63 M black 3pk,FBALYB Amazon,562,554,8,8,8,0
,roller pen refill M63 M blue,roller pen refill M63 M blue,Default Ridgefield,1290,1290,0,0,0,0
,roller pen refill M63 M blue,roller pen refill M63 M blue,FBALYB Amazon,180,170,10,1,10,0
,roller pen refill M66 black,roller pen refill M66 black,Default Ridgefield,107,107,0,0,0,0
,roller pen refill M66 black 3pk,roller pen refill M66 black 3pk,FBALYB Amazon,0,0,0,2,0,0
,roller pen refill M66 blue,roller pen refill M66 blue,Default Ridgefield,3,3,0,0,0,0
,roller pen refill M66 blue 3pk,roller pen refill M66 blue 3pk,FBALYB Amazon,9,9,0,2,0,0
,ROSMAR- Sanidry 300 Dsnfct Wipes 2 pack,ROSMAR- Sanidry 300 Dsnfct Wipes 2 pack,FBALYB Amazon,198,196,2,89,2,0
,ROSMAR- Sanidry 300 Dsnfct Wipes 4 pack,ROSMAR- Sanidry 300 Dsnfct Wipes 4 pack,FBALYB Amazon,116,110,6,0,6,0
,Round Red Copper Ceramic Non-Stick Pan,Red Copper Ceramic Non-Stick 10in Cookware Pan,FBAAP Amazon,18,18,0,0,0,0
,"Rowenta, DW3180, Steam Iron","Rowenta, DW3180, Steam Iron",FBALYB Amazon,-2,-2,0,0,0,0
,"Royal Dansk Cookies, 5lbs","Royal Dansk Danish Butter Cookies, 5lbs ",FBALYB Amazon,33,33,0,4,0,0
,RubA5 100g + 350g Combo,RubA5 100g + 350g Combo,Default,0,-5,5,0,0,0
,RubA5 100g + 350g Combo,RubA5 100g + 350g Combo,Default Oxford,14,14,0,0,0,0
,RubA5 100g + 350g Combo,RubA5 100g + 350g Combo,FBALYB Amazon,10,4,6,0,6,0
,RubA5 100g + 350g Combo,RubA5 100g + 350g Combo,FBALYB Canada,5,5,0,0,0,0
,Rub A535 Cream 350g plus 100g,Rub A535 Cream 350g plus 100g,Default Ridgefield,6,6,0,0,0,0
,Rub A535 Cream 350g plus 100g,Rub A535 Cream 350g plus 100g,FBALYB Amazon,1,1,0,0,0,0
,Rub a Dub Whistling Hippos,ALEX Toys Rub a Dub Whistling Hippos,FBALYB Amazon,1,1,0,0,0,0
,"Rubber Horse Braid Bands, White, 5""","Rubber Horse Braid Bands, White, 5""",FBALYB Amazon,3,3,0,0,0,0
,Rubbermaid 10 Cup Dry Food Container,Rubbermaid 10 Cup Dry Food Container,Default,0,0,0,0,0,188
,Rubbermaid 10 Cup Dry Food Container,Rubbermaid 10 Cup Dry Food Container,Default CT,3108,3108,0,0,0,0
,Rubbermaid 10 Cup Dry Food Container,Rubbermaid 10 Cup Dry Food Container,FBALYB Amazon,-17,-19,2,0,2,0
,Rubbermaid 10 Cup Dry Food Container 2pk,Rubbermaid 10 Cup Dry Food Container 2pk,FBALYB Amazon,100,99,1,0,1,0
,Rubbermaid 10 Cup Dry Food Container 3pk,Rubbermaid 10 Cup Dry Food Container 3pk,FBALYB Amazon,-1,-1,0,0,0,0
,Rubbermaid 10 Cup Dry Food Container 4pk,Rubbermaid 10 Cup Dry Food Container 4pk,FBALYB Amazon,-6,-6,0,7,0,0
,Rubbermaid 10 Cup Dry Food Container 6pk,Rubbermaid 10 Cup Dry Food Container 6pk,FBALYB Amazon,-2,-2,0,0,0,0
,RUBBERMAID 1.1 GAL SQUARE DRY FOOD CANISTER - FLEX & SEAL,RUBBERMAID 1.1 GAL SQUARE DRY FOOD CANISTER - FLEX & SEAL,Default,0,0,0,0,0,44
,RUBBERMAID 1.1 GAL SQUARE DRY FOOD CANISTER - FLEX & SEAL,RUBBERMAID 1.1 GAL SQUARE DRY FOOD CANISTER - FLEX & SEAL,Default Ridgefield,256,256,0,0,0,0
,RUBBERMAID 1.1 GAL SQUARE DRY FOOD CANISTER - FLEX & SEAL 2pk,RUBBERMAID 1.1 GAL SQUARE DRY FOOD CANISTER - FLEX & SEAL 2pk,FBALYB Amazon,60,58,2,0,2,0
,Rubbermaid 1.25 Cup Easy Find Lid Square,Rubbermaid 1.25 Cup Easy Find Lid Square,Default,0,0,0,0,0,162
,Rubbermaid 1.25 Cup Easy Find Lid Square,Rubbermaid 1.25 Cup Easy Find Lid Square,Default CT,32,32,0,0,0,0
,Rubbermaid 1.25 Cup Easy Find Lid Square,Rubbermaid 1.25 Cup Easy Find Lid Square,Default Ridgefield,4,4,0,0,0,0
,Rubbermaid 1.25 Cup Easy Find Lid Square 12pk,Rubbermaid 1.25 Cup Easy Find Lid Square 12pk,FBALYB Amazon,-10,-10,0,0,0,0
,Rubbermaid 1.25 Cup Easy Find Lid Square 4pk,Rubbermaid 1.25 Cup Easy Find Lid Square 4pk,Default,0,-2,2,0,0,0
,Rubbermaid 1.25 Cup Easy Find Lid Square 4pk,Rubbermaid 1.25 Cup Easy Find Lid Square 4pk,FBALYB Amazon,-9,-10,1,3,1,0
,Rubbermaid 1.25 Cup Easy Find Lid Square 6pk,Rubbermaid 1.25 Cup Easy Find Lid Square 6pk,FBALYB Amazon,-19,-27,8,0,8,0
,RUBBERMAID 12X3X2 DRAWER ORGANIZER,RUBBERMAID 12X3X2 DRAWER ORGANIZER,Default Ridgefield,400,400,0,0,0,0
,RUBBERMAID 12X3X2 DRAWER ORGANIZER,RUBBERMAID 12X3X2 DRAWER ORGANIZER,FBALYB Amazon,137,137,0,0,0,0
,Rubbermaid 14 Cup Easy Find Lid Square,Rubbermaid 14 Cup Easy Find Lid Square,Default,0,0,0,0,0,112
,Rubbermaid 14 Cup Easy Find Lid Square,Rubbermaid 14 Cup Easy Find Lid Square,Default CT,1472,1472,0,0,0,0
,Rubbermaid 14 Cup Easy Find Lid Square,Rubbermaid 14 Cup Easy Find Lid Square,Default Ridgefield,1586,1586,0,0,0,0
,Rubbermaid 14 Cup Easy Find Lid Square,Rubbermaid 14 Cup Easy Find Lid Square,FBALYB Amazon,736,669,67,0,67,0
,Rubbermaid 14 Cup Easy Find Lid Square 2pk,Rubbermaid 14 Cup Easy Find Lid Square 2pk,FBALYB Amazon,509,499,10,0,10,0
,Rubbermaid 14 Cup Easy Find Lid Square 3pk,Rubbermaid 14 Cup Easy Find Lid Square 3pk,FBALYB Amazon,-21,-22,1,4,1,0
,RUBBERMAID 15.01X6X2 ORGANIZER,RUBBERMAID 15.01X6X2 DRAWER ORGANIZER,Default Ridgefield,312,312,0,0,0,0
,RUBBERMAID 15.01X6X2 ORGANIZER,RUBBERMAID 15.01X6X2 DRAWER ORGANIZER,FBALYB Amazon,288,288,0,0,0,0
,Rubbermaid 1.5 Gallon (24 Cup) Easy Find Lid Rectangle,Rubbermaid 1.5 Gallon (24 Cup) Easy Find Lid Rectangle,Default,0,-3,3,0,0,79
,Rubbermaid 1.5 Gallon (24 Cup) Easy Find Lid Rectangle,Rubbermaid 1.5 Gallon (24 Cup) Easy Find Lid Rectangle,Default CT,3048,-606,3654,0,0,0
,Rubbermaid 1.5 Gallon (24 Cup) Easy Find Lid Rectangle,Rubbermaid 1.5 Gallon (24 Cup) Easy Find Lid Rectangle,Default Ridgefield,0,0,0,0,0,10000
,Rubbermaid 1.5 Gallon (24 Cup) Easy Find Lid Rectangle,Rubbermaid 1.5 Gallon (24 Cup) Easy Find Lid Rectangle,FBALYB Amazon,86,83,3,49,3,0
,Rubbermaid 1.5 Gallon (24 Cup) Easy Find Lid Rectangle 2pk,Rubbermaid 1.5 Gallon (24 Cup) Easy Find Lid Rectangle 2pk,Default,-2,-6,4,0,0,0
,Rubbermaid 1.5 Gallon (24 Cup) Easy Find Lid Rectangle 2pk,Rubbermaid 1.5 Gallon (24 Cup) Easy Find Lid Rectangle 2pk,FBALYB Amazon,-112,-125,13,40,13,0
,Rubbermaid 1.5 Gallon (24 Cup) Easy Find Lid Rectangle 4pk,Rubbermaid 1.5 Gallon (24 Cup) Easy Find Lid Rectangle 4pk,Default,0,-2,2,0,0,0
,Rubbermaid 1.5 Gallon (24 Cup) Easy Find Lid Rectangle 4pk,Rubbermaid 1.5 Gallon (24 Cup) Easy Find Lid Rectangle 4pk,FBALYB Amazon,5,4,1,46,1,0
,Rubbermaid 16 Cup Dry Food Container,Rubbermaid 16 Cup Dry Food Container,Default CT,112,112,0,0,0,0
,Rubbermaid 16 Cup Dry Food Container,Rubbermaid 16 Cup Dry Food Container,FBALYB Amazon,-10,-12,2,0,2,0
,Rubbermaid 16 Cup Dry Food Container 2pk,Rubbermaid 16 Cup Dry Food Container 2pk,FBALYB Amazon,74,74,0,0,0,0
,Rubbermaid 16 Cup Dry Food Container 3pk,Rubbermaid 16 Cup Dry Food Container 3pk,FBALYB Amazon,-4,-4,0,0,0,0
,RUBBERMAID 1 GALLON CLASSIC PITCHER,RUBBERMAID 1 GALLON CLASSIC PITCHER,Default Ridgefield,7,7,0,0,0,0
,RUBBERMAID 1 GALLON CLASSIC PITCHER,RUBBERMAID 1 GALLON CLASSIC PITCHER,FBALYB Amazon,541,524,17,1,17,0
,RUBBERMAID 1 GALLON CLASSIC PITCHER 2pk,RUBBERMAID 1 GALLON CLASSIC PITCHER 2pk,FBALYB Amazon,110,101,9,0,9,0
,Rubbermaid 1 Gallon Mixermate? Pitcher,Rubbermaid 1 Gallon Mixermate? Pitcher,Default,0,-8,8,0,0,0
,Rubbermaid 1 Gallon Mixermate? Pitcher,Rubbermaid 1 Gallon Mixermate? Pitcher,Default Ridgefield,116,116,0,0,0,0
,Rubbermaid 1 Gallon Mixermate? Pitcher,Rubbermaid 1 Gallon Mixermate? Pitcher,FBALYB Amazon,-14,-16,2,78,2,0
,Rubbermaid 1 Gallon Mixermate? Pitcher 2pk,Rubbermaid 1 Gallon Mixermate? Pitcher 2pk,FBALYB Amazon,-5,-5,0,14,0,0
,RUBBERMAID 1 PT MIXERMATE BOTTLE,RUBBERMAID 1 PT MIXERMATE BOTTLE,Default,0,0,0,0,0,176
,RUBBERMAID 1 PT MIXERMATE BOTTLE,RUBBERMAID 1 PT MIXERMATE BOTTLE,FBALYB Amazon,2,-3,5,0,5,0
,RUBBERMAID 1 PT MIXERMATE BOTTLE 2pk,RUBBERMAID 1 PT MIXERMATE BOTTLE 2pk,FBALYB Amazon,-5,-5,0,2,0,0
,RUBBERMAID 21 CUP DRY FOOD CONTAINER 4/1CT,RUBBERMAID 21 CUP DRY FOOD CONTAINER 4/1CT,Default CT,304,304,0,0,0,0
,Rubbermaid 2.25Qt Classic Pitcher,Rubbermaid 2.25Qt Classic Pitcher,Default,0,0,0,0,0,30
,Rubbermaid 2.25Qt Classic Pitcher,Rubbermaid 2.25Qt Classic Pitcher,Default CT,0,-1,1,0,0,0
,Rubbermaid 2.25Qt Classic Pitcher,Rubbermaid 2.25Qt Classic Pitcher,Default Ridgefield,3960,3960,0,0,0,0
,Rubbermaid 2.25Qt Classic Pitcher,Rubbermaid 2.25Qt Classic Pitcher,FBALYB Amazon,1181,1048,133,2,133,0
,Rubbermaid 2.25Qt Classic Pitcher 2pk,Rubbermaid 2.25Qt Classic Pitcher 2pk,Default Ridgefield,8,8,0,0,0,0
,Rubbermaid 2.25Qt Classic Pitcher 2pk,Rubbermaid 2.25Qt Classic Pitcher 2pk,FBALYB Amazon,408,397,11,0,11,0
,Rubbermaid 2.5 Gallon (40 Cup)  Easy Find Lid Rectangle,Rubbermaid 2.5 Gallon (40 Cup)  Easy Find Lid Rectangle,Default CT,0,-320,320,0,0,0
,Rubbermaid 2.5 Gallon (40 Cup) Easy Find Lid Rectangle 2pk,Rubbermaid 2.5 Gallon (40 Cup) Easy Find Lid Rectangle 2pk,FBALYB Amazon,0,-2,2,0,2,0
,Rubbermaid  2 Cup Easy Find Lid Square,Rubbermaid  2 Cup Easy Find Lid Square,Default,0,-252,252,0,0,0
,Rubbermaid  2 Cup Easy Find Lid Square,Rubbermaid  2 Cup Easy Find Lid Square,Default CT,1916,1916,0,0,0,0
,Rubbermaid  2 Cup Easy Find Lid Square,Rubbermaid  2 Cup Easy Find Lid Square,Default Ridgefield,0,-638,638,0,0,0
,Rubbermaid  2 Cup Easy Find Lid Square,Rubbermaid  2 Cup Easy Find Lid Square,FBALYB Amazon,108,108,0,0,0,0
,Rubbermaid 2 Cup Easy Find Lid Square 2PK,Rubbermaid 2 Cup Easy Find Lid Square 2PK,FBALYB Amazon,57,56,1,0,1,0
,Rubbermaid 2 Cup Easy Find Lid Square 4pk,Rubbermaid 2 Cup Easy Find Lid Square 4pk,FBALYB Amazon,200,200,0,0,0,0
,Rubbermaid 2 Cup Easy Find Lid Square 6pk,Rubbermaid 2 Cup Easy Find Lid Square 6pk,Default CT,0,-1,1,0,0,0
,Rubbermaid 2 Cup Easy Find Lid Square 6pk,Rubbermaid 2 Cup Easy Find Lid Square 6pk,FBALYB Amazon,1120,1096,24,0,24,0
,Rubbermaid 2 Cup Easy Find Lid Square 8pk,Rubbermaid 2 Cup Easy Find Lid Square 8pk,FBALYB Amazon,-10,-18,8,2,8,0
,Rubbermaid 2 Cup New Premier,Rubbermaid 2 Cup New Premier,Default Ridgefield,4,4,0,0,0,0
,Rubbermaid 2 Cup New Premier 4pk,Rubbermaid 2 Cup New Premier 4pk,FBALYB Amazon,-2,-5,3,1,3,0
,RUBBERMAID 2QT MIXERMATE BOTTLE,"RUBBERMAID 2QT MIXERMATE BOTTLE	",Default Ridgefield,3796,3796,0,0,0,0
,RUBBERMAID 2QT MIXERMATE BOTTLE,"RUBBERMAID 2QT MIXERMATE BOTTLE	",FBALYB Amazon,904,897,7,0,7,0
,RUBBERMAID 2QT MIXERMATE BOTTLE 2 pack,RUBBERMAID 2QT MIXERMATE BOTTLE 2 pack,FBALYB Amazon,981,969,12,264,12,0
,RUBBERMAID 2QT MIXERMATE BOTTLE 3 pack,RUBBERMAID 2QT MIXERMATE BOTTLE 3 pack,FBALYB Amazon,237,236,1,0,1,0
,Rubbermaid  3 Cup Easy Find Lid Square,Rubbermaid  3 Cup Easy Find Lid Square,Default,0,0,0,0,0,132
,Rubbermaid  3 Cup Easy Find Lid Square,Rubbermaid  3 Cup Easy Find Lid Square,Default CT,1868,1868,0,0,0,0
,Rubbermaid 3 Cup Easy Find Lid Square 4pk,Rubbermaid 3 Cup Easy Find Lid Square 4pk,FBALYB Amazon,3,1,2,0,2,0
,Rubbermaid 3 Pc. 6.25 Cup Round Ruby,Rubbermaid 3 Pc. 6.25 Cup Round Ruby,Default CT,128,128,0,0,0,0
,Rubbermaid 3 Pc Rectangle 4 Cup - Trilingual,Rubbermaid 3 Pc Rectangle 4 Cup - Trilingual,Default,0,0,0,0,0,40
,Rubbermaid 3 Pc Rectangle 4 Cup - Trilingual,Rubbermaid 3 Pc Rectangle 4 Cup - Trilingual,Default CT,2928,2928,0,0,0,0
,Rubbermaid 3 Pc Rectangle 4 Cup - Trilingual 2pk,Rubbermaid 3 Pc Rectangle 4 Cup - Trilingual 2pk,Default,0,-4,4,0,0,0
,Rubbermaid 3 Pc Rectangle 4 Cup - Trilingual 2pk,Rubbermaid 3 Pc Rectangle 4 Cup - Trilingual 2pk,FBALYB Amazon,222,218,4,2,4,0
,Rubbermaid 3 Pc Rectangle 4 Cup - Trilingual 2pk,Rubbermaid 3 Pc Rectangle 4 Cup - Trilingual 2pk,WFS,-52,-52,0,0,0,0
,Rubbermaid 3 Pc Rectangle 4 Cup - Trilingual 3pk,Rubbermaid 3 Pc Rectangle 4 Cup - Trilingual 3pk,Default,0,-4,4,0,0,0
,Rubbermaid 3 Pc Rectangle 4 Cup - Trilingual 3pk,Rubbermaid 3 Pc Rectangle 4 Cup - Trilingual 3pk,Default Ridgefield,2,2,0,0,0,0
,Rubbermaid 3 Pc Rectangle 4 Cup - Trilingual 3pk,Rubbermaid 3 Pc Rectangle 4 Cup - Trilingual 3pk,FBALYB Amazon,41,40,1,89,1,0
,Rubbermaid 4 Pc. 1.2 Cup Twist & Seal,Rubbermaid 4 Pc. 1.2 Cup Twist & Seal,Default,0,0,0,0,0,109
,Rubbermaid 4 Pc. 1.2 Cup Twist & Seal,Rubbermaid 4 Pc. 1.2 Cup Twist & Seal,Default CT,586,586,0,0,0,0
,Rubbermaid 4 Pc. 1.2 Cup Twist & Seal,Rubbermaid 4 Pc. 1.2 Cup Twist & Seal,FBALYB Amazon,-206,-208,2,0,2,0
,Rubbermaid 4 Pc. 1.2 Cup Twist & Seal 2pk,Rubbermaid 4 Pc. 1.2 Cup Twist & Seal 2pk,FBALYB Amazon,-9,-11,2,0,2,0
,Rubbermaid 4 Pc. Deep Square 5.2 Cup - Trilingual Ruby,Rubbermaid 4 Pc. Deep Square 5.2 Cup - Trilingual Ruby,Default CT,576,576,0,0,0,0
,Rubbermaid .5 Cup 2 Count Easy Find Square Lid,Rubbermaid .5 Cup 2 Count Easy Find Square Lid,Default CT,1600,1600,0,0,0,0
,Rubbermaid .5 Cup 2 Count Easy Find Square Lid,Rubbermaid .5 Cup 2 Count Easy Find Square Lid,Default Ridgefield,2,2,0,0,0,0
,Rubbermaid .5 Cup 2 Count Easy Find Square Lid,Rubbermaid .5 Cup 2 Count Easy Find Square Lid,FBALYB Amazon,1,1,0,1,0,0
,Rubbermaid .5 Cup 2 Count Easy Find Square Lid 4pk,Rubbermaid .5 Cup 2 Count Easy Find Square Lid 4pk,FBALYB Amazon,72,72,0,0,0,0
,Rubbermaid .5 Cup 2ct Square Lid 3pk,Rubbermaid .5 Cup 2ct Square Lid 3pk,Default Ridgefield,2,2,0,0,0,0
,Rubbermaid .5 Cup 2ct Square Lid 3pk,Rubbermaid .5 Cup 2ct Square Lid 3pk,FBALYB Amazon,9,-5,14,5,14,0
,Rubbermaid .5 Cup 2ct Square Lid 6pk,Rubbermaid .5 Cup 2ct Square Lid 6pk,FBALYB Amazon,2,1,1,0,1,0
,Rubbermaid 5 Cup Dry Food Container,Rubbermaid 5 Cup Dry Food Container,Default CT,1200,1200,0,0,0,0
,Rubbermaid  7 Cup Easy Find Lid Square,Rubbermaid  7 Cup Easy Find Lid Square,Default CT,2634,2634,0,0,0,0
,RUBBERMAID 8C TKA 2 PK RECT RUBY,RUBBERMAID 8C TKA 2 CT RECT RUBY,FBALYB Amazon,126,126,0,0,0,0
,Rubbermaid 9 Cup Easy Find Lid Square,Rubbermaid 9 Cup Easy Find Lid Square,Default,0,-2184,2184,0,0,68
,Rubbermaid 9 Cup Easy Find Lid Square,Rubbermaid 9 Cup Easy Find Lid Square,Default CT,4461,4461,0,0,0,0
,Rubbermaid 9 Cup Easy Find Lid Square,Rubbermaid 9 Cup Easy Find Lid Square,Default Ridgefield,11492,11492,0,0,0,0
,Rubbermaid 9 Cup Easy Find Lid Square,Rubbermaid 9 Cup Easy Find Lid Square,FBALYB Amazon,61,58,3,0,3,0
,Rubbermaid 9 Cup Easy Find Lid Square 2pk,Rubbermaid 9 Cup Easy Find Lid Square 2pk,FBALYB Amazon,242,238,4,1,4,0
,Rubbermaid 9 Cup Easy Find Lid Square 3pk,Rubbermaid 9 Cup Easy Find Lid Square 3pk,FBALYB Amazon,-6,-12,6,79,6,0
,Rubbermaid 9 Cup Easy Find Lid Square 4pk,Rubbermaid 9 Cup Easy Find Lid Square 4pk,Default CT,0,-200,200,0,0,0
,Rubbermaid 9 Cup Easy Find Lid Square 4pk,Rubbermaid 9 Cup Easy Find Lid Square 4pk,FBALYB Amazon,-4,-4,0,0,0,0
,Rubbermaid 9X3X2 Drawer Organizer,Rubbermaid 9X3X2 Drawer Organizer,Default,0,0,0,0,0,12
,Rubbermaid 9X3X2 Drawer Organizer,Rubbermaid 9X3X2 Drawer Organizer,Default CT,3324,3324,0,0,0,0
,RUBBERMAID ANTIMICROBIAL SMALL DISH DRAINER,RUBBERMAID ANTIMICROBIAL SMALL DISH DRAINER,Default,0,0,0,0,0,6
,RUBBERMAID ANTIMICROBIAL SMALL DRAIN BOARD - Black,RUBBERMAID ANTIMICROBIAL SMALL DRAIN BOARD - Black,Default CT,276,276,0,0,0,0
,RUBBERMAID ANTIMICROBIAL SMALL DRAIN BOARD - Black,RUBBERMAID ANTIMICROBIAL SMALL DRAIN BOARD - Black,Default Ridgefield,113,113,0,0,0,0
,RUBBERMAID ANTIMICROBIAL SMALL DRAIN BOARD - Black,RUBBERMAID ANTIMICROBIAL SMALL DRAIN BOARD - Black,FBALYB Amazon,120,120,0,0,0,0
,RUBBERMAID ANTIMICROBIAL SMALL DRAIN BOARD - Clear,RUBBERMAID ANTIMICROBIAL SMALL DRAIN BOARD - Clear,Default Ridgefield,4,4,0,0,0,0
,RUBBERMAID ANTIMICROBIAL SMALL DRAIN BOARD - Clear,RUBBERMAID ANTIMICROBIAL SMALL DRAIN BOARD - Clear,FBALYB Amazon,-4,-4,0,2,0,0
,Rubbermaid Brilliance 18ct Storage Set,Rubbermaid Brilliance 18ct Storage Set,Default,0,0,0,0,0,4
,Rubbermaid Brilliance 18ct Storage Set,Rubbermaid Brilliance 18ct Storage Set,FBALYB Amazon,7,6,1,0,1,0
,Rubbermaid Brilliance Leak-Proof Three Large Containers 9.6,Rubbermaid Brilliance Leak-Proof Three Large Containers 9.6,FBALYB Amazon,-4,-4,0,2,0,0
,RUBBERMAID DRAIN BOARD UNIVERSAL - WHITE,RUBBERMAID DRAIN BOARD UNIVERSAL - WHITE,Default CT,48,48,0,0,0,0
,RUBBERMAID DRAIN BOARD UNIVERSAL - WHITE,RUBBERMAID DRAIN BOARD UNIVERSAL - WHITE,FBALYB Amazon,-15,-15,0,1,0,0
,Rubbermaid Easy Release Ice Cube Tray,Rubbermaid Easy Release Ice Cube Tray,Default CT,10666,7686,2980,0,0,0
,Rubbermaid Easy Release Ice Cube Tray 2pk,Rubbermaid Easy Release Ice Cube Tray 2pk,FBALYB Amazon,521,392,129,0,129,0
,Rubbermaid Easy Release Ice Cube Tray 3pk,Rubbermaid Easy Release Ice Cube Tray 3pk,FBALYB Amazon,686,654,32,0,32,0
,Rubbermaid Easy Release Ice Cube Tray 4pk,Rubbermaid Easy Release Ice Cube Tray 4pk,FBALYB Amazon,3109,3093,16,18,16,0
,Rubbermaid Easy Release Ice Cube Tray 8pk,Rubbermaid Easy Release Ice Cube Tray 8pk,FBALYB Amazon,190,189,1,0,1,0
,RUBBERMAID EZ CHANGE P TOWEL HOLDR,RUBBERMAID EASY CHANGE PAPER TOWEL HOLDER,Default Ridgefield,765,765,0,0,0,0
,RUBBERMAID EZ CHANGE P TOWEL HOLDR,RUBBERMAID EASY CHANGE PAPER TOWEL HOLDER,FBALYB Amazon,406,371,35,0,35,0
,RUBBERMAID LARGE CUTLERY TRAY,RUBBERMAID LARGE CUTLERY TRAY,Default,0,0,0,0,0,96
,RUBBERMAID LARGE CUTLERY TRAY,RUBBERMAID LARGE CUTLERY TRAY,Default CT,18,18,0,0,0,0
,RUBBERMAID LARGE CUTLERY TRAY,RUBBERMAID LARGE CUTLERY TRAY,FBALYB Amazon,37,31,6,3,6,0
,RUBBERMAID PARTY PLATTER,RUBBERMAID PARTY PLATTER,Default,0,0,0,0,0,15
,RUBBERMAID PARTY PLATTER,RUBBERMAID PARTY PLATTER,Default CT,526,525,1,0,0,0
,RUBBERMAID PARTY PLATTER,RUBBERMAID PARTY PLATTER,FBALYB Amazon,935,915,20,0,20,0
,RUBBERMAID PARTY PLATTER 2pk,RUBBERMAID PARTY PLATTER 2pk,FBALYB Amazon,80,80,0,0,0,0
,Rubbermaid Premier 30pc Food Storage Set,Rubbermaid Premier 30pc Food Storage Set,FBASKCK Amazon,198,198,0,2,0,0
,RUBBERMAID RECT EGG KEEPER SERVIN SAVER - RED LID,RUBBERMAID RECT EGG KEEPER SERVIN SAVER - RED LID,Default CT,12,12,0,0,0,0
,RUBBERMAID RECT EGG KEEPER SERVIN SAVER - RED LID,RUBBERMAID RECT EGG KEEPER SERVIN SAVER - RED LID,Default Ridgefield,5250,5250,0,0,0,0
,RUBBERMAID RECT EGG KEEPER SERVIN SAVER - RED LID,RUBBERMAID RECT EGG KEEPER SERVIN SAVER - RED LID,FBALYB Amazon,635,621,14,408,14,0
,Rubbermaid Round Cake Keeper Servin Saver + Wht,Rubbermaid Round Cake Keeper Servin Saver + Wht,Default,0,0,0,0,0,8
,Rubbermaid Round Cake Keeper Servin Saver + Wht,Rubbermaid Round Cake Keeper Servin Saver + Wht,FBALYB Amazon,-17,-17,0,1,0,0
,RUBBERMAID SEAL N SAVER CEREAL 1.5 GAL,RUBBERMAID SEAL N SAVER CEREAL 1.5 GAL,Default,0,0,0,0,0,26
,RUBBERMAID SEAL N SAVER CEREAL 1.5 GAL,RUBBERMAID SEAL N SAVER CEREAL 1.5 GAL,Default CT,108,108,0,0,0,0
,RUBBERMAID SEAL N SAVER CEREAL 1.5 GAL,RUBBERMAID SEAL N SAVER CEREAL 1.5 GAL,FBALYB Amazon,15,13,2,1,2,0
,RUBBERMAID SEAL N SAVER CEREAL 1.5 GAL 3pk,RUBBERMAID SEAL N SAVER CEREAL 1.5 GAL 3pk,FBALYB Amazon,8,8,0,8,0,0
,RUBBERMAID SMALL SINK MAT,RUBBERMAID SMALL SINK MAT,Default CT,496,496,0,0,0,0
,RUBBERMAID SMALL SINK MAT,RUBBERMAID SMALL SINK MAT,FBALYB Amazon,80,62,18,1,18,0
,Rubbermaid Small Sink Mat Black,Rubbermaid Small Sink Mat Black,Default CT,336,336,0,0,0,0
,Rubber Maid White Rectangle Dishpan 2pk,Rubber Maid White Rectangle Dishpan 2pk,FBALYB Amazon,2,2,0,2,0,0
,Rumford Baking Powder,Rumford Baking Powder (2 canisters),FBALYB Amazon,-1,-1,0,0,0,0
,Rumford Baking Powder 2pk,Rumford Baking Powder 2pk (4 canisters),FBALYB Amazon,-6,-6,0,0,0,0
,Russell Candies 19.7oz Bag,Russell Stover Sugar Free 5 Flavor Assortment Candies 19.7oz Bag,Default,0,0,0,0,0,1
,Russell Candies 19.7oz Bag,Russell Stover Sugar Free 5 Flavor Assortment Candies 19.7oz Bag,FBALYB Amazon,25,25,0,5,0,0
,Russell Stover Asst Chocolates 19.9oz,Russell Stover Asst Chocolates 19.9oz,FBALYB Amazon,1,1,0,7,0,0
,RYET bulb E12 400 lumen globe opal 2ct,RYET bulb E12 400 lumen globe opal 2ct,FBALYB Amazon,-18,-18,0,0,0,0
,RZ-CAR6-9ODJ,"Prynt, Get Instant Photo Prints with The Prynt Case for Apple iPhone 6s , iPh...",FBALYB Amazon,7,7,0,0,0,0
,R‑Zilla Cricket Water Pillow ‑ 6 pack,R‑Zilla Cricket Water Pillow ‑ 6 pack,FBALYB Amazon,46,46,0,0,0,0
,Sabatier Cutting Board Set,Sabatier Cutting Board Set,FBALYB Amazon,2,2,0,0,0,0
,Sabatier Dish Rack,Sabatier Dish Rack,Default,0,0,0,0,0,1
,Sabatier Dish Rack,Sabatier Dish Rack,FBALYB Amazon,-1,-1,0,0,0,0
,"Sabre Pepper Spray w/Quick Release Keyring, Mint HC-14-MT-02","Sabre Pepper Spray w/Quick Release Keyring, Mint HC-14-MT-02",Avrami - Ebay,2580,2580,0,0,0,0
,"Sabre Pepper Spray w/Quick Release Keyring, Mint HC-14-MT-02","Sabre Pepper Spray w/Quick Release Keyring, Mint HC-14-MT-02",Default Oxford,-3,-3,0,0,0,0
,"Sabre Pepper Spray w/Quick Release Keyring, Mint HC-14-MT-02","Sabre Pepper Spray w/Quick Release Keyring, Mint HC-14-MT-02",Default Ridgefield,5114,5114,0,0,0,0
,"Sabre Pepper Spray w/Quick Release Keyring, Mint HC-14-MT-02","Sabre Pepper Spray w/Quick Release Keyring, Mint HC-14-MT-02",FBALYB Amazon,2579,2571,8,0,8,0
,"Sabre Pepper Spray w/Quick Release Keyring, Mint HC-14-MT-02","Sabre Pepper Spray w/Quick Release Keyring, Mint HC-14-MT-02",WFS,-155,-155,0,0,0,0
,Sabre Red 2 Million Shu Flip-Top Pepper Spray Gel MK-3-GEL-US,Sabre Red 2 Million Shu Flip-Top Pepper Spray Gel MK-3-GEL-US,FBALYB Amazon,858,803,55,3,55,0
,Sabre Red Jogger Pepper Spray with Hand Strap P-22J-OC-US,Sabre Red Jogger Pepper Spray with Hand Strap P-22J-OC-US,Avrami - Ebay,230,230,0,0,0,0
,Sabre Red Jogger Pepper Spray with Hand Strap P-22J-OC-US,Sabre Red Jogger Pepper Spray with Hand Strap P-22J-OC-US,FBALYB Amazon,410,395,15,4801,15,0
,Sabre Red Jogger Pepper Spray with Hand Strap P-22J-OC-US,Sabre Red Jogger Pepper Spray with Hand Strap P-22J-OC-US,WFS,-131,-131,0,0,0,0
,"SABRE RED Pepper Spray Keychain with Quick Release Key Ring, Black HC-14-BK-US","SABRE RED Pepper Spray Keychain with Quick Release Key Ring, Black HC-14-BK-US",Avrami - Ebay,3673,3673,0,0,0,0
,"SABRE RED Pepper Spray Keychain with Quick Release Key Ring, Black HC-14-BK-US","SABRE RED Pepper Spray Keychain with Quick Release Key Ring, Black HC-14-BK-US",FBALYB Amazon,-32,-63,31,0,31,0
,"SABRE RED Pepper Spray Keychain with Quick Release Key Ring, Black HC-14-BK-US","SABRE RED Pepper Spray Keychain with Quick Release Key Ring, Black HC-14-BK-US",WFS,-62,-62,0,0,0,0
,Safari Bristle Medium-Large Brush,Safari Bristle Medium-Large Brush,FBALYB Amazon,1,1,0,0,0,0
,Safari Cat Bristle Brush,Safari Cat Bristle Brush,FBALYB Amazon,-3,-3,0,3,0,0
,Safari Combo Bristle/Pin Brush for Medium Dogs,Safari Combo Bristle/Pin Brush for Medium Dogs,FBALYB Amazon,-2,-2,0,0,0,0
,Safari Shedding Comb Long Hair,Safari Shedding Comb Long Hair ,FBALYB Amazon,-1,-1,0,0,0,0
,Safari Wire Pin Brush Small,Safari Wire Pin Brush Small,FBALYB Amazon,0,0,0,3,0,0
,"Salerm Salerm 21 B5 Silk Protein, 3.46 Ounce 5739","Salerm Salerm 21 B5 Silk Protein, 3.46 Ounce 5739",Default Ridgefield,280,280,0,0,0,0
,"Salerm Salerm 21 B5 Silk Protein, 3.46 Ounce 5739","Salerm Salerm 21 B5 Silk Protein, 3.46 Ounce 5739",FBALYB Amazon,272,265,7,0,7,0
,"Salerm Salerm 21 B5 Silk Protein Leave-in Conditioner, 34.5 Ounce 5738","Salerm Salerm 21 B5 Silk Protein Leave-in Conditioner, 34.5 Ounce 5738",FBALYB Amazon,22,22,0,18,0,0
,Salerm Salerm 21 Essential Conditioning Oil 4 Applications 90A,Salerm Salerm 21 Essential Conditioning Oil 4 Applications 90A,Default Ridgefield,150,150,0,0,0,0
,Salerm Salerm 21 Silk Protein Leave-In Conditioner Jasmine & Amber 6.9 Oz 5726,Salerm Salerm 21 Silk Protein Leave-In Conditioner Jasmine & Amber 6.9 Oz 5726,Default Ridgefield,22,22,0,0,0,0
,Salerm Salerm 21 Silk Protein Leave-In Conditioner Jasmine & Amber 6.9 Oz 5726,Salerm Salerm 21 Silk Protein Leave-In Conditioner Jasmine & Amber 6.9 Oz 5726,FBALYB Amazon,176,176,0,2,0,0
,Salerm Salerm Keratin Shot Deep Impact Mask Plus 1000ml 795,Salerm Salerm Keratin Shot Deep Impact Mask Plus 1000ml 795,FBALYB Amazon,1,1,0,1,0,0
,"Salerm Salerm Wheat Germ Mascarilla Capilar Conditioning Treatment, 33.7 Ounce 798","Salerm Salerm Wheat Germ Mascarilla Capilar Conditioning Treatment, 33.7 Ounce 798",FBALYB Amazon,19,19,0,0,0,0
,Sally Hansen Facial Hair Remove 2pk,Sally Hansen Facial Hair Remove 2pk,FBALYB Amazon,-1,-1,0,0,0,0
,Salomon Men CROSSAMPHIBIAN SWIFT 2 Aqua Gray/U L41298300 UK 10.5 US 11,Salomon Men CROSSAMPHIBIAN SWIFT 2 Aqua Gray/U L41298300 UK 10.5 US 11,Default Ridgefield,15,15,0,0,0,0
,Salomon Men CROSSAMPHIBIAN SWIFT 2 Aqua Gray/U L41298300 UK 10 US 10.5,Salomon Men CROSSAMPHIBIAN SWIFT 2 Aqua Gray/U L41298300 UK 10 US 10.5,Default Ridgefield,15,15,0,0,0,0
,Salomon Men CROSSAMPHIBIAN SWIFT 2 Aqua Gray/U L41298300 UK 11.5 US 12,Salomon Men CROSSAMPHIBIAN SWIFT 2 Aqua Gray/U L41298300 UK 11.5 US 12,Default Ridgefield,15,15,0,0,0,0
,Salomon Men CROSSAMPHIBIAN SWIFT 2 Aqua Gray/U L41298300 UK 11 US 11.5,Salomon Men CROSSAMPHIBIAN SWIFT 2 Aqua Gray/U L41298300 UK 11 US 11.5,Default Ridgefield,15,15,0,0,0,0
,Salomon Men CROSSAMPHIBIAN SWIFT 2 Aqua Gray/U L41298300 UK 8.5 US 9,Salomon Men CROSSAMPHIBIAN SWIFT 2 Aqua Gray/U L41298300 UK 8.5 US 9,Default Ridgefield,10,10,0,0,0,0
,Salomon Men CROSSAMPHIBIAN SWIFT 2 Aqua Gray/U L41298300 UK 8 US 8.5,Salomon Men CROSSAMPHIBIAN SWIFT 2 Aqua Gray/U L41298300 UK 8 US 8.5,Default Ridgefield,5,5,0,0,0,0
,Salomon Men CROSSAMPHIBIAN SWIFT 2 Aqua Gray/U L41298300 UK 9.5 US 10,Salomon Men CROSSAMPHIBIAN SWIFT 2 Aqua Gray/U L41298300 UK 9.5 US 10,Default Ridgefield,15,15,0,0,0,0
,Salomon Men CROSSAMPHIBIAN SWIFT 2 Aqua Gray/U L41298300 UK 9 US 9.5,Salomon Men CROSSAMPHIBIAN SWIFT 2 Aqua Gray/U L41298300 UK 9 US 9.5,Default Ridgefield,15,15,0,0,0,0
,Salomon Men OUTline GTX Urban Chic/Black/Green L40477100 UK 10.5 US 11,Salomon Men OUTline GTX Urban Chic/Black/Green L40477100 UK 10.5 US 11,FBALYB Amazon,103,102,1,0,1,0
,Salomon Men OUTline GTX Urban Chic/Black/Green L40477100 UK 10 US 10.5,Salomon Men OUTline GTX Urban Chic/Black/Green L40477100 UK 10 US 10.5,FBALYB Amazon,118,118,0,0,0,0
,Salomon Men OUTline GTX Urban Chic/Black/Green L40477100 UK 11.5 US 12,Salomon Men OUTline GTX Urban Chic/Black/Green L40477100 UK 11.5 US 12,FBALYB Amazon,95,94,1,0,1,0
,Salomon Men OUTline GTX Urban Chic/Black/Green L40477100 UK 11 US 11.5,Salomon Men OUTline GTX Urban Chic/Black/Green L40477100 UK 11 US 11.5,FBALYB Amazon,79,78,1,0,1,0
,Salomon Men OUTline GTX Urban Chic/Black/Green L40477100 UK 12 US 12.5,Salomon Men OUTline GTX Urban Chic/Black/Green L40477100 UK 12 US 12.5,Default Ridgefield,40,40,0,0,0,0
,Salomon Men OUTline GTX Urban Chic/Black/Green L40477100 UK 12 US 12.5,Salomon Men OUTline GTX Urban Chic/Black/Green L40477100 UK 12 US 12.5,FBALYB Amazon,5,5,0,0,0,0
,Salomon Men OUTline GTX Urban Chic/Black/Green L40477100 UK 8.5 US 9,Salomon Men OUTline GTX Urban Chic/Black/Green L40477100 UK 8.5 US 9,FBALYB Amazon,44,44,0,0,0,0
,Salomon Men OUTline GTX Urban Chic/Black/Green L40477100 UK 9.5 US 10,Salomon Men OUTline GTX Urban Chic/Black/Green L40477100 UK 9.5 US 10,FBALYB Amazon,75,75,0,0,0,0
,Salomon Men OUTline GTX Urban Chic/Black/Green L40477100 UK 9 US 9.5,Salomon Men OUTline GTX Urban Chic/Black/Green L40477100 UK 9 US 9.5,Default Ridgefield,60,60,0,0,0,0
,Salomon Men OUTline GTX Urban Chic/Black/Green L40477100 UK 9 US 9.5,Salomon Men OUTline GTX Urban Chic/Black/Green L40477100 UK 9 US 9.5,FBALYB Amazon,-1,-1,0,0,0,0
,Salomon Mens L41042000 X Reveal Black/Black/Quiet US 10,Salomon Mens L41042000 X Reveal Black/Black/Quiet US 10,Default Ridgefield,10,10,0,0,0,0
,Salomon Mens L41042000 X Reveal Black/Black/Quiet US 10,Salomon Mens L41042000 X Reveal Black/Black/Quiet US 10,FBALYB Amazon,11,11,0,0,0,0
,Salomon Mens L41042000 X Reveal Black/Black/Quiet US 10.5,Salomon Mens L41042000 X Reveal Black/Black/Quiet US 10.5,FBALYB Amazon,-1,-1,0,0,0,0
,Salomon Mens L41042000 X Reveal Black/Black/Quiet US 11,Salomon Mens L41042000 X Reveal Black/Black/Quiet US 11,FBALYB Amazon,0,-1,1,0,1,0
,Salomon Mens L41042000 X Reveal Black/Black/Quiet US 12,Salomon Mens L41042000 X Reveal Black/Black/Quiet US 12,FBALYB Amazon,5,5,0,0,0,0
,Salomon Mens L41042000 X Reveal Black/Black/Quiet US 12.5,Salomon Mens L41042000 X Reveal Black/Black/Quiet US 12.5,Default,0,0,0,0,0,10
,Salomon Mens L41042000 X Reveal Black/Black/Quiet US 12.5,Salomon Mens L41042000 X Reveal Black/Black/Quiet US 12.5,FBALYB Amazon,8,7,1,0,1,0
,Salomon Mens L41042000 X Reveal Black/Black/Quiet US 8.5,Salomon Mens L41042000 X Reveal Black/Black/Quiet US 8.5,Default Ridgefield,5,5,0,0,0,0
,Salomon Mens L41042000 X Reveal Black/Black/Quiet US 8.5,Salomon Mens L41042000 X Reveal Black/Black/Quiet US 8.5,FBALYB Amazon,5,5,0,0,0,0
,Salomon Mens L41042000 X Reveal Black/Black/Quiet US 9,Salomon Mens L41042000 X Reveal Black/Black/Quiet US 9,FBALYB Amazon,4,4,0,0,0,0
,Salomon Mens L41042000 X Reveal Black/Black/Quiet US 9.5,Salomon Mens L41042000 X Reveal Black/Black/Quiet US 9.5,FBALYB Amazon,2,2,0,0,0,0
,Salomon Mens L41383900 OUTline Magnet/Black/Monument US 10,Salomon Mens L41383900 OUTline Magnet/Black/Monument US 10,Default Ridgefield,30,30,0,0,0,0
,Salomon Mens L41383900 OUTline Magnet/Black/Monument US 10.5,Salomon Mens L41383900 OUTline Magnet/Black/Monument US 10.5,Default Ridgefield,30,30,0,0,0,0
,Salomon Mens L41383900 OUTline Magnet/Black/Monument US 11,Salomon Mens L41383900 OUTline Magnet/Black/Monument US 11,Default Ridgefield,30,30,0,0,0,0
,Salomon Mens L41383900 OUTline Magnet/Black/Monument US 11.5,Salomon Mens L41383900 OUTline Magnet/Black/Monument US 11.5,Default Ridgefield,30,30,0,0,0,0
,Salomon Mens L41383900 OUTline Magnet/Black/Monument US 12,Salomon Mens L41383900 OUTline Magnet/Black/Monument US 12,Default Ridgefield,30,30,0,0,0,0
,Salomon Mens L41383900 OUTline Magnet/Black/Monument US 12.5,Salomon Mens L41383900 OUTline Magnet/Black/Monument US 12.5,Default Ridgefield,20,20,0,0,0,0
,Salomon Mens L41383900 OUTline Magnet/Black/Monument US 8.5,Salomon Mens L41383900 OUTline Magnet/Black/Monument US 8.5,Default Ridgefield,10,10,0,0,0,0
,Salomon Mens L41383900 OUTline Magnet/Black/Monument US 9,Salomon Mens L41383900 OUTline Magnet/Black/Monument US 9,Default Ridgefield,20,20,0,0,0,0
,Salomon Mens L41383900 OUTline Magnet/Black/Monument US 9.5,Salomon Mens L41383900 OUTline Magnet/Black/Monument US 9.5,Default Ridgefield,30,30,0,0,0,0
,Salomon Men TECH AMPHIB 4 Black/Belu/Castor Gr L40992500 UK 10.5 US 11,Salomon Men TECH AMPHIB 4 Black/Belu/Castor Gr L40992500 UK 10.5 US 11,Default Ridgefield,15,15,0,0,0,0
,Salomon Men TECH AMPHIB 4 Black/Belu/Castor Gr L40992500 UK 10.5 US 11,Salomon Men TECH AMPHIB 4 Black/Belu/Castor Gr L40992500 UK 10.5 US 11,FBALYB Amazon,-1,-1,0,0,0,0
,Salomon Men TECH AMPHIB 4 Black/Belu/Castor Gr L40992500 UK 10 US 10.5,Salomon Men TECH AMPHIB 4 Black/Belu/Castor Gr L40992500 UK 10 US 10.5,Default Ridgefield,15,15,0,0,0,0
,Salomon Men TECH AMPHIB 4 Black/Belu/Castor Gr L40992500 UK 10 US 10.5,Salomon Men TECH AMPHIB 4 Black/Belu/Castor Gr L40992500 UK 10 US 10.5,FBALYB Amazon,-1,-1,0,0,0,0
,Salomon Men TECH AMPHIB 4 Black/Belu/Castor Gr L40992500 UK 11.5 US 12,Salomon Men TECH AMPHIB 4 Black/Belu/Castor Gr L40992500 UK 11.5 US 12,Default Ridgefield,15,15,0,0,0,0
,Salomon Men TECH AMPHIB 4 Black/Belu/Castor Gr L40992500 UK 11.5 US 12,Salomon Men TECH AMPHIB 4 Black/Belu/Castor Gr L40992500 UK 11.5 US 12,FBALYB Amazon,1,1,0,0,0,0
,Salomon Men TECH AMPHIB 4 Black/Belu/Castor Gr L40992500 UK 11 US 11.5,Salomon Men TECH AMPHIB 4 Black/Belu/Castor Gr L40992500 UK 11 US 11.5,Default Ridgefield,15,15,0,0,0,0
,Salomon Men TECH AMPHIB 4 Black/Belu/Castor Gr L40992500 UK 11 US 11.5,Salomon Men TECH AMPHIB 4 Black/Belu/Castor Gr L40992500 UK 11 US 11.5,FBALYB Amazon,1,1,0,0,0,0
,Salomon Men TECH AMPHIB 4 Black/Belu/Castor Gr L40992500 UK 8.5 US 9,Salomon Men TECH AMPHIB 4 Black/Belu/Castor Gr L40992500 UK 8.5 US 9,Default Ridgefield,10,10,0,0,0,0
,Salomon Men TECH AMPHIB 4 Black/Belu/Castor Gr L40992500 UK 8.5 US 9,Salomon Men TECH AMPHIB 4 Black/Belu/Castor Gr L40992500 UK 8.5 US 9,FBALYB Amazon,8,8,0,0,0,0
,Salomon Men TECH AMPHIB 4 Black/Belu/Castor Gr L40992500 UK 8 US 8.5,Salomon Men TECH AMPHIB 4 Black/Belu/Castor Gr L40992500 UK 8 US 8.5,Default Ridgefield,5,5,0,0,0,0
,Salomon Men TECH AMPHIB 4 Black/Belu/Castor Gr L40992500 UK 8 US 8.5,Salomon Men TECH AMPHIB 4 Black/Belu/Castor Gr L40992500 UK 8 US 8.5,FBALYB Amazon,-1,-1,0,0,0,0
,Salomon Men TECH AMPHIB 4 Black/Belu/Castor Gr L40992500 UK 9.5 US 10,Salomon Men TECH AMPHIB 4 Black/Belu/Castor Gr L40992500 UK 9.5 US 10,Default Ridgefield,15,15,0,0,0,0
,Salomon Men TECH AMPHIB 4 Black/Belu/Castor Gr L40992500 UK 9.5 US 10,Salomon Men TECH AMPHIB 4 Black/Belu/Castor Gr L40992500 UK 9.5 US 10,FBALYB Amazon,4,3,1,0,1,0
,Salomon Men TECH AMPHIB 4 Black/Belu/Castor Gr L40992500 UK 9 US 9.5,Salomon Men TECH AMPHIB 4 Black/Belu/Castor Gr L40992500 UK 9 US 9.5,Default Ridgefield,15,15,0,0,0,0
,Salomon Men TECH AMPHIB 4 Black/Belu/Castor Gr L40992500 UK 9 US 9.5,Salomon Men TECH AMPHIB 4 Black/Belu/Castor Gr L40992500 UK 9 US 9.5,FBALYB Amazon,2,2,0,0,0,0
,Salomon Men X REVEAL GTX Black/Phantom/Magnet L40969100 UK 10.5 US 11,Salomon Men X REVEAL GTX Black/Phantom/Magnet L40969100 UK 10.5 US 11,FBALYB Amazon,20,20,0,0,0,0
,Salomon Men X REVEAL GTX Black/Phantom/Magnet L40969100 UK 10 US 10.5,Salomon Men X REVEAL GTX Black/Phantom/Magnet L40969100 UK 10 US 10.5,FBALYB Amazon,11,11,0,0,0,0
,Salomon Men X REVEAL GTX Black/Phantom/Magnet L40969100 UK 11.5 US 12,Salomon Men X REVEAL GTX Black/Phantom/Magnet L40969100 UK 11.5 US 12,FBALYB Amazon,14,13,1,0,1,0
,Salomon Men X REVEAL GTX Black/Phantom/Magnet L40969100 UK 11 US 11.5,Salomon Men X REVEAL GTX Black/Phantom/Magnet L40969100 UK 11 US 11.5,FBALYB Amazon,17,17,0,0,0,0
,Salomon Men X REVEAL GTX Black/Phantom/Magnet L40969100 UK 12 US 12.5,Salomon Men X REVEAL GTX Black/Phantom/Magnet L40969100 UK 12 US 12.5,Default Ridgefield,10,10,0,0,0,0
,Salomon Men X REVEAL GTX Black/Phantom/Magnet L40969100 UK 12 US 12.5,Salomon Men X REVEAL GTX Black/Phantom/Magnet L40969100 UK 12 US 12.5,FBALYB Amazon,6,6,0,0,0,0
,Salomon Men X REVEAL GTX Black/Phantom/Magnet L40969100 UK 8.5 US 9,Salomon Men X REVEAL GTX Black/Phantom/Magnet L40969100 UK 8.5 US 9,FBALYB Amazon,14,14,0,0,0,0
,Salomon Men X REVEAL GTX Black/Phantom/Magnet L40969100 UK 8 US 8.5,Salomon Men X REVEAL GTX Black/Phantom/Magnet L40969100 UK 8 US 8.5,Default Ridgefield,5,5,0,0,0,0
,Salomon Men X REVEAL GTX Black/Phantom/Magnet L40969100 UK 8 US 8.5,Salomon Men X REVEAL GTX Black/Phantom/Magnet L40969100 UK 8 US 8.5,FBALYB Amazon,-4,-4,0,5,0,0
,Salomon Men X REVEAL GTX Black/Phantom/Magnet L40969100 UK 9.5 US 10,Salomon Men X REVEAL GTX Black/Phantom/Magnet L40969100 UK 9.5 US 10,FBALYB Amazon,12,12,0,0,0,0
,Salomon Men X REVEAL GTX Black/Phantom/Magnet L40969100 UK 9 US 9.5,Salomon Men X REVEAL GTX Black/Phantom/Magnet L40969100 UK 9 US 9.5,FBALYB Amazon,19,19,0,0,0,0
,Salomon Men X ULTRA 3 Dark Denim/Black/Cumin L41139900 UK 10.5 US 11,Salomon Men X ULTRA 3 Dark Denim/Black/Cumin L41139900 UK 10.5 US 11,FBALYB Amazon,-4,-4,0,0,0,0
,Salomon Men X ULTRA 3 Dark Denim/Black/Cumin L41139900 UK 10 US 10.5,Salomon Men X ULTRA 3 Dark Denim/Black/Cumin L41139900 UK 10 US 10.5,FBALYB Amazon,-3,-3,0,0,0,0
,Salomon Men X ULTRA 3 Dark Denim/Black/Cumin L41139900 UK 11.5 US 12,Salomon Men X ULTRA 3 Dark Denim/Black/Cumin L41139900 UK 11.5 US 12,FBALYB Amazon,-7,-8,1,0,1,0
,Salomon Men X ULTRA 3 Dark Denim/Black/Cumin L41139900 UK 8.5 US 9,Salomon Men X ULTRA 3 Dark Denim/Black/Cumin L41139900 UK 8.5 US 9,FBALYB Amazon,-3,-3,0,0,0,0
,Salomon Men X ULTRA 3 Dark Denim/Black/Cumin L41139900 UK 9.5 US 10,Salomon Men X ULTRA 3 Dark Denim/Black/Cumin L41139900 UK 9.5 US 10,FBALYB Amazon,-3,-3,0,0,0,0
,Salomon Men X ULTRA 3 Dark Denim/Black/Cumin L41139900 UK 9 US 9.5,Salomon Men X ULTRA 3 Dark Denim/Black/Cumin L41139900 UK 9 US 9.5,FBALYB Amazon,-6,-6,0,0,0,0
,Salomon Men X ULTRA 3 GTX Urban Chic/Shad/LunR L41168400 UK 10.5 US 11,Salomon Men X ULTRA 3 GTX Urban Chic/Shad/LunR L41168400 UK 10.5 US 11,Default Ridgefield,30,30,0,0,0,0
,Salomon Men X ULTRA 3 GTX Urban Chic/Shad/LunR L41168400 UK 10 US 10.5,Salomon Men X ULTRA 3 GTX Urban Chic/Shad/LunR L41168400 UK 10 US 10.5,Default Ridgefield,30,30,0,0,0,0
,Salomon Men X ULTRA 3 GTX Urban Chic/Shad/LunR L41168400 UK 11.5 US 12,Salomon Men X ULTRA 3 GTX Urban Chic/Shad/LunR L41168400 UK 11.5 US 12,Default Ridgefield,30,30,0,0,0,0
,Salomon Men X ULTRA 3 GTX Urban Chic/Shad/LunR L41168400 UK 11 US 11.5,Salomon Men X ULTRA 3 GTX Urban Chic/Shad/LunR L41168400 UK 11 US 11.5,Default Ridgefield,30,30,0,0,0,0
,Salomon Men X ULTRA 3 GTX Urban Chic/Shad/LunR L41168400 UK 12 US 12.5,Salomon Men X ULTRA 3 GTX Urban Chic/Shad/LunR L41168400 UK 12 US 12.5,Default Ridgefield,20,20,0,0,0,0
,Salomon Men X ULTRA 3 GTX Urban Chic/Shad/LunR L41168400 UK 8.5 US 9,Salomon Men X ULTRA 3 GTX Urban Chic/Shad/LunR L41168400 UK 8.5 US 9,Default Ridgefield,20,20,0,0,0,0
,Salomon Men X ULTRA 3 GTX Urban Chic/Shad/LunR L41168400 UK 8 US 8.5,Salomon Men X ULTRA 3 GTX Urban Chic/Shad/LunR L41168400 UK 8 US 8.5,Default Ridgefield,10,10,0,0,0,0
,Salomon Men X ULTRA 3 GTX Urban Chic/Shad/LunR L41168400 UK 9.5 US 10,Salomon Men X ULTRA 3 GTX Urban Chic/Shad/LunR L41168400 UK 9.5 US 10,Default Ridgefield,30,30,0,0,0,0
,Salomon Men X ULTRA 3 GTX Urban Chic/Shad/LunR L41168400 UK 9 US 9.5,Salomon Men X ULTRA 3 GTX Urban Chic/Shad/LunR L41168400 UK 9 US 9.5,Default Ridgefield,30,30,0,0,0,0
,Salomon Shoes Alphacross Blast Black/Black/Black L41232600 Men's UK 10/US 10.5,Salomon Shoes Alphacross Blast Black/Black/Black L41232600 Men's UK 10/US 10.5,Default,0,0,0,0,0,15
,Salomon Shoes Alphacross Blast Black/Black/Black L41232600 Men's UK 10/US 10.5,Salomon Shoes Alphacross Blast Black/Black/Black L41232600 Men's UK 10/US 10.5,Default Ridgefield,30,30,0,0,0,0
,Salomon Shoes Alphacross Blast Black/Black/Black L41232600 Men's UK 6.5/US 7,Salomon Shoes Alphacross Blast Black/Black/Black L41232600 Men's UK 6.5/US 7,Default,0,0,0,0,0,20
,Salomon Shoes Alphacross Blast Black/Black/Black L41232600 Men's UK 6.5/US 7,Salomon Shoes Alphacross Blast Black/Black/Black L41232600 Men's UK 6.5/US 7,Default Ridgefield,20,20,0,0,0,0
,Salomon Shoes Alphacross Blast Black/Black/Black L41232600 Men's UK 6.5/US 7,Salomon Shoes Alphacross Blast Black/Black/Black L41232600 Men's UK 6.5/US 7,FBALYB Amazon,19,19,0,0,0,0
,Salomon Shoes Alphacross Blast Black/Black/Black L41232600 Men's UK 7.5/US 8,Salomon Shoes Alphacross Blast Black/Black/Black L41232600 Men's UK 7.5/US 8,FBALYB Amazon,43,43,0,0,0,0
,Salomon Shoes Alphacross Blast Black/Black/Black L41232600 Men's UK 7/US 7.5,Salomon Shoes Alphacross Blast Black/Black/Black L41232600 Men's UK 7/US 7.5,FBALYB Amazon,48,48,0,0,0,0
,Salomon Shoes Alphacross Blast Black/Black/Black L41232600 Men's UK 8.5/US 9,Salomon Shoes Alphacross Blast Black/Black/Black L41232600 Men's UK 8.5/US 9,FBALYB Amazon,51,51,0,0,0,0
,Salomon Shoes Alphacross Blast Black/Black/Black L41232600 Men's UK 8/US 8.5,Salomon Shoes Alphacross Blast Black/Black/Black L41232600 Men's UK 8/US 8.5,Default,0,0,0,0,0,30
,Salomon Shoes Alphacross Blast Black/Black/Black L41232600 Men's UK 8/US 8.5,Salomon Shoes Alphacross Blast Black/Black/Black L41232600 Men's UK 8/US 8.5,Default Ridgefield,60,60,0,0,0,0
,Salomon Shoes Alphacross Blast Black/Black/Black L41232600 Men's UK 9.5/US 10,Salomon Shoes Alphacross Blast Black/Black/Black L41232600 Men's UK 9.5/US 10,FBALYB Amazon,38,38,0,0,0,0
,Salomon Shoes Alphacross Blast Black/Black/Black L41232600 Men's UK 9/US 9.5,Salomon Shoes Alphacross Blast Black/Black/Black L41232600 Men's UK 9/US 9.5,Default,0,0,0,0,0,30
,Salomon Shoes Alphacross Blast Black/Black/Black L41232600 Men's UK 9/US 9.5,Salomon Shoes Alphacross Blast Black/Black/Black L41232600 Men's UK 9/US 9.5,Default Ridgefield,60,60,0,0,0,0
,Salomon Shoes Alphacross Blast GTX Black/Black/Black L41105300 Men's UK 10.5/US 11,Salomon Shoes Alphacross Blast GTX Black/Black/Black L41105300 Men's UK 10.5/US 11,Default Ridgefield,25,25,0,0,0,0
,Salomon Shoes Alphacross Blast GTX Black/Black/Black L41105300 Men's UK 10.5/US 11,Salomon Shoes Alphacross Blast GTX Black/Black/Black L41105300 Men's UK 10.5/US 11,FBALYB Amazon,24,24,0,0,0,0
,Salomon Shoes Alphacross Blast GTX Black/Black/Black L41105300 Men's UK 10/US 10.5,Salomon Shoes Alphacross Blast GTX Black/Black/Black L41105300 Men's UK 10/US 10.5,Default Ridgefield,30,30,0,0,0,0
,Salomon Shoes Alphacross Blast GTX Black/Black/Black L41105300 Men's UK 10/US 10.5,Salomon Shoes Alphacross Blast GTX Black/Black/Black L41105300 Men's UK 10/US 10.5,FBALYB Amazon,3,2,1,1,1,0
,Salomon Shoes Alphacross Blast GTX Black/Black/Black L41105300 Men's UK 11.5/US 12,Salomon Shoes Alphacross Blast GTX Black/Black/Black L41105300 Men's UK 11.5/US 12,FBALYB Amazon,37,35,2,0,2,0
,Salomon Shoes Alphacross Blast GTX Black/Black/Black L41105300 Men's UK 11/US 11.5,Salomon Shoes Alphacross Blast GTX Black/Black/Black L41105300 Men's UK 11/US 11.5,Default Ridgefield,30,30,0,0,0,0
,Salomon Shoes Alphacross Blast GTX Black/Black/Black L41105300 Men's UK 11/US 11.5,Salomon Shoes Alphacross Blast GTX Black/Black/Black L41105300 Men's UK 11/US 11.5,FBALYB Amazon,17,17,0,0,0,0
,Salomon Shoes Alphacross Blast GTX Black/Black/Black L41105300 Men's UK 12/US 12.5,Salomon Shoes Alphacross Blast GTX Black/Black/Black L41105300 Men's UK 12/US 12.5,FBALYB Amazon,28,28,0,0,0,0
,Salomon Shoes Alphacross Blast GTX Black/Black/Black L41105300 Men's UK 8.5/US 9,Salomon Shoes Alphacross Blast GTX Black/Black/Black L41105300 Men's UK 8.5/US 9,FBALYB Amazon,19,18,1,0,1,0
,Salomon Shoes Alphacross Blast GTX Black/Black/Black L41105300 Men's UK 8/US 8.5,Salomon Shoes Alphacross Blast GTX Black/Black/Black L41105300 Men's UK 8/US 8.5,Default Ridgefield,10,10,0,0,0,0
,Salomon Shoes Alphacross Blast GTX Black/Black/Black L41105300 Men's UK 8/US 8.5,Salomon Shoes Alphacross Blast GTX Black/Black/Black L41105300 Men's UK 8/US 8.5,FBALYB Amazon,10,10,0,0,0,0
,Salomon Shoes Alphacross Blast GTX Black/Black/Black L41105300 Men's UK 9.5/US 10,Salomon Shoes Alphacross Blast GTX Black/Black/Black L41105300 Men's UK 9.5/US 10,FBALYB Amazon,33,32,1,0,1,0
,Salomon Shoes Alphacross Blast GTX Black/Black/Black L41105300 Men's UK 9/US 9.5,Salomon Shoes Alphacross Blast GTX Black/Black/Black L41105300 Men's UK 9/US 9.5,Default Ridgefield,15,15,0,0,0,0
,Salomon Shoes Alphacross Blast GTX Black/Black/Black L41105300 Men's UK 9/US 9.5,Salomon Shoes Alphacross Blast GTX Black/Black/Black L41105300 Men's UK 9/US 9.5,FBALYB Amazon,22,22,0,0,0,0
,Salomon Shoes Alphacross Blast GTX W Black/Black L41106300 Women's UK 5.5/US 6,Salomon Shoes Alphacross Blast GTX W Black/Black L41106300 Women's UK 5.5/US 6,FBALYB Amazon,-6,-6,0,0,0,0
,Salomon Shoes Alphacross Blast GTX W Black/Black L41106300 Women's UK 5.5/US 7,Salomon Shoes Alphacross Blast GTX W Black/Black L41106300 Women's UK 5.5/US 7,Default Ridgefield,20,20,0,0,0,0
,Salomon Shoes Alphacross Blast GTX W Black/Black L41106300 Women's UK 5/US 5.5,Salomon Shoes Alphacross Blast GTX W Black/Black L41106300 Women's UK 5/US 5.5,FBALYB Amazon,-3,-3,0,0,0,0
,Salomon Shoes Alphacross Blast GTX W Black/Black L41106300 Women's UK 5/US 6.5,Salomon Shoes Alphacross Blast GTX W Black/Black L41106300 Women's UK 5/US 6.5,Default Ridgefield,10,10,0,0,0,0
,Salomon Shoes Alphacross Blast GTX W Black/Black L41106300 Women's UK 6.5/US 7,Salomon Shoes Alphacross Blast GTX W Black/Black L41106300 Women's UK 6.5/US 7,FBALYB Amazon,-5,-5,0,0,0,0
,Salomon Shoes Alphacross Blast GTX W Black/Black L41106300 Women's UK 6.5/US 8,Salomon Shoes Alphacross Blast GTX W Black/Black L41106300 Women's UK 6.5/US 8,Default Ridgefield,25,25,0,0,0,0
,Salomon Shoes Alphacross Blast GTX W Black/Black L41106300 Women's UK 6/US 6.5,Salomon Shoes Alphacross Blast GTX W Black/Black L41106300 Women's UK 6/US 6.5,FBALYB Amazon,3,2,1,0,1,0
,Salomon Shoes Alphacross Blast GTX W Black/Black L41106300 Women's UK 6/US 7.5,Salomon Shoes Alphacross Blast GTX W Black/Black L41106300 Women's UK 6/US 7.5,Default Ridgefield,25,25,0,0,0,0
,Salomon Shoes Alphacross Blast GTX W Black/Black L41106300 Women's UK 7.5/US 8,Salomon Shoes Alphacross Blast GTX W Black/Black L41106300 Women's UK 7.5/US 8,FBALYB Amazon,15,15,0,0,0,0
,Salomon Shoes Alphacross Blast GTX W Black/Black L41106300 Women's UK 7.5/US 9,Salomon Shoes Alphacross Blast GTX W Black/Black L41106300 Women's UK 7.5/US 9,Default Ridgefield,30,30,0,0,0,0
,Salomon Shoes Alphacross Blast GTX W Black/Black L41106300 Women's UK 7/US 7.5,Salomon Shoes Alphacross Blast GTX W Black/Black L41106300 Women's UK 7/US 7.5,FBALYB Amazon,8,8,0,0,0,0
,Salomon Shoes Alphacross Blast GTX W Black/Black L41106300 Women's UK 7/US 8.5,Salomon Shoes Alphacross Blast GTX W Black/Black L41106300 Women's UK 7/US 8.5,Default Ridgefield,30,30,0,0,0,0
,Salomon Shoes Alphacross Blast GTX W Black/Black L41106300 Women's UK 8.5/US 10,Salomon Shoes Alphacross Blast GTX W Black/Black L41106300 Women's UK 8.5/US 10,Default Ridgefield,30,30,0,0,0,0
,Salomon Shoes Alphacross Blast GTX W Black/Black L41106300 Women's UK 8.5/US 9,Salomon Shoes Alphacross Blast GTX W Black/Black L41106300 Women's UK 8.5/US 9,FBALYB Amazon,21,21,0,0,0,0
,Salomon Shoes Alphacross Blast GTX W Black/Black L41106300 Women's UK 8/US 8.5,Salomon Shoes Alphacross Blast GTX W Black/Black L41106300 Women's UK 8/US 8.5,FBALYB Amazon,21,21,0,1,0,0
,Salomon Shoes Alphacross Blast GTX W Black/Black L41106300 Women's UK 8/US 9.5,Salomon Shoes Alphacross Blast GTX W Black/Black L41106300 Women's UK 8/US 9.5,Default Ridgefield,30,30,0,0,0,0
,Salomon Shoes Alphacross Blast GTX W Black/Black L41106300 Women's UK 9/US 10.5,Salomon Shoes Alphacross Blast GTX W Black/Black L41106300 Women's UK 9/US 10.5,Default Ridgefield,15,15,0,0,0,0
,Salomon Shoes Alphacross Blast GTX W Black/Black L41106300 Women's UK 9/US 9.5,Salomon Shoes Alphacross Blast GTX W Black/Black L41106300 Women's UK 9/US 9.5,FBALYB Amazon,14,14,0,0,0,0
,Salomon Shoes Crossamphibian Swift 2 W Opal Blue/Stormy Weather/White L41298800 Women's UK 5.5/US 6,Salomon Shoes Crossamphibian Swift 2 W Opal Blue/Stormy Weather/White L41298800 Women's UK 5.5/US 6,FBALYB Amazon,-4,-4,0,0,0,0
,Salomon Shoes Crossamphibian Swift 2 W Opal Blue/Stormy Weather/White L41298800 Women's UK 5/US 5.5,Salomon Shoes Crossamphibian Swift 2 W Opal Blue/Stormy Weather/White L41298800 Women's UK 5/US 5.5,FBALYB Amazon,-1,-1,0,0,0,0
,Salomon Shoes Crossamphibian Swift 2 W Opal Blue/Stormy Weather/White L41298800 Women's UK 6.5/US 7,Salomon Shoes Crossamphibian Swift 2 W Opal Blue/Stormy Weather/White L41298800 Women's UK 6.5/US 7,FBALYB Amazon,-4,-5,1,0,1,0
,Salomon Shoes Crossamphibian Swift 2 W Opal Blue/Stormy Weather/White L41298800 Women's UK 6/US 6.5,Salomon Shoes Crossamphibian Swift 2 W Opal Blue/Stormy Weather/White L41298800 Women's UK 6/US 6.5,FBALYB Amazon,-1,-1,0,0,0,0
,Salomon Shoes Crossamphibian Swift 2 W Opal Blue/Stormy Weather/White L41298800 Women's UK 7.5/US 8,Salomon Shoes Crossamphibian Swift 2 W Opal Blue/Stormy Weather/White L41298800 Women's UK 7.5/US 8,FBALYB Amazon,-7,-7,0,0,0,0
,Salomon Shoes Crossamphibian Swift 2 W Opal Blue/Stormy Weather/White L41298800 Women's UK 7/US 7.5,Salomon Shoes Crossamphibian Swift 2 W Opal Blue/Stormy Weather/White L41298800 Women's UK 7/US 7.5,FBALYB Amazon,-2,-2,0,0,0,0
,Salomon Shoes Crossamphibian Swift 2 W Opal Blue/Stormy Weather/White L41298800 Women's UK 8.5/US 9,Salomon Shoes Crossamphibian Swift 2 W Opal Blue/Stormy Weather/White L41298800 Women's UK 8.5/US 9,FBALYB Amazon,5,4,1,0,1,0
,Salomon Shoes Crossamphibian Swift 2 W Opal Blue/Stormy Weather/White L41298800 Women's UK 8/US 8.5,Salomon Shoes Crossamphibian Swift 2 W Opal Blue/Stormy Weather/White L41298800 Women's UK 8/US 8.5,FBALYB Amazon,3,3,0,0,0,0
,Salomon Shoes OUTline GTX Black/Phantom/Magnet L40477000 Men's UK 10.5/US 11,Salomon Shoes OUTline GTX Black/Phantom/Magnet L40477000 Men's UK 10.5/US 11,FBALYB Amazon,-5,-5,0,0,0,0
,Salomon Shoes OUTline GTX Black/Phantom/Magnet L40477000 Men's UK 10/US 10.5,Salomon Shoes OUTline GTX Black/Phantom/Magnet L40477000 Men's UK 10/US 10.5,FBALYB Amazon,-6,-6,0,0,0,0
,Salomon Shoes OUTline GTX Black/Phantom/Magnet L40477000 Men's UK 11.5/US 12,Salomon Shoes OUTline GTX Black/Phantom/Magnet L40477000 Men's UK 11.5/US 12,FBALYB Amazon,-4,-4,0,0,0,0
,Salomon Shoes OUTline GTX Black/Phantom/Magnet L40477000 Men's UK 11/US 11.5,Salomon Shoes OUTline GTX Black/Phantom/Magnet L40477000 Men's UK 11/US 11.5,FBALYB Amazon,7,7,0,0,0,0
,Salomon Shoes OUTline GTX Black/Phantom/Magnet L40477000 Men's UK 12/US 12.5,Salomon Shoes OUTline GTX Black/Phantom/Magnet L40477000 Men's UK 12/US 12.5,FBALYB Amazon,-1,-1,0,0,0,0
,Salomon Shoes OUTline GTX Black/Phantom/Magnet L40477000 Men's UK 8.5/US 9,Salomon Shoes OUTline GTX Black/Phantom/Magnet L40477000 Men's UK 8.5/US 9,FBALYB Amazon,-5,-5,0,0,0,0
,Salomon Shoes OUTline GTX Black/Phantom/Magnet L40477000 Men's UK 8/US 8.5,Salomon Shoes OUTline GTX Black/Phantom/Magnet L40477000 Men's UK 8/US 8.5,FBALYB Amazon,-4,-4,0,0,0,0
,Salomon Shoes OUTline GTX Black/Phantom/Magnet L40477000 Men's UK 9.5/US 10,Salomon Shoes OUTline GTX Black/Phantom/Magnet L40477000 Men's UK 9.5/US 10,FBALYB Amazon,-3,-3,0,0,0,0
,Salomon Shoes OUTline GTX Black/Phantom/Magnet L40477000 Men's UK 9/US 9.5,Salomon Shoes OUTline GTX Black/Phantom/Magnet L40477000 Men's UK 9/US 9.5,FBALYB Amazon,-8,-8,0,0,0,0
,Salomon Shoes OUTline GTX W Trellis/Navy Blazer L40618800 Women's UK 5.5/US 7,Salomon Shoes OUTline GTX W Trellis/Navy Blazer L40618800 Women's UK 5.5/US 7,FBALYB Amazon,-4,-4,0,0,0,0
,Salomon Shoes OUTline GTX W Trellis/Navy Blazer L40618800 Women's UK 5/US 6.5,Salomon Shoes OUTline GTX W Trellis/Navy Blazer L40618800 Women's UK 5/US 6.5,FBALYB Amazon,-3,-3,0,0,0,0
,Salomon Shoes OUTline GTX W Trellis/Navy Blazer L40618800 Women's UK 6.5/US 8,Salomon Shoes OUTline GTX W Trellis/Navy Blazer L40618800 Women's UK 6.5/US 8,FBALYB Amazon,-6,-6,0,0,0,0
,Salomon Shoes OUTline GTX W Trellis/Navy Blazer L40618800 Women's UK 6/US 7.5,Salomon Shoes OUTline GTX W Trellis/Navy Blazer L40618800 Women's UK 6/US 7.5,FBALYB Amazon,-8,-8,0,0,0,0
,Salomon Shoes OUTline GTX W Trellis/Navy Blazer L40618800 Women's UK 7.5/US 9,Salomon Shoes OUTline GTX W Trellis/Navy Blazer L40618800 Women's UK 7.5/US 9,FBALYB Amazon,-10,-10,0,0,0,0
,Salomon Shoes OUTline GTX W Trellis/Navy Blazer L40618800 Women's UK 7/US 8.5,Salomon Shoes OUTline GTX W Trellis/Navy Blazer L40618800 Women's UK 7/US 8.5,FBALYB Amazon,-8,-8,0,0,0,0
,Salomon Shoes OUTline GTX W Trellis/Navy Blazer L40618800 Women's UK 8.5/US 10,Salomon Shoes OUTline GTX W Trellis/Navy Blazer L40618800 Women's UK 8.5/US 10,FBALYB Amazon,-7,-7,0,0,0,0
,Salomon Shoes OUTline GTX W Trellis/Navy Blazer L40618800 Women's UK 8/US 9.5,Salomon Shoes OUTline GTX W Trellis/Navy Blazer L40618800 Women's UK 8/US 9.5,FBALYB Amazon,-8,-8,0,0,0,0
,Salomon Shoes OUTline GTX W Trellis/Navy Blazer L40618800 Women's UK 9/US 10.5,Salomon Shoes OUTline GTX W Trellis/Navy Blazer L40618800 Women's UK 9/US 10.5,FBALYB Amazon,-10,-10,0,0,0,0
,Salomon Shoes Quest 4D 3 GTX Phantom/Black/Quiet Shade L40245500 Men's UK 10.5/US 11,Salomon Shoes Quest 4D 3 GTX Phantom/Black/Quiet Shade L40245500 Men's UK 10.5/US 11,FBALYB Amazon,-10,-10,0,0,0,0
,Salomon Shoes Quest 4D 3 GTX Phantom/Black/Quiet Shade L40245500 Men's UK 10/US 10.5,Salomon Shoes Quest 4D 3 GTX Phantom/Black/Quiet Shade L40245500 Men's UK 10/US 10.5,FBALYB Amazon,-10,-10,0,0,0,0
,Salomon Shoes Quest 4D 3 GTX Phantom/Black/Quiet Shade L40245500 Men's UK 11.5/US 12,Salomon Shoes Quest 4D 3 GTX Phantom/Black/Quiet Shade L40245500 Men's UK 11.5/US 12,FBALYB Amazon,-6,-6,0,0,0,0
,Salomon Shoes Quest 4D 3 GTX Phantom/Black/Quiet Shade L40245500 Men's UK 11/US 11.5,Salomon Shoes Quest 4D 3 GTX Phantom/Black/Quiet Shade L40245500 Men's UK 11/US 11.5,FBALYB Amazon,-12,-12,0,2,0,0
,Salomon Shoes Quest 4D 3 GTX Phantom/Black/Quiet Shade L40245500 Men's UK 12/US 12.5,Salomon Shoes Quest 4D 3 GTX Phantom/Black/Quiet Shade L40245500 Men's UK 12/US 12.5,FBALYB Amazon,-3,-3,0,0,0,0
,Salomon Shoes Quest 4D 3 GTX Phantom/Black/Quiet Shade L40245500 Men's UK 6.5/US 7,Salomon Shoes Quest 4D 3 GTX Phantom/Black/Quiet Shade L40245500 Men's UK 6.5/US 7,FBALYB Amazon,-5,-5,0,0,0,0
,Salomon Shoes Quest 4D 3 GTX Phantom/Black/Quiet Shade L40245500 Men's UK 8.5/US 9,Salomon Shoes Quest 4D 3 GTX Phantom/Black/Quiet Shade L40245500 Men's UK 8.5/US 9,FBALYB Amazon,-6,-6,0,0,0,0
,Salomon Shoes Quest 4D 3 GTX Phantom/Black/Quiet Shade L40245500 Men's UK 8/US 8.5,Salomon Shoes Quest 4D 3 GTX Phantom/Black/Quiet Shade L40245500 Men's UK 8/US 8.5,FBALYB Amazon,-7,-7,0,0,0,0
,Salomon Shoes Quest 4D 3 GTX Phantom/Black/Quiet Shade L40245500 Men's UK 9/US 9.5,Salomon Shoes Quest 4D 3 GTX Phantom/Black/Quiet Shade L40245500 Men's UK 9/US 9.5,FBALYB Amazon,-7,-7,0,0,0,0
,Salomon Shoes Quest 4D 3 GTX Wren/Bungee Cord/Green Sulphur L40151800 Men's UK 10.5/US 11,Salomon Shoes Quest 4D 3 GTX Wren/Bungee Cord/Green Sulphur L40151800 Men's UK 10.5/US 11,FBALYB Amazon,-6,-6,0,0,0,0
,Salomon Shoes Quest 4D 3 GTX Wren/Bungee Cord/Green Sulphur L40151800 Men's UK 10/US 10.5,Salomon Shoes Quest 4D 3 GTX Wren/Bungee Cord/Green Sulphur L40151800 Men's UK 10/US 10.5,FBALYB Amazon,-10,-10,0,0,0,0
,Salomon Shoes Quest 4D 3 GTX Wren/Bungee Cord/Green Sulphur L40151800 Men's UK 11.5/US 12,Salomon Shoes Quest 4D 3 GTX Wren/Bungee Cord/Green Sulphur L40151800 Men's UK 11.5/US 12,FBALYB Amazon,-7,-7,0,0,0,0
,Salomon Shoes Quest 4D 3 GTX Wren/Bungee Cord/Green Sulphur L40151800 Men's UK 11/US 11.5,Salomon Shoes Quest 4D 3 GTX Wren/Bungee Cord/Green Sulphur L40151800 Men's UK 11/US 11.5,FBALYB Amazon,-7,-7,0,0,0,0
,Salomon Shoes Quest 4D 3 GTX Wren/Bungee Cord/Green Sulphur L40151800 Men's UK 12.5/US 13,Salomon Shoes Quest 4D 3 GTX Wren/Bungee Cord/Green Sulphur L40151800 Men's UK 12.5/US 13,FBALYB Amazon,-7,-7,0,0,0,0
,Salomon Shoes Quest 4D 3 GTX Wren/Bungee Cord/Green Sulphur L40151800 Men's UK 12/US 12.5,Salomon Shoes Quest 4D 3 GTX Wren/Bungee Cord/Green Sulphur L40151800 Men's UK 12/US 12.5,FBALYB Amazon,-7,-7,0,0,0,0
,Salomon Shoes Quest 4D 3 GTX Wren/Bungee Cord/Green Sulphur L40151800 Men's UK 6.5/US 7,Salomon Shoes Quest 4D 3 GTX Wren/Bungee Cord/Green Sulphur L40151800 Men's UK 6.5/US 7,FBALYB Amazon,-2,-2,0,0,0,0
,Salomon Shoes Quest 4D 3 GTX Wren/Bungee Cord/Green Sulphur L40151800 Men's UK 7.5/US 8,Salomon Shoes Quest 4D 3 GTX Wren/Bungee Cord/Green Sulphur L40151800 Men's UK 7.5/US 8,FBALYB Amazon,-4,-4,0,0,0,0
,Salomon Shoes Quest 4D 3 GTX Wren/Bungee Cord/Green Sulphur L40151800 Men's UK 8.5/US 9,Salomon Shoes Quest 4D 3 GTX Wren/Bungee Cord/Green Sulphur L40151800 Men's UK 8.5/US 9,FBALYB Amazon,-5,-5,0,0,0,0
,Salomon Shoes Quest 4D 3 GTX Wren/Bungee Cord/Green Sulphur L40151800 Men's UK 8/US 8.5,Salomon Shoes Quest 4D 3 GTX Wren/Bungee Cord/Green Sulphur L40151800 Men's UK 8/US 8.5,FBALYB Amazon,-3,-3,0,0,0,0
,Salomon Shoes Quest 4D 3 GTX Wren/Bungee Cord/Green Sulphur L40151800 Men's UK 9.5/US 10,Salomon Shoes Quest 4D 3 GTX Wren/Bungee Cord/Green Sulphur L40151800 Men's UK 9.5/US 10,FBALYB Amazon,-3,-3,0,1,0,0
,Salomon Shoes Quest 4D 3 GTX Wren/Bungee Cord/Green Sulphur L40151800 Men's UK 9/US 9.5,Salomon Shoes Quest 4D 3 GTX Wren/Bungee Cord/Green Sulphur L40151800 Men's UK 9/US 9.5,FBALYB Amazon,-6,-6,0,0,0,0
,Salomon Shoes Quest Prime GTX Phantom/Black/QuSh L40463700 Men's UK 10.5/US 11,Salomon Shoes Quest Prime GTX Phantom/Black/QuSh L40463700 Men's UK 10.5/US 11,FBALYB Amazon,-6,-6,0,0,0,0
,Salomon Shoes Quest Prime GTX Phantom/Black/QuSh L40463700 Men's UK 10/US 10.5,Salomon Shoes Quest Prime GTX Phantom/Black/QuSh L40463700 Men's UK 10/US 10.5,FBALYB Amazon,-2,-2,0,0,0,0
,Salomon Shoes Quest Prime GTX Phantom/Black/QuSh L40463700 Men's UK 11.5/US 12,Salomon Shoes Quest Prime GTX Phantom/Black/QuSh L40463700 Men's UK 11.5/US 12,FBALYB Amazon,-4,-4,0,0,0,0
,Salomon Shoes Quest Prime GTX Phantom/Black/QuSh L40463700 Men's UK 11/US 11.5,Salomon Shoes Quest Prime GTX Phantom/Black/QuSh L40463700 Men's UK 11/US 11.5,FBALYB Amazon,-7,-7,0,0,0,0
,Salomon Shoes Quest Prime GTX Phantom/Black/QuSh L40463700 Men's UK 8.5/US 9,Salomon Shoes Quest Prime GTX Phantom/Black/QuSh L40463700 Men's UK 8.5/US 9,FBALYB Amazon,-5,-5,0,0,0,0
,Salomon Shoes Quest Prime GTX Phantom/Black/QuSh L40463700 Men's UK 8/US 8.5,Salomon Shoes Quest Prime GTX Phantom/Black/QuSh L40463700 Men's UK 8/US 8.5,FBALYB Amazon,-6,-6,0,0,0,0
,Salomon Shoes Quest Prime GTX Phantom/Black/QuSh L40463700 Men's UK 9.5/US 10,Salomon Shoes Quest Prime GTX Phantom/Black/QuSh L40463700 Men's UK 9.5/US 10,FBALYB Amazon,-3,-3,0,0,0,0
,Salomon Shoes Quest Prime GTX Phantom/Black/QuSh L40463700 Men's UK 9/US 9.5,Salomon Shoes Quest Prime GTX Phantom/Black/QuSh L40463700 Men's UK 9/US 9.5,FBALYB Amazon,-8,-8,0,0,0,0
,Salomon Shoes Quest Prime GTX W Shad/Green Gable L40997600 Women's UK 5.5/US 7,Salomon Shoes Quest Prime GTX W Shad/Green Gable L40997600 Women's UK 5.5/US 7,FBALYB Amazon,7,7,0,0,0,0
,Salomon Shoes Quest Prime GTX W Shad/Green Gable L40997600 Women's UK 5/US 6.5,Salomon Shoes Quest Prime GTX W Shad/Green Gable L40997600 Women's UK 5/US 6.5,FBALYB Amazon,13,13,0,0,0,0
,Salomon Shoes Quest Prime GTX W Shad/Green Gable L40997600 Women's UK 6.5/US 8,Salomon Shoes Quest Prime GTX W Shad/Green Gable L40997600 Women's UK 6.5/US 8,FBALYB Amazon,4,4,0,0,0,0
,Salomon Shoes Quest Prime GTX W Shad/Green Gable L40997600 Women's UK 6/US 7.5,Salomon Shoes Quest Prime GTX W Shad/Green Gable L40997600 Women's UK 6/US 7.5,FBALYB Amazon,11,11,0,0,0,0
,Salomon Shoes Quest Prime GTX W Shad/Green Gable L40997600 Women's UK 7.5/US 9,Salomon Shoes Quest Prime GTX W Shad/Green Gable L40997600 Women's UK 7.5/US 9,FBALYB Amazon,25,25,0,0,0,0
,Salomon Shoes Quest Prime GTX W Shad/Green Gable L40997600 Women's UK 7/US 8.5,Salomon Shoes Quest Prime GTX W Shad/Green Gable L40997600 Women's UK 7/US 8.5,FBALYB Amazon,23,23,0,0,0,0
,Salomon Shoes Quest Prime GTX W Shad/Green Gable L40997600 Women's UK 8.5/US 10,Salomon Shoes Quest Prime GTX W Shad/Green Gable L40997600 Women's UK 8.5/US 10,FBALYB Amazon,28,28,0,0,0,0
,Salomon Shoes Quest Prime GTX W Shad/Green Gable L40997600 Women's UK 8/US 9.5,Salomon Shoes Quest Prime GTX W Shad/Green Gable L40997600 Women's UK 8/US 9.5,FBALYB Amazon,30,30,0,0,0,0
,Salomon Shoes Speedcross 4 Black/Black/Black Metallic L38313000 Men's UK 10.5/US 11,Salomon Shoes Speedcross 4 Black/Black/Black Metallic L38313000 Men's UK 10.5/US 11,Default Oxford,5,5,0,0,0,0
,Salomon Shoes Speedcross 4 Black/Black/Black Metallic L38313000 Men's UK 10.5/US 11,Salomon Shoes Speedcross 4 Black/Black/Black Metallic L38313000 Men's UK 10.5/US 11,Default Ridgefield,140,140,0,0,0,0
,Salomon Shoes Speedcross 4 Black/Black/Black Metallic L38313000 Men's UK 10.5/US 11,Salomon Shoes Speedcross 4 Black/Black/Black Metallic L38313000 Men's UK 10.5/US 11,FBALYB Amazon,-34,-34,0,0,0,0
,Salomon Shoes Speedcross 4 Black/Black/Black Metallic L38313000 Men's UK 10/US 10.5,Salomon Shoes Speedcross 4 Black/Black/Black Metallic L38313000 Men's UK 10/US 10.5,FBALYB Amazon,-20,-20,0,0,0,0
,Salomon Shoes Speedcross 4 Black/Black/Black Metallic L38313000 Men's UK 11.5/US 12,Salomon Shoes Speedcross 4 Black/Black/Black Metallic L38313000 Men's UK 11.5/US 12,Default Oxford,120,120,0,0,0,0
,Salomon Shoes Speedcross 4 Black/Black/Black Metallic L38313000 Men's UK 11.5/US 12,Salomon Shoes Speedcross 4 Black/Black/Black Metallic L38313000 Men's UK 11.5/US 12,FBALYB Amazon,-25,-25,0,1,0,0
,Salomon Shoes Speedcross 4 Black/Black/Black Metallic L38313000 Men's UK 11/US 11.5,Salomon Shoes Speedcross 4 Black/Black/Black Metallic L38313000 Men's UK 11/US 11.5,Default Oxford,5,5,0,0,0,0
,Salomon Shoes Speedcross 4 Black/Black/Black Metallic L38313000 Men's UK 11/US 11.5,Salomon Shoes Speedcross 4 Black/Black/Black Metallic L38313000 Men's UK 11/US 11.5,FBALYB Amazon,-21,-21,0,0,0,0
,Salomon Shoes Speedcross 4 Black/Black/Black Metallic L38313000 Men's UK 12.5/US 13,Salomon Shoes Speedcross 4 Black/Black/Black Metallic L38313000 Men's UK 12.5/US 13,FBALYB Amazon,-2,-2,0,0,0,0
,Salomon Shoes Speedcross 4 Black/Black/Black Metallic L38313000 Men's UK 12/US 12.5,Salomon Shoes Speedcross 4 Black/Black/Black Metallic L38313000 Men's UK 12/US 12.5,FBALYB Amazon,-5,-5,0,0,0,0
,Salomon Shoes Speedcross 4 Black/Black/Black Metallic L38313000 Men's UK 6.5/US 7,Salomon Shoes Speedcross 4 Black/Black/Black Metallic L38313000 Men's UK 6.5/US 7,FBALYB Amazon,-6,-6,0,0,0,0
,Salomon Shoes Speedcross 4 Black/Black/Black Metallic L38313000 Men's UK 7.5/US 8,Salomon Shoes Speedcross 4 Black/Black/Black Metallic L38313000 Men's UK 7.5/US 8,FBALYB Amazon,-5,-5,0,0,0,0
,Salomon Shoes Speedcross 4 Black/Black/Black Metallic L38313000 Men's UK 7/US 7.5,Salomon Shoes Speedcross 4 Black/Black/Black Metallic L38313000 Men's UK 7/US 7.5,FBALYB Amazon,-8,-8,0,0,0,0
,Salomon Shoes Speedcross 4 Black/Black/Black Metallic L38313000 Men's UK 8.5/US 9,Salomon Shoes Speedcross 4 Black/Black/Black Metallic L38313000 Men's UK 8.5/US 9,Default Oxford,46,46,0,0,0,0
,Salomon Shoes Speedcross 4 Black/Black/Black Metallic L38313000 Men's UK 8.5/US 9,Salomon Shoes Speedcross 4 Black/Black/Black Metallic L38313000 Men's UK 8.5/US 9,Default Ridgefield,18,18,0,0,0,0
,Salomon Shoes Speedcross 4 Black/Black/Black Metallic L38313000 Men's UK 8.5/US 9,Salomon Shoes Speedcross 4 Black/Black/Black Metallic L38313000 Men's UK 8.5/US 9,FBALYB Amazon,-38,-38,0,0,0,0
,Salomon Shoes Speedcross 4 Black/Black/Black Metallic L38313000 Men's UK 8/US 8.5,Salomon Shoes Speedcross 4 Black/Black/Black Metallic L38313000 Men's UK 8/US 8.5,FBALYB Amazon,-15,-15,0,0,0,0
,Salomon Shoes Speedcross 4 Black/Black/Black Metallic L38313000 Men's UK 9.5/US 10,Salomon Shoes Speedcross 4 Black/Black/Black Metallic L38313000 Men's UK 9.5/US 10,Default Oxford,5,5,0,0,0,0
,Salomon Shoes Speedcross 4 Black/Black/Black Metallic L38313000 Men's UK 9.5/US 10,Salomon Shoes Speedcross 4 Black/Black/Black Metallic L38313000 Men's UK 9.5/US 10,Default Ridgefield,100,100,0,0,0,0
,Salomon Shoes Speedcross 4 Black/Black/Black Metallic L38313000 Men's UK 9.5/US 10,Salomon Shoes Speedcross 4 Black/Black/Black Metallic L38313000 Men's UK 9.5/US 10,FBALYB Amazon,-19,-19,0,0,0,0
,Salomon Shoes Speedcross 4 Black/Black/Black Metallic L38313000 Men's UK 9/US 9.5,Salomon Shoes Speedcross 4 Black/Black/Black Metallic L38313000 Men's UK 9/US 9.5,Default Ridgefield,70,70,0,0,0,0
,Salomon Shoes Speedcross 4 Black/Black/Black Metallic L38313000 Men's UK 9/US 9.5,Salomon Shoes Speedcross 4 Black/Black/Black Metallic L38313000 Men's UK 9/US 9.5,FBALYB Amazon,23,22,1,0,1,0
,Salomon Shoes Speedcross 4 W Black/Black/Black Metallic L38309700 Women's UK 4.5/US 6,Salomon Shoes Speedcross 4 W Black/Black/Black Metallic L38309700 Women's UK 4.5/US 6,Default Oxford,50,50,0,0,0,0
,Salomon Shoes Speedcross 4 W Black/Black/Black Metallic L38309700 Women's UK 4.5/US 6,Salomon Shoes Speedcross 4 W Black/Black/Black Metallic L38309700 Women's UK 4.5/US 6,FBALYB Amazon,-11,-11,0,1,0,0
,Salomon Shoes Speedcross 4 W Black/Black/Black Metallic L38309700 Women's UK 4/US 5.5,Salomon Shoes Speedcross 4 W Black/Black/Black Metallic L38309700 Women's UK 4/US 5.5,FBALYB Amazon,1,1,0,0,0,0
,Salomon Shoes Speedcross 4 W Black/Black/Black Metallic L38309700 Women's UK 5.5/US 7,Salomon Shoes Speedcross 4 W Black/Black/Black Metallic L38309700 Women's UK 5.5/US 7,Default Oxford,70,70,0,0,0,0
,Salomon Shoes Speedcross 4 W Black/Black/Black Metallic L38309700 Women's UK 5.5/US 7,Salomon Shoes Speedcross 4 W Black/Black/Black Metallic L38309700 Women's UK 5.5/US 7,FBALYB Amazon,27,27,0,0,0,0
,Salomon Shoes Speedcross 4 W Black/Black/Black Metallic L38309700 Women's UK 5/US 6.5,Salomon Shoes Speedcross 4 W Black/Black/Black Metallic L38309700 Women's UK 5/US 6.5,Default Ridgefield,10,10,0,0,0,0
,Salomon Shoes Speedcross 4 W Black/Black/Black Metallic L38309700 Women's UK 5/US 6.5,Salomon Shoes Speedcross 4 W Black/Black/Black Metallic L38309700 Women's UK 5/US 6.5,FBALYB Amazon,-5,-5,0,0,0,0
,Salomon Shoes Speedcross 4 W Black/Black/Black Metallic L38309700 Women's UK 6.5/US 8,Salomon Shoes Speedcross 4 W Black/Black/Black Metallic L38309700 Women's UK 6.5/US 8,FBALYB Amazon,-28,-28,0,2,0,0
,Salomon Shoes Speedcross 4 W Black/Black/Black Metallic L38309700 Women's UK 6/US 7.5,Salomon Shoes Speedcross 4 W Black/Black/Black Metallic L38309700 Women's UK 6/US 7.5,Default Ridgefield,45,45,0,0,0,0
,Salomon Shoes Speedcross 4 W Black/Black/Black Metallic L38309700 Women's UK 6/US 7.5,Salomon Shoes Speedcross 4 W Black/Black/Black Metallic L38309700 Women's UK 6/US 7.5,FBALYB Amazon,-15,-15,0,2,0,0
,Salomon Shoes Speedcross 4 W Black/Black/Black Metallic L38309700 Women's UK 7.5/US 9,Salomon Shoes Speedcross 4 W Black/Black/Black Metallic L38309700 Women's UK 7.5/US 9,Default Ridgefield,175,175,0,0,0,0
,Salomon Shoes Speedcross 4 W Black/Black/Black Metallic L38309700 Women's UK 7.5/US 9,Salomon Shoes Speedcross 4 W Black/Black/Black Metallic L38309700 Women's UK 7.5/US 9,FBALYB Amazon,13,13,0,0,0,0
,Salomon Shoes Speedcross 4 W Black/Black/Black Metallic L38309700 Women's UK 7/US 8.5,Salomon Shoes Speedcross 4 W Black/Black/Black Metallic L38309700 Women's UK 7/US 8.5,Default Oxford,7,7,0,0,0,0
,Salomon Shoes Speedcross 4 W Black/Black/Black Metallic L38309700 Women's UK 7/US 8.5,Salomon Shoes Speedcross 4 W Black/Black/Black Metallic L38309700 Women's UK 7/US 8.5,Default Ridgefield,40,40,0,0,0,0
,Salomon Shoes Speedcross 4 W Black/Black/Black Metallic L38309700 Women's UK 7/US 8.5,Salomon Shoes Speedcross 4 W Black/Black/Black Metallic L38309700 Women's UK 7/US 8.5,FBALYB Amazon,-23,-23,0,0,0,0
,Salomon Shoes Speedcross 4 W Black/Black/Black Metallic L38309700 Women's UK 8.5/US 10,Salomon Shoes Speedcross 4 W Black/Black/Black Metallic L38309700 Women's UK 8.5/US 10,Default Oxford,68,68,0,0,0,0
,Salomon Shoes Speedcross 4 W Black/Black/Black Metallic L38309700 Women's UK 8.5/US 10,Salomon Shoes Speedcross 4 W Black/Black/Black Metallic L38309700 Women's UK 8.5/US 10,FBALYB Amazon,-10,-10,0,0,0,0
,Salomon Shoes Speedcross 4 W Black/Black/Black Metallic L38309700 Women's UK 8/US 9.5,Salomon Shoes Speedcross 4 W Black/Black/Black Metallic L38309700 Women's UK 8/US 9.5,Default Oxford,45,45,0,0,0,0
,Salomon Shoes Speedcross 4 W Black/Black/Black Metallic L38309700 Women's UK 8/US 9.5,Salomon Shoes Speedcross 4 W Black/Black/Black Metallic L38309700 Women's UK 8/US 9.5,FBALYB Amazon,-16,-16,0,0,0,0
,Salomon Shoes Speedcross 4 W Black/Black/Black Metallic L38309700 Women's UK 9.5/US 11,Salomon Shoes Speedcross 4 W Black/Black/Black Metallic L38309700 Women's UK 9.5/US 11,Default Oxford,10,10,0,0,0,0
,Salomon Shoes Speedcross 4 W Black/Black/Black Metallic L38309700 Women's UK 9/US 10.5,Salomon Shoes Speedcross 4 W Black/Black/Black Metallic L38309700 Women's UK 9/US 10.5,Default Oxford,30,30,0,0,0,0
,Salomon Shoes Speedcross 4 W Black/Black/Black Metallic L38309700 Women's UK 9/US 10.5,Salomon Shoes Speedcross 4 W Black/Black/Black Metallic L38309700 Women's UK 9/US 10.5,FBALYB Amazon,-5,-5,0,0,0,0
,Salomon Shoes Speedcross 4 W Poseidon/Eggshell Blue/Black L40243100 Women's UK 4.5/US 6,Salomon Shoes Speedcross 4 W Poseidon/Eggshell Blue/Black L40243100 Women's UK 4.5/US 6,Default Ridgefield,30,30,0,0,0,0
,Salomon Shoes Speedcross 4 W Poseidon/Eggshell Blue/Black L40243100 Women's UK 4.5/US 6,Salomon Shoes Speedcross 4 W Poseidon/Eggshell Blue/Black L40243100 Women's UK 4.5/US 6,FBALYB Amazon,-6,-6,0,0,0,0
,Salomon Shoes Speedcross 4 W Poseidon/Eggshell Blue/Black L40243100 Women's UK 4/US 5.5,Salomon Shoes Speedcross 4 W Poseidon/Eggshell Blue/Black L40243100 Women's UK 4/US 5.5,Default Ridgefield,10,10,0,0,0,0
,Salomon Shoes Speedcross 4 W Poseidon/Eggshell Blue/Black L40243100 Women's UK 4/US 5.5,Salomon Shoes Speedcross 4 W Poseidon/Eggshell Blue/Black L40243100 Women's UK 4/US 5.5,FBALYB Amazon,-3,-3,0,0,0,0
,Salomon Shoes Speedcross 4 W Poseidon/Eggshell Blue/Black L40243100 Women's UK 5.5/US 7,Salomon Shoes Speedcross 4 W Poseidon/Eggshell Blue/Black L40243100 Women's UK 5.5/US 7,Default Ridgefield,10,10,0,0,0,0
,Salomon Shoes Speedcross 4 W Poseidon/Eggshell Blue/Black L40243100 Women's UK 5.5/US 7,Salomon Shoes Speedcross 4 W Poseidon/Eggshell Blue/Black L40243100 Women's UK 5.5/US 7,FBALYB Amazon,-10,-10,0,0,0,0
,Salomon Shoes Speedcross 4 W Poseidon/Eggshell Blue/Black L40243100 Women's UK 5/US 6.5,Salomon Shoes Speedcross 4 W Poseidon/Eggshell Blue/Black L40243100 Women's UK 5/US 6.5,FBALYB Amazon,-4,-4,0,0,0,0
,Salomon Shoes Speedcross 4 W Poseidon/Eggshell Blue/Black L40243100 Women's UK 6.5/US 8,Salomon Shoes Speedcross 4 W Poseidon/Eggshell Blue/Black L40243100 Women's UK 6.5/US 8,Default Oxford,80,80,0,0,0,0
,Salomon Shoes Speedcross 4 W Poseidon/Eggshell Blue/Black L40243100 Women's UK 6/US 7.5,Salomon Shoes Speedcross 4 W Poseidon/Eggshell Blue/Black L40243100 Women's UK 6/US 7.5,Default Oxford,20,20,0,0,0,0
,Salomon Shoes Speedcross 4 W Poseidon/Eggshell Blue/Black L40243100 Women's UK 6/US 7.5,Salomon Shoes Speedcross 4 W Poseidon/Eggshell Blue/Black L40243100 Women's UK 6/US 7.5,FBALYB Amazon,-13,-13,0,0,0,0
,Salomon Shoes Speedcross 4 W Poseidon/Eggshell Blue/Black L40243100 Women's UK 7.5/US 9,Salomon Shoes Speedcross 4 W Poseidon/Eggshell Blue/Black L40243100 Women's UK 7.5/US 9,Default Ridgefield,59,59,0,0,0,0
,Salomon Shoes Speedcross 4 W Poseidon/Eggshell Blue/Black L40243100 Women's UK 7.5/US 9,Salomon Shoes Speedcross 4 W Poseidon/Eggshell Blue/Black L40243100 Women's UK 7.5/US 9,FBALYB Amazon,-4,-4,0,0,0,0
,Salomon Shoes Speedcross 4 W Poseidon/Eggshell Blue/Black L40243100 Women's UK 7/US 8.5,Salomon Shoes Speedcross 4 W Poseidon/Eggshell Blue/Black L40243100 Women's UK 7/US 8.5,Default Ridgefield,25,25,0,0,0,0
,Salomon Shoes Speedcross 4 W Poseidon/Eggshell Blue/Black L40243100 Women's UK 7/US 8.5,Salomon Shoes Speedcross 4 W Poseidon/Eggshell Blue/Black L40243100 Women's UK 7/US 8.5,FBALYB Amazon,-6,-6,0,0,0,0
,Salomon Shoes Speedcross 4 W Poseidon/Eggshell Blue/Black L40243100 Women's UK 8.5/US 10,Salomon Shoes Speedcross 4 W Poseidon/Eggshell Blue/Black L40243100 Women's UK 8.5/US 10,Default Oxford,24,24,0,0,0,0
,Salomon Shoes Speedcross 4 W Poseidon/Eggshell Blue/Black L40243100 Women's UK 8.5/US 10,Salomon Shoes Speedcross 4 W Poseidon/Eggshell Blue/Black L40243100 Women's UK 8.5/US 10,FBALYB Amazon,-4,-4,0,1,0,0
,Salomon Shoes Speedcross 4 W Poseidon/Eggshell Blue/Black L40243100 Women's UK 8/US 9.5,Salomon Shoes Speedcross 4 W Poseidon/Eggshell Blue/Black L40243100 Women's UK 8/US 9.5,Default Oxford,19,19,0,0,0,0
,Salomon Shoes Speedcross 4 W Poseidon/Eggshell Blue/Black L40243100 Women's UK 8/US 9.5,Salomon Shoes Speedcross 4 W Poseidon/Eggshell Blue/Black L40243100 Women's UK 8/US 9.5,FBALYB Amazon,-7,-7,0,1,0,0
,Salomon Shoes Speedcross 4 W Poseidon/Eggshell Blue/Black L40243100 Women's UK 9/US 10.5,Salomon Shoes Speedcross 4 W Poseidon/Eggshell Blue/Black L40243100 Women's UK 9/US 10.5,Default Oxford,20,20,0,0,0,0
,Salomon Shoes Speedcross 5 Black/Black/Phantom L40684000 Men's UK 10.5/US 11,Salomon Shoes Speedcross 5 Black/Black/Phantom L40684000 Men's UK 10.5/US 11,Avrami - Ebay,150,150,0,0,0,0
,Salomon Shoes Speedcross 5 Black/Black/Phantom L40684000 Men's UK 10.5/US 11,Salomon Shoes Speedcross 5 Black/Black/Phantom L40684000 Men's UK 10.5/US 11,Default Oxford,15,15,0,0,0,0
,Salomon Shoes Speedcross 5 Black/Black/Phantom L40684000 Men's UK 10.5/US 11,Salomon Shoes Speedcross 5 Black/Black/Phantom L40684000 Men's UK 10.5/US 11,FBALYB Amazon,-86,-86,0,0,0,0
,Salomon Shoes Speedcross 5 Black/Black/Phantom L40684000 Men's UK 10.5/US 11,Salomon Shoes Speedcross 5 Black/Black/Phantom L40684000 Men's UK 10.5/US 11,WFS,-120,-121,1,0,1,0
,Salomon Shoes Speedcross 5 Black/Black/Phantom L40684000 Men's UK 10/US 10.5,Salomon Shoes Speedcross 5 Black/Black/Phantom L40684000 Men's UK 10/US 10.5,Avrami - Ebay,238,238,0,0,0,0
,Salomon Shoes Speedcross 5 Black/Black/Phantom L40684000 Men's UK 10/US 10.5,Salomon Shoes Speedcross 5 Black/Black/Phantom L40684000 Men's UK 10/US 10.5,FBALYB Amazon,-76,-76,0,0,0,0
,Salomon Shoes Speedcross 5 Black/Black/Phantom L40684000 Men's UK 10/US 10.5,Salomon Shoes Speedcross 5 Black/Black/Phantom L40684000 Men's UK 10/US 10.5,WFS,-209,-209,0,0,0,0
,Salomon Shoes Speedcross 5 Black/Black/Phantom L40684000 Men's UK 11.5/US 12,Salomon Shoes Speedcross 5 Black/Black/Phantom L40684000 Men's UK 11.5/US 12,Avrami - Ebay,71,71,0,0,0,0
,Salomon Shoes Speedcross 5 Black/Black/Phantom L40684000 Men's UK 11.5/US 12,Salomon Shoes Speedcross 5 Black/Black/Phantom L40684000 Men's UK 11.5/US 12,Default Ridgefield,36,36,0,0,0,0
,Salomon Shoes Speedcross 5 Black/Black/Phantom L40684000 Men's UK 11.5/US 12,Salomon Shoes Speedcross 5 Black/Black/Phantom L40684000 Men's UK 11.5/US 12,FBALYB Amazon,-52,-52,0,2,0,0
,Salomon Shoes Speedcross 5 Black/Black/Phantom L40684000 Men's UK 11/US 11.5,Salomon Shoes Speedcross 5 Black/Black/Phantom L40684000 Men's UK 11/US 11.5,Default,36,36,0,0,0,0
,Salomon Shoes Speedcross 5 Black/Black/Phantom L40684000 Men's UK 11/US 11.5,Salomon Shoes Speedcross 5 Black/Black/Phantom L40684000 Men's UK 11/US 11.5,FBALYB Amazon,-49,-49,0,0,0,0
,Salomon Shoes Speedcross 5 Black/Black/Phantom L40684000 Men's UK 12.5/US 13,Salomon Shoes Speedcross 5 Black/Black/Phantom L40684000 Men's UK 12.5/US 13,Avrami - Ebay,70,70,0,0,0,0
,Salomon Shoes Speedcross 5 Black/Black/Phantom L40684000 Men's UK 12.5/US 13,Salomon Shoes Speedcross 5 Black/Black/Phantom L40684000 Men's UK 12.5/US 13,FBALYB Amazon,-58,-58,0,0,0,0
,Salomon Shoes Speedcross 5 Black/Black/Phantom L40684000 Men's UK 12/US 12.5,Salomon Shoes Speedcross 5 Black/Black/Phantom L40684000 Men's UK 12/US 12.5,Avrami - Ebay,35,35,0,0,0,0
,Salomon Shoes Speedcross 5 Black/Black/Phantom L40684000 Men's UK 12/US 12.5,Salomon Shoes Speedcross 5 Black/Black/Phantom L40684000 Men's UK 12/US 12.5,FBALYB Amazon,152,148,4,0,4,0
,Salomon Shoes Speedcross 5 Black/Black/Phantom L40684000 Men's UK 6.5/US 7,Salomon Shoes Speedcross 5 Black/Black/Phantom L40684000 Men's UK 6.5/US 7,FBALYB Amazon,47,46,1,0,1,0
,Salomon Shoes Speedcross 5 Black/Black/Phantom L40684000 Men's UK 7.5/US 8,Salomon Shoes Speedcross 5 Black/Black/Phantom L40684000 Men's UK 7.5/US 8,FBALYB Amazon,-9,-10,1,0,1,0
,Salomon Shoes Speedcross 5 Black/Black/Phantom L40684000 Men's UK 7/US 7.5,Salomon Shoes Speedcross 5 Black/Black/Phantom L40684000 Men's UK 7/US 7.5,Default Ridgefield,6,6,0,0,0,0
,Salomon Shoes Speedcross 5 Black/Black/Phantom L40684000 Men's UK 7/US 7.5,Salomon Shoes Speedcross 5 Black/Black/Phantom L40684000 Men's UK 7/US 7.5,FBALYB Amazon,-1,-1,0,0,0,0
,Salomon Shoes Speedcross 5 Black/Black/Phantom L40684000 Men's UK 8.5/US 9,Salomon Shoes Speedcross 5 Black/Black/Phantom L40684000 Men's UK 8.5/US 9,Avrami - Ebay,190,190,0,0,0,0
,Salomon Shoes Speedcross 5 Black/Black/Phantom L40684000 Men's UK 8.5/US 9,Salomon Shoes Speedcross 5 Black/Black/Phantom L40684000 Men's UK 8.5/US 9,FBALYB Amazon,115,102,13,0,13,0
,Salomon Shoes Speedcross 5 Black/Black/Phantom L40684000 Men's UK 8/US 8.5,Salomon Shoes Speedcross 5 Black/Black/Phantom L40684000 Men's UK 8/US 8.5,Default Ridgefield,65,65,0,0,0,0
,Salomon Shoes Speedcross 5 Black/Black/Phantom L40684000 Men's UK 8/US 8.5,Salomon Shoes Speedcross 5 Black/Black/Phantom L40684000 Men's UK 8/US 8.5,FBALYB Amazon,-37,-39,2,4,2,0
,Salomon Shoes Speedcross 5 Black/Black/Phantom L40684000 Men's UK 9.5/US 10,Salomon Shoes Speedcross 5 Black/Black/Phantom L40684000 Men's UK 9.5/US 10,Avrami - Ebay,190,190,0,0,0,0
,Salomon Shoes Speedcross 5 Black/Black/Phantom L40684000 Men's UK 9.5/US 10,Salomon Shoes Speedcross 5 Black/Black/Phantom L40684000 Men's UK 9.5/US 10,Default Ridgefield,38,38,0,0,0,0
,Salomon Shoes Speedcross 5 Black/Black/Phantom L40684000 Men's UK 9.5/US 10,Salomon Shoes Speedcross 5 Black/Black/Phantom L40684000 Men's UK 9.5/US 10,FBALYB Amazon,-64,-64,0,2,0,0
,Salomon Shoes Speedcross 5 Black/Black/Phantom L40684000 Men's UK 9.5/US 10,Salomon Shoes Speedcross 5 Black/Black/Phantom L40684000 Men's UK 9.5/US 10,WFS,-34,-34,0,0,0,0
,Salomon Shoes Speedcross 5 Black/Black/Phantom L40684000 Men's UK 9/US 9.5,Salomon Shoes Speedcross 5 Black/Black/Phantom L40684000 Men's UK 9/US 9.5,FBALYB Amazon,7,5,2,0,2,0
,Salomon Shoes Speedcross 5 Goji Berry/Wht/Black L41308600 UK 10.5/US 11,Salomon Shoes Speedcross 5 Goji Berry/Wht/Black L41308600 UK 10.5/US 11,FBALYB Amazon,-2,-2,0,0,0,0
,Salomon Shoes Speedcross 5 Goji Berry/Wht/Black L41308600 UK 10/US 10.5,Salomon Shoes Speedcross 5 Goji Berry/Wht/Black L41308600 UK 10/US 10.5,FBALYB Amazon,-1,-1,0,0,0,0
,Salomon Shoes Speedcross 5 Goji Berry/Wht/Black L41308600 UK 11.5/US 12,Salomon Shoes Speedcross 5 Goji Berry/Wht/Black L41308600 UK 11.5/US 12,FBALYB Amazon,-1,-1,0,0,0,0
,Salomon Shoes Speedcross 5 Goji Berry/Wht/Black L41308600 UK 11/US 11.5,Salomon Shoes Speedcross 5 Goji Berry/Wht/Black L41308600 UK 11/US 11.5,FBALYB Amazon,-3,-3,0,0,0,0
,Salomon Shoes Speedcross 5 Goji Berry/Wht/Black L41308600 UK 12/US 12.5,Salomon Shoes Speedcross 5 Goji Berry/Wht/Black L41308600 UK 12/US 12.5,FBALYB Amazon,-2,-2,0,0,0,0
,Salomon Shoes Speedcross 5 Goji Berry/Wht/Black L41308600 UK 8.5/US 9,Salomon Shoes Speedcross 5 Goji Berry/Wht/Black L41308600 UK 8.5/US 9,FBALYB Amazon,-1,-1,0,0,0,0
,Salomon Shoes Speedcross 5 Goji Berry/Wht/Black L41308600 UK 8/US 8.5,Salomon Shoes Speedcross 5 Goji Berry/Wht/Black L41308600 UK 8/US 8.5,FBALYB Amazon,-1,-1,0,0,0,0
,Salomon Shoes Speedcross 5 Goji Berry/Wht/Black L41308600 UK 9.5/US 10,Salomon Shoes Speedcross 5 Goji Berry/Wht/Black L41308600 UK 9.5/US 10,FBALYB Amazon,-2,-2,0,0,0,0
,Salomon Shoes Speedcross 5 Goji Berry/Wht/Black L41308600 UK 9/US 9.5,Salomon Shoes Speedcross 5 Goji Berry/Wht/Black L41308600 UK 9/US 9.5,FBALYB Amazon,-1,-1,0,0,0,0
,Salomon Shoes Speedcross 5 Grape Leaf/Black/Phan L40968100 Men's UK 10.5/US 11,Salomon Shoes Speedcross 5 Grape Leaf/Black/Phan L40968100 Men's UK 10.5/US 11,FBALYB Amazon,-4,-4,0,0,0,0
,Salomon Shoes Speedcross 5 Grape Leaf/Black/Phan L40968100 Men's UK 10/US 10.5,Salomon Shoes Speedcross 5 Grape Leaf/Black/Phan L40968100 Men's UK 10/US 10.5,FBALYB Amazon,-6,-6,0,0,0,0
,Salomon Shoes Speedcross 5 Grape Leaf/Black/Phan L40968100 Men's UK 11.5/US 12,Salomon Shoes Speedcross 5 Grape Leaf/Black/Phan L40968100 Men's UK 11.5/US 12,FBALYB Amazon,-5,-5,0,0,0,0
,Salomon Shoes Speedcross 5 Grape Leaf/Black/Phan L40968100 Men's UK 11/US 11.5,Salomon Shoes Speedcross 5 Grape Leaf/Black/Phan L40968100 Men's UK 11/US 11.5,FBALYB Amazon,-2,-2,0,0,0,0
,Salomon Shoes Speedcross 5 Grape Leaf/Black/Phan L40968100 Men's UK 12/US 12.5,Salomon Shoes Speedcross 5 Grape Leaf/Black/Phan L40968100 Men's UK 12/US 12.5,FBALYB Amazon,-5,-5,0,0,0,0
,Salomon Shoes Speedcross 5 Grape Leaf/Black/Phan L40968100 Men's UK 8.5/US 9,Salomon Shoes Speedcross 5 Grape Leaf/Black/Phan L40968100 Men's UK 8.5/US 9,FBALYB Amazon,-6,-6,0,0,0,0
,Salomon Shoes Speedcross 5 Grape Leaf/Black/Phan L40968100 Men's UK 8/US 8.5,Salomon Shoes Speedcross 5 Grape Leaf/Black/Phan L40968100 Men's UK 8/US 8.5,FBALYB Amazon,-2,-2,0,0,0,0
,Salomon Shoes Speedcross 5 Grape Leaf/Black/Phan L40968100 Men's UK 9.5/US 10,Salomon Shoes Speedcross 5 Grape Leaf/Black/Phan L40968100 Men's UK 9.5/US 10,FBALYB Amazon,-5,-5,0,0,0,0
,Salomon Shoes Speedcross 5 Grape Leaf/Black/Phan L40968100 Men's UK 9/US 9.5,Salomon Shoes Speedcross 5 Grape Leaf/Black/Phan L40968100 Men's UK 9/US 9.5,FBALYB Amazon,-5,-5,0,0,0,0
,Salomon Shoes Speedcross 5 GTX Black/Black/Phantom L40795300 Men's UK 10.5/US 11,Salomon Shoes Speedcross 5 GTX Black/Black/Phantom L40795300 Men's UK 10.5/US 11,FBALYB Amazon,-7,-7,0,0,0,0
,Salomon Shoes Speedcross 5 GTX Black/Black/Phantom L40795300 Men's UK 10/US 10.5,Salomon Shoes Speedcross 5 GTX Black/Black/Phantom L40795300 Men's UK 10/US 10.5,FBALYB Amazon,-14,-14,0,0,0,0
,Salomon Shoes Speedcross 5 GTX Black/Black/Phantom L40795300 Men's UK 11.5/US 12,Salomon Shoes Speedcross 5 GTX Black/Black/Phantom L40795300 Men's UK 11.5/US 12,FBALYB Amazon,-8,-8,0,0,0,0
,Salomon Shoes Speedcross 5 GTX Black/Black/Phantom L40795300 Men's UK 11/US 11.5,Salomon Shoes Speedcross 5 GTX Black/Black/Phantom L40795300 Men's UK 11/US 11.5,FBALYB Amazon,-6,-6,0,0,0,0
,Salomon Shoes Speedcross 5 GTX Black/Black/Phantom L40795300 Men's UK 12.5/US 13,Salomon Shoes Speedcross 5 GTX Black/Black/Phantom L40795300 Men's UK 12.5/US 13,FBALYB Amazon,-2,-2,0,0,0,0
,Salomon Shoes Speedcross 5 GTX Black/Black/Phantom L40795300 Men's UK 8.5/US 9,Salomon Shoes Speedcross 5 GTX Black/Black/Phantom L40795300 Men's UK 8.5/US 9,FBALYB Amazon,-7,-7,0,0,0,0
,Salomon Shoes Speedcross 5 GTX Black/Black/Phantom L40795300 Men's UK 8/US 8.5,Salomon Shoes Speedcross 5 GTX Black/Black/Phantom L40795300 Men's UK 8/US 8.5,FBALYB Amazon,-6,-6,0,0,0,0
,Salomon Shoes Speedcross 5 GTX Black/Black/Phantom L40795300 Men's UK 9.5/US 10,Salomon Shoes Speedcross 5 GTX Black/Black/Phantom L40795300 Men's UK 9.5/US 10,FBALYB Amazon,-3,-3,0,0,0,0
,Salomon Shoes Speedcross 5 GTX Black/Black/Phantom L40795300 Men's UK 9/US 9.5,Salomon Shoes Speedcross 5 GTX Black/Black/Phantom L40795300 Men's UK 9/US 9.5,FBALYB Amazon,-5,-5,0,0,0,0
,Salomon Shoes Speedcross 5 GTX W Black/Black/Phantom L40795400 Women's UK 4.5/US 5,Salomon Shoes Speedcross 5 GTX W Black/Black/Phantom L40795400 Women's UK 4.5/US 5,FBALYB Amazon,-9,-9,0,0,0,0
,Salomon Shoes Speedcross 5 GTX W Black/Black/Phantom L40795400 Women's UK 4/US 4.5,Salomon Shoes Speedcross 5 GTX W Black/Black/Phantom L40795400 Women's UK 4/US 4.5,FBALYB Amazon,-1,-1,0,0,0,0
,Salomon Shoes Speedcross 5 GTX W Black/Black/Phantom L40795400 Women's UK 5.5/US 6,Salomon Shoes Speedcross 5 GTX W Black/Black/Phantom L40795400 Women's UK 5.5/US 6,FBALYB Amazon,-5,-5,0,0,0,0
,Salomon Shoes Speedcross 5 GTX W Black/Black/Phantom L40795400 Women's UK 6.5/US 7,Salomon Shoes Speedcross 5 GTX W Black/Black/Phantom L40795400 Women's UK 6.5/US 7,FBALYB Amazon,-7,-7,0,0,0,0
,Salomon Shoes Speedcross 5 GTX W Black/Black/Phantom L40795400 Women's UK 6/US 6.5,Salomon Shoes Speedcross 5 GTX W Black/Black/Phantom L40795400 Women's UK 6/US 6.5,FBALYB Amazon,-19,-19,0,0,0,0
,Salomon Shoes Speedcross 5 GTX W Black/Black/Phantom L40795400 Women's UK 7.5/US 8,Salomon Shoes Speedcross 5 GTX W Black/Black/Phantom L40795400 Women's UK 7.5/US 8,FBALYB Amazon,-4,-4,0,0,0,0
,Salomon Shoes Speedcross 5 GTX W Black/Black/Phantom L40795400 Women's UK 7/US 7.5,Salomon Shoes Speedcross 5 GTX W Black/Black/Phantom L40795400 Women's UK 7/US 7.5,FBALYB Amazon,-9,-9,0,0,0,0
,Salomon Shoes Speedcross 5 GTX W Black/Black/Phantom L40795400 Women's UK 8.5/US 9,Salomon Shoes Speedcross 5 GTX W Black/Black/Phantom L40795400 Women's UK 8.5/US 9,FBALYB Amazon,-9,-9,0,0,0,0
,Salomon Shoes Speedcross 5 GTX W Black/Black/Phantom L40795400 Women's UK 8/US 8.5,Salomon Shoes Speedcross 5 GTX W Black/Black/Phantom L40795400 Women's UK 8/US 8.5,FBALYB Amazon,-5,-5,0,0,0,0
,Salomon Shoes Speedcross 5 GTX W Black/Black/Phantom L40795400 Women's UK 9/US 9.5,Salomon Shoes Speedcross 5 GTX W Black/Black/Phantom L40795400 Women's UK 9/US 9.5,FBALYB Amazon,2,2,0,0,0,0
,Salomon Shoes Speedcross 5 Hawaiian Ocean/StoWea L41308900 Men's UK 10.5/US 11,Salomon Shoes Speedcross 5 Hawaiian Ocean/StoWea L41308900 Men's UK 10.5/US 11,FBALYB Amazon,-1,-1,0,0,0,0
,Salomon Shoes Speedcross 5 Hawaiian Ocean/StoWea L41308900 Men's UK 10/US 10.5,Salomon Shoes Speedcross 5 Hawaiian Ocean/StoWea L41308900 Men's UK 10/US 10.5,FBALYB Amazon,-3,-3,0,0,0,0
,Salomon Shoes Speedcross 5 Hawaiian Ocean/StoWea L41308900 Men's UK 11.5/US 12,Salomon Shoes Speedcross 5 Hawaiian Ocean/StoWea L41308900 Men's UK 11.5/US 12,FBALYB Amazon,-5,-5,0,0,0,0
,Salomon Shoes Speedcross 5 Hawaiian Ocean/StoWea L41308900 Men's UK 11/US 11.5,Salomon Shoes Speedcross 5 Hawaiian Ocean/StoWea L41308900 Men's UK 11/US 11.5,FBALYB Amazon,-5,-5,0,0,0,0
,Salomon Shoes Speedcross 5 Hawaiian Ocean/StoWea L41308900 Men's UK 12/US 12.5,Salomon Shoes Speedcross 5 Hawaiian Ocean/StoWea L41308900 Men's UK 12/US 12.5,FBALYB Amazon,-2,-2,0,0,0,0
,Salomon Shoes Speedcross 5 Hawaiian Ocean/StoWea L41308900 Men's UK 9/US 9.5,Salomon Shoes Speedcross 5 Hawaiian Ocean/StoWea L41308900 Men's UK 9/US 9.5,FBALYB Amazon,-1,-1,0,0,0,0
,Salomon Shoes Speedcross 5 Magnet/Black/Phantom L41042900 Men's UK 10.5/US 11,Salomon Shoes Speedcross 5 Magnet/Black/Phantom L41042900 Men's UK 10.5/US 11,FBALYB Amazon,-5,-5,0,0,0,0
,Salomon Shoes Speedcross 5 Magnet/Black/Phantom L41042900 Men's UK 10/US 10.5,Salomon Shoes Speedcross 5 Magnet/Black/Phantom L41042900 Men's UK 10/US 10.5,FBALYB Amazon,-8,-8,0,0,0,0
,Salomon Shoes Speedcross 5 Magnet/Black/Phantom L41042900 Men's UK 11.5/US 12,Salomon Shoes Speedcross 5 Magnet/Black/Phantom L41042900 Men's UK 11.5/US 12,FBALYB Amazon,-6,-6,0,0,0,0
,Salomon Shoes Speedcross 5 Magnet/Black/Phantom L41042900 Men's UK 11/US 11.5,Salomon Shoes Speedcross 5 Magnet/Black/Phantom L41042900 Men's UK 11/US 11.5,FBALYB Amazon,-8,-8,0,0,0,0
,Salomon Shoes Speedcross 5 Magnet/Black/Phantom L41042900 Men's UK 12/US 12.5,Salomon Shoes Speedcross 5 Magnet/Black/Phantom L41042900 Men's UK 12/US 12.5,FBALYB Amazon,-6,-6,0,0,0,0
,Salomon Shoes Speedcross 5 Magnet/Black/Phantom L41042900 Men's UK 8.5/US 9,Salomon Shoes Speedcross 5 Magnet/Black/Phantom L41042900 Men's UK 8.5/US 9,FBALYB Amazon,-7,-7,0,0,0,0
,Salomon Shoes Speedcross 5 Magnet/Black/Phantom L41042900 Men's UK 8/US 8.5,Salomon Shoes Speedcross 5 Magnet/Black/Phantom L41042900 Men's UK 8/US 8.5,FBALYB Amazon,-1,-1,0,0,0,0
,Salomon Shoes Speedcross 5 Magnet/Black/Phantom L41042900 Men's UK 9.5/US 10,Salomon Shoes Speedcross 5 Magnet/Black/Phantom L41042900 Men's UK 9.5/US 10,FBALYB Amazon,-2,-2,0,0,0,0
,Salomon Shoes Speedcross 5 Magnet/Black/Phantom L41042900 Men's UK 9/US 9.5,Salomon Shoes Speedcross 5 Magnet/Black/Phantom L41042900 Men's UK 9/US 9.5,FBALYB Amazon,-4,-4,0,0,0,0
,Salomon Shoes Speedcross 5 W Black/Black/Phantom 40684900 Women's UK 5.5/US 7,Salomon Shoes Speedcross 5 W Black/Black/Phantom 40684900 Women's UK 5.5/US 7,Default,6,6,0,0,0,0
,Salomon Shoes Speedcross 5 W Black/Black/Phantom 40684900 Women's UK 5.5/US 7,Salomon Shoes Speedcross 5 W Black/Black/Phantom 40684900 Women's UK 5.5/US 7,FBALYB Amazon,-40,-40,0,0,0,0
,Salomon Shoes Speedcross 5 W Black/Black/Phantom 40684900 Women's UK 5/US 6.5,Salomon Shoes Speedcross 5 W Black/Black/Phantom 40684900 Women's UK 5/US 6.5,FBALYB Amazon,-22,-22,0,0,0,0
,Salomon Shoes Speedcross 5 W Black/Black/Phantom 40684900 Women's UK 6.5/US 8,Salomon Shoes Speedcross 5 W Black/Black/Phantom 40684900 Women's UK 6.5/US 8,FBALYB Amazon,-19,-19,0,0,0,0
,Salomon Shoes Speedcross 5 W Black/Black/Phantom 40684900 Women's UK 6/US 7.5,Salomon Shoes Speedcross 5 W Black/Black/Phantom 40684900 Women's UK 6/US 7.5,FBALYB Amazon,-32,-32,0,0,0,0
,Salomon Shoes Speedcross 5 W Black/Black/Phantom 40684900 Women's UK 7.5/US 9,Salomon Shoes Speedcross 5 W Black/Black/Phantom 40684900 Women's UK 7.5/US 9,FBALYB Amazon,-19,-19,0,0,0,0
,Salomon Shoes Speedcross 5 W Black/Black/Phantom 40684900 Women's UK 7/US 8.5,Salomon Shoes Speedcross 5 W Black/Black/Phantom 40684900 Women's UK 7/US 8.5,FBALYB Amazon,-43,-44,1,0,1,0
,Salomon Shoes Speedcross 5 W Black/Black/Phantom 40684900 Women's UK 8.5/US 10,Salomon Shoes Speedcross 5 W Black/Black/Phantom 40684900 Women's UK 8.5/US 10,FBALYB Amazon,7,7,0,0,0,0
,Salomon Shoes Speedcross 5 W Black/Black/Phantom 40684900 Women's UK 8/US 9.5,Salomon Shoes Speedcross 5 W Black/Black/Phantom 40684900 Women's UK 8/US 9.5,FBALYB Amazon,-17,-17,0,0,0,0
,Salomon Shoes Speedcross 5 W Black/Black/Phantom 40684900 Women's UK 9/US 10.5,Salomon Shoes Speedcross 5 W Black/Black/Phantom 40684900 Women's UK 9/US 10.5,FBALYB Amazon,30,29,1,0,1,0
,Salomon Shoes Speedcross 5 W Bleached Sand/Wht/S L41309200 UK 5.5/US 7,Salomon Shoes Speedcross 5 W Bleached Sand/Wht/S L41309200 UK 5.5/US 7,Default,0,0,0,0,0,10
,Salomon Shoes Speedcross 5 W Bleached Sand/Wht/S L41309200 UK 5.5/US 7,Salomon Shoes Speedcross 5 W Bleached Sand/Wht/S L41309200 UK 5.5/US 7,Default Ridgefield,10,10,0,0,0,0
,Salomon Shoes Speedcross 5 W Bleached  Sand/Wht/S L41309200 UK 5/US 6.5,Salomon Shoes Speedcross 5 W Bleached  Sand/Wht/S L41309200 UK 5/US 6.5,Default,0,0,0,0,0,10
,Salomon Shoes Speedcross 5 W Bleached  Sand/Wht/S L41309200 UK 6.5/US 8,Salomon Shoes Speedcross 5 W Bleached  Sand/Wht/S L41309200 UK 6.5/US 8,Default,0,0,0,0,0,20
,Salomon Shoes Speedcross 5 W Bleached  Sand/Wht/S L41309200 UK 6.5/US 8,Salomon Shoes Speedcross 5 W Bleached  Sand/Wht/S L41309200 UK 6.5/US 8,Default Ridgefield,10,10,0,0,0,0
,Salomon Shoes Speedcross 5 W Bleached  Sand/Wht/S L41309200 UK 6/US 7.5,Salomon Shoes Speedcross 5 W Bleached  Sand/Wht/S L41309200 UK 6/US 7.5,Default,0,0,0,0,0,30
,Salomon Shoes Speedcross 5 W Bleached  Sand/Wht/S L41309200 UK 7.5/US 9,Salomon Shoes Speedcross 5 W Bleached  Sand/Wht/S L41309200 UK 7.5/US 9,Default Ridgefield,30,30,0,0,0,0
,Salomon Shoes Speedcross 5 W Bleached  Sand/Wht/S L41309200 UK 7/US 8.5,Salomon Shoes Speedcross 5 W Bleached  Sand/Wht/S L41309200 UK 7/US 8.5,Default,0,0,0,0,0,20
,Salomon Shoes Speedcross 5 W Bleached  Sand/Wht/S L41309200 UK 7/US 8.5,Salomon Shoes Speedcross 5 W Bleached  Sand/Wht/S L41309200 UK 7/US 8.5,Default Ridgefield,10,10,0,0,0,0
,Salomon Shoes Speedcross 5 W Bleached  Sand/Wht/S L41309200 UK 8.5/US 10,Salomon Shoes Speedcross 5 W Bleached  Sand/Wht/S L41309200 UK 8.5/US 10,Default Ridgefield,30,30,0,0,0,0
,Salomon Shoes Speedcross 5 W Bleached  Sand/Wht/S L41309200 UK 8/US 9.5,Salomon Shoes Speedcross 5 W Bleached  Sand/Wht/S L41309200 UK 8/US 9.5,Default Ridgefield,30,30,0,0,0,0
,Salomon Shoes Speedcross 5 W Bleached  Sand/Wht/S L41309200 UK 9/US 10.5,Salomon Shoes Speedcross 5 W Bleached  Sand/Wht/S L41309200 UK 9/US 10.5,Default Ridgefield,20,20,0,0,0,0
,Salomon Shoes Speedcross 5 W Brick Dust/Persimon L41309000 Women's UK 5.5/US 7,Salomon Shoes Speedcross 5 W Brick Dust/Persimon L41309000 Women's UK 5.5/US 7,FBALYB Amazon,-1,-2,1,0,1,0
,Salomon Shoes Speedcross 5 W Brick Dust/Persimon L41309000 Women's UK 5/US 6.5,Salomon Shoes Speedcross 5 W Brick Dust/Persimon L41309000 Women's UK 5/US 6.5,Default Ridgefield,20,20,0,0,0,0
,Salomon Shoes Speedcross 5 W Brick Dust/Persimon L41309000 Women's UK 6.5/US 8,Salomon Shoes Speedcross 5 W Brick Dust/Persimon L41309000 Women's UK 6.5/US 8,FBALYB Amazon,8,6,2,0,2,0
,Salomon Shoes Speedcross 5 W Brick Dust/Persimon L41309000 Women's UK 6/US 7.5,Salomon Shoes Speedcross 5 W Brick Dust/Persimon L41309000 Women's UK 6/US 7.5,Default Ridgefield,30,30,0,0,0,0
,Salomon Shoes Speedcross 5 W Brick Dust/Persimon L41309000 Women's UK 6/US 7.5,Salomon Shoes Speedcross 5 W Brick Dust/Persimon L41309000 Women's UK 6/US 7.5,FBALYB Amazon,-6,-6,0,0,0,0
,Salomon Shoes Speedcross 5 W Brick Dust/Persimon L41309000 Women's UK 7.5/US 9,Salomon Shoes Speedcross 5 W Brick Dust/Persimon L41309000 Women's UK 7.5/US 9,FBALYB Amazon,24,22,2,0,2,0
,Salomon Shoes Speedcross 5 W Brick Dust/Persimon L41309000 Women's UK 7/US 8.5,Salomon Shoes Speedcross 5 W Brick Dust/Persimon L41309000 Women's UK 7/US 8.5,Default Ridgefield,40,40,0,0,0,0
,Salomon Shoes Speedcross 5 W Brick Dust/Persimon L41309000 Women's UK 7/US 8.5,Salomon Shoes Speedcross 5 W Brick Dust/Persimon L41309000 Women's UK 7/US 8.5,FBALYB Amazon,-1,-1,0,0,0,0
,Salomon Shoes Speedcross 5 W Brick Dust/Persimon L41309000 Women's UK 8.5/US 10,Salomon Shoes Speedcross 5 W Brick Dust/Persimon L41309000 Women's UK 8.5/US 10,Default Ridgefield,20,20,0,0,0,0
,Salomon Shoes Speedcross 5 W Brick Dust/Persimon L41309000 Women's UK 8.5/US 10,Salomon Shoes Speedcross 5 W Brick Dust/Persimon L41309000 Women's UK 8.5/US 10,FBALYB Amazon,-1,-1,0,0,0,0
,Salomon Shoes Speedcross 5 W Brick Dust/Persimon L41309000 Women's UK 8/US 9.5,Salomon Shoes Speedcross 5 W Brick Dust/Persimon L41309000 Women's UK 8/US 9.5,FBALYB Amazon,22,22,0,0,0,0
,Salomon Shoes Speedcross 5 W Brick Dust/Persimon L41309000 Women's UK 9/US 10.5,Salomon Shoes Speedcross 5 W Brick Dust/Persimon L41309000 Women's UK 9/US 10.5,FBALYB Amazon,12,12,0,0,0,0
,Salomon Shoes Speedcross 5 Wide Black/Black/Phantom L40793500 Men's UK 10.5/US 11,Salomon Shoes Speedcross 5 Wide Black/Black/Phantom L40793500 Men's UK 10.5/US 11,FBALYB Amazon,-1,-1,0,0,0,0
,Salomon Shoes Speedcross 5 Wide Black/Black/Phantom L40793500 Men's UK 10/US 10.5,Salomon Shoes Speedcross 5 Wide Black/Black/Phantom L40793500 Men's UK 10/US 10.5,FBALYB Amazon,-1,-1,0,0,0,0
,Salomon Shoes Speedcross 5 Wide Black/Black/Phantom L40793500 Men's UK 11.5/US 12,Salomon Shoes Speedcross 5 Wide Black/Black/Phantom L40793500 Men's UK 11.5/US 12,FBALYB Amazon,-5,-5,0,0,0,0
,Salomon Shoes Speedcross 5 Wide Black/Black/Phantom L40793500 Men's UK 11/US 11.5,Salomon Shoes Speedcross 5 Wide Black/Black/Phantom L40793500 Men's UK 11/US 11.5,FBALYB Amazon,-3,-3,0,0,0,0
,Salomon Shoes Speedcross 5 Wide Black/Black/Phantom L40793500 Men's UK 12/US 12.5,Salomon Shoes Speedcross 5 Wide Black/Black/Phantom L40793500 Men's UK 12/US 12.5,FBALYB Amazon,-1,-1,0,0,0,0
,Salomon Shoes Speedcross 5 Wide Black/Black/Phantom L40793500 Men's UK 9.5/US 10,Salomon Shoes Speedcross 5 Wide Black/Black/Phantom L40793500 Men's UK 9.5/US 10,FBALYB Amazon,-6,-6,0,0,0,0
,Salomon Shoes Speedcross 5 Wide Black/Black/Phantom L40793500 Men's UK 9/US 9.5,Salomon Shoes Speedcross 5 Wide Black/Black/Phantom L40793500 Men's UK 9/US 9.5,FBALYB Amazon,-6,-6,0,0,0,0
,Salomon Shoes Speedcross 5 W  Sargasso Sea/Navy B L40801200 Women's UK 5.5/US 7,Salomon Shoes Speedcross 5 W  Sargasso Sea/Navy B L40801200 Women's UK 5.5/US 7,FBALYB Amazon,-23,-23,0,0,0,0
,Salomon Shoes Speedcross 5 W  Sargasso Sea/Navy B L40801200 Women's UK 5/US 6.5,Salomon Shoes Speedcross 5 W  Sargasso Sea/Navy B L40801200 Women's UK 5/US 6.5,FBALYB Amazon,-15,-15,0,0,0,0
,Salomon Shoes Speedcross 5 W  Sargasso Sea/Navy B L40801200 Women's UK 6.5/US 8,Salomon Shoes Speedcross 5 W  Sargasso Sea/Navy B L40801200 Women's UK 6.5/US 8,FBALYB Amazon,-17,-17,0,0,0,0
,Salomon Shoes Speedcross 5 W  Sargasso Sea/Navy B L40801200 Women's UK 6/US 7.5,Salomon Shoes Speedcross 5 W  Sargasso Sea/Navy B L40801200 Women's UK 6/US 7.5,FBALYB Amazon,-23,-23,0,0,0,0
,Salomon Shoes Speedcross 5 W  Sargasso Sea/Navy B L40801200 Women's UK 7.5/US 9,Salomon Shoes Speedcross 5 W  Sargasso Sea/Navy B L40801200 Women's UK 7.5/US 9,FBALYB Amazon,-63,-63,0,0,0,0
,Salomon Shoes Speedcross 5 W  Sargasso Sea/Navy B L40801200 Women's UK 7/US 8.5,Salomon Shoes Speedcross 5 W  Sargasso Sea/Navy B L40801200 Women's UK 7/US 8.5,FBALYB Amazon,-13,-13,0,0,0,0
,Salomon Shoes Speedcross 5 W  Sargasso Sea/Navy B L40801200 Women's UK 8.5/US 10,Salomon Shoes Speedcross 5 W  Sargasso Sea/Navy B L40801200 Women's UK 8.5/US 10,FBALYB Amazon,-15,-15,0,0,0,0
,Salomon Shoes Speedcross 5 W  Sargasso Sea/Navy B L40801200 Women's UK 8/US 9.5,Salomon Shoes Speedcross 5 W  Sargasso Sea/Navy B L40801200 Women's UK 8/US 9.5,FBALYB Amazon,-10,-10,0,0,0,0
,Salomon Shoes Speedcross 5 W Sargasso Sea/Navy Blazer/Heather L40801200 Women's UK 4.5/US 6,Salomon Shoes Speedcross 5 W Sargasso Sea/Navy Blazer/Heather L40801200 Women's UK 4.5/US 6,Default Oxford,15,15,0,0,0,0
,Salomon Shoes Speedcross 5 W Sargasso Sea/Navy Blazer/Heather L40801200 Women's UK 4.5/US 6,Salomon Shoes Speedcross 5 W Sargasso Sea/Navy Blazer/Heather L40801200 Women's UK 4.5/US 6,FBALYB Amazon,-6,-6,0,1,0,0
,Salomon Shoes Speedcross 5 W Sargasso Sea/Navy Blazer/Heather L40801200 Women's UK 4/US 5.5,Salomon Shoes Speedcross 5 W Sargasso Sea/Navy Blazer/Heather L40801200 Women's UK 4/US 5.5,FBALYB Amazon,-1,-1,0,2,0,0
,Salomon Shoes Speedcross 5 W Sargasso Sea/Navy Blazer/Heather L40801200 Women's UK 5.5/US 7,Salomon Shoes Speedcross 5 W Sargasso Sea/Navy Blazer/Heather L40801200 Women's UK 5.5/US 7,Default Ridgefield,5,5,0,0,0,0
,Salomon Shoes Speedcross 5 W Sargasso Sea/Navy Blazer/Heather L40801200 Women's UK 5.5/US 7,Salomon Shoes Speedcross 5 W Sargasso Sea/Navy Blazer/Heather L40801200 Women's UK 5.5/US 7,FBALYB Amazon,-1,-3,2,2,2,0
,Salomon Shoes Speedcross 5 W Sargasso Sea/Navy Blazer/Heather L40801200 Women's UK 5/US 6.5,Salomon Shoes Speedcross 5 W Sargasso Sea/Navy Blazer/Heather L40801200 Women's UK 5/US 6.5,FBALYB Amazon,-1,-1,0,0,0,0
,Salomon Shoes Speedcross 5 W Sargasso Sea/Navy Blazer/Heather L40801200 Women's UK 6/US 7.5,Salomon Shoes Speedcross 5 W Sargasso Sea/Navy Blazer/Heather L40801200 Women's UK 6/US 7.5,Default Ridgefield,2,2,0,0,0,0
,Salomon Shoes Speedcross 5 W Sargasso Sea/Navy Blazer/Heather L40801200 Women's UK 6/US 7.5,Salomon Shoes Speedcross 5 W Sargasso Sea/Navy Blazer/Heather L40801200 Women's UK 6/US 7.5,FBALYB Amazon,-5,-5,0,0,0,0
,Salomon Shoes Speedcross 5 W Sargasso Sea/Navy Blazer/Heather L40801200 Women's UK 7.5/US 9,Salomon Shoes Speedcross 5 W Sargasso Sea/Navy Blazer/Heather L40801200 Women's UK 7.5/US 9,Default Ridgefield,40,40,0,0,0,0
,Salomon Shoes Speedcross 5 W Sargasso Sea/Navy Blazer/Heather L40801200 Women's UK 7.5/US 9,Salomon Shoes Speedcross 5 W Sargasso Sea/Navy Blazer/Heather L40801200 Women's UK 7.5/US 9,FBALYB Amazon,-8,-8,0,0,0,0
,Salomon Shoes Speedcross 5 W Sargasso Sea/Navy Blazer/Heather L40801200 Women's UK 7/US 8.5,Salomon Shoes Speedcross 5 W Sargasso Sea/Navy Blazer/Heather L40801200 Women's UK 7/US 8.5,Default Oxford,50,50,0,0,0,0
,Salomon Shoes Speedcross 5 W Sargasso Sea/Navy Blazer/Heather L40801200 Women's UK 7/US 8.5,Salomon Shoes Speedcross 5 W Sargasso Sea/Navy Blazer/Heather L40801200 Women's UK 7/US 8.5,Default Ridgefield,5,5,0,0,0,0
,Salomon Shoes Speedcross 5 W Sargasso Sea/Navy Blazer/Heather L40801200 Women's UK 8.5/US 10,Salomon Shoes Speedcross 5 W Sargasso Sea/Navy Blazer/Heather L40801200 Women's UK 8.5/US 10,Default Oxford,15,15,0,0,0,0
,Salomon Shoes Speedcross 5 W Sargasso Sea/Navy Blazer/Heather L40801200 Women's UK 8.5/US 10,Salomon Shoes Speedcross 5 W Sargasso Sea/Navy Blazer/Heather L40801200 Women's UK 8.5/US 10,FBALYB Amazon,-6,-6,0,0,0,0
,Salomon Shoes Speedcross 5 W Sargasso Sea/Navy Blazer/Heather L40801200 Women's UK 8/US 9.5,Salomon Shoes Speedcross 5 W Sargasso Sea/Navy Blazer/Heather L40801200 Women's UK 8/US 9.5,Default Oxford,15,15,0,0,0,0
,Salomon Shoes Speedcross 5 W Sargasso Sea/Navy Blazer/Heather L40801200 Women's UK 8/US 9.5,Salomon Shoes Speedcross 5 W Sargasso Sea/Navy Blazer/Heather L40801200 Women's UK 8/US 9.5,FBALYB Amazon,-5,-5,0,0,0,0
,Salomon Shoes Speedcross 5 W Sargasso Sea/Navy Blazer/Heather L40801200 Women's UK 9/US 10.5,Salomon Shoes Speedcross 5 W Sargasso Sea/Navy Blazer/Heather L40801200 Women's UK 9/US 10.5,Default Oxford,15,15,0,0,0,0
,Salomon Shoes Speedcross 5 W Trellis/StoWea/Phan L41309300 Women's UK 5.5/US 7,Salomon Shoes Speedcross 5 W Trellis/StoWea/Phan L41309300 Women's UK 5.5/US 7,FBALYB Amazon,4,4,0,0,0,0
,Salomon Shoes Speedcross 5 W Trellis/StoWea/Phan L41309300 Women's UK 6.5/US 8,Salomon Shoes Speedcross 5 W Trellis/StoWea/Phan L41309300 Women's UK 6.5/US 8,FBALYB Amazon,-4,-4,0,0,0,0
,Salomon Shoes Speedcross 5 W Trellis/StoWea/Phan L41309300 Women's UK 6/US 7.5,Salomon Shoes Speedcross 5 W Trellis/StoWea/Phan L41309300 Women's UK 6/US 7.5,FBALYB Amazon,-6,-6,0,0,0,0
,Salomon Shoes Speedcross 5 W Trellis/StoWea/Phan L41309300 Women's UK 7.5/US 9,Salomon Shoes Speedcross 5 W Trellis/StoWea/Phan L41309300 Women's UK 7.5/US 9,FBALYB Amazon,-2,-2,0,0,0,0
,Salomon Shoes Speedcross 5 W Trellis/StoWea/Phan L41309300 Women's UK 7/US 8.5,Salomon Shoes Speedcross 5 W Trellis/StoWea/Phan L41309300 Women's UK 7/US 8.5,FBALYB Amazon,-6,-6,0,0,0,0
,Salomon Shoes Speedcross 5 W Trellis/StoWea/Phan L41309300 Women's UK 8.5/US 10,Salomon Shoes Speedcross 5 W Trellis/StoWea/Phan L41309300 Women's UK 8.5/US 10,FBALYB Amazon,7,6,1,0,1,0
,Salomon Shoes Speedcross 5 W Trellis/StoWea/Phan L41309300 Women's UK 8/US 9.5,Salomon Shoes Speedcross 5 W Trellis/StoWea/Phan L41309300 Women's UK 8/US 9.5,FBALYB Amazon,-13,-13,0,0,0,0
,Salomon Shoes Speedcross 5 W Trellis/StoWea/Phan L41309300 Women's UK 9/US 10.5,Salomon Shoes Speedcross 5 W Trellis/StoWea/Phan L41309300 Women's UK 9/US 10.5,FBALYB Amazon,4,4,0,0,0,0
,Salomon Shoes Speedcross GTX W Black/Black/Phantom L40795400 Women's UK 5/US 5.5,Salomon Shoes Speedcross GTX W Black/Black/Phantom L40795400 Women's UK 5/US 5.5,FBALYB Amazon,-4,-4,0,0,0,0
,Salomon Shoes Tech Amphib 4 W Black/Bistre/Tawny L40992800 Women's UK 5.5/US 7,Salomon Shoes Tech Amphib 4 W Black/Bistre/Tawny L40992800 Women's UK 5.5/US 7,FBALYB Amazon,-7,-7,0,0,0,0
,Salomon Shoes Tech Amphib 4 W Black/Bistre/Tawny L40992800 Women's UK 6.5/US 8,Salomon Shoes Tech Amphib 4 W Black/Bistre/Tawny L40992800 Women's UK 6.5/US 8,FBALYB Amazon,-2,-2,0,0,0,0
,Salomon Shoes Tech Amphib 4 W Black/Bistre/Tawny L40992800 Women's UK 6/US 7.5,Salomon Shoes Tech Amphib 4 W Black/Bistre/Tawny L40992800 Women's UK 6/US 7.5,FBALYB Amazon,-3,-3,0,0,0,0
,Salomon Shoes Tech Amphib 4 W Black/Bistre/Tawny L40992800 Women's UK 7.5/US 9,Salomon Shoes Tech Amphib 4 W Black/Bistre/Tawny L40992800 Women's UK 7.5/US 9,FBALYB Amazon,-3,-3,0,0,0,0
,Salomon Shoes Tech Amphib 4 W Black/Bistre/Tawny L40992800 Women's UK 7/US 8.5,Salomon Shoes Tech Amphib 4 W Black/Bistre/Tawny L40992800 Women's UK 7/US 8.5,FBALYB Amazon,-5,-5,0,0,0,0
,Salomon Shoes Tech Amphib 4 W Black/Bistre/Tawny L40992800 Women's UK 8/US 9.5,Salomon Shoes Tech Amphib 4 W Black/Bistre/Tawny L40992800 Women's UK 8/US 9.5,FBALYB Amazon,6,6,0,0,0,0
,Salomon Shoes XA Pro 3D V8 Black/Black/Black L40987400 Men's UK 10.5/US 11,Salomon Shoes XA Pro 3D V8 Black/Black/Black L40987400 Men's UK 10.5/US 11,Default Ridgefield,25,25,0,0,0,0
,Salomon Shoes XA Pro 3D V8 Black/Black/Black L40987400 Men's UK 10.5/US 11,Salomon Shoes XA Pro 3D V8 Black/Black/Black L40987400 Men's UK 10.5/US 11,FBALYB Amazon,-2,-2,0,0,0,0
,Salomon Shoes XA Pro 3D V8 Black/Black/Black L40987400 Men's UK 10/US 10.5,Salomon Shoes XA Pro 3D V8 Black/Black/Black L40987400 Men's UK 10/US 10.5,FBALYB Amazon,-17,-17,0,0,0,0
,Salomon Shoes XA Pro 3D V8 Black/Black/Black L40987400 Men's UK 11.5/US 12,Salomon Shoes XA Pro 3D V8 Black/Black/Black L40987400 Men's UK 11.5/US 12,FBALYB Amazon,-19,-19,0,0,0,0
,Salomon Shoes XA Pro 3D V8 Black/Black/Black L40987400 Men's UK 11/US 11.5,Salomon Shoes XA Pro 3D V8 Black/Black/Black L40987400 Men's UK 11/US 11.5,FBALYB Amazon,-6,-6,0,0,0,0
,Salomon Shoes XA Pro 3D V8 Black/Black/Black L40987400 Men's UK 12.5/US 13,Salomon Shoes XA Pro 3D V8 Black/Black/Black L40987400 Men's UK 12.5/US 13,FBALYB Amazon,-1,-1,0,0,0,0
,Salomon Shoes XA Pro 3D V8 Black/Black/Black L40987400 Men's UK 12/US 12.5,Salomon Shoes XA Pro 3D V8 Black/Black/Black L40987400 Men's UK 12/US 12.5,Default Ridgefield,15,15,0,0,0,0
,Salomon Shoes XA Pro 3D V8 Black/Black/Black L40987400 Men's UK 12/US 12.5,Salomon Shoes XA Pro 3D V8 Black/Black/Black L40987400 Men's UK 12/US 12.5,FBALYB Amazon,-3,-3,0,0,0,0
,Salomon Shoes XA Pro 3D V8 Black/Black/Black L40987400 Men's UK 6.5/US 7,Salomon Shoes XA Pro 3D V8 Black/Black/Black L40987400 Men's UK 6.5/US 7,FBALYB Amazon,-2,-2,0,0,0,0
,Salomon Shoes XA Pro 3D V8 Black/Black/Black L40987400 Men's UK 7.5/US 8,Salomon Shoes XA Pro 3D V8 Black/Black/Black L40987400 Men's UK 7.5/US 8,FBALYB Amazon,-1,-1,0,0,0,0
,Salomon Shoes XA Pro 3D V8 Black/Black/Black L40987400 Men's UK 8.5/US 9,Salomon Shoes XA Pro 3D V8 Black/Black/Black L40987400 Men's UK 8.5/US 9,Default Ridgefield,20,20,0,0,0,0
,Salomon Shoes XA Pro 3D V8 Black/Black/Black L40987400 Men's UK 8.5/US 9,Salomon Shoes XA Pro 3D V8 Black/Black/Black L40987400 Men's UK 8.5/US 9,FBALYB Amazon,-12,-12,0,1,0,0
,Salomon Shoes XA Pro 3D V8 Black/Black/Black L40987400 Men's UK 8/US 8.5,Salomon Shoes XA Pro 3D V8 Black/Black/Black L40987400 Men's UK 8/US 8.5,Default Ridgefield,10,10,0,0,0,0
,Salomon Shoes XA Pro 3D V8 Black/Black/Black L40987400 Men's UK 8/US 8.5,Salomon Shoes XA Pro 3D V8 Black/Black/Black L40987400 Men's UK 8/US 8.5,FBALYB Amazon,-3,-3,0,0,0,0
,Salomon Shoes XA Pro 3D V8 Black/Black/Black L40987400 Men's UK 9.5/US 10,Salomon Shoes XA Pro 3D V8 Black/Black/Black L40987400 Men's UK 9.5/US 10,Default Ridgefield,25,25,0,0,0,0
,Salomon Shoes XA Pro 3D V8 Black/Black/Black L40987400 Men's UK 9.5/US 10,Salomon Shoes XA Pro 3D V8 Black/Black/Black L40987400 Men's UK 9.5/US 10,FBALYB Amazon,-7,-7,0,0,0,0
,Salomon Shoes XA Pro 3D V8 Black/Black/Black L40987400 Men's UK 9/US 9.5,Salomon Shoes XA Pro 3D V8 Black/Black/Black L40987400 Men's UK 9/US 9.5,FBALYB Amazon,-13,-13,0,0,0,0
,Salomon Shoes Xa Pro 3D V8 Grape Leaf/Peat/Shadow L40987500 Men's UK 10.5/US 11,Salomon Shoes Xa Pro 3D V8 Grape Leaf/Peat/Shadow L40987500 Men's UK 10.5/US 11,Default Ridgefield,15,15,0,0,0,0
,Salomon Shoes Xa Pro 3D V8 Grape Leaf/Peat/Shadow L40987500 Men's UK 10.5/US 11,Salomon Shoes Xa Pro 3D V8 Grape Leaf/Peat/Shadow L40987500 Men's UK 10.5/US 11,FBALYB Amazon,-8,-8,0,0,0,0
,Salomon Shoes Xa Pro 3D V8 Grape Leaf/Peat/Shadow L40987500 Men's UK 10/US 10.5,Salomon Shoes Xa Pro 3D V8 Grape Leaf/Peat/Shadow L40987500 Men's UK 10/US 10.5,Default Ridgefield,15,15,0,0,0,0
,Salomon Shoes Xa Pro 3D V8 Grape Leaf/Peat/Shadow L40987500 Men's UK 10/US 10.5,Salomon Shoes Xa Pro 3D V8 Grape Leaf/Peat/Shadow L40987500 Men's UK 10/US 10.5,FBALYB Amazon,-9,-9,0,0,0,0
,Salomon Shoes Xa Pro 3D V8 Grape Leaf/Peat/Shadow L40987500 Men's UK 11.5/US 12,Salomon Shoes Xa Pro 3D V8 Grape Leaf/Peat/Shadow L40987500 Men's UK 11.5/US 12,Default Ridgefield,15,15,0,0,0,0
,Salomon Shoes Xa Pro 3D V8 Grape Leaf/Peat/Shadow L40987500 Men's UK 11.5/US 12,Salomon Shoes Xa Pro 3D V8 Grape Leaf/Peat/Shadow L40987500 Men's UK 11.5/US 12,FBALYB Amazon,-6,-6,0,0,0,0
,Salomon Shoes Xa Pro 3D V8 Grape Leaf/Peat/Shadow L40987500 Men's UK 11/US 11.5,Salomon Shoes Xa Pro 3D V8 Grape Leaf/Peat/Shadow L40987500 Men's UK 11/US 11.5,Default Ridgefield,15,15,0,0,0,0
,Salomon Shoes Xa Pro 3D V8 Grape Leaf/Peat/Shadow L40987500 Men's UK 11/US 11.5,Salomon Shoes Xa Pro 3D V8 Grape Leaf/Peat/Shadow L40987500 Men's UK 11/US 11.5,FBALYB Amazon,-6,-6,0,0,0,0
,Salomon Shoes Xa Pro 3D V8 Grape Leaf/Peat/Shadow L40987500 Men's UK 12.5/US 13,Salomon Shoes Xa Pro 3D V8 Grape Leaf/Peat/Shadow L40987500 Men's UK 12.5/US 13,FBALYB Amazon,-4,-4,0,0,0,0
,Salomon Shoes Xa Pro 3D V8 Grape Leaf/Peat/Shadow L40987500 Men's UK 12/US 12.5,Salomon Shoes Xa Pro 3D V8 Grape Leaf/Peat/Shadow L40987500 Men's UK 12/US 12.5,Default Ridgefield,10,10,0,0,0,0
,Salomon Shoes Xa Pro 3D V8 Grape Leaf/Peat/Shadow L40987500 Men's UK 12/US 12.5,Salomon Shoes Xa Pro 3D V8 Grape Leaf/Peat/Shadow L40987500 Men's UK 12/US 12.5,FBALYB Amazon,-2,-2,0,0,0,0
,Salomon Shoes Xa Pro 3D V8 Grape Leaf/Peat/Shadow L40987500 Men's UK 8.5/US 9,Salomon Shoes Xa Pro 3D V8 Grape Leaf/Peat/Shadow L40987500 Men's UK 8.5/US 9,Default Ridgefield,10,10,0,0,0,0
,Salomon Shoes Xa Pro 3D V8 Grape Leaf/Peat/Shadow L40987500 Men's UK 8.5/US 9,Salomon Shoes Xa Pro 3D V8 Grape Leaf/Peat/Shadow L40987500 Men's UK 8.5/US 9,FBALYB Amazon,-1,-1,0,0,0,0
,Salomon Shoes Xa Pro 3D V8 Grape Leaf/Peat/Shadow L40987500 Men's UK 8/US 8.5,Salomon Shoes Xa Pro 3D V8 Grape Leaf/Peat/Shadow L40987500 Men's UK 8/US 8.5,Default Ridgefield,5,5,0,0,0,0
,Salomon Shoes Xa Pro 3D V8 Grape Leaf/Peat/Shadow L40987500 Men's UK 8/US 8.5,Salomon Shoes Xa Pro 3D V8 Grape Leaf/Peat/Shadow L40987500 Men's UK 8/US 8.5,FBALYB Amazon,-1,-1,0,0,0,0
,Salomon Shoes Xa Pro 3D V8 Grape Leaf/Peat/Shadow L40987500 Men's UK 9.5/US 10,Salomon Shoes Xa Pro 3D V8 Grape Leaf/Peat/Shadow L40987500 Men's UK 9.5/US 10,Default Ridgefield,15,15,0,0,0,0
,Salomon Shoes Xa Pro 3D V8 Grape Leaf/Peat/Shadow L40987500 Men's UK 9.5/US 10,Salomon Shoes Xa Pro 3D V8 Grape Leaf/Peat/Shadow L40987500 Men's UK 9.5/US 10,FBALYB Amazon,-4,-4,0,0,0,0
,Salomon Shoes Xa Pro 3D V8 Grape Leaf/Peat/Shadow L40987500 Men's UK 9/US 9.5,Salomon Shoes Xa Pro 3D V8 Grape Leaf/Peat/Shadow L40987500 Men's UK 9/US 9.5,Default Ridgefield,15,15,0,0,0,0
,Salomon Shoes Xa Pro 3D V8 Grape Leaf/Peat/Shadow L40987500 Men's UK 9/US 9.5,Salomon Shoes Xa Pro 3D V8 Grape Leaf/Peat/Shadow L40987500 Men's UK 9/US 9.5,FBALYB Amazon,-1,-1,0,0,0,0
,Salomon Shoes XA Pro 3D V8 GTX Black/Black/Black L40988900 Men's UK 10.5/US 11,Salomon Shoes XA Pro 3D V8 GTX Black/Black/Black L40988900 Men's UK 10.5/US 11,FBALYB Amazon,-9,-9,0,0,0,0
,Salomon Shoes XA Pro 3D V8 GTX Black/Black/Black L40988900 Men's UK 10/US 10.5,Salomon Shoes XA Pro 3D V8 GTX Black/Black/Black L40988900 Men's UK 10/US 10.5,FBALYB Amazon,-8,-9,1,0,1,0
,Salomon Shoes XA Pro 3D V8 GTX Black/Black/Black L40988900 Men's UK 11.5/US 12,Salomon Shoes XA Pro 3D V8 GTX Black/Black/Black L40988900 Men's UK 11.5/US 12,FBALYB Amazon,-8,-8,0,0,0,0
,Salomon Shoes XA Pro 3D V8 GTX Black/Black/Black L40988900 Men's UK 11/US 11.5,Salomon Shoes XA Pro 3D V8 GTX Black/Black/Black L40988900 Men's UK 11/US 11.5,FBALYB Amazon,-7,-7,0,0,0,0
,Salomon Shoes XA Pro 3D V8 GTX Black/Black/Black L40988900 Men's UK 12.5/US 13,Salomon Shoes XA Pro 3D V8 GTX Black/Black/Black L40988900 Men's UK 12.5/US 13,Default,1,1,0,0,0,0
,Salomon Shoes XA Pro 3D V8 GTX Black/Black/Black L40988900 Men's UK 12.5/US 13,Salomon Shoes XA Pro 3D V8 GTX Black/Black/Black L40988900 Men's UK 12.5/US 13,FBALYB Amazon,-3,-3,0,0,0,0
,Salomon Shoes XA Pro 3D V8 GTX Black/Black/Black L40988900 Men's UK 12/US 12.5,Salomon Shoes XA Pro 3D V8 GTX Black/Black/Black L40988900 Men's UK 12/US 12.5,FBALYB Amazon,-4,-4,0,0,0,0
,Salomon Shoes XA Pro 3D V8 GTX Black/Black/Black L40988900 Men's UK 8.5/US 9,Salomon Shoes XA Pro 3D V8 GTX Black/Black/Black L40988900 Men's UK 8.5/US 9,Default Ridgefield,15,15,0,0,0,0
,Salomon Shoes XA Pro 3D V8 GTX Black/Black/Black L40988900 Men's UK 8.5/US 9,Salomon Shoes XA Pro 3D V8 GTX Black/Black/Black L40988900 Men's UK 8.5/US 9,FBALYB Amazon,-1,-1,0,0,0,0
,Salomon Shoes XA Pro 3D V8 GTX Black/Black/Black L40988900 Men's UK 8/US 8.5,Salomon Shoes XA Pro 3D V8 GTX Black/Black/Black L40988900 Men's UK 8/US 8.5,FBALYB Amazon,-1,-1,0,0,0,0
,Salomon Shoes XA Pro 3D V8 GTX Black/Black/Black L40988900 Men's UK 9.5/US 10,Salomon Shoes XA Pro 3D V8 GTX Black/Black/Black L40988900 Men's UK 9.5/US 10,FBALYB Amazon,-3,-3,0,0,0,0
,Salomon Shoes XA Pro 3D V8 GTX Black/Black/Black L40988900 Men's UK 9/US 9.5,Salomon Shoes XA Pro 3D V8 GTX Black/Black/Black L40988900 Men's UK 9/US 9.5,Default Ridgefield,20,20,0,0,0,0
,Salomon Shoes XA Pro 3D V8 GTX Black/Black/Black L40988900 Men's UK 9/US 9.5,Salomon Shoes XA Pro 3D V8 GTX Black/Black/Black L40988900 Men's UK 9/US 9.5,FBALYB Amazon,-7,-7,0,0,0,0
,Salomon Shoes Xa Pro 3D V8 GTX Ebony/Caramel Cafe/Black L40989200 Men's UK 10.5/US 11,Salomon Shoes Xa Pro 3D V8 GTX Ebony/Caramel Cafe/Black L40989200 Men's UK 10.5/US 11,FBALYB Amazon,-5,-5,0,0,0,0
,Salomon Shoes Xa Pro 3D V8 GTX Ebony/Caramel Cafe/Black L40989200 Men's UK 10/US 10.5,Salomon Shoes Xa Pro 3D V8 GTX Ebony/Caramel Cafe/Black L40989200 Men's UK 10/US 10.5,FBALYB Amazon,-7,-7,0,0,0,0
,Salomon Shoes Xa Pro 3D V8 GTX Ebony/Caramel Cafe/Black L40989200 Men's UK 11.5/US 12,Salomon Shoes Xa Pro 3D V8 GTX Ebony/Caramel Cafe/Black L40989200 Men's UK 11.5/US 12,FBALYB Amazon,-11,-11,0,0,0,0
,Salomon Shoes Xa Pro 3D V8 GTX Ebony/Caramel Cafe/Black L40989200 Men's UK 12.5/US 13,Salomon Shoes Xa Pro 3D V8 GTX Ebony/Caramel Cafe/Black L40989200 Men's UK 12.5/US 13,FBALYB Amazon,-2,-2,0,0,0,0
,Salomon Shoes Xa Pro 3D V8 GTX Ebony/Caramel Cafe/Black L40989200 Men's UK 8.5/US 9,Salomon Shoes Xa Pro 3D V8 GTX Ebony/Caramel Cafe/Black L40989200 Men's UK 8.5/US 9,FBALYB Amazon,-2,-2,0,0,0,0
,Salomon Shoes Xa Pro 3D V8 GTX Ebony/Caramel Cafe/Black L40989200 Men's UK 8/US 8.5,Salomon Shoes Xa Pro 3D V8 GTX Ebony/Caramel Cafe/Black L40989200 Men's UK 8/US 8.5,FBALYB Amazon,-1,-1,0,0,0,0
,Salomon Shoes Xa Pro 3D V8 GTX Ebony/Caramel Cafe/Black L40989200 Men's UK 9.5/US 10,Salomon Shoes Xa Pro 3D V8 GTX Ebony/Caramel Cafe/Black L40989200 Men's UK 9.5/US 10,FBALYB Amazon,-1,-1,0,0,0,0
,Salomon Shoes Xa Pro 3D V8 GTX Ebony/Caramel Cafe/Black L40989200 Men's UK 9/US 9.5,Salomon Shoes Xa Pro 3D V8 GTX Ebony/Caramel Cafe/Black L40989200 Men's UK 9/US 9.5,FBALYB Amazon,-1,-1,0,0,0,0
,Salomon Shoes XA Pro 3D v8 GTX W Black/Black/Pha L41118200 Women's UK 5.5/US 7,Salomon Shoes XA Pro 3D v8 GTX W Black/Black/Pha L41118200 Women's UK 5.5/US 7,Avrami - Ebay,10,10,0,0,0,0
,Salomon Shoes XA Pro 3D v8 GTX W Black/Black/Pha L41118200 Women's UK 5.5/US 7,Salomon Shoes XA Pro 3D v8 GTX W Black/Black/Pha L41118200 Women's UK 5.5/US 7,Default Ridgefield,10,10,0,0,0,0
,Salomon Shoes XA Pro 3D v8 GTX W Black/Black/Pha L41118200 Women's UK 5/US 6.5,Salomon Shoes XA Pro 3D v8 GTX W Black/Black/Pha L41118200 Women's UK 5/US 6.5,Avrami - Ebay,5,5,0,0,0,0
,Salomon Shoes XA Pro 3D v8 GTX W Black/Black/Pha L41118200 Women's UK 5/US 6.5,Salomon Shoes XA Pro 3D v8 GTX W Black/Black/Pha L41118200 Women's UK 5/US 6.5,Default Ridgefield,5,5,0,0,0,0
,Salomon Shoes XA Pro 3D v8 GTX W Black/Black/Pha L41118200 Women's UK 6.5/US 8,Salomon Shoes XA Pro 3D v8 GTX W Black/Black/Pha L41118200 Women's UK 6.5/US 8,Avrami - Ebay,15,15,0,0,0,0
,Salomon Shoes XA Pro 3D v8 GTX W Black/Black/Pha L41118200 Women's UK 6.5/US 8,Salomon Shoes XA Pro 3D v8 GTX W Black/Black/Pha L41118200 Women's UK 6.5/US 8,Default Ridgefield,15,15,0,0,0,0
,Salomon Shoes XA Pro 3D v8 GTX W Black/Black/Pha L41118200 Women's UK 6/US 7.5,Salomon Shoes XA Pro 3D v8 GTX W Black/Black/Pha L41118200 Women's UK 6/US 7.5,Avrami - Ebay,15,15,0,0,0,0
,Salomon Shoes XA Pro 3D v8 GTX W Black/Black/Pha L41118200 Women's UK 6/US 7.5,Salomon Shoes XA Pro 3D v8 GTX W Black/Black/Pha L41118200 Women's UK 6/US 7.5,Default Ridgefield,15,15,0,0,0,0
,Salomon Shoes XA Pro 3D v8 GTX W Black/Black/Pha L41118200 Women's UK 7.5/US 9,Salomon Shoes XA Pro 3D v8 GTX W Black/Black/Pha L41118200 Women's UK 7.5/US 9,Avrami - Ebay,15,15,0,0,0,0
,Salomon Shoes XA Pro 3D v8 GTX W Black/Black/Pha L41118200 Women's UK 7.5/US 9,Salomon Shoes XA Pro 3D v8 GTX W Black/Black/Pha L41118200 Women's UK 7.5/US 9,Default Ridgefield,15,15,0,0,0,0
,Salomon Shoes XA Pro 3D v8 GTX W Black/Black/Pha L41118200 Women's UK 7/US 8.5,Salomon Shoes XA Pro 3D v8 GTX W Black/Black/Pha L41118200 Women's UK 7/US 8.5,Avrami - Ebay,15,15,0,0,0,0
,Salomon Shoes XA Pro 3D v8 GTX W Black/Black/Pha L41118200 Women's UK 7/US 8.5,Salomon Shoes XA Pro 3D v8 GTX W Black/Black/Pha L41118200 Women's UK 7/US 8.5,Default Ridgefield,15,15,0,0,0,0
,Salomon Shoes XA Pro 3D v8 GTX W Black/Black/Pha L41118200 Women's UK 8.5/US 10,Salomon Shoes XA Pro 3D v8 GTX W Black/Black/Pha L41118200 Women's UK 8.5/US 10,Avrami - Ebay,15,15,0,0,0,0
,Salomon Shoes XA Pro 3D v8 GTX W Black/Black/Pha L41118200 Women's UK 8.5/US 10,Salomon Shoes XA Pro 3D v8 GTX W Black/Black/Pha L41118200 Women's UK 8.5/US 10,Default Ridgefield,15,15,0,0,0,0
,Salomon Shoes XA Pro 3D v8 GTX W Black/Black/Pha L41118200 Women's UK 8/US 9.5,Salomon Shoes XA Pro 3D v8 GTX W Black/Black/Pha L41118200 Women's UK 8/US 9.5,Avrami - Ebay,15,15,0,0,0,0
,Salomon Shoes XA Pro 3D v8 GTX W Black/Black/Pha L41118200 Women's UK 8/US 9.5,Salomon Shoes XA Pro 3D v8 GTX W Black/Black/Pha L41118200 Women's UK 8/US 9.5,Default Ridgefield,15,15,0,0,0,0
,Salomon Shoes XA Pro 3D v8 GTX W Black/Black/Pha L41118200 Women's UK 9/US 10.5,Salomon Shoes XA Pro 3D v8 GTX W Black/Black/Pha L41118200 Women's UK 9/US 10.5,Avrami - Ebay,10,10,0,0,0,0
,Salomon Shoes XA Pro 3D v8 GTX W Black/Black/Pha L41118200 Women's UK 9/US 10.5,Salomon Shoes XA Pro 3D v8 GTX W Black/Black/Pha L41118200 Women's UK 9/US 10.5,Default Ridgefield,10,10,0,0,0,0
,Salomon Shoes XA Pro 3D V8 Sargasso Sea/Imperial Blue/Angel Falls L40987700 Men's UK 10.5/US 11,Salomon Shoes XA Pro 3D V8 Sargasso Sea/Imperial Blue/Angel Falls L40987700 Men's UK 10.5/US 11,FBALYB Amazon,-1,-1,0,0,0,0
,Salomon Shoes XA Pro 3D V8 Sargasso Sea/Imperial Blue/Angel Falls L40987700 Men's UK 10/US 10.5,Salomon Shoes XA Pro 3D V8 Sargasso Sea/Imperial Blue/Angel Falls L40987700 Men's UK 10/US 10.5,FBALYB Amazon,-1,-1,0,0,0,0
,Salomon Shoes XA Pro 3D V8 Sargasso Sea/Imperial Blue/Angel Falls L40987700 Men's UK 11.5/US 12,Salomon Shoes XA Pro 3D V8 Sargasso Sea/Imperial Blue/Angel Falls L40987700 Men's UK 11.5/US 12,FBALYB Amazon,-1,-1,0,0,0,0
,Salomon Shoes XA Pro 3D V8 Sargasso Sea/Imperial Blue/Angel Falls L40987700 Men's UK 11/US 11.5,Salomon Shoes XA Pro 3D V8 Sargasso Sea/Imperial Blue/Angel Falls L40987700 Men's UK 11/US 11.5,FBALYB Amazon,-4,-4,0,0,0,0
,Salomon Shoes XA Pro 3D V8 Sargasso Sea/Imperial Blue/Angel Falls L40987700 Men's UK 8.5/US 9,Salomon Shoes XA Pro 3D V8 Sargasso Sea/Imperial Blue/Angel Falls L40987700 Men's UK 8.5/US 9,FBALYB Amazon,-2,-2,0,0,0,0
,Salomon Shoes XA Pro 3D V8 Sargasso Sea/Imperial Blue/Angel Falls L40987700 Men's UK 9.5/US 10,Salomon Shoes XA Pro 3D V8 Sargasso Sea/Imperial Blue/Angel Falls L40987700 Men's UK 9.5/US 10,FBALYB Amazon,-2,-2,0,0,0,0
,Salomon Shoes XA Pro 3D v8 W Black/Phantom/Ebony L41117800 Women's UK5.5/US 7,Salomon Shoes XA Pro 3D v8 W Black/Phantom/Ebony L41117800 Women's UK5.5/US 7,Default Ridgefield,10,10,0,0,0,0
,Salomon Shoes XA Pro 3D v8 W Black/Phantom/Ebony L41117800 Women's UK5.5/US 7,Salomon Shoes XA Pro 3D v8 W Black/Phantom/Ebony L41117800 Women's UK5.5/US 7,FBALYB Amazon,-1,-1,0,0,0,0
,Salomon Shoes XA Pro 3D v8 W Black/Phantom/Ebony L41117800 Women's UK 5/US 6.5,Salomon Shoes XA Pro 3D v8 W Black/Phantom/Ebony L41117800 Women's UK 5/US 6.5,Default Ridgefield,5,5,0,0,0,0
,Salomon Shoes XA Pro 3D v8 W Black/Phantom/Ebony L41117800 Women's UK 5/US 6.5,Salomon Shoes XA Pro 3D v8 W Black/Phantom/Ebony L41117800 Women's UK 5/US 6.5,FBALYB Amazon,-2,-2,0,0,0,0
,Salomon Shoes XA Pro 3D v8 W Black/Phantom/Ebony L41117800 Women's UK 6.5/US 8,Salomon Shoes XA Pro 3D v8 W Black/Phantom/Ebony L41117800 Women's UK 6.5/US 8,Default Ridgefield,15,15,0,0,0,0
,Salomon Shoes XA Pro 3D v8 W Black/Phantom/Ebony L41117800 Women's UK 6.5/US 8,Salomon Shoes XA Pro 3D v8 W Black/Phantom/Ebony L41117800 Women's UK 6.5/US 8,FBALYB Amazon,-6,-6,0,0,0,0
,Salomon Shoes XA Pro 3D v8 W Black/Phantom/Ebony L41117800 Women's UK 6/US 7.5,Salomon Shoes XA Pro 3D v8 W Black/Phantom/Ebony L41117800 Women's UK 6/US 7.5,Default Ridgefield,15,15,0,0,0,0
,Salomon Shoes XA Pro 3D v8 W Black/Phantom/Ebony L41117800 Women's UK 6/US 7.5,Salomon Shoes XA Pro 3D v8 W Black/Phantom/Ebony L41117800 Women's UK 6/US 7.5,FBALYB Amazon,-2,-2,0,0,0,0
,Salomon Shoes XA Pro 3D v8 W Black/Phantom/Ebony L41117800 Women's UK 7.5/US 9,Salomon Shoes XA Pro 3D v8 W Black/Phantom/Ebony L41117800 Women's UK 7.5/US 9,Default Ridgefield,15,15,0,0,0,0
,Salomon Shoes XA Pro 3D v8 W Black/Phantom/Ebony L41117800 Women's UK 7.5/US 9,Salomon Shoes XA Pro 3D v8 W Black/Phantom/Ebony L41117800 Women's UK 7.5/US 9,FBALYB Amazon,-4,-4,0,0,0,0
,Salomon Shoes XA Pro 3D v8 W Black/Phantom/Ebony L41117800 Women's UK 7/US 8.5,Salomon Shoes XA Pro 3D v8 W Black/Phantom/Ebony L41117800 Women's UK 7/US 8.5,Default Ridgefield,15,15,0,0,0,0
,Salomon Shoes XA Pro 3D v8 W Black/Phantom/Ebony L41117800 Women's UK 8.5/US 10,Salomon Shoes XA Pro 3D v8 W Black/Phantom/Ebony L41117800 Women's UK 8.5/US 10,Default Ridgefield,15,15,0,0,0,0
,Salomon Shoes XA Pro 3D v8 W Black/Phantom/Ebony L41117800 Women's UK 8.5/US 10,Salomon Shoes XA Pro 3D v8 W Black/Phantom/Ebony L41117800 Women's UK 8.5/US 10,FBALYB Amazon,-1,-1,0,0,0,0
,Salomon Shoes XA Pro 3D v8 W Black/Phantom/Ebony L41117800 Women's UK 8/US 9.5,Salomon Shoes XA Pro 3D v8 W Black/Phantom/Ebony L41117800 Women's UK 8/US 9.5,Default Ridgefield,15,15,0,0,0,0
,Salomon Shoes XA Pro 3D v8 W Black/Phantom/Ebony L41117800 Women's UK 8/US 9.5,Salomon Shoes XA Pro 3D v8 W Black/Phantom/Ebony L41117800 Women's UK 8/US 9.5,FBALYB Amazon,-2,-2,0,0,0,0
,Salomon Shoes XA Pro 3D v8 W Black/Phantom/Ebony L41117800 Women's UK 9/US 10.5,Salomon Shoes XA Pro 3D v8 W Black/Phantom/Ebony L41117800 Women's UK 9/US 10.5,Default Ridgefield,10,10,0,0,0,0
,Salomon Shoes X Ultra 3 GTX Black/Magnet/Quiet Shade L39867200 Men's UK 10.5/US 11,Salomon Shoes X Ultra 3 GTX Black/Magnet/Quiet Shade L39867200 Men's UK 10.5/US 11,Default Ridgefield,0,0,0,0,0,160
,Salomon Shoes X Ultra 3 GTX Black/Magnet/Quiet Shade L39867200 Men's UK 10.5/US 11,Salomon Shoes X Ultra 3 GTX Black/Magnet/Quiet Shade L39867200 Men's UK 10.5/US 11,FBALYB Amazon,-23,-24,1,0,1,0
,Salomon Shoes X Ultra 3 GTX Black/Magnet/Quiet Shade L39867200 Men's UK 10/US 10.5,Salomon Shoes X Ultra 3 GTX Black/Magnet/Quiet Shade L39867200 Men's UK 10/US 10.5,Default Ridgefield,0,0,0,0,0,140
,Salomon Shoes X Ultra 3 GTX Black/Magnet/Quiet Shade L39867200 Men's UK 10/US 10.5,Salomon Shoes X Ultra 3 GTX Black/Magnet/Quiet Shade L39867200 Men's UK 10/US 10.5,FBALYB Amazon,-66,-66,0,0,0,0
,Salomon Shoes X Ultra 3 GTX Black/Magnet/Quiet Shade L39867200 Men's UK 11.5/US 12,Salomon Shoes X Ultra 3 GTX Black/Magnet/Quiet Shade L39867200 Men's UK 11.5/US 12,Default Ridgefield,0,0,0,0,0,140
,Salomon Shoes X Ultra 3 GTX Black/Magnet/Quiet Shade L39867200 Men's UK 11.5/US 12,Salomon Shoes X Ultra 3 GTX Black/Magnet/Quiet Shade L39867200 Men's UK 11.5/US 12,FBALYB Amazon,-54,-54,0,0,0,0
,Salomon Shoes X Ultra 3 GTX Black/Magnet/Quiet Shade L39867200 Men's UK 11/US 11.5,Salomon Shoes X Ultra 3 GTX Black/Magnet/Quiet Shade L39867200 Men's UK 11/US 11.5,Default Ridgefield,0,0,0,0,0,100
,Salomon Shoes X Ultra 3 GTX Black/Magnet/Quiet Shade L39867200 Men's UK 11/US 11.5,Salomon Shoes X Ultra 3 GTX Black/Magnet/Quiet Shade L39867200 Men's UK 11/US 11.5,FBALYB Amazon,-13,-13,0,0,0,0
,Salomon Shoes X Ultra 3 GTX Black/Magnet/Quiet Shade L39867200 Men's UK 12.5/US 13,Salomon Shoes X Ultra 3 GTX Black/Magnet/Quiet Shade L39867200 Men's UK 12.5/US 13,Default Ridgefield,20,20,0,0,0,20
,Salomon Shoes X Ultra 3 GTX Black/Magnet/Quiet Shade L39867200 Men's UK 12.5/US 13,Salomon Shoes X Ultra 3 GTX Black/Magnet/Quiet Shade L39867200 Men's UK 12.5/US 13,FBALYB Amazon,-8,-8,0,0,0,0
,Salomon Shoes X Ultra 3 GTX Black/Magnet/Quiet Shade L39867200 Men's UK 12/US 12.5,Salomon Shoes X Ultra 3 GTX Black/Magnet/Quiet Shade L39867200 Men's UK 12/US 12.5,Default Ridgefield,0,0,0,0,0,70
,Salomon Shoes X Ultra 3 GTX Black/Magnet/Quiet Shade L39867200 Men's UK 12/US 12.5,Salomon Shoes X Ultra 3 GTX Black/Magnet/Quiet Shade L39867200 Men's UK 12/US 12.5,FBALYB Amazon,-4,-5,1,0,1,0
,Salomon Shoes X Ultra 3 GTX Black/Magnet/Quiet Shade L39867200 Men's UK 6.5/US 7,Salomon Shoes X Ultra 3 GTX Black/Magnet/Quiet Shade L39867200 Men's UK 6.5/US 7,FBALYB Amazon,-11,-11,0,0,0,0
,Salomon Shoes X Ultra 3 GTX Black/Magnet/Quiet Shade L39867200 Men's UK 7.5/US 8,Salomon Shoes X Ultra 3 GTX Black/Magnet/Quiet Shade L39867200 Men's UK 7.5/US 8,FBALYB Amazon,-13,-13,0,0,0,0
,Salomon Shoes X Ultra 3 GTX Black/Magnet/Quiet Shade L39867200 Men's UK 8.5/US 9,Salomon Shoes X Ultra 3 GTX Black/Magnet/Quiet Shade L39867200 Men's UK 8.5/US 9,Default Ridgefield,0,0,0,0,0,65
,Salomon Shoes X Ultra 3 GTX Black/Magnet/Quiet Shade L39867200 Men's UK 8.5/US 9,Salomon Shoes X Ultra 3 GTX Black/Magnet/Quiet Shade L39867200 Men's UK 8.5/US 9,FBALYB Amazon,-15,-15,0,0,0,0
,Salomon Shoes X Ultra 3 GTX Black/Magnet/Quiet Shade L39867200 Men's UK 8/US 8.5,Salomon Shoes X Ultra 3 GTX Black/Magnet/Quiet Shade L39867200 Men's UK 8/US 8.5,FBALYB Amazon,-19,-19,0,0,0,0
,Salomon Shoes X Ultra 3 GTX Black/Magnet/Quiet Shade L39867200 Men's UK 9.5/US 10,Salomon Shoes X Ultra 3 GTX Black/Magnet/Quiet Shade L39867200 Men's UK 9.5/US 10,Default Ridgefield,0,0,0,0,0,120
,Salomon Shoes X Ultra 3 GTX Black/Magnet/Quiet Shade L39867200 Men's UK 9.5/US 10,Salomon Shoes X Ultra 3 GTX Black/Magnet/Quiet Shade L39867200 Men's UK 9.5/US 10,FBALYB Amazon,-49,-49,0,0,0,0
,Salomon Shoes X Ultra 3 GTX Black/Magnet/Quiet Shade L39867200 Men's UK 9/US 9.5,Salomon Shoes X Ultra 3 GTX Black/Magnet/Quiet Shade L39867200 Men's UK 9/US 9.5,Default Ridgefield,0,0,0,0,0,85
,Salomon Shoes X Ultra 3 GTX Black/Magnet/Quiet Shade L39867200 Men's UK 9/US 9.5,Salomon Shoes X Ultra 3 GTX Black/Magnet/Quiet Shade L39867200 Men's UK 9/US 9.5,FBALYB Amazon,-31,-31,0,0,0,0
,Salomon Shoes X Ultra 3 GTX Dark Denim/Copen Blue/Pale Khaki L41168500 Men's UK 10.5/US 11,Salomon Shoes X Ultra 3 GTX Dark Denim/Copen Blue/Pale Khaki L41168500 Men's UK 10.5/US 11,FBALYB Amazon,-8,-8,0,0,0,0
,Salomon Shoes X Ultra 3 GTX Dark Denim/Copen Blue/Pale Khaki L41168500 Men's UK 10/US 10.5,Salomon Shoes X Ultra 3 GTX Dark Denim/Copen Blue/Pale Khaki L41168500 Men's UK 10/US 10.5,FBALYB Amazon,-5,-5,0,0,0,0
,Salomon Shoes X Ultra 3 GTX Dark Denim/Copen Blue/Pale Khaki L41168500 Men's UK 11.5/US 12,Salomon Shoes X Ultra 3 GTX Dark Denim/Copen Blue/Pale Khaki L41168500 Men's UK 11.5/US 12,FBALYB Amazon,-5,-5,0,0,0,0
,Salomon Shoes X Ultra 3 GTX Dark Denim/Copen Blue/Pale Khaki L41168500 Men's UK 11/US 11.5,Salomon Shoes X Ultra 3 GTX Dark Denim/Copen Blue/Pale Khaki L41168500 Men's UK 11/US 11.5,FBALYB Amazon,-6,-6,0,0,0,0
,Salomon Shoes X Ultra 3 GTX Dark Denim/Copen Blue/Pale Khaki L41168500 Men's UK 12/US 12.5,Salomon Shoes X Ultra 3 GTX Dark Denim/Copen Blue/Pale Khaki L41168500 Men's UK 12/US 12.5,FBALYB Amazon,-7,-7,0,0,0,0
,Salomon Shoes X Ultra 3 GTX Dark Denim/Copen Blue/Pale Khaki L41168500 Men's UK 8.5/US 9,Salomon Shoes X Ultra 3 GTX Dark Denim/Copen Blue/Pale Khaki L41168500 Men's UK 8.5/US 9,FBALYB Amazon,-4,-4,0,0,0,0
,Salomon Shoes X Ultra 3 GTX Dark Denim/Copen Blue/Pale Khaki L41168500 Men's UK 8/US 8.5,Salomon Shoes X Ultra 3 GTX Dark Denim/Copen Blue/Pale Khaki L41168500 Men's UK 8/US 8.5,FBALYB Amazon,-3,-3,0,0,0,0
,Salomon Shoes X Ultra 3 GTX Dark Denim/Copen Blue/Pale Khaki L41168500 Men's UK 9.5/US 10,Salomon Shoes X Ultra 3 GTX Dark Denim/Copen Blue/Pale Khaki L41168500 Men's UK 9.5/US 10,FBALYB Amazon,-10,-10,0,0,0,0
,Salomon Shoes X Ultra 3 GTX Dark Denim/Copen Blue/Pale Khaki L41168500 Men's UK 9/US 9.5,Salomon Shoes X Ultra 3 GTX Dark Denim/Copen Blue/Pale Khaki L41168500 Men's UK 9/US 9.5,FBALYB Amazon,-6,-6,0,0,0,0
,Salomon Shoes X Ultra 3 GTX W Artic/Darkest Spru L40006500 Women's UK 5.5/US 7,Salomon Shoes X Ultra 3 GTX W Artic/Darkest Spru L40006500 Women's UK 5.5/US 7,FBALYB Amazon,-7,-7,0,0,0,0
,Salomon Shoes X Ultra 3 GTX W Artic/Darkest Spru L40006500 Women's UK 57.5/US 9,Salomon Shoes X Ultra 3 GTX W Artic/Darkest Spru L40006500 Women's UK 57.5/US 9,FBALYB Amazon,-7,-7,0,0,0,0
,Salomon Shoes X Ultra 3 GTX W Artic/Darkest Spru L40006500 Women's UK 5/US 6.5,Salomon Shoes X Ultra 3 GTX W Artic/Darkest Spru L40006500 Women's UK 5/US 6.5,FBALYB Amazon,-3,-3,0,0,0,0
,Salomon Shoes X Ultra 3 GTX W Artic/Darkest Spru L40006500 Women's UK 6.5/US 8,Salomon Shoes X Ultra 3 GTX W Artic/Darkest Spru L40006500 Women's UK 6.5/US 8,FBALYB Amazon,-8,-8,0,0,0,0
,Salomon Shoes X Ultra 3 GTX W Artic/Darkest Spru L40006500 Women's UK 6/US 7.5,Salomon Shoes X Ultra 3 GTX W Artic/Darkest Spru L40006500 Women's UK 6/US 7.5,FBALYB Amazon,-5,-5,0,0,0,0
,Salomon Shoes X Ultra 3 GTX W Artic/Darkest Spru L40006500 Women's UK 7/US 8.5,Salomon Shoes X Ultra 3 GTX W Artic/Darkest Spru L40006500 Women's UK 7/US 8.5,FBALYB Amazon,-6,-6,0,0,0,0
,Salomon Shoes X Ultra 3 GTX W Artic/Darkest Spru L40006500 Women's UK 8.5/US 10,Salomon Shoes X Ultra 3 GTX W Artic/Darkest Spru L40006500 Women's UK 8.5/US 10,FBALYB Amazon,-11,-11,0,0,0,0
,Salomon Shoes X Ultra 3 GTX W Artic/Darkest Spru L40006500 Women's UK 8/US 9.5,Salomon Shoes X Ultra 3 GTX W Artic/Darkest Spru L40006500 Women's UK 8/US 9.5,FBALYB Amazon,-10,-10,0,0,0,0
,Salomon Shoes X Ultra 3 GTX W Artic/Darkest Spru L40006500 Women's UK 9/US 10.5,Salomon Shoes X Ultra 3 GTX W Artic/Darkest Spru L40006500 Women's UK 9/US 10.5,FBALYB Amazon,-7,-7,0,0,0,0
,Salomon Shoes X Ultra 3 GTX W Magnet/Black/Mineral Red L39868500 Women's UK 5/US 6.5,Salomon Shoes X Ultra 3 GTX W Magnet/Black/Mineral Red L39868500 Women's UK 5/US 6.5,Default,0,0,0,0,0,10
,Salomon Shoes X Ultra 3 GTX W Magnet/Black/Mineral Red L39868500 Women's UK 5/US 6.5,Salomon Shoes X Ultra 3 GTX W Magnet/Black/Mineral Red L39868500 Women's UK 5/US 6.5,Default Ridgefield,20,20,0,0,0,0
,Salomon Shoes X Ultra 3 GTX W Magnet/Black/Mineral Red L39868500 Women's UK 6.5/US 8,Salomon Shoes X Ultra 3 GTX W Magnet/Black/Mineral Red L39868500 Women's UK 6.5/US 8,Default,0,0,0,0,0,25
,Salomon Shoes X Ultra 3 GTX W Magnet/Black/Mineral Red L39868500 Women's UK 6.5/US 8,Salomon Shoes X Ultra 3 GTX W Magnet/Black/Mineral Red L39868500 Women's UK 6.5/US 8,Default Ridgefield,45,45,0,0,0,0
,Salomon Shoes X Ultra 3 GTX W Magnet/Black/Mineral Red L39868500 Women's UK 6/US 7.5,Salomon Shoes X Ultra 3 GTX W Magnet/Black/Mineral Red L39868500 Women's UK 6/US 7.5,Default,0,0,0,0,0,25
,Salomon Shoes X Ultra 3 GTX W Magnet/Black/Mineral Red L39868500 Women's UK 6/US 7.5,Salomon Shoes X Ultra 3 GTX W Magnet/Black/Mineral Red L39868500 Women's UK 6/US 7.5,Default Ridgefield,55,55,0,0,0,0
,Salomon Shoes X Ultra 3 GTX W Magnet/Black/Mineral Red L39868500 Women's UK 7.5/US 9,Salomon Shoes X Ultra 3 GTX W Magnet/Black/Mineral Red L39868500 Women's UK 7.5/US 9,Default,0,0,0,0,0,30
,Salomon Shoes X Ultra 3 GTX W Magnet/Black/Mineral Red L39868500 Women's UK 7.5/US 9,Salomon Shoes X Ultra 3 GTX W Magnet/Black/Mineral Red L39868500 Women's UK 7.5/US 9,Default Ridgefield,60,60,0,0,0,0
,Salomon Shoes X Ultra 3 GTX W Magnet/Black/Mineral Red L39868500 Women's UK 7/US 8.5,Salomon Shoes X Ultra 3 GTX W Magnet/Black/Mineral Red L39868500 Women's UK 7/US 8.5,Default,0,0,0,0,0,30
,Salomon Shoes X Ultra 3 GTX W Magnet/Black/Mineral Red L39868500 Women's UK 7/US 8.5,Salomon Shoes X Ultra 3 GTX W Magnet/Black/Mineral Red L39868500 Women's UK 7/US 8.5,Default Ridgefield,60,60,0,0,0,0
,Salomon Shoes X Ultra 3 GTX W Magnet/Black/Mineral Red L39868500 Women's UK 8.5/US 10,Salomon Shoes X Ultra 3 GTX W Magnet/Black/Mineral Red L39868500 Women's UK 8.5/US 10,Default,0,0,0,0,0,30
,Salomon Shoes X Ultra 3 GTX W Magnet/Black/Mineral Red L39868500 Women's UK 8.5/US 10,Salomon Shoes X Ultra 3 GTX W Magnet/Black/Mineral Red L39868500 Women's UK 8.5/US 10,Default Ridgefield,60,60,0,0,0,0
,Salomon Shoes X Ultra 3 GTX W Magnet/Black/Mineral Red L39868500 Women's UK 8/US 9.5,Salomon Shoes X Ultra 3 GTX W Magnet/Black/Mineral Red L39868500 Women's UK 8/US 9.5,Default,0,0,0,0,0,30
,Salomon Shoes X Ultra 3 GTX W Magnet/Black/Mineral Red L39868500 Women's UK 8/US 9.5,Salomon Shoes X Ultra 3 GTX W Magnet/Black/Mineral Red L39868500 Women's UK 8/US 9.5,Default Ridgefield,60,60,0,0,0,0
,Salomon Shoes X Ultra 3 GTX W Magnet/Black/Mineral Red L39868500 Women's UK 9/US 10.5,Salomon Shoes X Ultra 3 GTX W Magnet/Black/Mineral Red L39868500 Women's UK 9/US 10.5,Default,0,0,0,0,0,15
,Salomon Shoes X Ultra 3 GTX W Magnet/Black/Mineral Red L39868500 Women's UK 9/US 10.5,Salomon Shoes X Ultra 3 GTX W Magnet/Black/Mineral Red L39868500 Women's UK 9/US 10.5,Default Ridgefield,30,30,0,0,0,0
,Salomon Shoes X Ultra 3 GTX W Magnet/Black/Mnrd L39868500 Women's UK 5.5/US 7,Salomon Shoes X Ultra 3 GTX W Magnet/Black/Mnrd L39868500 Women's UK 5.5/US 7,Default,0,0,0,0,0,20
,Salomon Shoes X Ultra 3 GTX W Magnet/Black/Mnrd L39868500 Women's UK 5.5/US 7,Salomon Shoes X Ultra 3 GTX W Magnet/Black/Mnrd L39868500 Women's UK 5.5/US 7,Default Ridgefield,40,40,0,0,0,0
,Salomon Shoes X Ultra 3 Mid GTX Black/India Ink/Monument L39867400 Men's UK 10.5/US 11,Salomon Shoes X Ultra 3 Mid GTX Black/India Ink/Monument L39867400 Men's UK 10.5/US 11,Default Ridgefield,0,0,0,0,0,160
,Salomon Shoes X Ultra 3 Mid GTX Black/India Ink/Monument L39867400 Men's UK 10.5/US 11,Salomon Shoes X Ultra 3 Mid GTX Black/India Ink/Monument L39867400 Men's UK 10.5/US 11,FBALYB Amazon,-26,-26,0,0,0,0
,Salomon Shoes X Ultra 3 Mid GTX Black/India Ink/Monument L39867400 Men's UK 10/US 10.5,Salomon Shoes X Ultra 3 Mid GTX Black/India Ink/Monument L39867400 Men's UK 10/US 10.5,Default Ridgefield,11,11,0,0,0,140
,Salomon Shoes X Ultra 3 Mid GTX Black/India Ink/Monument L39867400 Men's UK 10/US 10.5,Salomon Shoes X Ultra 3 Mid GTX Black/India Ink/Monument L39867400 Men's UK 10/US 10.5,FBALYB Amazon,-5,-15,10,0,10,0
,Salomon Shoes X Ultra 3 Mid GTX Black/India Ink/Monument L39867400 Men's UK 11.5/US 12,Salomon Shoes X Ultra 3 Mid GTX Black/India Ink/Monument L39867400 Men's UK 11.5/US 12,Default Ridgefield,5,5,0,0,0,140
,Salomon Shoes X Ultra 3 Mid GTX Black/India Ink/Monument L39867400 Men's UK 11.5/US 12,Salomon Shoes X Ultra 3 Mid GTX Black/India Ink/Monument L39867400 Men's UK 11.5/US 12,FBALYB Amazon,-41,-43,2,0,2,0
,Salomon Shoes X Ultra 3 Mid GTX Black/India Ink/Monument L39867400 Men's UK 11/US 11.5,Salomon Shoes X Ultra 3 Mid GTX Black/India Ink/Monument L39867400 Men's UK 11/US 11.5,Default Ridgefield,0,0,0,0,0,100
,Salomon Shoes X Ultra 3 Mid GTX Black/India Ink/Monument L39867400 Men's UK 11/US 11.5,Salomon Shoes X Ultra 3 Mid GTX Black/India Ink/Monument L39867400 Men's UK 11/US 11.5,FBALYB Amazon,-45,-46,1,0,1,0
,Salomon Shoes X Ultra 3 Mid GTX Black/India Ink/Monument L39867400 Men's UK 12.5/US 13,Salomon Shoes X Ultra 3 Mid GTX Black/India Ink/Monument L39867400 Men's UK 12.5/US 13,Default Ridgefield,5,5,0,0,0,20
,Salomon Shoes X Ultra 3 Mid GTX Black/India Ink/Monument L39867400 Men's UK 12.5/US 13,Salomon Shoes X Ultra 3 Mid GTX Black/India Ink/Monument L39867400 Men's UK 12.5/US 13,FBALYB Amazon,-27,-27,0,0,0,0
,Salomon Shoes X Ultra 3 Mid GTX Black/India Ink/Monument L39867400 Men's UK 12/US 12.5,Salomon Shoes X Ultra 3 Mid GTX Black/India Ink/Monument L39867400 Men's UK 12/US 12.5,Default Ridgefield,0,0,0,0,0,70
,Salomon Shoes X Ultra 3 Mid GTX Black/India Ink/Monument L39867400 Men's UK 12/US 12.5,Salomon Shoes X Ultra 3 Mid GTX Black/India Ink/Monument L39867400 Men's UK 12/US 12.5,FBALYB Amazon,-1,-1,0,0,0,0
,Salomon Shoes X Ultra 3 Mid GTX Black/India Ink/Monument L39867400 Men's UK 6.5/US 7,Salomon Shoes X Ultra 3 Mid GTX Black/India Ink/Monument L39867400 Men's UK 6.5/US 7,FBALYB Amazon,19,19,0,1,0,0
,Salomon Shoes X Ultra 3 Mid GTX Black/India Ink/Monument L39867400 Men's UK 7.5/US 8,Salomon Shoes X Ultra 3 Mid GTX Black/India Ink/Monument L39867400 Men's UK 7.5/US 8,FBALYB Amazon,-9,-9,0,0,0,0
,Salomon Shoes X Ultra 3 Mid GTX Black/India Ink/Monument L39867400 Men's UK 7/US 7.5,Salomon Shoes X Ultra 3 Mid GTX Black/India Ink/Monument L39867400 Men's UK 7/US 7.5,FBALYB Amazon,-1,-1,0,0,0,0
,Salomon Shoes X Ultra 3 Mid GTX Black/India Ink/Monument L39867400 Men's UK 8.5/US 9,Salomon Shoes X Ultra 3 Mid GTX Black/India Ink/Monument L39867400 Men's UK 8.5/US 9,Default Ridgefield,0,0,0,0,0,65
,Salomon Shoes X Ultra 3 Mid GTX Black/India Ink/Monument L39867400 Men's UK 8.5/US 9,Salomon Shoes X Ultra 3 Mid GTX Black/India Ink/Monument L39867400 Men's UK 8.5/US 9,FBALYB Amazon,-12,-12,0,0,0,0
,Salomon Shoes X Ultra 3 Mid GTX Black/India Ink/Monument L39867400 Men's UK 8/US 8.5,Salomon Shoes X Ultra 3 Mid GTX Black/India Ink/Monument L39867400 Men's UK 8/US 8.5,FBALYB Amazon,-15,-15,0,0,0,0
,Salomon Shoes X Ultra 3 Mid GTX Black/India Ink/Monument L39867400 Men's UK 9.5/US 10,Salomon Shoes X Ultra 3 Mid GTX Black/India Ink/Monument L39867400 Men's UK 9.5/US 10,Default Ridgefield,0,0,0,0,0,120
,Salomon Shoes X Ultra 3 Mid GTX Black/India Ink/Monument L39867400 Men's UK 9.5/US 10,Salomon Shoes X Ultra 3 Mid GTX Black/India Ink/Monument L39867400 Men's UK 9.5/US 10,FBALYB Amazon,-47,-48,1,0,1,0
,Salomon Shoes X Ultra 3 Mid GTX Black/India Ink/Monument L39867400 Men's UK 9/US 9.5,Salomon Shoes X Ultra 3 Mid GTX Black/India Ink/Monument L39867400 Men's UK 9/US 9.5,Default Ridgefield,0,0,0,0,0,85
,Salomon Shoes X Ultra 3 Mid GTX Black/India Ink/Monument L39867400 Men's UK 9/US 9.5,Salomon Shoes X Ultra 3 Mid GTX Black/India Ink/Monument L39867400 Men's UK 9/US 9.5,FBALYB Amazon,-35,-35,0,0,0,0
,Salomon Shoes X Ultra 3 Mid GTX Castor Gra/Bk/Gr L40133700 Men's UK 10.5/US 11,Salomon Shoes X Ultra 3 Mid GTX Castor Gra/Bk/Gr L40133700 Men's UK 10.5/US 11,Default Ridgefield,0,0,0,0,0,160
,Salomon Shoes X Ultra 3 Mid GTX Castor Gra/Bk/Gr L40133700 Men's UK 10.5/US 11,Salomon Shoes X Ultra 3 Mid GTX Castor Gra/Bk/Gr L40133700 Men's UK 10.5/US 11,FBALYB Amazon,-24,-24,0,0,0,0
,Salomon Shoes X Ultra 3 Mid GTX Castor Gra/Bk/Gr L40133700 Men's UK 10/US 10.5,Salomon Shoes X Ultra 3 Mid GTX Castor Gra/Bk/Gr L40133700 Men's UK 10/US 10.5,Default Ridgefield,0,0,0,0,0,140
,Salomon Shoes X Ultra 3 Mid GTX Castor Gra/Bk/Gr L40133700 Men's UK 10/US 10.5,Salomon Shoes X Ultra 3 Mid GTX Castor Gra/Bk/Gr L40133700 Men's UK 10/US 10.5,FBALYB Amazon,-36,-36,0,0,0,0
,Salomon Shoes X Ultra 3 Mid GTX Castor Gra/Bk/Gr L40133700 Men's UK 11.5/US 12,Salomon Shoes X Ultra 3 Mid GTX Castor Gra/Bk/Gr L40133700 Men's UK 11.5/US 12,Default Ridgefield,0,0,0,0,0,130
,Salomon Shoes X Ultra 3 Mid GTX Castor Gra/Bk/Gr L40133700 Men's UK 11.5/US 12,Salomon Shoes X Ultra 3 Mid GTX Castor Gra/Bk/Gr L40133700 Men's UK 11.5/US 12,FBALYB Amazon,-16,-18,2,0,2,0
,Salomon Shoes X Ultra 3 Mid GTX Castor Gra/Bk/Gr L40133700 Men's UK 11/US 11.5,Salomon Shoes X Ultra 3 Mid GTX Castor Gra/Bk/Gr L40133700 Men's UK 11/US 11.5,Default Ridgefield,0,0,0,0,0,100
,Salomon Shoes X Ultra 3 Mid GTX Castor Gra/Bk/Gr L40133700 Men's UK 11/US 11.5,Salomon Shoes X Ultra 3 Mid GTX Castor Gra/Bk/Gr L40133700 Men's UK 11/US 11.5,FBALYB Amazon,-29,-30,1,0,1,0
,Salomon Shoes X Ultra 3 Mid GTX Castor Gra/Bk/Gr L40133700 Men's UK 12.5/US 13,Salomon Shoes X Ultra 3 Mid GTX Castor Gra/Bk/Gr L40133700 Men's UK 12.5/US 13,Default Ridgefield,10,10,0,0,0,20
,Salomon Shoes X Ultra 3 Mid GTX Castor Gra/Bk/Gr L40133700 Men's UK 12.5/US 13,Salomon Shoes X Ultra 3 Mid GTX Castor Gra/Bk/Gr L40133700 Men's UK 12.5/US 13,FBALYB Amazon,-12,-12,0,0,0,0
,Salomon Shoes X Ultra 3 Mid GTX Castor Gra/Bk/Gr L40133700 Men's UK 12/US 12.5,Salomon Shoes X Ultra 3 Mid GTX Castor Gra/Bk/Gr L40133700 Men's UK 12/US 12.5,Default Ridgefield,0,0,0,0,0,70
,Salomon Shoes X Ultra 3 Mid GTX Castor Gra/Bk/Gr L40133700 Men's UK 12/US 12.5,Salomon Shoes X Ultra 3 Mid GTX Castor Gra/Bk/Gr L40133700 Men's UK 12/US 12.5,FBALYB Amazon,-6,-6,0,0,0,0
,Salomon Shoes X Ultra 3 Mid GTX Castor Gra/Bk/Gr L40133700 Men's UK 6.5/US 7,Salomon Shoes X Ultra 3 Mid GTX Castor Gra/Bk/Gr L40133700 Men's UK 6.5/US 7,FBALYB Amazon,-10,-10,0,20,0,0
,Salomon Shoes X Ultra 3 Mid GTX Castor Gra/Bk/Gr L40133700 Men's UK 7.5/US 8,Salomon Shoes X Ultra 3 Mid GTX Castor Gra/Bk/Gr L40133700 Men's UK 7.5/US 8,FBALYB Amazon,2,2,0,0,0,0
,Salomon Shoes X Ultra 3 Mid GTX Castor Gra/Bk/Gr L40133700 Men's UK 7/US 7.5,Salomon Shoes X Ultra 3 Mid GTX Castor Gra/Bk/Gr L40133700 Men's UK 7/US 7.5,FBALYB Amazon,4,3,1,0,1,0
,Salomon Shoes X Ultra 3 Mid GTX Castor Gra/Bk/Gr L40133700 Men's UK 8.5/US 9,Salomon Shoes X Ultra 3 Mid GTX Castor Gra/Bk/Gr L40133700 Men's UK 8.5/US 9,Default Ridgefield,0,0,0,0,0,65
,Salomon Shoes X Ultra 3 Mid GTX Castor Gra/Bk/Gr L40133700 Men's UK 8.5/US 9,Salomon Shoes X Ultra 3 Mid GTX Castor Gra/Bk/Gr L40133700 Men's UK 8.5/US 9,FBALYB Amazon,-13,-13,0,0,0,0
,Salomon Shoes X Ultra 3 Mid GTX Castor Gra/Bk/Gr L40133700 Men's UK 8/US 8.5,Salomon Shoes X Ultra 3 Mid GTX Castor Gra/Bk/Gr L40133700 Men's UK 8/US 8.5,FBALYB Amazon,-9,-9,0,0,0,0
,Salomon Shoes X Ultra 3 Mid GTX Castor Gra/Bk/Gr L40133700 Men's UK 9.5/US 10,Salomon Shoes X Ultra 3 Mid GTX Castor Gra/Bk/Gr L40133700 Men's UK 9.5/US 10,Default Ridgefield,0,0,0,0,0,130
,Salomon Shoes X Ultra 3 Mid GTX Castor Gra/Bk/Gr L40133700 Men's UK 9.5/US 10,Salomon Shoes X Ultra 3 Mid GTX Castor Gra/Bk/Gr L40133700 Men's UK 9.5/US 10,FBALYB Amazon,-32,-34,2,0,2,0
,Salomon Shoes X Ultra 3 Mid GTX Castor Gra/Bk/Gr L40133700 Men's UK 9/US 9.5,Salomon Shoes X Ultra 3 Mid GTX Castor Gra/Bk/Gr L40133700 Men's UK 9/US 9.5,Default Ridgefield,0,0,0,0,0,85
,Salomon Shoes X Ultra 3 Mid GTX Castor Gra/Bk/Gr L40133700 Men's UK 9/US 9.5,Salomon Shoes X Ultra 3 Mid GTX Castor Gra/Bk/Gr L40133700 Men's UK 9/US 9.5,FBALYB Amazon,-32,-33,1,0,1,0
,Salomon SHOES X ULTRA 3 MID GTX W Crown Blue/Eve L39869100 Women UK 4.5/ US 6,Salomon SHOES X ULTRA 3 MID GTX W Crown Blue/Eve L39869100 Women UK 4.5/ US 6,Default Ridgefield,0,0,0,0,0,30
,Salomon SHOES X ULTRA 3 MID GTX W Crown Blue/Eve L39869100 Women UK 5.5/ US 7,Salomon SHOES X ULTRA 3 MID GTX W Crown Blue/Eve L39869100 Women UK 5.5/ US 7,Default Ridgefield,0,0,0,0,0,80
,Salomon SHOES X ULTRA 3 MID GTX W Crown Blue/Eve L39869100 Women UK 5/ US 6.5,Salomon SHOES X ULTRA 3 MID GTX W Crown Blue/Eve L39869100 Women UK 5/ US 6.5,Default Ridgefield,0,0,0,0,0,40
,Salomon SHOES X ULTRA 3 MID GTX W Crown Blue/Eve L39869100 Women UK 6.5/ US 8,Salomon SHOES X ULTRA 3 MID GTX W Crown Blue/Eve L39869100 Women UK 6.5/ US 8,Default Ridgefield,0,0,0,0,0,80
,Salomon SHOES X ULTRA 3 MID GTX W Crown Blue/Eve L39869100 Women UK 6/ US 7.5,Salomon SHOES X ULTRA 3 MID GTX W Crown Blue/Eve L39869100 Women UK 6/ US 7.5,Default Ridgefield,0,0,0,0,0,70
,Salomon SHOES X ULTRA 3 MID GTX W Crown Blue/Eve L39869100 Women UK 7.5/ US 9,Salomon SHOES X ULTRA 3 MID GTX W Crown Blue/Eve L39869100 Women UK 7.5/ US 9,Default Ridgefield,0,0,0,0,0,80
,Salomon SHOES X ULTRA 3 MID GTX W Crown Blue/Eve L39869100 Women UK 7/ US 8.5,Salomon SHOES X ULTRA 3 MID GTX W Crown Blue/Eve L39869100 Women UK 7/ US 8.5,Default Ridgefield,0,0,0,0,0,90
,Salomon SHOES X ULTRA 3 MID GTX W Crown Blue/Eve L39869100 Women  UK 8.5/ US 10,Salomon SHOES X ULTRA 3 MID GTX W Crown Blue/Eve L39869100 Women  UK 8.5/ US 10,Default Ridgefield,0,0,0,0,0,40
,Salomon SHOES X ULTRA 3 MID GTX W Crown Blue/Eve L39869100 Women UK 8/ US 9.5,Salomon SHOES X ULTRA 3 MID GTX W Crown Blue/Eve L39869100 Women UK 8/ US 9.5,Default Ridgefield,0,0,0,0,0,70
,Salomon SHOES X ULTRA 3 MID GTX W Crown Blue/Eve L39869100 Women UK 9/ US 10.5,Salomon SHOES X ULTRA 3 MID GTX W Crown Blue/Eve L39869100 Women UK 9/ US 10.5,Default Ridgefield,0,0,0,0,0,20
,Salomon Shoes X Ultra 3 Phantom/Black/Hawaiian L40286200 Men's UK 10.5/US 11,Salomon Shoes X Ultra 3 Phantom/Black/Hawaiian L40286200 Men's UK 10.5/US 11,Default Ridgefield,50,50,0,0,0,0
,Salomon Shoes X Ultra 3 Phantom/Black/Hawaiian L40286200 Men's UK 10.5/US 11,Salomon Shoes X Ultra 3 Phantom/Black/Hawaiian L40286200 Men's UK 10.5/US 11,FBALYB Amazon,-3,-14,11,10,11,0
,Salomon Shoes X Ultra 3 Phantom/Black/Hawaiian L40286200 Men's UK 10/US 10.5,Salomon Shoes X Ultra 3 Phantom/Black/Hawaiian L40286200 Men's UK 10/US 10.5,FBALYB Amazon,-85,-93,8,80,8,0
,Salomon Shoes X Ultra 3 Phantom/Black/Hawaiian L40286200 Men's UK 11.5/US 12,Salomon Shoes X Ultra 3 Phantom/Black/Hawaiian L40286200 Men's UK 11.5/US 12,Default Ridgefield,40,40,0,0,0,0
,Salomon Shoes X Ultra 3 Phantom/Black/Hawaiian L40286200 Men's UK 11.5/US 12,Salomon Shoes X Ultra 3 Phantom/Black/Hawaiian L40286200 Men's UK 11.5/US 12,FBALYB Amazon,13,10,3,0,3,0
,Salomon Shoes X Ultra 3 Phantom/Black/Hawaiian L40286200 Men's UK 11/US 11.5,Salomon Shoes X Ultra 3 Phantom/Black/Hawaiian L40286200 Men's UK 11/US 11.5,FBALYB Amazon,51,49,2,0,2,0
,Salomon Shoes X Ultra 3 Phantom/Black/Hawaiian L40286200 Men's UK 12.5/US 13,Salomon Shoes X Ultra 3 Phantom/Black/Hawaiian L40286200 Men's UK 12.5/US 13,FBALYB Amazon,-21,-21,0,0,0,0
,Salomon Shoes X Ultra 3 Phantom/Black/Hawaiian L40286200 Men's UK 12/US 12.5,Salomon Shoes X Ultra 3 Phantom/Black/Hawaiian L40286200 Men's UK 12/US 12.5,FBALYB Amazon,16,15,1,0,1,0
,Salomon Shoes X Ultra 3 Phantom/Black/Hawaiian L40286200 Men's UK 7.5/US 8,Salomon Shoes X Ultra 3 Phantom/Black/Hawaiian L40286200 Men's UK 7.5/US 8,FBALYB Amazon,-10,-11,1,0,1,0
,Salomon Shoes X Ultra 3 Phantom/Black/Hawaiian L40286200 Men's UK 8.5/US 9,Salomon Shoes X Ultra 3 Phantom/Black/Hawaiian L40286200 Men's UK 8.5/US 9,FBALYB Amazon,19,15,4,0,4,0
,Salomon Shoes X Ultra 3 Phantom/Black/Hawaiian L40286200 Men's UK 8/US 8.5,Salomon Shoes X Ultra 3 Phantom/Black/Hawaiian L40286200 Men's UK 8/US 8.5,FBALYB Amazon,-16,-17,1,0,1,0
,Salomon Shoes X Ultra 3 Phantom/Black/Hawaiian L40286200 Men's UK 9.5/US 10,Salomon Shoes X Ultra 3 Phantom/Black/Hawaiian L40286200 Men's UK 9.5/US 10,Default Ridgefield,75,75,0,0,0,0
,Salomon Shoes X Ultra 3 Phantom/Black/Hawaiian L40286200 Men's UK 9.5/US 10,Salomon Shoes X Ultra 3 Phantom/Black/Hawaiian L40286200 Men's UK 9.5/US 10,FBALYB Amazon,-32,-32,0,0,0,0
,Salomon Shoes X Ultra 3 Phantom/Black/Hawaiian L40286200 Men's UK 9/US 9.5,Salomon Shoes X Ultra 3 Phantom/Black/Hawaiian L40286200 Men's UK 9/US 9.5,FBALYB Amazon,17,15,2,0,2,0
,Salomon Shoes X Ultra 3 Wide Mid GTX Black/India Ink/Monument L40129300 Men's UK 10.5/US 11,Salomon Shoes X Ultra 3 Wide Mid GTX Black/India Ink/Monument L40129300 Men's UK 10.5/US 11,FBALYB Amazon,-2,-2,0,0,0,0
,Salomon Shoes X Ultra 3 Wide Mid GTX Black/India Ink/Monument L40129300 Men's UK 10/US 10.5,Salomon Shoes X Ultra 3 Wide Mid GTX Black/India Ink/Monument L40129300 Men's UK 10/US 10.5,FBALYB Amazon,-9,-9,0,0,0,0
,Salomon Shoes X Ultra 3 Wide Mid GTX Black/India Ink/Monument L40129300 Men's UK 11.5/US 12,Salomon Shoes X Ultra 3 Wide Mid GTX Black/India Ink/Monument L40129300 Men's UK 11.5/US 12,FBALYB Amazon,-4,-4,0,0,0,0
,Salomon Shoes X Ultra 3 Wide Mid GTX Black/India Ink/Monument L40129300 Men's UK 11/US 11.5,Salomon Shoes X Ultra 3 Wide Mid GTX Black/India Ink/Monument L40129300 Men's UK 11/US 11.5,FBALYB Amazon,-4,-4,0,0,0,0
,Salomon Shoes X Ultra 3 Wide Mid GTX Black/India Ink/Monument L40129300 Men's UK 12.5/US 13,Salomon Shoes X Ultra 3 Wide Mid GTX Black/India Ink/Monument L40129300 Men's UK 12.5/US 13,FBALYB Amazon,-3,-3,0,0,0,0
,Salomon Shoes X Ultra 3 Wide Mid GTX Black/India Ink/Monument L40129300 Men's UK 12/US 12.5,Salomon Shoes X Ultra 3 Wide Mid GTX Black/India Ink/Monument L40129300 Men's UK 12/US 12.5,FBALYB Amazon,-6,-6,0,0,0,0
,Salomon Shoes X Ultra 3 Wide Mid GTX Black/India Ink/Monument L40129300 Men's UK 7.5/US 8,Salomon Shoes X Ultra 3 Wide Mid GTX Black/India Ink/Monument L40129300 Men's UK 7.5/US 8,FBALYB Amazon,-3,-3,0,0,0,0
,Salomon Shoes X Ultra 3 Wide Mid GTX Black/India Ink/Monument L40129300 Men's UK 8.5/US 9,Salomon Shoes X Ultra 3 Wide Mid GTX Black/India Ink/Monument L40129300 Men's UK 8.5/US 9,FBALYB Amazon,-6,-6,0,0,0,0
,Salomon Shoes X Ultra 3 Wide Mid GTX Black/India Ink/Monument L40129300 Men's UK 8/US 8.5,Salomon Shoes X Ultra 3 Wide Mid GTX Black/India Ink/Monument L40129300 Men's UK 8/US 8.5,FBALYB Amazon,-3,-3,0,0,0,0
,Salomon Shoes X Ultra 3 Wide Mid GTX Black/India Ink/Monument L40129300 Men's UK 9.5/US 10,Salomon Shoes X Ultra 3 Wide Mid GTX Black/India Ink/Monument L40129300 Men's UK 9.5/US 10,FBALYB Amazon,-10,-10,0,0,0,0
,Salomon Shoes X Ultra 3 Wide Mid GTX Black/India Ink/Monument L40129300 Men's UK 9/US 9.5,Salomon Shoes X Ultra 3 Wide Mid GTX Black/India Ink/Monument L40129300 Men's UK 9/US 9.5,FBALYB Amazon,-3,-3,0,0,0,0
,Salomon Shoes X Ultra 3 Wide Mid GTX Castor Gray/Black/Green Sulphur L40129500 Men's UK 10.5/US 11,Salomon Shoes X Ultra 3 Wide Mid GTX Castor Gray/Black/Green Sulphur L40129500 Men's UK 10.5/US 11,FBALYB Amazon,-4,-4,0,0,0,0
,Salomon Shoes X Ultra 3 Wide Mid GTX Castor Gray/Black/Green Sulphur L40129500 Men's UK 10/US 10.5,Salomon Shoes X Ultra 3 Wide Mid GTX Castor Gray/Black/Green Sulphur L40129500 Men's UK 10/US 10.5,FBALYB Amazon,-11,-11,0,0,0,0
,Salomon Shoes X Ultra 3 Wide Mid GTX Castor Gray/Black/Green Sulphur L40129500 Men's UK 11.5/US 12,Salomon Shoes X Ultra 3 Wide Mid GTX Castor Gray/Black/Green Sulphur L40129500 Men's UK 11.5/US 12,FBALYB Amazon,-3,-3,0,0,0,0
,Salomon Shoes X Ultra 3 Wide Mid GTX Castor Gray/Black/Green Sulphur L40129500 Men's UK 11/US 11.5,Salomon Shoes X Ultra 3 Wide Mid GTX Castor Gray/Black/Green Sulphur L40129500 Men's UK 11/US 11.5,FBALYB Amazon,-3,-3,0,0,0,0
,Salomon Shoes X Ultra 3 Wide Mid GTX Castor Gray/Black/Green Sulphur L40129500 Men's UK 12.5/US 13,Salomon Shoes X Ultra 3 Wide Mid GTX Castor Gray/Black/Green Sulphur L40129500 Men's UK 12.5/US 13,FBALYB Amazon,-4,-4,0,0,0,0
,Salomon Shoes X Ultra 3 Wide Mid GTX Castor Gray/Black/Green Sulphur L40129500 Men's UK 12/US 12.5,Salomon Shoes X Ultra 3 Wide Mid GTX Castor Gray/Black/Green Sulphur L40129500 Men's UK 12/US 12.5,FBALYB Amazon,-7,-7,0,0,0,0
,Salomon Shoes X Ultra 3 Wide Mid GTX Castor Gray/Black/Green Sulphur L40129500 Men's UK 7.5/US 8,Salomon Shoes X Ultra 3 Wide Mid GTX Castor Gray/Black/Green Sulphur L40129500 Men's UK 7.5/US 8,FBALYB Amazon,-1,-1,0,0,0,0
,Salomon Shoes X Ultra 3 Wide Mid GTX Castor Gray/Black/Green Sulphur L40129500 Men's UK 8.5/US 9,Salomon Shoes X Ultra 3 Wide Mid GTX Castor Gray/Black/Green Sulphur L40129500 Men's UK 8.5/US 9,FBALYB Amazon,-9,-9,0,0,0,0
,Salomon Shoes X Ultra 3 Wide Mid GTX Castor Gray/Black/Green Sulphur L40129500 Men's UK 9.5/US 10,Salomon Shoes X Ultra 3 Wide Mid GTX Castor Gray/Black/Green Sulphur L40129500 Men's UK 9.5/US 10,FBALYB Amazon,-6,-6,0,0,0,0
,Salomon Shoes X Ultra 3 Wide Mid GTX Castor Gray/Black/Green Sulphur L40129500 Men's UK 9/US 9.5,Salomon Shoes X Ultra 3 Wide Mid GTX Castor Gray/Black/Green Sulphur L40129500 Men's UK 9/US 9.5,FBALYB Amazon,-3,-3,0,0,0,0
,Salomon Women  SHOES OUTline GTX W Shad/Urban Chic/Cora L40796900 Size UK  5.5/ US 7,Salomon Women  SHOES OUTline GTX W Shad/Urban Chic/Cora L40796900 Size UK  5.5/ US 7,Default Ridgefield,30,30,0,0,0,0
,Salomon Women  SHOES OUTline GTX W Shad/Urban Chic/Cora L40796900 Size UK  5/ US 6.5,Salomon Women  SHOES OUTline GTX W Shad/Urban Chic/Cora L40796900 Size UK  5/ US 6.5,Default Ridgefield,20,20,0,0,0,0
,Salomon Women  SHOES OUTline GTX W Shad/Urban Chic/Cora L40796900 Size UK  6.5/ US 8,Salomon Women  SHOES OUTline GTX W Shad/Urban Chic/Cora L40796900 Size UK  6.5/ US 8,FBALYB Amazon,20,17,3,0,3,0
,Salomon Women  SHOES OUTline GTX W Shad/Urban Chic/Cora L40796900 Size UK  6/ US 7.5,Salomon Women  SHOES OUTline GTX W Shad/Urban Chic/Cora L40796900 Size UK  6/ US 7.5,Default Ridgefield,40,40,0,0,0,0
,Salomon Women  SHOES OUTline GTX W Shad/Urban Chic/Cora L40796900 Size UK  7.5/ US 9,Salomon Women  SHOES OUTline GTX W Shad/Urban Chic/Cora L40796900 Size UK  7.5/ US 9,FBALYB Amazon,34,33,1,0,1,0
,Salomon Women  SHOES OUTline GTX W Shad/Urban Chic/Cora L40796900 Size UK  7/ US 8.5,Salomon Women  SHOES OUTline GTX W Shad/Urban Chic/Cora L40796900 Size UK  7/ US 8.5,Default Ridgefield,40,40,0,0,0,0
,Salomon Women  SHOES OUTline GTX W Shad/Urban Chic/Cora L40796900 Size UK  8.5/ US 10,Salomon Women  SHOES OUTline GTX W Shad/Urban Chic/Cora L40796900 Size UK  8.5/ US 10,Default Ridgefield,40,40,0,0,0,0
,Salomon Women  SHOES OUTline GTX W Shad/Urban Chic/Cora L40796900 Size UK  8/ US 9.5,Salomon Women  SHOES OUTline GTX W Shad/Urban Chic/Cora L40796900 Size UK  8/ US 9.5,Default Ridgefield,40,40,0,0,0,0
,Salomon Women  SHOES OUTline GTX W Shad/Urban Chic/Cora L40796900 Size UK  9/ US 10.5,Salomon Women  SHOES OUTline GTX W Shad/Urban Chic/Cora L40796900 Size UK  9/ US 10.5,Default Ridgefield,30,30,0,0,0,0
,Salomon Women SHOES X ULTRA 3 GTX W Gr/MnGr/Bellini L40987800 UK Size: 5 US Size 6.5,Salomon Women SHOES X ULTRA 3 GTX W Gr/MnGr/Bellini L40987800 UK Size: 5 US Size 6.5,FBALYB Amazon,4,4,0,0,0,0
,Salomon Women SHOES X ULTRA 3 GTX W Gr/MnGr/Bellini L40987800 UK Size: 6.5 US Size 8,Salomon Women SHOES X ULTRA 3 GTX W Gr/MnGr/Bellini L40987800 UK Size: 6.5 US Size 8,FBALYB Amazon,-2,-2,0,0,0,0
,Salomon Women SHOES X ULTRA 3 GTX W Gr/MnGr/Bellini L40987800 UK Size: 6 US Size 7.5,Salomon Women SHOES X ULTRA 3 GTX W Gr/MnGr/Bellini L40987800 UK Size: 6 US Size 7.5,FBALYB Amazon,-1,-1,0,0,0,0
,Salomon Women SHOES X ULTRA 3 GTX W Gr/MnGr/Bellini L40987800 UK Size: 7.5 US Size 9,Salomon Women SHOES X ULTRA 3 GTX W Gr/MnGr/Bellini L40987800 UK Size: 7.5 US Size 9,Default Ridgefield,5,5,0,0,0,0
,Salomon Women SHOES X ULTRA 3 GTX W Gr/MnGr/Bellini L40987800 UK Size: 7.5 US Size 9,Salomon Women SHOES X ULTRA 3 GTX W Gr/MnGr/Bellini L40987800 UK Size: 7.5 US Size 9,FBALYB Amazon,19,19,0,0,0,0
,Salomon Women SHOES X ULTRA 3 GTX W Gr/MnGr/Bellini L40987800 UK Size: 7 US Size 8.5,Salomon Women SHOES X ULTRA 3 GTX W Gr/MnGr/Bellini L40987800 UK Size: 7 US Size 8.5,Default Ridgefield,30,30,0,0,0,0
,Salomon Women SHOES X ULTRA 3 GTX W Gr/MnGr/Bellini L40987800 UK Size: 7 US Size 8.5,Salomon Women SHOES X ULTRA 3 GTX W Gr/MnGr/Bellini L40987800 UK Size: 7 US Size 8.5,FBALYB Amazon,-31,-31,0,0,0,0
,Salomon Women SHOES X ULTRA 3 GTX W Gr/MnGr/Bellini L40987800 UK Size: 8.5 US Size 10,Salomon Women SHOES X ULTRA 3 GTX W Gr/MnGr/Bellini L40987800 UK Size: 8.5 US Size 10,FBALYB Amazon,26,26,0,0,0,0
,Salomon Women SHOES X ULTRA 3 GTX W Gr/MnGr/Bellini L40987800 UK Size: 8 US Size 9.5,Salomon Women SHOES X ULTRA 3 GTX W Gr/MnGr/Bellini L40987800 UK Size: 8 US Size 9.5,FBALYB Amazon,19,19,0,0,0,0
,Salomon Women SHOES X ULTRA 3 GTX W Gr/MnGr/Bellini L40987800 UK Size: 9 US Size 10.5,Salomon Women SHOES X ULTRA 3 GTX W Gr/MnGr/Bellini L40987800 UK Size: 9 US Size 10.5,FBALYB Amazon,19,19,0,0,0,0
,Salomon Women SHOES X ULTRA 3 GTX W Gr/MnGr/Bellini UK L40987800 Size: 5.5 US Size 7,Salomon Women SHOES X ULTRA 3 GTX W Gr/MnGr/Bellini UK L40987800 Size: 5.5 US Size 7,FBALYB Amazon,3,3,0,0,0,0
,Salomon Women's L40664400 X Ultra 3 W StoWea/Ebony/Cashmere UK 5.5 / US 7,Salomon Women's L40664400 X Ultra 3 W StoWea/Ebony/Cashmere UK 5.5 / US 7,FBALYB Amazon,-5,-5,0,0,0,0
,Salomon Women's L40664400 X Ultra 3 W StoWea/Ebony/Cashmere UK 5 / US 6.5,Salomon Women's L40664400 X Ultra 3 W StoWea/Ebony/Cashmere UK 5 / US 6.5,FBALYB Amazon,-15,-16,1,0,1,0
,Salomon Women's L40664400 X Ultra 3 W StoWea/Ebony/Cashmere UK 6.5 / 8,Salomon Women's L40664400 X Ultra 3 W StoWea/Ebony/Cashmere UK 6.5 / 8,FBALYB Amazon,-7,-7,0,0,0,0
,Salomon Women's L40664400 X Ultra 3 W StoWea/Ebony/Cashmere UK 6 / US 7.5,Salomon Women's L40664400 X Ultra 3 W StoWea/Ebony/Cashmere UK 6 / US 7.5,FBALYB Amazon,-19,-20,1,0,1,0
,Salomon Women's L40664400 X Ultra 3 W StoWea/Ebony/Cashmere UK 7.5 / US 9,Salomon Women's L40664400 X Ultra 3 W StoWea/Ebony/Cashmere UK 7.5 / US 9,FBALYB Amazon,-6,-6,0,0,0,0
,Salomon Women's L40664400 X Ultra 3 W StoWea/Ebony/Cashmere UK 7 / US 8.5,Salomon Women's L40664400 X Ultra 3 W StoWea/Ebony/Cashmere UK 7 / US 8.5,FBALYB Amazon,-7,-7,0,0,0,0
,Salomon Women's L40664400 X Ultra 3 W StoWea/Ebony/Cashmere US 6.5,Salomon Women's L40664400 X Ultra 3 W StoWea/Ebony/Cashmere US 6.5,FBALYB Amazon,6,6,0,0,0,0
,Salomon Women's L40664400 X Ultra 3 W StoWea/Ebony/Cashmere US 7,Salomon Women's L40664400 X Ultra 3 W StoWea/Ebony/Cashmere US 7,FBALYB Amazon,6,6,0,0,0,0
,Salomon Women's L40664400 X Ultra 3 W StoWea/Ebony/Cashmere US 7.5,Salomon Women's L40664400 X Ultra 3 W StoWea/Ebony/Cashmere US 7.5,FBALYB Amazon,-2,-2,0,0,0,0
,Salomon Women's L40664400 X Ultra 3 W StoWea/Ebony/Cashmere US 8,Salomon Women's L40664400 X Ultra 3 W StoWea/Ebony/Cashmere US 8,FBALYB Amazon,-2,-2,0,0,0,0
,Salomon Women's L40664400 X Ultra 3 W StoWea/Ebony/Cashmere US 8.5,Salomon Women's L40664400 X Ultra 3 W StoWea/Ebony/Cashmere US 8.5,FBALYB Amazon,-5,-5,0,0,0,0
,Salomon Women's L41042200 X Reveal GTX W Black/StoWea/Ebony US 10,Salomon Women's L41042200 X Reveal GTX W Black/StoWea/Ebony US 10,FBALYB Amazon,26,26,0,0,0,0
,Salomon Women's L41042200 X Reveal GTX W Black/StoWea/Ebony US 10.5,Salomon Women's L41042200 X Reveal GTX W Black/StoWea/Ebony US 10.5,FBALYB Amazon,18,18,0,0,0,0
,Salomon Women's L41042200 X Reveal GTX W Black/StoWea/Ebony US 6.5,Salomon Women's L41042200 X Reveal GTX W Black/StoWea/Ebony US 6.5,FBALYB Amazon,3,3,0,0,0,0
,Salomon Women's L41042200 X Reveal GTX W Black/StoWea/Ebony US 7,Salomon Women's L41042200 X Reveal GTX W Black/StoWea/Ebony US 7,FBALYB Amazon,8,7,1,0,1,0
,Salomon Women's L41042200 X Reveal GTX W Black/StoWea/Ebony US 7.5,Salomon Women's L41042200 X Reveal GTX W Black/StoWea/Ebony US 7.5,FBALYB Amazon,9,9,0,0,0,0
,Salomon Women's L41042200 X Reveal GTX W Black/StoWea/Ebony US 8,Salomon Women's L41042200 X Reveal GTX W Black/StoWea/Ebony US 8,FBALYB Amazon,7,6,1,0,1,0
,Salomon Women's L41042200 X Reveal GTX W Black/StoWea/Ebony US 8.5,Salomon Women's L41042200 X Reveal GTX W Black/StoWea/Ebony US 8.5,FBALYB Amazon,25,25,0,0,0,0
,Salomon Women's L41042200 X Reveal GTX W Black/StoWea/Ebony US 9,Salomon Women's L41042200 X Reveal GTX W Black/StoWea/Ebony US 9,FBALYB Amazon,20,20,0,0,0,0
,Salomon Women's L41042200 X Reveal GTX W Black/StoWea/Ebony US 9.5,Salomon Women's L41042200 X Reveal GTX W Black/StoWea/Ebony US 9.5,FBALYB Amazon,24,24,0,0,0,0
,Salomon Women X REVEAL W Phantom/Gr/Black L40972900 UK 5.5 US 7,Salomon Women X REVEAL W Phantom/Gr/Black L40972900 UK 5.5 US 7,Default Ridgefield,10,10,0,0,0,0
,Salomon Women X REVEAL W Phantom/Gr/Black L40972900 UK 5.5 US 7,Salomon Women X REVEAL W Phantom/Gr/Black L40972900 UK 5.5 US 7,FBALYB Amazon,9,9,0,0,0,0
,Salomon Women X REVEAL W Phantom/Gr/Black L40972900 UK 5 US 6.5,Salomon Women X REVEAL W Phantom/Gr/Black L40972900 UK 5 US 6.5,Default Ridgefield,5,5,0,0,0,0
,Salomon Women X REVEAL W Phantom/Gr/Black L40972900 UK 5 US 6.5,Salomon Women X REVEAL W Phantom/Gr/Black L40972900 UK 5 US 6.5,FBALYB Amazon,1,1,0,0,0,0
,Salomon Women X REVEAL W Phantom/Gr/Black L40972900 UK 6.5 US 8,Salomon Women X REVEAL W Phantom/Gr/Black L40972900 UK 6.5 US 8,Default Ridgefield,15,15,0,0,0,0
,Salomon Women X REVEAL W Phantom/Gr/Black L40972900 UK 6.5 US 8,Salomon Women X REVEAL W Phantom/Gr/Black L40972900 UK 6.5 US 8,FBALYB Amazon,12,12,0,0,0,0
,Salomon Women X REVEAL W Phantom/Gr/Black L40972900 UK 6 US 7.5,Salomon Women X REVEAL W Phantom/Gr/Black L40972900 UK 6 US 7.5,Default Ridgefield,15,15,0,0,0,0
,Salomon Women X REVEAL W Phantom/Gr/Black L40972900 UK 6 US 7.5,Salomon Women X REVEAL W Phantom/Gr/Black L40972900 UK 6 US 7.5,FBALYB Amazon,10,10,0,0,0,0
,Salomon Women X REVEAL W Phantom/Gr/Black L40972900 UK 7.5 US 9,Salomon Women X REVEAL W Phantom/Gr/Black L40972900 UK 7.5 US 9,Default Ridgefield,15,15,0,0,0,0
,Salomon Women X REVEAL W Phantom/Gr/Black L40972900 UK 7.5 US 9,Salomon Women X REVEAL W Phantom/Gr/Black L40972900 UK 7.5 US 9,FBALYB Amazon,9,9,0,0,0,0
,Salomon Women X REVEAL W Phantom/Gr/Black L40972900 UK 7 US 8.5,Salomon Women X REVEAL W Phantom/Gr/Black L40972900 UK 7 US 8.5,Default Ridgefield,15,15,0,0,0,0
,Salomon Women X REVEAL W Phantom/Gr/Black L40972900 UK 7 US 8.5,Salomon Women X REVEAL W Phantom/Gr/Black L40972900 UK 7 US 8.5,FBALYB Amazon,11,11,0,0,0,0
,Salomon Women X REVEAL W Phantom/Gr/Black L40972900 UK 8.5 US 10,Salomon Women X REVEAL W Phantom/Gr/Black L40972900 UK 8.5 US 10,Default Ridgefield,15,15,0,0,0,0
,Salomon Women X REVEAL W Phantom/Gr/Black L40972900 UK 8.5 US 10,Salomon Women X REVEAL W Phantom/Gr/Black L40972900 UK 8.5 US 10,FBALYB Amazon,12,12,0,0,0,0
,Salomon Women X REVEAL W Phantom/Gr/Black L40972900 UK 8 US 9.5,Salomon Women X REVEAL W Phantom/Gr/Black L40972900 UK 8 US 9.5,Default Ridgefield,15,15,0,0,0,0
,Salomon Women X REVEAL W Phantom/Gr/Black L40972900 UK 8 US 9.5,Salomon Women X REVEAL W Phantom/Gr/Black L40972900 UK 8 US 9.5,FBALYB Amazon,14,14,0,0,0,0
,Salomon Women X REVEAL W Phantom/Gr/Black L40972900 UK 9 US 10.5,Salomon Women X REVEAL W Phantom/Gr/Black L40972900 UK 9 US 10.5,Default Ridgefield,10,10,0,0,0,0
,Salomon Women X REVEAL W Phantom/Gr/Black L40972900 UK 9 US 10.5,Salomon Women X REVEAL W Phantom/Gr/Black L40972900 UK 9 US 10.5,FBALYB Amazon,9,9,0,0,0,0
,Salomon Women X ULTRA 3 GTX W Shad/LunRoc/Aqua G L41140100 UK 5.5 US 7,Salomon Women X ULTRA 3 GTX W Shad/LunRoc/Aqua G L41140100 UK 5.5 US 7,FBALYB Amazon,12,11,1,0,1,0
,Salomon Women X ULTRA 3 GTX W Shad/LunRoc/Aqua G L41140100 UK 5 US 6.5,Salomon Women X ULTRA 3 GTX W Shad/LunRoc/Aqua G L41140100 UK 5 US 6.5,FBALYB Amazon,-4,-5,1,10,1,0
,Salomon Women X ULTRA 3 GTX W Shad/LunRoc/Aqua G L41140100 UK 6.5 US 8,Salomon Women X ULTRA 3 GTX W Shad/LunRoc/Aqua G L41140100 UK 6.5 US 8,FBALYB Amazon,16,15,1,0,1,0
,Salomon Women X ULTRA 3 GTX W Shad/LunRoc/Aqua G L41140100 UK 6 US 7.5,Salomon Women X ULTRA 3 GTX W Shad/LunRoc/Aqua G L41140100 UK 6 US 7.5,FBALYB Amazon,19,18,1,0,1,0
,Salomon Women X ULTRA 3 GTX W Shad/LunRoc/Aqua G L41140100 UK 7.5 US 9,Salomon Women X ULTRA 3 GTX W Shad/LunRoc/Aqua G L41140100 UK 7.5 US 9,Default Ridgefield,30,30,0,0,0,0
,Salomon Women X ULTRA 3 GTX W Shad/LunRoc/Aqua G L41140100 UK 7.5 US 9,Salomon Women X ULTRA 3 GTX W Shad/LunRoc/Aqua G L41140100 UK 7.5 US 9,FBALYB Amazon,-18,-19,1,0,1,0
,Salomon Women X ULTRA 3 GTX W Shad/LunRoc/Aqua G L41140100 UK 7 US 8.5,Salomon Women X ULTRA 3 GTX W Shad/LunRoc/Aqua G L41140100 UK 7 US 8.5,FBALYB Amazon,22,22,0,0,0,0
,Salomon Women X ULTRA 3 GTX W Shad/LunRoc/Aqua G L41140100 UK 8.5 US 10,Salomon Women X ULTRA 3 GTX W Shad/LunRoc/Aqua G L41140100 UK 8.5 US 10,Default Ridgefield,30,30,0,0,0,0
,Salomon Women X ULTRA 3 GTX W Shad/LunRoc/Aqua G L41140100 UK 8.5 US 10,Salomon Women X ULTRA 3 GTX W Shad/LunRoc/Aqua G L41140100 UK 8.5 US 10,FBALYB Amazon,23,23,0,0,0,0
,Salomon Women X ULTRA 3 GTX W Shad/LunRoc/Aqua G L41140100 UK 8 US 9.5,Salomon Women X ULTRA 3 GTX W Shad/LunRoc/Aqua G L41140100 UK 8 US 9.5,FBALYB Amazon,21,21,0,0,0,0
,Salomon Women X ULTRA 3 GTX W Shad/LunRoc/Aqua G L41140100 UK 9 US 10.5,Salomon Women X ULTRA 3 GTX W Shad/LunRoc/Aqua G L41140100 UK 9 US 10.5,Default Ridgefield,15,15,0,0,0,0
,Salomon Women X ULTRA 3 GTX W Shad/LunRoc/Aqua G L41140100 UK 9 US 10.5,Salomon Women X ULTRA 3 GTX W Shad/LunRoc/Aqua G L41140100 UK 9 US 10.5,FBALYB Amazon,-3,-3,0,15,0,0
,Salomon Women X ULTRA 3 MID GTX WMgnt/Black/Mon L40475600 UK 5.5 US 7,Salomon Women X ULTRA 3 MID GTX WMgnt/Black/Mon L40475600 UK 5.5 US 7,Default Ridgefield,20,20,0,0,0,0
,Salomon Women X ULTRA 3 MID GTX WMgnt/Black/Mon L40475600 UK 5 US 6.5,Salomon Women X ULTRA 3 MID GTX WMgnt/Black/Mon L40475600 UK 5 US 6.5,Default Ridgefield,5,5,0,0,0,0
,Salomon Women X ULTRA 3 MID GTX WMgnt/Black/Mon L40475600 UK 5 US 6.5,Salomon Women X ULTRA 3 MID GTX WMgnt/Black/Mon L40475600 UK 5 US 6.5,FBALYB Amazon,2,2,0,0,0,0
,Salomon Women X ULTRA 3 MID GTX WMgnt/Black/Mon L40475600 UK 6.5 US 8,Salomon Women X ULTRA 3 MID GTX WMgnt/Black/Mon L40475600 UK 6.5 US 8,Default Ridgefield,30,30,0,0,0,0
,Salomon Women X ULTRA 3 MID GTX WMgnt/Black/Mon L40475600 UK 6 US 7.5,Salomon Women X ULTRA 3 MID GTX WMgnt/Black/Mon L40475600 UK 6 US 7.5,Default Ridgefield,30,30,0,0,0,0
,Salomon Women X ULTRA 3 MID GTX WMgnt/Black/Mon L40475600 UK 7.5 US 9,Salomon Women X ULTRA 3 MID GTX WMgnt/Black/Mon L40475600 UK 7.5 US 9,Default Ridgefield,30,30,0,0,0,0
,Salomon Women X ULTRA 3 MID GTX WMgnt/Black/Mon L40475600 UK 7 US 8.5,Salomon Women X ULTRA 3 MID GTX WMgnt/Black/Mon L40475600 UK 7 US 8.5,Default Ridgefield,30,30,0,0,0,0
,Salomon Women X ULTRA 3 MID GTX WMgnt/Black/Mon L40475600 UK 8.5 US 10,Salomon Women X ULTRA 3 MID GTX WMgnt/Black/Mon L40475600 UK 8.5 US 10,Default Ridgefield,30,30,0,0,0,0
,Salomon Women X ULTRA 3 MID GTX WMgnt/Black/Mon L40475600 UK 8 US 9.5,Salomon Women X ULTRA 3 MID GTX WMgnt/Black/Mon L40475600 UK 8 US 9.5,Default Ridgefield,30,30,0,0,0,0
,Salomon Women X ULTRA 3 MID GTX WMgnt/Black/Mon L40475600 UK 9 US 10.5,Salomon Women X ULTRA 3 MID GTX WMgnt/Black/Mon L40475600 UK 9 US 10.5,Default Ridgefield,20,20,0,0,0,0
,SalonPas 140 ct 2pk,SalonPas 140 ct 2pk,FBALYB Amazon,-3,-3,0,0,0,0
,Salonpas 140 patch,Salonpas pain relieving patch 140 patch,FBALYB Amazon,-41,-41,0,41,0,0
,Salonpas 140 patch,Salonpas pain relieving patch 140 patch,WFS,-1,-1,0,0,0,0
,Salonpas Lidocaine 4% 15ct,Salonpas Lidocaine 4% 15ct,FBALYB Amazon,1,1,0,0,0,0
,Salonpas Patches 140ct,Salonpas Patches 140ct,Avrami - Ebay,245,245,0,0,0,0
,Salonpas Patches 140ct,Salonpas Patches 140ct,Default,0,-768,768,0,0,4
,Salonpas Patches 140ct,Salonpas Patches 140ct,Default Ridgefield,16,16,0,0,0,0
,Salonpas Patches 140ct,Salonpas Patches 140ct,FBALYB Amazon,887,809,78,26,78,0
,Salonpas Patches 140ct,Salonpas Patches 140ct,WFS,-215,-215,0,0,0,0
,Salonpas Patches 140ct 2 pack,Salonpas Patches 140ct 2 pack,FBALYB Amazon,332,332,0,1,0,0
,Salt Water - Adult - Black SAW-886Y08 Size: 08 US,Salt Water - Adult - Black SAW-886Y08 Size: 08 US,Default Ridgefield,144,144,0,0,0,0
,Salt Water - Adult - Black SAW-886Y08 Size: 08 US,Salt Water - Adult - Black SAW-886Y08 Size: 08 US,FBALYB Amazon,-14,-14,0,0,0,0
,Salt Water - Adult - Black SAW-886Y08 Size: 10 US,Salt Water - Adult - Black SAW-886Y08 Size: 10 US,FBALYB Amazon,-11,-11,0,0,0,0
,Salt Water - Adult - Black SAW-886Y09 Size: 09 US,Salt Water - Adult - Black SAW-886Y09 Size: 09 US,Default Ridgefield,48,48,0,0,0,0
,Salt Water - Adult - Black SAW-886Y09 Size: 09 US,Salt Water - Adult - Black SAW-886Y09 Size: 09 US,FBALYB Amazon,-5,-5,0,0,0,0
,Salt Water - Adult - Black SAW-886Y09 Size: 11 US,Salt Water - Adult - Black SAW-886Y09 Size: 11 US,FBALYB Amazon,40,40,0,0,0,0
,Salt Water - Adult - Gold SAW-820Y08 Size: 08 US,Salt Water - Adult - Gold SAW-820Y08 Size: 08 US,Default Ridgefield,48,48,0,0,0,0
,Salt Water - Adult - Gold SAW-820Y08 Size: 08 US,Salt Water - Adult - Gold SAW-820Y08 Size: 08 US,FBALYB Amazon,48,48,0,0,0,0
,Salt Water - Adult - Gold SAW-820Y08 Size: 10 US,Salt Water - Adult - Gold SAW-820Y08 Size: 10 US,FBALYB Amazon,92,92,0,0,0,0
,Salt Water - Adult - Gold SAW-820Y09 Size: 09 US,Salt Water - Adult - Gold SAW-820Y09 Size: 09 US,FBALYB Amazon,81,81,0,0,0,0
,Salt Water - Adult - Gold SAW-820Y09 Size: 11 US,Salt Water - Adult - Gold SAW-820Y09 Size: 11 US,FBALYB Amazon,65,65,0,0,0,0
,Salt Water - Adult - Navy SAW-887Y08 Size: 08 US,Salt Water - Adult - Navy SAW-887Y08 Size: 08 US,FBALYB Amazon,17,16,1,0,1,0
,Salt Water - Adult - Navy SAW-887Y08 Size: 10 US,Salt Water - Adult - Navy SAW-887Y08 Size: 10 US,FBALYB Amazon,31,31,0,0,0,0
,Salt Water - Adult - Navy SAW-887Y09 Size: 09 US,Salt Water - Adult - Navy SAW-887Y09 Size: 09 US,Default Ridgefield,36,36,0,0,0,0
,Salt Water - Adult - Navy SAW-887Y09 Size: 09 US,Salt Water - Adult - Navy SAW-887Y09 Size: 09 US,FBALYB Amazon,-6,-6,0,0,0,0
,Salt Water - Adult - Navy SAW-887Y09 Size: 11 US,Salt Water - Adult - Navy SAW-887Y09 Size: 11 US,FBALYB Amazon,11,11,0,0,0,0
,Salt Water-Adult-Pewter SAW-814Y08 Size: 08 US,Salt Water-Adult-Pewter SAW-814Y08 Size: 08 US,FBALYB Amazon,-4,-4,0,0,0,0
,Salt Water-Adult-Pewter SAW-814Y08 Size: 10 US,Salt Water-Adult-Pewter SAW-814Y08 Size: 10 US,FBALYB Amazon,19,19,0,0,0,0
,Salt Water-Adult-Pewter SAW-814Y09 Size: 09 US,Salt Water-Adult-Pewter SAW-814Y09 Size: 09 US,FBALYB Amazon,2,2,0,0,0,0
,Salt Water-Adult-Pewter SAW-814Y09 Size: 11 US,Salt Water-Adult-Pewter SAW-814Y09 Size: 11 US,FBALYB Amazon,23,23,0,0,0,0
,Salt Water - Adult - Red SAW-884Y08 Size: 08 US,Salt Water - Adult - Red SAW-884Y08 Size: 08 US,Default Ridgefield,24,24,0,0,0,0
,Salt Water - Adult - Red SAW-884Y08 Size: 08 US,Salt Water - Adult - Red SAW-884Y08 Size: 08 US,FBALYB Amazon,13,13,0,0,0,0
,Salt Water - Adult - Red SAW-884Y08 Size: 10 US,Salt Water - Adult - Red SAW-884Y08 Size: 10 US,FBALYB Amazon,39,39,0,0,0,0
,Salt Water - Adult - Red SAW-884Y09 Size: 09 US,Salt Water - Adult - Red SAW-884Y09 Size: 09 US,Default Ridgefield,48,48,0,0,0,0
,Salt Water - Adult - Red SAW-884Y09 Size: 09 US,Salt Water - Adult - Red SAW-884Y09 Size: 09 US,FBALYB Amazon,21,21,0,0,0,0
,Salt Water - Adult - Red SAW-884Y09 Size:11 US,Salt Water - Adult - Red SAW-884Y09 Size:11 US,FBALYB Amazon,31,31,0,0,0,0
,Salt Water - Adult - Rose Gold SAW-821Y08 Size: 08 US,Salt Water - Adult - Rose Gold SAW-821Y08 Size: 08 US,Default Ridgefield,36,36,0,0,0,0
,Salt Water - Adult - Rose Gold SAW-821Y08 Size: 08 US,Salt Water - Adult - Rose Gold SAW-821Y08 Size: 08 US,FBALYB Amazon,-7,-7,0,0,0,0
,Salt Water - Adult - Rose Gold SAW-821Y08 Size: 10 US,Salt Water - Adult - Rose Gold SAW-821Y08 Size: 10 US,FBALYB Amazon,-3,-3,0,0,0,0
,Salt Water - Adult - Rose Gold SAW-821Y09 Size: 09 US,Salt Water - Adult - Rose Gold SAW-821Y09 Size: 09 US,Default Ridgefield,48,48,0,0,0,0
,Salt Water - Adult - Rose Gold SAW-821Y09 Size: 09 US,Salt Water - Adult - Rose Gold SAW-821Y09 Size: 09 US,FBALYB Amazon,-5,-5,0,0,0,0
,Salt Water - Adult - Rose Gold SAW-821Y09 Size: 11 US,Salt Water - Adult - Rose Gold SAW-821Y09 Size: 11 US,FBALYB Amazon,18,18,0,0,0,0
,Salt Water - Adult - Silver SAW-812Y08 Size: 08 US,Salt Water - Adult - Silver SAW-812Y08 Size: 08 US,Default Ridgefield,36,36,0,0,0,0
,Salt Water - Adult - Silver SAW-812Y08 Size: 08 US,Salt Water - Adult - Silver SAW-812Y08 Size: 08 US,FBALYB Amazon,4,4,0,0,0,0
,Salt Water - Adult - Silver SAW-812Y08 Size: 10 US,Salt Water - Adult - Silver SAW-812Y08 Size: 10 US,FBALYB Amazon,11,11,0,0,0,0
,Salt Water - Adult - Silver SAW-812Y09 Size: 09 US,Salt Water - Adult - Silver SAW-812Y09 Size: 09 US,Default Ridgefield,36,36,0,0,0,0
,Salt Water - Adult - Silver SAW-812Y09 Size: 09 US,Salt Water - Adult - Silver SAW-812Y09 Size: 09 US,FBALYB Amazon,10,10,0,0,0,0
,Salt Water - Adult - Silver SAW-812Y09 Size: 11 US,Salt Water - Adult - Silver SAW-812Y09 Size: 11 US,FBALYB Amazon,11,11,0,0,0,0
,Salt Water - Adult - Tan SAW-885Y08 Size: 08 US,Salt Water - Adult - Tan SAW-885Y08 Size: 08 US,Default Ridgefield,1080,1080,0,0,0,0
,Salt Water - Adult - Tan SAW-885Y08 Size: 08 US,Salt Water - Adult - Tan SAW-885Y08 Size: 08 US,FBALYB Amazon,-9,-9,0,0,0,0
,Salt Water - Adult - Tan SAW-885Y08 Size: 10 US,Salt Water - Adult - Tan SAW-885Y08 Size: 10 US,FBALYB Amazon,95,95,0,0,0,0
,Salt Water - Adult - Tan SAW-885Y08 Size: 10 US,Salt Water - Adult - Tan SAW-885Y08 Size: 10 US,WFS,-17,-17,0,0,0,0
,Salt Water - Adult - Tan SAW-885Y09 Size: 09 US,Salt Water - Adult - Tan SAW-885Y09 Size: 09 US,FBALYB Amazon,-23,-23,0,0,0,0
,Salt Water - Adult - Tan SAW-885Y09 Size: 11 US,Salt Water - Adult - Tan SAW-885Y09 Size: 11 US,FBALYB Amazon,47,47,0,0,0,0
,Salt Water - Adult - White SAW-883Y08 Size: 08 US,Salt Water - Adult - White SAW-883Y08 Size: 08 US,FBALYB Amazon,9,8,1,0,1,0
,Salt Water - Adult - White SAW-883Y08 Size: 10 US,Salt Water - Adult - White SAW-883Y08 Size: 10 US,FBALYB Amazon,52,52,0,0,0,0
,Salt Water - Adult - White SAW-883Y09 Size: 09 US,Salt Water - Adult - White SAW-883Y09 Size: 09 US,Default Ridgefield,48,48,0,0,0,0
,Salt Water - Adult - White SAW-883Y09 Size: 09 US,Salt Water - Adult - White SAW-883Y09 Size: 09 US,FBALYB Amazon,-13,-13,0,0,0,0
,Salt Water - Adult - White SAW-883Y09 Size: 11 US,Salt Water - Adult - White SAW-883Y09 Size: 11 US,FBALYB Amazon,50,50,0,0,0,0
,Salt Water - Child - Black SAW-886C09 Size: 09 US,Salt Water - Child - Black SAW-886C09 Size: 09 US,FBALYB Amazon,21,21,0,0,0,0
,Salt Water - Child - Black SAW-886C10 Size: 10 US,Salt Water - Child - Black SAW-886C10 Size: 10 US,FBALYB Amazon,58,58,0,0,0,0
,Salt Water - Child - Black SAW-886C11 Size: 11 US,Salt Water - Child - Black SAW-886C11 Size: 11 US,FBALYB Amazon,39,39,0,0,0,0
,Salt Water - Child - Black SAW-886C12 Size: 12 US,Salt Water - Child - Black SAW-886C12 Size: 12 US,FBALYB Amazon,41,41,0,0,0,0
,Salt Water - Child - Gold SAW-820C09 Size: 09 US,Salt Water - Child - Gold SAW-820C09 Size: 09 US,FBALYB Amazon,27,27,0,0,0,0
,Salt Water - Child - Gold SAW-820C10 Size: 10 US,Salt Water - Child - Gold SAW-820C10 Size: 10 US,FBALYB Amazon,69,69,0,0,0,0
,Salt Water - Child - Gold SAW-820C11 Size: 11 US,Salt Water - Child - Gold SAW-820C11 Size: 11 US,FBALYB Amazon,-30,-30,0,0,0,0
,Salt Water - Child - Gold SAW-820C12 Size: 12 US,Salt Water - Child - Gold SAW-820C12 Size: 12 US,Default Ridgefield,35,35,0,0,0,0
,Salt Water - Child - Gold SAW-820C12 Size: 12 US,Salt Water - Child - Gold SAW-820C12 Size: 12 US,FBALYB Amazon,201,200,1,0,1,0
,Salt Water-Child-Mustard SAW-815C09 Size: 09 US,Salt Water-Child-Mustard SAW-815C09 Size: 09 US,FBALYB Amazon,-3,-3,0,0,0,0
,Salt Water-Child-Mustard SAW-815C10 Size: 10 US,Salt Water-Child-Mustard SAW-815C10 Size: 10 US,FBALYB Amazon,18,18,0,0,0,0
,Salt Water-Child-Mustard SAW-815C11 Size: 11 US,Salt Water-Child-Mustard SAW-815C11 Size: 11 US,FBALYB Amazon,15,15,0,0,0,0
,Salt Water-Child-Mustard SAW-815C12 Size: 12 US,Salt Water-Child-Mustard SAW-815C12 Size: 12 US,FBALYB Amazon,23,23,0,0,0,0
,Salt Water - Child - Navy SAW-887C09 Size: 09 US,Salt Water - Child - Navy SAW-887C09 Size: 09 US,FBALYB Amazon,39,39,0,0,0,0
,Salt Water - Child - Navy SAW-887C10 Size: 10 US,Salt Water - Child - Navy SAW-887C10 Size: 10 US,FBALYB Amazon,54,54,0,0,0,0
,Salt Water - Child - Navy SAW-887C11 Size: 11 US,Salt Water - Child - Navy SAW-887C11 Size: 11 US,FBALYB Amazon,38,38,0,0,0,0
,Salt Water - Child - Navy SAW-887C12 Size: 12 US,Salt Water - Child - Navy SAW-887C12 Size: 12 US,FBALYB Amazon,39,39,0,0,0,0
,Salt Water-Child-Olive SAW-816C09 Size: 09 US,Salt Water-Child-Olive SAW-816C09 Size: 09 US,FBALYB Amazon,-1,-1,0,0,0,0
,Salt Water-Child-Olive SAW-816C10 Size: 10 US,Salt Water-Child-Olive SAW-816C10 Size: 10 US,FBALYB Amazon,-2,-2,0,0,0,0
,Salt Water-Child-Olive SAW-816C11 Size: 11 US,Salt Water-Child-Olive SAW-816C11 Size: 11 US,FBALYB Amazon,1,1,0,0,0,0
,Salt Water-Child-Olive SAW-816C12 Size: 12 US,Salt Water-Child-Olive SAW-816C12 Size: 12 US,FBALYB Amazon,-3,-3,0,0,0,0
,Salt Water-Child-Pewter SAW-814C09 Size: 09 US,Salt Water-Child-Pewter SAW-814C09 Size: 09 US,FBALYB Amazon,-1,-1,0,0,0,0
,Salt Water-Child-Pewter SAW-814C10 Size: 10 US,Salt Water-Child-Pewter SAW-814C10 Size: 10 US,FBALYB Amazon,-1,-1,0,0,0,0
,Salt Water-Child-Pewter SAW-814C11 Size: 11 US,Salt Water-Child-Pewter SAW-814C11 Size: 11 US,FBALYB Amazon,-4,-4,0,0,0,0
,Salt Water-Child-Pewter SAW-814C12 Size: 12 US,Salt Water-Child-Pewter SAW-814C12 Size: 12 US,FBALYB Amazon,-9,-9,0,0,0,0
,Salt Water - Child - Red SAW-884C09 Size: 09 US,Salt Water - Child - Red SAW-884C09 Size: 09 US,FBALYB Amazon,48,48,0,0,0,0
,Salt Water - Child - Red SAW-884C10 Size: 10 US,Salt Water - Child - Red SAW-884C10 Size: 10 US,FBALYB Amazon,37,37,0,0,0,0
,Salt Water - Child - Red SAW-884C11 Size: 11 US,Salt Water - Child - Red SAW-884C11 Size: 11 US,FBALYB Amazon,45,45,0,0,0,0
,Salt Water - Child - Red SAW-884C12 Size: 12 US,Salt Water - Child - Red SAW-884C12 Size: 12 US,FBALYB Amazon,28,28,0,0,0,0
,Salt Water - Child - Rose Gold SAW-821C09 Size: 09 US,Salt Water - Child - Rose Gold SAW-821C09 Size: 09 US,FBALYB Amazon,39,39,0,0,0,0
,Salt Water - Child - Rose Gold SAW-821C10 Size: 10 US,Salt Water - Child - Rose Gold SAW-821C10 Size: 10 US,FBALYB Amazon,48,48,0,0,0,0
,Salt Water - Child - Rose Gold SAW-821C11 Size: 11 US,Salt Water - Child - Rose Gold SAW-821C11 Size: 11 US,FBALYB Amazon,50,50,0,0,0,0
,Salt Water - Child - Rose Gold SAW-821C12 Size: 12 US,Salt Water - Child - Rose Gold SAW-821C12 Size: 12 US,FBALYB Amazon,191,191,0,0,0,0
,Salt Water - Child - Silver SAW-812C09 Size: 09 US,Salt Water - Child - Silver SAW-812C09 Size: 09 US,FBALYB Amazon,36,36,0,0,0,0
,Salt Water - Child - Silver SAW-812C10 Size: 10 US,Salt Water - Child - Silver SAW-812C10 Size: 10 US,FBALYB Amazon,31,31,0,0,0,0
,Salt Water - Child - Silver SAW-812C11 Size: 11 US,Salt Water - Child - Silver SAW-812C11 Size: 11 US,FBALYB Amazon,37,37,0,0,0,0
,Salt Water - Child - Silver SAW-812C12 Size: 12 US,Salt Water - Child - Silver SAW-812C12 Size: 12 US,FBALYB Amazon,37,37,0,0,0,0
,Salt Water - Child - Tan SAW-885C09 Size: 09 US,Salt Water - Child - Tan SAW-885C09 Size: 09 US,FBALYB Amazon,125,125,0,0,0,0
,Salt Water - Child - Tan SAW-885C10 Size: 10 US,Salt Water - Child - Tan SAW-885C10 Size: 10 US,FBALYB Amazon,345,344,1,0,1,0
,Salt Water - Child - Tan SAW-885C11 Size: 11 US,Salt Water - Child - Tan SAW-885C11 Size: 11 US,FBALYB Amazon,20,20,0,0,0,0
,Salt Water - Child - Tan SAW-885C12 Size: 12 US,Salt Water - Child - Tan SAW-885C12 Size: 12 US,FBALYB Amazon,17,16,1,0,1,0
,Salt Water - Child - White SAW-883C09 Size: 09 US,Salt Water - Child - White SAW-883C09 Size: 09 US,Default Ridgefield,48,48,0,0,0,0
,Salt Water - Child - White SAW-883C09 Size: 09 US,Salt Water - Child - White SAW-883C09 Size: 09 US,FBALYB Amazon,-5,-5,0,0,0,0
,Salt Water - Child - White SAW-883C10 Size: 10 US,Salt Water - Child - White SAW-883C10 Size: 10 US,FBALYB Amazon,59,59,0,0,0,0
,Salt Water - Child - White SAW-883C11 Size: 11 US,Salt Water - Child - White SAW-883C11 Size: 11 US,FBALYB Amazon,20,20,0,0,0,0
,Salt Water - Child - White SAW-883C12 Size: 12 US,Salt Water - Child - White SAW-883C12 Size: 12 US,FBALYB Amazon,94,94,0,1,0,0
,Salt Water - Infant - Black SAW-886B04 Size: 04 US,Salt Water - Infant - Black SAW-886B04 Size: 04 US,FBALYB Amazon,26,26,0,0,0,0
,Salt Water - Infant - Black SAW-886B05 Size: 05 US,Salt Water - Infant - Black SAW-886B05 Size: 05 US,FBALYB Amazon,36,36,0,0,0,0
,Salt Water - Infant - Black SAW-886B06 Size: 06 US,Salt Water - Infant - Black SAW-886B06 Size: 06 US,FBALYB Amazon,74,74,0,0,0,0
,Salt Water - Infant - Black SAW-886B07 Size: 07 US,Salt Water - Infant - Black SAW-886B07 Size: 07 US,FBALYB Amazon,38,38,0,0,0,0
,Salt Water - Infant - Black SAW-886B08 Size: 08 US,Salt Water - Infant - Black SAW-886B08 Size: 08 US,FBALYB Amazon,38,38,0,0,0,0
,Salt Water - Infant - Gold SAW-820B04 Size: 04 US,Salt Water - Infant - Gold SAW-820B04 Size: 04 US,FBALYB Amazon,-32,-32,0,48,0,0
,Salt Water - Infant - Gold SAW-820B05 Size: 05 US,Salt Water - Infant - Gold SAW-820B05 Size: 05 US,FBALYB Amazon,-12,-12,0,0,0,0
,Salt Water - Infant - Gold SAW-820B06 Size: 06 US,Salt Water - Infant - Gold SAW-820B06 Size: 06 US,FBALYB Amazon,-22,-22,0,36,0,0
,Salt Water - Infant - Gold SAW-820B07 Size: 07 US,Salt Water - Infant - Gold SAW-820B07 Size: 07 US,FBALYB Amazon,5,5,0,0,0,0
,Salt Water - Infant - Gold SAW-820B08 Size: 08 US,Salt Water - Infant - Gold SAW-820B08 Size: 08 US,FBALYB Amazon,41,41,0,0,0,0
,Salt Water-Infant-Mustard SAW-815B04 Size: 04 US,Salt Water-Infant-Mustard SAW-815B04 Size: 04 US,FBALYB Amazon,8,8,0,0,0,0
,Salt Water-Infant-Mustard SAW-815B05 Size: 05 US,Salt Water-Infant-Mustard SAW-815B05 Size: 05 US,FBALYB Amazon,-3,-4,1,0,1,0
,Salt Water-Infant-Mustard SAW-815B07 Size: 07 US,Salt Water-Infant-Mustard SAW-815B07 Size: 07 US,FBALYB Amazon,-4,-4,0,0,0,0
,Salt Water-Infant-Mustard SAW-815B08 Size: 08 US,Salt Water-Infant-Mustard SAW-815B08 Size: 08 US,FBALYB Amazon,14,14,0,0,0,0
,Salt Water - Infant - Navy SAW-887B04 Size: 04 US,Salt Water - Infant - Navy SAW-887B04 Size: 04 US,FBALYB Amazon,9,9,0,0,0,0
,Salt Water - Infant - Navy SAW-887B05 Size: 05 US,Salt Water - Infant - Navy SAW-887B05 Size: 05 US,FBALYB Amazon,-3,-3,0,0,0,0
,Salt Water - Infant - Navy SAW-887B06 Size: 06 US,Salt Water - Infant - Navy SAW-887B06 Size: 06 US,Default Ridgefield,24,24,0,0,0,0
,Salt Water - Infant - Navy SAW-887B06 Size: 06 US,Salt Water - Infant - Navy SAW-887B06 Size: 06 US,FBALYB Amazon,-7,-7,0,0,0,0
,Salt Water - Infant - Navy SAW-887B07 Size: 07 US,Salt Water - Infant - Navy SAW-887B07 Size: 07 US,FBALYB Amazon,35,35,0,0,0,0
,Salt Water - Infant - Navy SAW-887B08 Size: 08 US,Salt Water - Infant - Navy SAW-887B08 Size: 08 US,FBALYB Amazon,55,55,0,0,0,0
,Salt Water-Infant-Olive SAW-816B04 Size: 04 US,Salt Water-Infant-Olive SAW-816B04 Size: 04 US,FBALYB Amazon,2,2,0,0,0,0
,Salt Water-Infant-Olive SAW-816B06 Size: 06 US,Salt Water-Infant-Olive SAW-816B06 Size: 06 US,FBALYB Amazon,-2,-2,0,0,0,0
,Salt Water-Infant-Olive SAW-816B07 Size: 07 US,Salt Water-Infant-Olive SAW-816B07 Size: 07 US,FBALYB Amazon,-1,-1,0,0,0,0
,Salt Water-Infant-Olive SAW-816B08 Size: 08 US,Salt Water-Infant-Olive SAW-816B08 Size: 08 US,FBALYB Amazon,-3,-3,0,0,0,0
,Salt Water-Infant-Pewter SAW-814B04 Size: 04 US,Salt Water-Infant-Pewter SAW-814B04 Size: 04 US,FBALYB Amazon,11,11,0,0,0,0
,Salt Water-Infant-Pewter SAW-814B06 Size: 06 US,Salt Water-Infant-Pewter SAW-814B06 Size: 06 US,FBALYB Amazon,15,15,0,0,0,0
,Salt Water-Infant-Pewter SAW-814B07 Size: 07 US,Salt Water-Infant-Pewter SAW-814B07 Size: 07 US,FBALYB Amazon,6,6,0,0,0,0
,Salt Water-Infant-Pewter SAW-814B08 Size: 08 US,Salt Water-Infant-Pewter SAW-814B08 Size: 08 US,FBALYB Amazon,8,8,0,0,0,0
,Salt Water - Infant - Red SAW-884B04 Size: 04 US,Salt Water - Infant - Red SAW-884B04 Size: 04 US,FBALYB Amazon,13,13,0,0,0,0
,Salt Water - Infant - Red SAW-884B05 Size: 05 US,Salt Water - Infant - Red SAW-884B05 Size: 05 US,FBALYB Amazon,-2,-2,0,0,0,0
,Salt Water - Infant - Red SAW-884B07 Size: 06 US,Salt Water - Infant - Red SAW-884B07 Size: 06 US,FBALYB Amazon,-2,-2,0,0,0,0
,Salt Water - Infant - Red SAW-884B07 Size: 07 US,Salt Water - Infant - Red SAW-884B07 Size: 07 US,FBALYB Amazon,34,34,0,0,0,0
,Salt Water - Infant - Red SAW-884B08 Size: 08 US,Salt Water - Infant - Red SAW-884B08 Size: 08 US,FBALYB Amazon,42,42,0,0,0,0
,Salt Water - Infant - Rose Gold SAW-821B04 Size: 04 US,Salt Water - Infant - Rose Gold SAW-821B04 Size: 04 US,FBALYB Amazon,5,5,0,0,0,0
,Salt Water - Infant - Rose Gold SAW-821B05 Size: 05 US,Salt Water - Infant - Rose Gold SAW-821B05 Size: 05 US,FBALYB Amazon,15,15,0,0,0,0
,Salt Water - Infant - Rose Gold SAW-821B06 Size: 06 US,Salt Water - Infant - Rose Gold SAW-821B06 Size: 06 US,FBALYB Amazon,6,6,0,0,0,0
,Salt Water - Infant - Rose Gold SAW-821B07 Size: 07 US,Salt Water - Infant - Rose Gold SAW-821B07 Size: 07 US,FBALYB Amazon,52,52,0,0,0,0
,Salt Water - Infant - Rose Gold SAW-821B08 Size: 08 US,Salt Water - Infant - Rose Gold SAW-821B08 Size: 08 US,FBALYB Amazon,39,39,0,0,0,0
,Salt Water - Infant - Silver SAW-812B04 Size: 04 US,Salt Water - Infant - Silver SAW-812B04 Size: 04 US,FBALYB Amazon,1,1,0,0,0,0
,Salt Water - Infant - Silver SAW-812B06 Size: 06 US,Salt Water - Infant - Silver SAW-812B06 Size: 06 US,FBALYB Amazon,47,47,0,0,0,0
,Salt Water - Infant - Silver SAW-812B07 Size: 07 US,Salt Water - Infant - Silver SAW-812B07 Size: 07 US,FBALYB Amazon,30,30,0,0,0,0
,Salt Water - Infant - Silver SAW-812B08 Size: 08 US,Salt Water - Infant - Silver SAW-812B08 Size: 08 US,FBALYB Amazon,35,35,0,0,0,0
,Salt Water - Infant - Tan SAW-885B04 Size: 04 US,Salt Water - Infant - Tan SAW-885B04 Size: 04 US,FBALYB Amazon,19,18,1,0,1,0
,Salt Water - Infant - Tan SAW-885B05 Size: 05 US,Salt Water - Infant - Tan SAW-885B05 Size: 05 US,FBALYB Amazon,59,59,0,0,0,0
,Salt Water - Infant - Tan SAW-885B06 Size: 06 US,Salt Water - Infant - Tan SAW-885B06 Size: 06 US,FBALYB Amazon,99,99,0,0,0,0
,Salt Water - Infant - Tan SAW-885B07 Size: 07 US,Salt Water - Infant - Tan SAW-885B07 Size: 07 US,FBALYB Amazon,171,171,0,0,0,0
,Salt Water - Infant - Tan SAW-885B08 Size: 08 US,Salt Water - Infant - Tan SAW-885B08 Size: 08 US,FBALYB Amazon,119,118,1,0,1,0
,Salt Water - Infant - White SAW-883B04 Size: 04 US,Salt Water - Infant - White SAW-883B04 Size: 04 US,FBALYB Amazon,53,53,0,0,0,0
,Salt Water - Infant - White SAW-883B05 Size: 05 US,Salt Water - Infant - White SAW-883B05 Size: 05 US,FBALYB Amazon,42,42,0,0,0,0
,Salt Water - Infant - White SAW-883B06 Size: 06 US,Salt Water - Infant - White SAW-883B06 Size: 06 US,FBALYB Amazon,197,197,0,0,0,0
,Salt Water - Infant - White SAW-883B07 Size: 07 US,Salt Water - Infant - White SAW-883B07 Size: 07 US,FBALYB Amazon,44,44,0,0,0,0
,Salt Water - Infant - White SAW-883B08 Size: 08 US,Salt Water - Infant - White SAW-883B08 Size: 08 US,FBALYB Amazon,175,175,0,1,0,0
,Salt Water - Youth - Black SAW-886M01 Size: 01 US,Salt Water - Youth - Black SAW-886M01 Size: 01 US,FBALYB Amazon,66,66,0,0,0,0
,Salt Water - Youth - Black SAW-886M03 Size: 03 US,Salt Water - Youth - Black SAW-886M03 Size: 03 US,FBALYB Amazon,19,19,0,0,0,0
,Salt Water - Youth - Black SAW-886M13 Size: 13 US,Salt Water - Youth - Black SAW-886M13 Size: 13 US,FBALYB Amazon,67,66,1,0,1,0
,Salt Water - Youth - Gold SAW-820M01 Size: 01 US,Salt Water - Youth - Gold SAW-820M01 Size: 01 US,FBALYB Amazon,11,9,2,0,2,0
,Salt Water - Youth - Gold SAW-820M03 Size: 03 US,Salt Water - Youth - Gold SAW-820M03 Size: 03 US,FBALYB Amazon,12,12,0,0,0,0
,Salt Water - Youth - Gold SAW-820M13 Size: 13 US,Salt Water - Youth - Gold SAW-820M13 Size: 13 US,FBALYB Amazon,-6,-6,0,0,0,0
,Salt Water - Youth - Navy SAW-887M01 Size: 01 US,Salt Water - Youth - Navy SAW-887M01 Size: 01 US,FBALYB Amazon,19,19,0,0,0,0
,Salt Water - Youth - Navy SAW-887M03 Size: 03 US,Salt Water - Youth - Navy SAW-887M03 Size: 03 US,FBALYB Amazon,36,36,0,0,0,0
,Salt Water - Youth - Navy SAW-887M13 Size: 13 US,Salt Water - Youth - Navy SAW-887M13 Size: 13 US,FBALYB Amazon,55,55,0,0,0,0
,Salt Water-Youth-Olive SAW-816M01 Size: 01 US,Salt Water-Youth-Olive SAW-816M01 Size: 01 US,FBALYB Amazon,6,6,0,0,0,0
,Salt Water-Youth-Olive SAW-816M13 Size: 13 US,Salt Water-Youth-Olive SAW-816M13 Size: 13 US,FBALYB Amazon,5,5,0,0,0,0
,Salt Water-Youth-Pewter SAW-814M01 Size: 01 US,Salt Water-Youth-Pewter SAW-814M01 Size: 01 US,FBALYB Amazon,-6,-6,0,0,0,0
,Salt Water-Youth-Pewter SAW-814M03 Size: 03 US,Salt Water-Youth-Pewter SAW-814M03 Size: 03 US,FBALYB Amazon,-1,-1,0,0,0,0
,Salt Water-Youth-Pewter SAW-814M13 Size: 13 US,Salt Water-Youth-Pewter SAW-814M13 Size: 13 US,FBALYB Amazon,9,9,0,0,0,0
,Salt Water - Youth - Red SAW-884M01 Size: 01 US,Salt Water - Youth - Red SAW-884M01 Size: 01 US,FBALYB Amazon,51,51,0,2,0,0
,Salt Water - Youth - Red SAW-884M03 Size: 03 US,Salt Water - Youth - Red SAW-884M03 Size: 03 US,FBALYB Amazon,37,37,0,0,0,0
,Salt Water - Youth - Red SAW-884M13 Size: 13 US,Salt Water - Youth - Red SAW-884M13 Size: 13 US,FBALYB Amazon,28,28,0,0,0,0
,Salt Water - Youth - Rose Gold SAW-821M01 Size: 01 US,Salt Water - Youth - Rose Gold SAW-821M01 Size: 01 US,FBALYB Amazon,154,154,0,1,0,0
,Salt Water - Youth - Rose Gold SAW-821M03 Size: 03 US,Salt Water - Youth - Rose Gold SAW-821M03 Size: 03 US,FBALYB Amazon,32,32,0,0,0,0
,Salt Water - Youth - Rose Gold SAW-821M13 Size: 13 US,Salt Water - Youth - Rose Gold SAW-821M13 Size: 13 US,FBALYB Amazon,46,46,0,0,0,0
,Salt Water - Youth - Silver SAW-812M01 Size: 01 US,Salt Water - Youth - Silver SAW-812M01 Size: 01 US,FBALYB Amazon,25,25,0,0,0,0
,Salt Water - Youth - Silver SAW-812M03 Size: 03 US,Salt Water - Youth - Silver SAW-812M03 Size: 03 US,FBALYB Amazon,-3,-3,0,0,0,0
,Salt Water - Youth - Silver SAW-812M13 Size: 13 US,Salt Water - Youth - Silver SAW-812M13 Size: 13 US,FBALYB Amazon,28,28,0,0,0,0
,Salt Water - Youth - Tan SAW-885M01 Size: 01 US,Salt Water - Youth - Tan SAW-885M01 Size: 01 US,FBALYB Amazon,42,41,1,0,1,0
,Salt Water - Youth - Tan SAW-885M03 Size: 03 US,Salt Water - Youth - Tan SAW-885M03 Size: 03 US,FBALYB Amazon,2,1,1,0,1,0
,Salt Water - Youth - Tan SAW-885M13 Size: 13 US,Salt Water - Youth - Tan SAW-885M13 Size: 13 US,FBALYB Amazon,-33,-34,1,0,1,0
,Salt Water - Youth - White SAW-883M01 Size: 01 US,Salt Water - Youth - White SAW-883M01 Size: 01 US,FBALYB Amazon,88,88,0,0,0,0
,Salt Water - Youth - White SAW-883M03 Size: 03 US,Salt Water - Youth - White SAW-883M03 Size: 03 US,FBALYB Amazon,23,23,0,0,0,0
,Salt Water - Youth - White SAW-883M13 Size: 13 US,Salt Water - Youth - White SAW-883M13 Size: 13 US,FBALYB Amazon,8,8,0,0,0,0
,Sams lenovo,"Lenovo IdeaPad Miix 700 - 12"" 2-in-1 Laptop/Tablet (Intel m5, 12 8GB SDRAM, 2...",FBALYB Amazon,-1,-1,0,0,0,0
,"SAMSUNG 40"" LED TV","SAMSUNG 40"" LED TV UN40H5003 BJ's",FBALYB Amazon,-1,-1,0,0,0,0
,Samsung Galaxy Tab A Black SM-T580NZKAXAR,"Samsung - Galaxy Tab A - 10.1"" - 16GB - Black SM-T580NZKAXAR",Default,0,0,0,0,0,2
,Samsung Galaxy Tab A SM-P580NZKAXAR,"Samsung Galaxy Tab A SM-P580NZKAXAR 10.1-Inch 16 GB, Tablet with S Pen (Black)",Default,0,0,0,0,0,2
,Samsung Galaxy Tab E Lite SM-T113NYKAXAR,"Samsung Galaxy Tab E Lite 7""; 8 GB Wifi Tablet (Black) SM-T113NYKAXAR",Default,0,0,0,0,0,2
,Samsung Gear IconX Black,Samsung Gear IconX Black,FBALYB Amazon,-1,-1,0,0,0,0
,Samsung Gear IconX Grey,Samsung Gear IconX Grey,FBALYB Amazon,-2,-2,0,0,0,0
,Samsung Gear Sport Smartwatch,Samsung Gear Sport Smartwatch SM-R600NZKAXAR,Default,0,0,0,0,0,4
,Samsung T510 Tablet,Samsung T510 Tablet,FBALYB Amazon,-1,-1,0,0,0,0
,Samsung UV Sterilizer + Wireless Charger in one (GP-TOUOZOSABWW),Samsung UV Sterilizer + Wireless Charger in one (GP-TOUOZOSABWW),FBALYB Amazon,793,791,2,0,2,0
,Sanders Dark Chocolate Sea Salt 2PK,Sanders Dark Chocolate Sea Salt 2PK,FBALYB Amazon,-9,-9,0,21,0,0
,Sanders Dark Chocolate Sea Salt 3pk,Sanders Dark Chocolate Sea Salt 3pk,FBALYB Amazon,1,1,0,0,0,0
,Sanders Dark Chocolate Sea Salt Caramels,Sanders Dark Chocolate Sea Salt Caramels,Default,0,-64,64,0,0,0
,San Francisco Bay Brand Hatchery,San Francisco Bay Brand Hatchery,Default,0,0,0,0,0,1
,San Lorenzo Dark 2pk B001D0GVA4,San Lorenzo Dark 2pk B001D0GVA4,Default,0,-1,1,0,0,0
,Saucony Cohesion Size 6.5,Saucony Cohesion Size 6.5,FBALYB Amazon,-1,-1,0,0,0,0
,Saucony Cohesion Size 8,Saucony Cohesion Size 8,FBALYB Amazon,-2,-2,0,0,0,0
,Saucony ECHELON 8 Alloy/Black - Men US Size: 10.5 S20574-30,Saucony ECHELON 8 Alloy/Black - Men US Size: 10.5 S20574-30,Default Ridgefield,24,24,0,0,0,0
,Saucony ECHELON 8 Alloy/Black - Men US Size: 10.5 S20574-30,Saucony ECHELON 8 Alloy/Black - Men US Size: 10.5 S20574-30,FBALYB Amazon,28,27,1,0,1,0
,Saucony ECHELON 8 Alloy/Black - Men US Size: 10 S20574-30,Saucony ECHELON 8 Alloy/Black - Men US Size: 10 S20574-30,Default Ridgefield,11,11,0,0,0,0
,Saucony ECHELON 8 Alloy/Black - Men US Size: 10 S20574-30,Saucony ECHELON 8 Alloy/Black - Men US Size: 10 S20574-30,FBALYB Amazon,30,30,0,0,0,0
,Saucony ECHELON 8 Alloy/Black - Men US Size: 11.5 S20574-30,Saucony ECHELON 8 Alloy/Black - Men US Size: 11.5 S20574-30,FBALYB Amazon,15,14,1,0,1,0
,Saucony ECHELON 8 Alloy/Black - Men US Size: 11 S20574-30,Saucony ECHELON 8 Alloy/Black - Men US Size: 11 S20574-30,Default Ridgefield,24,24,0,0,0,0
,Saucony ECHELON 8 Alloy/Black - Men US Size: 11 S20574-30,Saucony ECHELON 8 Alloy/Black - Men US Size: 11 S20574-30,FBALYB Amazon,25,25,0,0,0,0
,Saucony ECHELON 8 Alloy/Black - Men US Size: 12.5 S20574-30,Saucony ECHELON 8 Alloy/Black - Men US Size: 12.5 S20574-30,FBALYB Amazon,10,10,0,0,0,0
,Saucony ECHELON 8 Alloy/Black - Men US Size: 12 S20574-30,Saucony ECHELON 8 Alloy/Black - Men US Size: 12 S20574-30,Default Ridgefield,18,18,0,0,0,0
,Saucony ECHELON 8 Alloy/Black - Men US Size: 12 S20574-30,Saucony ECHELON 8 Alloy/Black - Men US Size: 12 S20574-30,FBALYB Amazon,26,26,0,0,0,0
,Saucony ECHELON 8 Alloy/Black - Men US Size: 9.5 S20574-30,Saucony ECHELON 8 Alloy/Black - Men US Size: 9.5 S20574-30,FBALYB Amazon,11,11,0,0,0,0
,Saucony ECHELON 8 Alloy/Black - Men US Size: 9 S20574-30,Saucony ECHELON 8 Alloy/Black - Men US Size: 9 S20574-30,FBALYB Amazon,3,3,0,0,0,0
,Saucony ECHELON 8 Alloy/Charcoal - Women US Size: 10.5 S10574-30,Saucony ECHELON 8 Alloy/Charcoal - Women US Size: 10.5 S10574-30,Default Ridgefield,22,22,0,0,0,0
,Saucony ECHELON 8 Alloy/Charcoal - Women US Size: 10.5 S10574-30,Saucony ECHELON 8 Alloy/Charcoal - Women US Size: 10.5 S10574-30,FBALYB Amazon,21,21,0,0,0,0
,Saucony ECHELON 8 Alloy/Charcoal - Women US Size: 10 S10574-30,Saucony ECHELON 8 Alloy/Charcoal - Women US Size: 10 S10574-30,Default Ridgefield,48,48,0,0,0,0
,Saucony ECHELON 8 Alloy/Charcoal - Women US Size: 10 S10574-30,Saucony ECHELON 8 Alloy/Charcoal - Women US Size: 10 S10574-30,FBALYB Amazon,17,17,0,0,0,0
,Saucony ECHELON 8 Alloy/Charcoal - Women US Size: 11 S10574-30,Saucony ECHELON 8 Alloy/Charcoal - Women US Size: 11 S10574-30,FBALYB Amazon,2,2,0,0,0,0
,Saucony ECHELON 8 Alloy/Charcoal - Women US Size: 7.5 S10574-30,Saucony ECHELON 8 Alloy/Charcoal - Women US Size: 7.5 S10574-30,FBALYB Amazon,15,12,3,0,3,0
,Saucony ECHELON 8 Alloy/Charcoal - Women US Size: 7 S10574-30,Saucony ECHELON 8 Alloy/Charcoal - Women US Size: 7 S10574-30,Default Ridgefield,24,24,0,0,0,0
,Saucony ECHELON 8 Alloy/Charcoal - Women US Size: 7 S10574-30,Saucony ECHELON 8 Alloy/Charcoal - Women US Size: 7 S10574-30,FBALYB Amazon,14,14,0,0,0,0
,Saucony ECHELON 8 Alloy/Charcoal - Women US Size: 8.5 S10574-30,Saucony ECHELON 8 Alloy/Charcoal - Women US Size: 8.5 S10574-30,FBALYB Amazon,41,39,2,0,2,0
,Saucony ECHELON 8 Alloy/Charcoal - Women US Size: 8 S10574-30,Saucony ECHELON 8 Alloy/Charcoal - Women US Size: 8 S10574-30,FBALYB Amazon,35,33,2,0,2,0
,Saucony ECHELON 8 Alloy/Charcoal - Women US Size: 9.5 S10574-30,Saucony ECHELON 8 Alloy/Charcoal - Women US Size: 9.5 S10574-30,Default Ridgefield,48,48,0,0,0,0
,Saucony ECHELON 8 Alloy/Charcoal - Women US Size: 9.5 S10574-30,Saucony ECHELON 8 Alloy/Charcoal - Women US Size: 9.5 S10574-30,FBALYB Amazon,18,18,0,0,0,0
,Saucony ECHELON 8 Alloy/Charcoal - Women US Size: 9 S10574-30,Saucony ECHELON 8 Alloy/Charcoal - Women US Size: 9 S10574-30,FBALYB Amazon,32,31,1,0,1,0
,Saucony ECHELON 8 Black/White - Men US Size: 10.5 S20574-40,Saucony ECHELON 8 Black/White - Men US Size: 10.5 S20574-40,Default Ridgefield,48,48,0,0,0,0
,Saucony ECHELON 8 Black/White - Men US Size: 10.5 S20574-40,Saucony ECHELON 8 Black/White - Men US Size: 10.5 S20574-40,FBALYB Amazon,34,34,0,0,0,0
,Saucony ECHELON 8 Black/White - Men US Size: 10 S20574-40,Saucony ECHELON 8 Black/White - Men US Size: 10 S20574-40,FBALYB Amazon,45,45,0,0,0,0
,Saucony ECHELON 8 Black/White - Men US Size: 11.5 S20574-40,Saucony ECHELON 8 Black/White - Men US Size: 11.5 S20574-40,FBALYB Amazon,14,13,1,24,1,0
,Saucony ECHELON 8 Black/White - Men US Size: 11 S20574-40,Saucony ECHELON 8 Black/White - Men US Size: 11 S20574-40,Default Ridgefield,48,48,0,0,0,0
,Saucony ECHELON 8 Black/White - Men US Size: 11 S20574-40,Saucony ECHELON 8 Black/White - Men US Size: 11 S20574-40,FBALYB Amazon,33,33,0,0,0,0
,Saucony ECHELON 8 Black/White - Men US Size: 12.5 S20574-40,Saucony ECHELON 8 Black/White - Men US Size: 12.5 S20574-40,FBALYB Amazon,9,9,0,0,0,0
,Saucony ECHELON 8 Black/White - Men US Size: 12 S20574-40,Saucony ECHELON 8 Black/White - Men US Size: 12 S20574-40,Default Ridgefield,36,36,0,0,0,0
,Saucony ECHELON 8 Black/White - Men US Size: 12 S20574-40,Saucony ECHELON 8 Black/White - Men US Size: 12 S20574-40,FBALYB Amazon,18,17,1,0,1,0
,Saucony ECHELON 8 Black/White - Men US Size: 9.5 S20574-40,Saucony ECHELON 8 Black/White - Men US Size: 9.5 S20574-40,Default Ridgefield,1,-9,10,0,0,0
,Saucony ECHELON 8 Black/White - Men US Size: 9.5 S20574-40,Saucony ECHELON 8 Black/White - Men US Size: 9.5 S20574-40,FBALYB Amazon,2,1,1,0,1,0
,Saucony ECHELON 8 Black/White - Men US Size: 9 S20574-40,Saucony ECHELON 8 Black/White - Men US Size: 9 S20574-40,FBALYB Amazon,11,11,0,0,0,0
,Saucony ECHELON 8 Black/White - Women US Size: 10.5 S10574-40,Saucony ECHELON 8 Black/White - Women US Size: 10.5 S10574-40,Default Ridgefield,12,12,0,0,0,0
,Saucony ECHELON 8 Black/White - Women US Size: 10.5 S10574-40,Saucony ECHELON 8 Black/White - Women US Size: 10.5 S10574-40,FBALYB Amazon,19,19,0,0,0,0
,Saucony ECHELON 8 Black/White - Women US Size: 10 S10574-40,Saucony ECHELON 8 Black/White - Women US Size: 10 S10574-40,FBALYB Amazon,17,17,0,24,0,0
,Saucony ECHELON 8 Black/White - Women US Size: 11 S10574-40,Saucony ECHELON 8 Black/White - Women US Size: 11 S10574-40,FBALYB Amazon,8,8,0,0,0,0
,Saucony ECHELON 8 Black/White - Women US Size: 7.5 S10574-40,Saucony ECHELON 8 Black/White - Women US Size: 7.5 S10574-40,Default Ridgefield,12,12,0,0,0,0
,Saucony ECHELON 8 Black/White - Women US Size: 7.5 S10574-40,Saucony ECHELON 8 Black/White - Women US Size: 7.5 S10574-40,FBALYB Amazon,14,14,0,0,0,0
,Saucony ECHELON 8 Black/White - Women US Size: 7 S10574-40,Saucony ECHELON 8 Black/White - Women US Size: 7 S10574-40,Default Ridgefield,12,12,0,0,0,0
,Saucony ECHELON 8 Black/White - Women US Size: 7 S10574-40,Saucony ECHELON 8 Black/White - Women US Size: 7 S10574-40,FBALYB Amazon,10,10,0,0,0,0
,Saucony ECHELON 8 Black/White - Women US Size: 8.5 S10574-40,Saucony ECHELON 8 Black/White - Women US Size: 8.5 S10574-40,Default Ridgefield,24,24,0,0,0,0
,Saucony ECHELON 8 Black/White - Women US Size: 8.5 S10574-40,Saucony ECHELON 8 Black/White - Women US Size: 8.5 S10574-40,FBALYB Amazon,9,9,0,0,0,0
,Saucony ECHELON 8 Black/White - Women US Size: 8 S10574-40,Saucony ECHELON 8 Black/White - Women US Size: 8 S10574-40,FBALYB Amazon,25,25,0,0,0,0
,Saucony ECHELON 8 Black/White - Women US Size: 9.5 S10574-40,Saucony ECHELON 8 Black/White - Women US Size: 9.5 S10574-40,Default Ridgefield,24,24,0,0,0,0
,Saucony ECHELON 8 Black/White - Women US Size: 9.5 S10574-40,Saucony ECHELON 8 Black/White - Women US Size: 9.5 S10574-40,FBALYB Amazon,21,20,1,0,1,0
,Saucony ECHELON 8 Black/White - Women US Size: 9 S10574-40,Saucony ECHELON 8 Black/White - Women US Size: 9 S10574-40,Default Ridgefield,24,24,0,0,0,0
,Saucony ECHELON 8 Black/White - Women US Size: 9 S10574-40,Saucony ECHELON 8 Black/White - Women US Size: 9 S10574-40,FBALYB Amazon,16,16,0,0,0,0
,Saucony ECHELON 8 Charcoal/Cherry - Women US Size: 10.5 S10574-55,Saucony ECHELON 8 Charcoal/Cherry - Women US Size: 10.5 S10574-55,FBALYB Amazon,13,13,0,0,0,0
,Saucony ECHELON 8 Charcoal/Cherry - Women US Size: 10 S10574-55,Saucony ECHELON 8 Charcoal/Cherry - Women US Size: 10 S10574-55,FBALYB Amazon,19,19,0,0,0,0
,Saucony ECHELON 8 Charcoal/Cherry - Women US Size: 11 S10574-55,Saucony ECHELON 8 Charcoal/Cherry - Women US Size: 11 S10574-55,FBALYB Amazon,8,8,0,0,0,0
,Saucony ECHELON 8 Charcoal/Cherry - Women US Size: 7.5 S10574-55,Saucony ECHELON 8 Charcoal/Cherry - Women US Size: 7.5 S10574-55,FBALYB Amazon,2,1,1,0,1,0
,Saucony ECHELON 8 Charcoal/Cherry - Women US Size: 7 S10574-55,Saucony ECHELON 8 Charcoal/Cherry - Women US Size: 7 S10574-55,FBALYB Amazon,10,10,0,0,0,0
,Saucony ECHELON 8 Charcoal/Cherry - Women US Size: 8.5 S10574-55,Saucony ECHELON 8 Charcoal/Cherry - Women US Size: 8.5 S10574-55,FBALYB Amazon,3,3,0,0,0,0
,Saucony ECHELON 8 Charcoal/Cherry - Women US Size: 8 S10574-55,Saucony ECHELON 8 Charcoal/Cherry - Women US Size: 8 S10574-55,FBALYB Amazon,10,10,0,0,0,0
,Saucony ECHELON 8 Charcoal/Cherry - Women US Size: 9.5 S10574-55,Saucony ECHELON 8 Charcoal/Cherry - Women US Size: 9.5 S10574-55,FBALYB Amazon,15,15,0,0,0,0
,Saucony ECHELON 8 Charcoal/Cherry - Women US Size: 9 S10574-55,Saucony ECHELON 8 Charcoal/Cherry - Women US Size: 9 S10574-55,FBALYB Amazon,10,10,0,0,0,0
,Saucony ECHELON 8 Storm/Black - Men US Size: 10.5 S20574-55,Saucony ECHELON 8 Storm/Black - Men US Size: 10.5 S20574-55,FBALYB Amazon,37,37,0,0,0,0
,Saucony ECHELON 8 Storm/Black - Men US Size: 10 S20574-55,Saucony ECHELON 8 Storm/Black - Men US Size: 10 S20574-55,FBALYB Amazon,28,28,0,0,0,0
,Saucony ECHELON 8 Storm/Black - Men US Size: 11.5 S20574-55,Saucony ECHELON 8 Storm/Black - Men US Size: 11.5 S20574-55,FBALYB Amazon,16,16,0,0,0,0
,Saucony ECHELON 8 Storm/Black - Men US Size: 11 S20574-55,Saucony ECHELON 8 Storm/Black - Men US Size: 11 S20574-55,FBALYB Amazon,32,32,0,0,0,0
,Saucony ECHELON 8 Storm/Black - Men US Size: 12.5 S20574-55,Saucony ECHELON 8 Storm/Black - Men US Size: 12.5 S20574-55,FBALYB Amazon,10,10,0,0,0,0
,Saucony ECHELON 8 Storm/Black - Men US Size: 12 S20574-55,Saucony ECHELON 8 Storm/Black - Men US Size: 12 S20574-55,FBALYB Amazon,29,29,0,0,0,0
,Saucony ECHELON 8 Storm/Black - Men US Size: 9.5 S20574-55,Saucony ECHELON 8 Storm/Black - Men US Size: 9.5 S20574-55,FBALYB Amazon,19,19,0,0,0,0
,Saucony ECHELON 8 Storm/Black - Men US Size: 9 S20574-55,Saucony ECHELON 8 Storm/Black - Men US Size: 9 S20574-55,FBALYB Amazon,10,10,0,0,0,0
,Saucony ENDORPHIN SHIFT BLACK / WHITE S20577-40 SIze 10,Saucony ENDORPHIN SHIFT BLACK / WHITE S20577-40 SIze 10,Default Ridgefield,24,24,0,0,0,0
,Saucony ENDORPHIN SHIFT BLACK / WHITE S20577-40 SIze 11,Saucony ENDORPHIN SHIFT BLACK / WHITE S20577-40 SIze 11,Default Ridgefield,12,12,0,0,0,0
,Saucony ENDORPHIN SHIFT BLACK / WHITE S20577-40 SIze 9.5,Saucony ENDORPHIN SHIFT BLACK / WHITE S20577-40 SIze 9.5,Default Ridgefield,24,24,0,0,0,0
,Saucony ENDORPHIN SHIFT WHITE S20577-10 Size 10,Saucony ENDORPHIN SHIFT WHITE S20577-10 Size 10,Default Ridgefield,48,48,0,0,0,0
,Saucony ENDORPHIN SHIFT WHITE S20577-10 Size 10.5,Saucony ENDORPHIN SHIFT WHITE S20577-10 Size 10.5,Default Ridgefield,48,48,0,0,0,0
,Saucony ENDORPHIN SHIFT WHITE S20577-10 Size 11,Saucony ENDORPHIN SHIFT WHITE S20577-10 Size 11,Default Ridgefield,48,48,0,0,0,0
,Saucony ENDORPHIN SHIFT WHITE S20577-10 Size 11.5,Saucony ENDORPHIN SHIFT WHITE S20577-10 Size 11.5,Default Ridgefield,48,48,0,0,0,0
,Saucony ENDORPHIN SHIFT WHITE S20577-10 Size 12,Saucony ENDORPHIN SHIFT WHITE S20577-10 Size 12,Default Ridgefield,24,24,0,0,0,0
,Saucony ENDORPHIN SHIFT WHITE S20577-10 Size 9.5,Saucony ENDORPHIN SHIFT WHITE S20577-10 Size 9.5,Default Ridgefield,24,24,0,0,0,0
,Saucony FREEDOM 4 BLACK/STONE - Men US Size: 10.5 S20617-45,Saucony FREEDOM 4 BLACK/STONE - Men US Size: 10.5 S20617-45,Default,0,0,0,0,0,48
,Saucony FREEDOM 4 BLACK/STONE - Men US Size: 10.5 S20617-45,Saucony FREEDOM 4 BLACK/STONE - Men US Size: 10.5 S20617-45,Default Ridgefield,23,23,0,0,0,0
,Saucony FREEDOM 4 BLACK/STONE - Men US Size: 10 S20617-45,Saucony FREEDOM 4 BLACK/STONE - Men US Size: 10 S20617-45,Default,0,0,0,0,0,36
,Saucony FREEDOM 4 BLACK/STONE - Men US Size: 10 S20617-45,Saucony FREEDOM 4 BLACK/STONE - Men US Size: 10 S20617-45,Default Ridgefield,12,12,0,0,0,0
,Saucony FREEDOM 4 BLACK/STONE - Men US Size: 11.5 S20617-45,Saucony FREEDOM 4 BLACK/STONE - Men US Size: 11.5 S20617-45,Default,0,0,0,0,0,24
,Saucony FREEDOM 4 BLACK/STONE - Men US Size: 11.5 S20617-45,Saucony FREEDOM 4 BLACK/STONE - Men US Size: 11.5 S20617-45,Default Ridgefield,12,12,0,0,0,0
,Saucony FREEDOM 4 BLACK/STONE - Men US Size: 11 S20617-45,Saucony FREEDOM 4 BLACK/STONE - Men US Size: 11 S20617-45,Default,0,0,0,0,0,48
,Saucony FREEDOM 4 BLACK/STONE - Men US Size: 11 S20617-45,Saucony FREEDOM 4 BLACK/STONE - Men US Size: 11 S20617-45,Default Ridgefield,24,24,0,0,0,0
,Saucony FREEDOM 4 BLACK/STONE - Men US Size: 12 S20617-45,Saucony FREEDOM 4 BLACK/STONE - Men US Size: 12 S20617-45,Default,0,0,0,0,0,36
,Saucony FREEDOM 4 BLACK/STONE - Men US Size: 12 S20617-45,Saucony FREEDOM 4 BLACK/STONE - Men US Size: 12 S20617-45,Default Ridgefield,23,23,0,0,0,0
,Saucony Men's Freedom ISO 2-S20440-37 Teal 10,Saucony Men's Freedom ISO 2-S20440-37 Teal 10,FBALYB Amazon,-1,-1,0,0,0,0
,Saucony Men's Freedom ISO 2-S20440-37 Teal 11,Saucony Men's Freedom ISO 2-S20440-37 Teal 11,FBALYB Amazon,-5,-5,0,0,0,0
,Saucony Men's Freedom ISO 2-S20440-37 Teal 11.5,Saucony Men's Freedom ISO 2-S20440-37 Teal 11.5,FBALYB Amazon,1,1,0,0,0,0
,Saucony Men's Freedom ISO 2-S20440-37 Teal 12.5,Saucony Men's Freedom ISO 2-S20440-37 Teal 12.5,FBALYB Amazon,-6,-6,0,0,0,0
,Saucony Men's Freedom ISO 2-S20440-41 Olive Shade 10,Saucony Men's Freedom ISO 2-S20440-41 Olive Shade 10,FBALYB Amazon,41,41,0,0,0,0
,Saucony Men's Freedom ISO 2-S20440-41 Olive Shade 10.5,Saucony Men's Freedom ISO 2-S20440-41 Olive Shade 10.5,FBALYB Amazon,-4,-4,0,0,0,0
,Saucony Men's Freedom ISO 2-S20440-41 Olive Shade 11,Saucony Men's Freedom ISO 2-S20440-41 Olive Shade 11,FBALYB Amazon,-7,-7,0,0,0,0
,Saucony Men's Freedom ISO 2-S20440-41 Olive Shade 11.5,Saucony Men's Freedom ISO 2-S20440-41 Olive Shade 11.5,FBALYB Amazon,10,10,0,0,0,0
,Saucony Men's Freedom ISO 2-S20440-41 Olive Shade 12,Saucony Men's Freedom ISO 2-S20440-41 Olive Shade 12,FBALYB Amazon,-3,-3,0,0,0,0
,Saucony Men's Freedom ISO 2-S20440-41 Olive Shade 12.5,Saucony Men's Freedom ISO 2-S20440-41 Olive Shade 12.5,FBALYB Amazon,13,13,0,0,0,0
,Saucony Men's Freedom ISO 2-S20440-41 Olive Shade 13,Saucony Men's Freedom ISO 2-S20440-41 Olive Shade 13,FBALYB Amazon,-2,-2,0,0,0,0
,Saucony Men's Freedom ISO 2-S20440-41 Olive Shade 7,Saucony Men's Freedom ISO 2-S20440-41 Olive Shade 7,FBALYB Amazon,-2,-2,0,0,0,0
,Saucony Men's Freedom ISO 2-S20440-41 Olive Shade 7.5,Saucony Men's Freedom ISO 2-S20440-41 Olive Shade 7.5,FBALYB Amazon,-2,-2,0,0,0,0
,Saucony Men's Freedom ISO 2-S20440-41 Olive Shade 8.5,Saucony Men's Freedom ISO 2-S20440-41 Olive Shade 8.5,FBALYB Amazon,3,3,0,0,0,0
,Saucony Men's Freedom ISO 2-S20440-41 Olive Shade 9,Saucony Men's Freedom ISO 2-S20440-41 Olive Shade 9,FBALYB Amazon,10,10,0,0,0,0
,Saucony Men's Freedom ISO 2-S20440-41 Olive Shade 9.5,Saucony Men's Freedom ISO 2-S20440-41 Olive Shade 9.5,FBALYB Amazon,31,31,0,0,0,0
,Saucony Men's Freedom ISO 2-S20440-4 Grey/Slime 10,Saucony Men's Freedom ISO 2-S20440-4 Grey/Slime 10,FBALYB Amazon,-3,-3,0,0,0,0
,Saucony Men's Freedom ISO 2-S20440-4 Grey/Slime 10.5,Saucony Men's Freedom ISO 2-S20440-4 Grey/Slime 10.5,FBALYB Amazon,-4,-4,0,0,0,0
,Saucony Men's Freedom ISO 2-S20440-4 Grey/Slime 11,Saucony Men's Freedom ISO 2-S20440-4 Grey/Slime 11,FBALYB Amazon,-4,-4,0,0,0,0
,Saucony Men's Freedom ISO 2-S20440-4 Grey/Slime 11.5,Saucony Men's Freedom ISO 2-S20440-4 Grey/Slime 11.5,FBALYB Amazon,17,17,0,0,0,0
,Saucony Men's Freedom ISO 2-S20440-4 Grey/Slime 12,Saucony Men's Freedom ISO 2-S20440-4 Grey/Slime 12,FBALYB Amazon,-2,-2,0,0,0,0
,Saucony Men's Freedom ISO 2-S20440-4 Grey/Slime 12.5,Saucony Men's Freedom ISO 2-S20440-4 Grey/Slime 12.5,FBALYB Amazon,-1,-1,0,0,0,0
,Saucony Men's Freedom ISO 2-S20440-4 Grey/Slime 9,Saucony Men's Freedom ISO 2-S20440-4 Grey/Slime 9,FBALYB Amazon,-1,-1,0,0,0,0
,Saucony Men's Freedom ISO 2-S20440-4 Grey/Slime 9.5,Saucony Men's Freedom ISO 2-S20440-4 Grey/Slime 9.5,FBALYB Amazon,-3,-3,0,0,0,0
,Saucony Men's Guide 13 Blue Silver Size  11.5,Saucony Men's Guide 13 Blue Silver Size  11.5,Default,0,0,0,0,0,30
,Saucony Men's Guide 13 Blue Silver Size  11.5,Saucony Men's Guide 13 Blue Silver Size  11.5,Default Ridgefield,6,6,0,0,0,0
,Saucony Men's Guide ISO 2 TR-S20466-1 Slate/Blue 10,Saucony Men's Guide ISO 2 TR-S20466-1 Slate/Blue 10,FBALYB Amazon,103,103,0,0,0,0
,Saucony Men's Guide ISO 2 TR-S20466-1 Slate/Blue 11,Saucony Men's Guide ISO 2 TR-S20466-1 Slate/Blue 11,FBALYB Amazon,-3,-3,0,0,0,0
,Saucony Men's Guide ISO 2 TR-S20466-1 Slate/Blue 11.5,Saucony Men's Guide ISO 2 TR-S20466-1 Slate/Blue 11.5,FBALYB Amazon,90,90,0,0,0,0
,Saucony Men's Guide ISO 2 TR-S20466-1 Slate/Blue 12,Saucony Men's Guide ISO 2 TR-S20466-1 Slate/Blue 12,FBALYB Amazon,1,0,1,0,1,0
,Saucony Men's Guide ISO 2 TR-S20466-1 Slate/Blue 7.5,Saucony Men's Guide ISO 2 TR-S20466-1 Slate/Blue 7.5,FBALYB Amazon,-1,-1,0,0,0,0
,Saucony Men's Guide ISO 2 TR-S20466-1 Slate/Blue 9,Saucony Men's Guide ISO 2 TR-S20466-1 Slate/Blue 9,FBALYB Amazon,88,88,0,0,0,0
,Saucony Men's Guide ISO 2 TR-S20466-1 Slate/Blue 9.5,Saucony Men's Guide ISO 2 TR-S20466-1 Slate/Blue 9.5,FBALYB Amazon,52,52,0,0,0,0
,Saucony Men's Hurricane 22 Grey/Black Size 10,Saucony Men's Hurricane 22 Grey/Black Size 10,Default,0,0,0,0,0,10
,Saucony Men's Hurricane 22 Grey/Black Size 11.5,Saucony Men's Hurricane 22 Grey/Black Size 11.5,Default,0,0,0,0,0,10
,Saucony Men's Hurricane 22 Grey/Black Size 11.5,Saucony Men's Hurricane 22 Grey/Black Size 11.5,Default Ridgefield,10,10,0,0,0,0
,Saucony Men's Hurricane 22 Grey/Black Size 11.5,Saucony Men's Hurricane 22 Grey/Black Size 11.5,FBALYB Amazon,2,2,0,1,0,0
,Saucony Men's Hurricane 22 Grey/Black Size 12.5,Saucony Men's Hurricane 22 Grey/Black Size 12.5,Default,0,0,0,0,0,10
,Saucony Men's Hurricane 22 Grey/Black Size 13,Saucony Men's Hurricane 22 Grey/Black Size 13,Default,0,0,0,0,0,10
,Saucony Men's Hurricane 22 Grey/Black Size 13,Saucony Men's Hurricane 22 Grey/Black Size 13,Default Ridgefield,7,7,0,0,0,0
,Saucony Men's Hurricane 22 Grey/Black Size 8,Saucony Men's Hurricane 22 Grey/Black Size 8,Default,0,0,0,0,0,10
,Saucony Men's Hurricane ISO 5-S20460-2 Navy/Citron 10,Saucony Men's Hurricane ISO 5-S20460-2 Navy/Citron 10,FBALYB Amazon,-1,-1,0,0,0,0
,Saucony Men's Hurricane ISO 5-S20460-2 Navy/Citron 10.5,Saucony Men's Hurricane ISO 5-S20460-2 Navy/Citron 10.5,FBALYB Amazon,-1,-1,0,0,0,0
,Saucony Men's Hurricane ISO 5-S20460-2 Navy/Citron 11.5,Saucony Men's Hurricane ISO 5-S20460-2 Navy/Citron 11.5,FBALYB Amazon,-1,-1,0,0,0,0
,Saucony Men's Hurricane ISO 5-S20460-2 Navy/Citron 12,Saucony Men's Hurricane ISO 5-S20460-2 Navy/Citron 12,FBALYB Amazon,-1,-1,0,0,0,0
,Saucony Men's Hurricane ISO 5-S20460-2 Navy/Citron 12.5,Saucony Men's Hurricane ISO 5-S20460-2 Navy/Citron 12.5,FBALYB Amazon,-1,-1,0,0,0,0
,Saucony Men's Hurricane ISO 5-S20460-2 Navy/Citron 14,Saucony Men's Hurricane ISO 5-S20460-2 Navy/Citron 14,FBALYB Amazon,-1,-1,0,0,0,0
,Saucony Men's Hurricane ISO 5-S20460-2 Navy/Citron 7,Saucony Men's Hurricane ISO 5-S20460-2 Navy/Citron 7,FBALYB Amazon,-1,-1,0,0,0,0
,Saucony Men's Hurricane ISO 5-S20460-2 Navy/Citron 8.5,Saucony Men's Hurricane ISO 5-S20460-2 Navy/Citron 8.5,FBALYB Amazon,-17,-17,0,0,0,0
,Saucony Men's Hurricane ISO 5-S20460-42 Slate Quake 10,Saucony Men's Hurricane ISO 5-S20460-42 Slate Quake 10,FBALYB Amazon,-1,-1,0,0,0,0
,Saucony Men's Hurricane ISO 5-S20460-42 Slate Quake 10.5,Saucony Men's Hurricane ISO 5-S20460-42 Slate Quake 10.5,FBALYB Amazon,-3,-3,0,0,0,0
,Saucony Men's Hurricane ISO 5-S20460-42 Slate Quake 12,Saucony Men's Hurricane ISO 5-S20460-42 Slate Quake 12,FBALYB Amazon,-6,-6,0,0,0,0
,Saucony Men's Hurricane ISO 5-S20460-42 Slate Quake 13,Saucony Men's Hurricane ISO 5-S20460-42 Slate Quake 13,FBALYB Amazon,-2,-2,0,0,0,0
,Saucony Men's Hurricane ISO 5-S20460-42 Slate Quake 9.5,Saucony Men's Hurricane ISO 5-S20460-42 Slate Quake 9.5,FBALYB Amazon,-1,-1,0,0,0,0
,Saucony Men's Hurricane ISO 5-S20461-1 Grey/Black 10.5W,Saucony Men's Hurricane ISO 5-S20461-1 Grey/Black 10.5W,FBALYB Amazon,-1,-1,0,0,0,0
,Saucony Men's Hurricane ISO 5-S20461-1 Grey/Black 10W,Saucony Men's Hurricane ISO 5-S20461-1 Grey/Black 10W,FBALYB Amazon,-2,-2,0,0,0,0
,Saucony Men's Hurricane ISO 5-S20461-1 Grey/Black 11W,Saucony Men's Hurricane ISO 5-S20461-1 Grey/Black 11W,FBALYB Amazon,-1,-1,0,0,0,0
,Saucony Men's Hurricane ISO 5-S20461-1 Grey/Black 7W,Saucony Men's Hurricane ISO 5-S20461-1 Grey/Black 7W,FBALYB Amazon,-2,-2,0,0,0,0
,Saucony Men's Hurricane ISO 5-S20461-1 Grey/Black 8W,Saucony Men's Hurricane ISO 5-S20461-1 Grey/Black 8W,Default Ridgefield,10,10,0,0,0,0
,Saucony Men's Hurricane ISO 5-S20461-1 Grey/Black 8W,Saucony Men's Hurricane ISO 5-S20461-1 Grey/Black 8W,FBALYB Amazon,1,1,0,0,0,0
,Saucony Men's Hurricane ISO 5-S20461-1 Grey/Black 9W,Saucony Men's Hurricane ISO 5-S20461-1 Grey/Black 9W,FBALYB Amazon,-1,-1,0,0,0,0
,Saucony Men's Kinvara 11 Blackout Size  10,Saucony Men's Kinvara 11 Blackout Size  10,Default,0,0,0,0,0,12
,Saucony Men's Kinvara 11 Blackout Size  10.5,Saucony Men's Kinvara 11 Blackout Size  10.5,Default,0,0,0,0,0,25
,Saucony Men's Kinvara 11 Blackout Size  10.5,Saucony Men's Kinvara 11 Blackout Size  10.5,Default Ridgefield,24,24,0,0,0,0
,Saucony Men's Kinvara 11 Blackout Size  11,Saucony Men's Kinvara 11 Blackout Size  11,Default,0,0,0,0,0,38
,Saucony Men's Kinvara 11 Blackout Size  11,Saucony Men's Kinvara 11 Blackout Size  11,FBALYB Amazon,18,18,0,0,0,0
,Saucony Men's Kinvara 11 Blackout Size  11.5,Saucony Men's Kinvara 11 Blackout Size  11.5,Default,0,0,0,0,0,26
,Saucony Men's Kinvara 11 Blackout Size  11.5,Saucony Men's Kinvara 11 Blackout Size  11.5,Default Ridgefield,12,12,0,0,0,0
,Saucony Men's Kinvara 11 Blackout Size  12,Saucony Men's Kinvara 11 Blackout Size  12,Default,0,0,0,0,0,12
,Saucony Men's Kinvara 11 Blackout Size  13,Saucony Men's Kinvara 11 Blackout Size  13,Default,0,0,0,0,0,12
,Saucony Men's Kinvara 11 Blackout Size  13,Saucony Men's Kinvara 11 Blackout Size  13,FBALYB Amazon,10,10,0,0,0,0
,Saucony Men's Kinvara 11 Blackout Size  8,Saucony Men's Kinvara 11 Blackout Size  8,Default,0,0,0,0,0,12
,Saucony Men's Kinvara 11 Blackout Size  8.5,Saucony Men's Kinvara 11 Blackout Size  8.5,Default,0,0,0,0,0,12
,Saucony Men's Kinvara 11 Blackout Size  9,Saucony Men's Kinvara 11 Blackout Size  9,Default,0,0,0,0,0,38
,Saucony Men's Kinvara 11 Blackout Size  9,Saucony Men's Kinvara 11 Blackout Size  9,Default Ridgefield,2,2,0,0,0,0
,Saucony Men's Kinvara 11 Blackout Size  9.5,Saucony Men's Kinvara 11 Blackout Size  9.5,Default,0,0,0,0,0,57
,Saucony Men's Kinvara 11 Blackout Size  9.5,Saucony Men's Kinvara 11 Blackout Size  9.5,Default Ridgefield,25,25,0,0,0,0
,Saucony Men's Kinvara 11 Blackout Size  9.5,Saucony Men's Kinvara 11 Blackout Size  9.5,FBALYB Amazon,12,12,0,0,0,0
,Saucony Men's Peregrine 10 Black/Red Size 10.5,Saucony Men's Peregrine 10 Black/Red Size 10.5,Default,0,0,0,0,0,72
,Saucony Men's Peregrine 10 Black/Red Size 10.5,Saucony Men's Peregrine 10 Black/Red Size 10.5,FBALYB Amazon,7,7,0,0,0,0
,Saucony Men's Peregrine 10 Black/Red Size 11,Saucony Men's Peregrine 10 Black/Red Size 11,Default,0,0,0,0,0,24
,Saucony Men's Peregrine 10 Black/Red Size 11.5,Saucony Men's Peregrine 10 Black/Red Size 11.5,Default,0,0,0,0,0,48
,Saucony Men's Peregrine 10 Black/Red Size 12,Saucony Men's Peregrine 10 Black/Red Size 12,Default,0,0,0,0,0,48
,Saucony Men's Peregrine 10 Black/Red Size 12.5,Saucony Men's Peregrine 10 Black/Red Size 12.5,Default,0,0,0,0,0,24
,Saucony Men's Peregrine 10 Black/Red Size 13,Saucony Men's Peregrine 10 Black/Red Size 13,Default,0,0,0,0,0,48
,Saucony Men's Peregrine 10 Black/Red Size 13,Saucony Men's Peregrine 10 Black/Red Size 13,FBALYB Amazon,11,11,0,0,0,0
,Saucony Men's Redeemer ISO 2-S20382-35 Grey/Black 10W,Saucony Men's Redeemer ISO 2-S20382-35 Grey/Black 10W,FBALYB Amazon,13,13,0,0,0,0
,Saucony Men's Redeemer ISO 2-S20382-35 Grey/Black 11.5W,Saucony Men's Redeemer ISO 2-S20382-35 Grey/Black 11.5W,FBALYB Amazon,-1,-1,0,0,0,0
,Saucony Men's Redeemer ISO 2-S20382-35 Grey/Black 11W,Saucony Men's Redeemer ISO 2-S20382-35 Grey/Black 11W,FBALYB Amazon,-3,-3,0,0,0,0
,Saucony Men's Redeemer ISO 2-S20382-35 Grey/Black 7W,Saucony Men's Redeemer ISO 2-S20382-35 Grey/Black 7W,FBALYB Amazon,2,2,0,0,0,0
,Saucony Men's Redeemer ISO 2-S20382-35 Grey/Black 9.5W,Saucony Men's Redeemer ISO 2-S20382-35 Grey/Black 9.5W,FBALYB Amazon,-1,-1,0,0,0,0
,Saucony Mens S20595 Triumph 18 Alloy/Red US 10,Saucony Mens S20595 Triumph 18 Alloy/Red US 10,Default Ridgefield,12,12,0,0,0,0
,Saucony Mens S20595 Triumph 18 Alloy/Red US 10,Saucony Mens S20595 Triumph 18 Alloy/Red US 10,FBALYB Amazon,-1,-1,0,0,0,0
,Saucony Mens S20595 Triumph 18 Alloy/Red US 10.5,Saucony Mens S20595 Triumph 18 Alloy/Red US 10.5,FBALYB Amazon,-3,-3,0,0,0,0
,Saucony Mens S20595 Triumph 18 Alloy/Red US 11,Saucony Mens S20595 Triumph 18 Alloy/Red US 11,Default,0,0,0,0,0,24
,Saucony Mens S20595 Triumph 18 Alloy/Red US 11,Saucony Mens S20595 Triumph 18 Alloy/Red US 11,FBALYB Amazon,-2,-2,0,0,0,0
,Saucony Mens S20595 Triumph 18 Alloy/Red US 11.5,Saucony Mens S20595 Triumph 18 Alloy/Red US 11.5,Default Ridgefield,12,12,0,0,0,0
,Saucony Mens S20595 Triumph 18 Alloy/Red US 11.5,Saucony Mens S20595 Triumph 18 Alloy/Red US 11.5,FBALYB Amazon,-3,-3,0,0,0,0
,Saucony Mens S20595 Triumph 18 Alloy/Red US 12,Saucony Mens S20595 Triumph 18 Alloy/Red US 12,Default,0,0,0,0,0,24
,Saucony Mens S20595 Triumph 18 Alloy/Red US 12,Saucony Mens S20595 Triumph 18 Alloy/Red US 12,FBALYB Amazon,-2,-2,0,0,0,0
,Saucony Mens S20595 Triumph 18 Alloy/Red US 12.5,Saucony Mens S20595 Triumph 18 Alloy/Red US 12.5,Default,0,0,0,0,0,12
,Saucony Mens S20595 Triumph 18 Alloy/Red US 8.5,Saucony Mens S20595 Triumph 18 Alloy/Red US 8.5,Default Ridgefield,12,12,0,0,0,0
,Saucony Mens S20595 Triumph 18 Alloy/Red US 9,Saucony Mens S20595 Triumph 18 Alloy/Red US 9,Default Ridgefield,24,24,0,0,0,0
,Saucony Mens S20595 Triumph 18 Alloy/Red US 9,Saucony Mens S20595 Triumph 18 Alloy/Red US 9,FBALYB Amazon,-4,-4,0,0,0,0
,Saucony Mens S20595 Triumph 18 Alloy/Red US 9.5,Saucony Mens S20595 Triumph 18 Alloy/Red US 9.5,Default Ridgefield,24,24,0,0,0,0
,Saucony Mens S20595 Triumph 18 Alloy/Red US 9.5,Saucony Mens S20595 Triumph 18 Alloy/Red US 9.5,FBALYB Amazon,2,2,0,0,0,0
,Saucony Mens S20595 Triumph 18 Charcoal/White US 10,Saucony Mens S20595 Triumph 18 Charcoal/White US 10,FBALYB Amazon,-5,-5,0,0,0,0
,Saucony Mens S20595 Triumph 18 Charcoal/White US 10.5,Saucony Mens S20595 Triumph 18 Charcoal/White US 10.5,FBALYB Amazon,-6,-6,0,0,0,0
,Saucony Mens S20595 Triumph 18 Charcoal/White US 11,Saucony Mens S20595 Triumph 18 Charcoal/White US 11,FBALYB Amazon,-9,-9,0,0,0,0
,Saucony Mens S20595 Triumph 18 Charcoal/White US 11.5,Saucony Mens S20595 Triumph 18 Charcoal/White US 11.5,FBALYB Amazon,-1,-1,0,0,0,0
,Saucony Mens S20595 Triumph 18 Charcoal/White US 12,Saucony Mens S20595 Triumph 18 Charcoal/White US 12,FBALYB Amazon,-1,-1,0,0,0,0
,Saucony Mens S20595 Triumph 18 Charcoal/White US 9.5,Saucony Mens S20595 Triumph 18 Charcoal/White US 9.5,FBALYB Amazon,-1,-1,0,0,0,0
,Saucony Mens S20595 Triumph 18 Cobalt/Storm US 10,Saucony Mens S20595 Triumph 18 Cobalt/Storm US 10,FBALYB Amazon,-3,-4,1,0,1,0
,Saucony Mens S20595 Triumph 18 Cobalt/Storm US 10.5,Saucony Mens S20595 Triumph 18 Cobalt/Storm US 10.5,FBALYB Amazon,-3,-3,0,0,0,0
,Saucony Mens S20595 Triumph 18 Cobalt/Storm US 11,Saucony Mens S20595 Triumph 18 Cobalt/Storm US 11,FBALYB Amazon,-4,-4,0,0,0,0
,Saucony Mens S20595 Triumph 18 Cobalt/Storm US 12,Saucony Mens S20595 Triumph 18 Cobalt/Storm US 12,FBALYB Amazon,-2,-2,0,0,0,0
,Saucony Mens S20595 Triumph 18 Cobalt/Storm US 9.5,Saucony Mens S20595 Triumph 18 Cobalt/Storm US 9.5,FBALYB Amazon,-3,-3,0,0,0,0
,Saucony Mens S20615 Hurricane 23 Black/ViziGold US 10,Saucony Mens S20615 Hurricane 23 Black/ViziGold US 10,FBALYB Amazon,17,16,1,0,1,0
,Saucony Mens S20615 Hurricane 23 Black/ViziGold US 10.5,Saucony Mens S20615 Hurricane 23 Black/ViziGold US 10.5,FBALYB Amazon,-4,-4,0,0,0,0
,Saucony Mens S20615 Hurricane 23 Black/ViziGold US 11,Saucony Mens S20615 Hurricane 23 Black/ViziGold US 11,FBALYB Amazon,35,35,0,0,0,0
,Saucony Mens S20615 Hurricane 23 Black/ViziGold US 11.5,Saucony Mens S20615 Hurricane 23 Black/ViziGold US 11.5,FBALYB Amazon,7,7,0,0,0,0
,Saucony Mens S20615 Hurricane 23 Black/ViziGold US 12,Saucony Mens S20615 Hurricane 23 Black/ViziGold US 12,FBALYB Amazon,27,27,0,0,0,0
,Saucony Mens S20615 Hurricane 23 Black/ViziGold US 12.5,Saucony Mens S20615 Hurricane 23 Black/ViziGold US 12.5,FBALYB Amazon,2,2,0,0,0,0
,Saucony Mens S20615 Hurricane 23 Black/ViziGold US 9,Saucony Mens S20615 Hurricane 23 Black/ViziGold US 9,FBALYB Amazon,-1,-1,0,0,0,0
,Saucony Mens S20615 Hurricane 23 Black/ViziGold US 9.5,Saucony Mens S20615 Hurricane 23 Black/ViziGold US 9.5,FBALYB Amazon,11,11,0,0,0,0
,Saucony Mens S20615 Hurricane 23 Fog/Cobalt US 10,Saucony Mens S20615 Hurricane 23 Fog/Cobalt US 10,FBALYB Amazon,19,18,1,0,1,0
,Saucony Mens S20615 Hurricane 23 Fog/Cobalt US 10.5,Saucony Mens S20615 Hurricane 23 Fog/Cobalt US 10.5,FBALYB Amazon,20,20,0,0,0,0
,Saucony Mens S20615 Hurricane 23 Fog/Cobalt US 11,Saucony Mens S20615 Hurricane 23 Fog/Cobalt US 11,FBALYB Amazon,2,2,0,0,0,0
,Saucony Mens S20615 Hurricane 23 Fog/Cobalt US 11.5,Saucony Mens S20615 Hurricane 23 Fog/Cobalt US 11.5,FBALYB Amazon,5,5,0,0,0,0
,Saucony Mens S20615 Hurricane 23 Fog/Cobalt US 12,Saucony Mens S20615 Hurricane 23 Fog/Cobalt US 12,FBALYB Amazon,18,18,0,0,0,0
,Saucony Mens S20615 Hurricane 23 Fog/Cobalt US 12.5,Saucony Mens S20615 Hurricane 23 Fog/Cobalt US 12.5,FBALYB Amazon,4,4,0,0,0,0
,Saucony Mens S20615 Hurricane 23 Fog/Cobalt US 9,Saucony Mens S20615 Hurricane 23 Fog/Cobalt US 9,FBALYB Amazon,-1,-1,0,0,0,0
,Saucony Mens S20615 Hurricane 23 Fog/Cobalt US 9.5,Saucony Mens S20615 Hurricane 23 Fog/Cobalt US 9.5,FBALYB Amazon,-1,-1,0,0,0,0
,Saucony Mens S20619 Kinvara 12 Black/Silver US 10,Saucony Mens S20619 Kinvara 12 Black/Silver US 10,FBALYB Amazon,-3,-3,0,0,0,0
,Saucony Mens S20619 Kinvara 12 Black/Silver US 10.5,Saucony Mens S20619 Kinvara 12 Black/Silver US 10.5,FBALYB Amazon,-2,-2,0,0,0,0
,Saucony Mens S20619 Kinvara 12 Black/Silver US 11,Saucony Mens S20619 Kinvara 12 Black/Silver US 11,FBALYB Amazon,-3,-3,0,0,0,0
,Saucony Mens S20619 Kinvara 12 Black/Silver US 11.5,Saucony Mens S20619 Kinvara 12 Black/Silver US 11.5,FBALYB Amazon,-4,-5,1,0,1,0
,Saucony Mens S20619 Kinvara 12 Black/Silver US 12,Saucony Mens S20619 Kinvara 12 Black/Silver US 12,FBALYB Amazon,25,25,0,0,0,0
,Saucony Mens S20619 Kinvara 12 Black/Silver US 12.5,Saucony Mens S20619 Kinvara 12 Black/Silver US 12.5,FBALYB Amazon,4,4,0,0,0,0
,Saucony Mens S20619 Kinvara 12 Black/Silver US 9,Saucony Mens S20619 Kinvara 12 Black/Silver US 9,FBALYB Amazon,-1,-1,0,0,0,0
,Saucony Mens S20619 Kinvara 12 Black/Silver US 9.5,Saucony Mens S20619 Kinvara 12 Black/Silver US 9.5,FBALYB Amazon,-6,-6,0,0,0,0
,Saucony Mens S20619 Kinvara 12 Cobalt/Citrus US 10,Saucony Mens S20619 Kinvara 12 Cobalt/Citrus US 10,FBALYB Amazon,-1,-1,0,0,0,0
,Saucony Mens S20619 Kinvara 12 Cobalt/Citrus US 10.5,Saucony Mens S20619 Kinvara 12 Cobalt/Citrus US 10.5,FBALYB Amazon,-4,-4,0,0,0,0
,Saucony Mens S20619 Kinvara 12 Cobalt/Citrus US 11,Saucony Mens S20619 Kinvara 12 Cobalt/Citrus US 11,FBALYB Amazon,-5,-5,0,0,0,0
,Saucony Mens S20619 Kinvara 12 Cobalt/Citrus US 11.5,Saucony Mens S20619 Kinvara 12 Cobalt/Citrus US 11.5,FBALYB Amazon,-1,-1,0,0,0,0
,Saucony Mens S20619 Kinvara 12 Cobalt/Citrus US 12,Saucony Mens S20619 Kinvara 12 Cobalt/Citrus US 12,FBALYB Amazon,-2,-2,0,0,0,0
,Saucony Mens S20619 Kinvara 12 Cobalt/Citrus US 12.5,Saucony Mens S20619 Kinvara 12 Cobalt/Citrus US 12.5,FBALYB Amazon,5,5,0,0,0,0
,Saucony Mens S20619 Kinvara 12 Cobalt/Citrus US 9,Saucony Mens S20619 Kinvara 12 Cobalt/Citrus US 9,FBALYB Amazon,-2,-2,0,0,0,0
,Saucony Mens S20619 Kinvara 12 Cobalt/Citrus US 9.5,Saucony Mens S20619 Kinvara 12 Cobalt/Citrus US 9.5,FBALYB Amazon,-8,-8,0,0,0,0
,Saucony Mens S20641 Peregrine 11 GRAVEL/BLACK US 10,Saucony Mens S20641 Peregrine 11 GRAVEL/BLACK US 10,FBALYB Amazon,-9,-10,1,0,1,0
,Saucony Mens S20641 Peregrine 11 GRAVEL/BLACK US 10.5,Saucony Mens S20641 Peregrine 11 GRAVEL/BLACK US 10.5,FBALYB Amazon,-10,-10,0,0,0,0
,Saucony Mens S20641 Peregrine 11 GRAVEL/BLACK US 11,Saucony Mens S20641 Peregrine 11 GRAVEL/BLACK US 11,FBALYB Amazon,-2,-4,2,0,2,0
,Saucony Mens S20641 Peregrine 11 GRAVEL/BLACK US 11.5,Saucony Mens S20641 Peregrine 11 GRAVEL/BLACK US 11.5,FBALYB Amazon,-2,-3,1,0,1,0
,Saucony Mens S20641 Peregrine 11 GRAVEL/BLACK US 12,Saucony Mens S20641 Peregrine 11 GRAVEL/BLACK US 12,FBALYB Amazon,-1,-1,0,0,0,0
,Saucony Mens S20641 Peregrine 11 GRAVEL/BLACK US 12.5,Saucony Mens S20641 Peregrine 11 GRAVEL/BLACK US 12.5,FBALYB Amazon,2,2,0,0,0,0
,Saucony Mens S20641 Peregrine 11 GRAVEL/BLACK US 9,Saucony Mens S20641 Peregrine 11 GRAVEL/BLACK US 9,Default,0,0,0,0,0,12
,Saucony Mens S20641 Peregrine 11 GRAVEL/BLACK US 9.5,Saucony Mens S20641 Peregrine 11 GRAVEL/BLACK US 9.5,FBALYB Amazon,-2,-2,0,0,0,0
,Saucony Mens S20654 Guide 14 Alloy/Cobalt US 10,Saucony Mens S20654 Guide 14 Alloy/Cobalt US 10,FBALYB Amazon,-1,-1,0,0,0,0
,Saucony Mens S20654 Guide 14 Alloy/Cobalt US 11,Saucony Mens S20654 Guide 14 Alloy/Cobalt US 11,FBALYB Amazon,-3,-5,2,0,2,0
,Saucony Mens S20654 Guide 14 Alloy/Cobalt US 11.5,Saucony Mens S20654 Guide 14 Alloy/Cobalt US 11.5,FBALYB Amazon,25,25,0,0,0,0
,Saucony Mens S20654 Guide 14 Alloy/Cobalt US 12,Saucony Mens S20654 Guide 14 Alloy/Cobalt US 12,FBALYB Amazon,24,24,0,0,0,0
,Saucony Mens S20654 Guide 14 Alloy/Cobalt US 12.5,Saucony Mens S20654 Guide 14 Alloy/Cobalt US 12.5,FBALYB Amazon,11,11,0,0,0,0
,Saucony Mens S20654 Guide 14 Alloy/Cobalt US 9,Saucony Mens S20654 Guide 14 Alloy/Cobalt US 9,FBALYB Amazon,-1,-1,0,0,0,0
,Saucony Mens S20654 Guide 14 Alloy/Cobalt US 9.5,Saucony Mens S20654 Guide 14 Alloy/Cobalt US 9.5,FBALYB Amazon,4,4,0,0,0,0
,Saucony Mens S20654 Guide 14 Charcoal/ViziGold US 10,Saucony Mens S20654 Guide 14 Charcoal/ViziGold US 10,FBALYB Amazon,-5,-5,0,0,0,0
,Saucony Mens S20654 Guide 14 Charcoal/ViziGold US 10.5,Saucony Mens S20654 Guide 14 Charcoal/ViziGold US 10.5,FBALYB Amazon,-6,-6,0,0,0,0
,Saucony Mens S20654 Guide 14 Charcoal/ViziGold US 11,Saucony Mens S20654 Guide 14 Charcoal/ViziGold US 11,FBALYB Amazon,2,2,0,0,0,0
,Saucony Mens S20654 Guide 14 Charcoal/ViziGold US 11.5,Saucony Mens S20654 Guide 14 Charcoal/ViziGold US 11.5,FBALYB Amazon,5,3,2,0,2,0
,Saucony Mens S20654 Guide 14 Charcoal/ViziGold US 12,Saucony Mens S20654 Guide 14 Charcoal/ViziGold US 12,FBALYB Amazon,16,16,0,0,0,0
,Saucony Mens S20654 Guide 14 Charcoal/ViziGold US 12.5,Saucony Mens S20654 Guide 14 Charcoal/ViziGold US 12.5,FBALYB Amazon,5,5,0,0,0,0
,Saucony Mens S20654 Guide 14 Charcoal/ViziGold US 9.5,Saucony Mens S20654 Guide 14 Charcoal/ViziGold US 9.5,FBALYB Amazon,-2,-2,0,0,0,0
,Saucony Men's Triumph ISO 5-S20462-1 Grey/Black 11.5,Saucony Men's Triumph ISO 5-S20462-1 Grey/Black 11.5,FBALYB Amazon,-7,-7,0,0,0,0
,Saucony Men's Triumph ISO 5-S20462-1 Grey/Black 7,Saucony Men's Triumph ISO 5-S20462-1 Grey/Black 7,FBALYB Amazon,-1,-1,0,0,0,0
,Saucony Men's Triumph ISO 5-S20462-1 Grey/Black 8,Saucony Men's Triumph ISO 5-S20462-1 Grey/Black 8,FBALYB Amazon,28,28,0,0,0,0
,Saucony Men's Triumph ISO 5-S20462-37 Frost/Teal 10,Saucony Men's Triumph ISO 5-S20462-37 Frost/Teal 10,FBALYB Amazon,-1,-1,0,0,0,0
,Saucony Men's Triumph ISO 5-S20462-37 Frost/Teal 11,Saucony Men's Triumph ISO 5-S20462-37 Frost/Teal 11,FBALYB Amazon,-2,-2,0,0,0,0
,Saucony Men's Triumph ISO 5-S20462-37 Frost/Teal 12,Saucony Men's Triumph ISO 5-S20462-37 Frost/Teal 12,FBALYB Amazon,-3,-3,0,0,0,0
,Saucony Men's Triumph ISO 5-S20462-37 Frost/Teal 12.5,Saucony Men's Triumph ISO 5-S20462-37 Frost/Teal 12.5,FBALYB Amazon,-7,-7,0,0,0,0
,Saucony Men's Triumph ISO 5-S20462-37 Frost/Teal 9.5,Saucony Men's Triumph ISO 5-S20462-37 Frost/Teal 9.5,FBALYB Amazon,-1,-1,0,0,0,0
,Saucony Men's Xodus Iso 3-S20449-1 Black/Slime 10,Saucony Men's Xodus Iso 3-S20449-1 Black/Slime 10,FBALYB Amazon,-4,-4,0,0,0,0
,Saucony Men's Xodus Iso 3-S20449-1 Black/Slime 10.5,Saucony Men's Xodus Iso 3-S20449-1 Black/Slime 10.5,FBALYB Amazon,-3,-3,0,0,0,0
,Saucony Men's Xodus Iso 3-S20449-1 Black/Slime 11,Saucony Men's Xodus Iso 3-S20449-1 Black/Slime 11,FBALYB Amazon,-3,-3,0,0,0,0
,Saucony Men's Xodus Iso 3-S20449-1 Black/Slime 11.5,Saucony Men's Xodus Iso 3-S20449-1 Black/Slime 11.5,FBALYB Amazon,-1,-1,0,0,0,0
,Saucony Men's Xodus Iso 3-S20449-1 Black/Slime 9.5,Saucony Men's Xodus Iso 3-S20449-1 Black/Slime 9.5,FBALYB Amazon,-2,-2,0,0,0,0
,Saucony Men's Xodus Iso 3-S20449-2 Olive/Black 10,Saucony Men's Xodus Iso 3-S20449-2 Olive/Black 10,FBALYB Amazon,15,15,0,0,0,0
,Saucony Men's Xodus Iso 3-S20449-2 Olive/Black 10.5,Saucony Men's Xodus Iso 3-S20449-2 Olive/Black 10.5,FBALYB Amazon,-2,-2,0,0,0,0
,Saucony Men's Xodus Iso 3-S20449-2 Olive/Black 11.5,Saucony Men's Xodus Iso 3-S20449-2 Olive/Black 11.5,FBALYB Amazon,-5,-5,0,0,0,0
,Saucony Men's Xodus Iso 3-S20449-2 Olive/Black 12,Saucony Men's Xodus Iso 3-S20449-2 Olive/Black 12,FBALYB Amazon,-6,-6,0,0,0,0
,Saucony Men's Xodus Iso 3-S20449-2 Olive/Black 12.5,Saucony Men's Xodus Iso 3-S20449-2 Olive/Black 12.5,FBALYB Amazon,-5,-5,0,0,0,0
,Saucony Men's Xodus Iso 3-S20449-2 Olive/Black 7.5,Saucony Men's Xodus Iso 3-S20449-2 Olive/Black 7.5,FBALYB Amazon,-1,-1,0,0,0,0
,Saucony Men's Xodus Iso 3-S20449-2 Olive/Black 9,Saucony Men's Xodus Iso 3-S20449-2 Olive/Black 9,FBALYB Amazon,14,14,0,0,0,0
,Saucony Men's Xodus Iso 3-S20449-2 Olive/Black 9.5,Saucony Men's Xodus Iso 3-S20449-2 Olive/Black 9.5,FBALYB Amazon,3,3,0,0,0,0
,Saucony Men's Xodus Iso 3-S20449-37 Green/Citron 10,Saucony Men's Xodus Iso 3-S20449-37 Green/Citron 10,FBALYB Amazon,-1,-1,0,0,0,0
,Saucony Men's Xodus Iso 3-S20449-37 Green/Citron 10.5,Saucony Men's Xodus Iso 3-S20449-37 Green/Citron 10.5,FBALYB Amazon,-3,-3,0,0,0,0
,Saucony Men's Xodus Iso 3-S20449-37 Green/Citron 11,Saucony Men's Xodus Iso 3-S20449-37 Green/Citron 11,FBALYB Amazon,-5,-5,0,0,0,0
,Saucony Men's Xodus Iso 3-S20449-37 Green/Citron 11.5,Saucony Men's Xodus Iso 3-S20449-37 Green/Citron 11.5,FBALYB Amazon,-1,-1,0,0,0,0
,Saucony Men's Xodus Iso 3-S20449-37 Green/Citron 12,Saucony Men's Xodus Iso 3-S20449-37 Green/Citron 12,FBALYB Amazon,-3,-3,0,0,0,0
,Saucony Men's Xodus Iso 3-S20449-37 Green/Citron 12.5,Saucony Men's Xodus Iso 3-S20449-37 Green/Citron 12.5,FBALYB Amazon,-4,-4,0,0,0,0
,Saucony Men's Xodus Iso 3-S20449-37 Green/Citron 13,Saucony Men's Xodus Iso 3-S20449-37 Green/Citron 13,FBALYB Amazon,-1,-1,0,0,0,0
,Saucony Men's Xodus Iso 3-S20449-37 Green/Citron 8,Saucony Men's Xodus Iso 3-S20449-37 Green/Citron 8,FBALYB Amazon,-1,-1,0,0,0,0
,Saucony Men's Xodus Iso 3-S20449-37 Green/Citron 8.5,Saucony Men's Xodus Iso 3-S20449-37 Green/Citron 8.5,FBALYB Amazon,-3,-3,0,0,0,0
,Saucony Men's Xodus Iso 3-S20449-37 Green/Citron 9.5,Saucony Men's Xodus Iso 3-S20449-37 Green/Citron 9.5,FBALYB Amazon,-2,-2,0,0,0,0
,Saucony Men's Xodus Iso 3-S20449-3 Grey/Black 10,Saucony Men's Xodus Iso 3-S20449-3 Grey/Black 10,FBALYB Amazon,-2,-2,0,0,0,0
,Saucony Men's Xodus Iso 3-S20449-3 Grey/Black 10.5,Saucony Men's Xodus Iso 3-S20449-3 Grey/Black 10.5,FBALYB Amazon,-2,-2,0,0,0,0
,Saucony Men's Xodus Iso 3-S20449-3 Grey/Black 7,Saucony Men's Xodus Iso 3-S20449-3 Grey/Black 7,FBALYB Amazon,-2,-2,0,1,0,0
,Saucony Men's Xodus Iso 3-S20449-3 Grey/Black 7.5,Saucony Men's Xodus Iso 3-S20449-3 Grey/Black 7.5,FBALYB Amazon,5,5,0,0,0,0
,Saucony Men's Xodus Iso 3-S20449-3 Grey/Black 8,Saucony Men's Xodus Iso 3-S20449-3 Grey/Black 8,FBALYB Amazon,-4,-4,0,0,0,0
,Saucony Men's Xodus Iso 3-S20449-3 Grey/Black 9,Saucony Men's Xodus Iso 3-S20449-3 Grey/Black 9,FBALYB Amazon,-2,-2,0,0,0,0
,Saucony Men's Xodus Iso 3-S20449-3 Grey/Black 9.5,Saucony Men's Xodus Iso 3-S20449-3 Grey/Black 9.5,FBALYB Amazon,-7,-7,0,0,0,0
,Saucony OMNI 19 ALLOY / SKY  S10570-30 Size 10,Saucony OMNI 19 ALLOY / SKY  S10570-30 Size 10,Default Ridgefield,24,24,0,0,0,0
,Saucony OMNI 19 ALLOY / SKY  S10570-30 Size 10.5,Saucony OMNI 19 ALLOY / SKY  S10570-30 Size 10.5,Default Ridgefield,12,12,0,0,0,0
,Saucony OMNI 19 ALLOY / SKY  S10570-30 Size 7,Saucony OMNI 19 ALLOY / SKY  S10570-30 Size 7,Default Ridgefield,11,11,0,0,0,0
,Saucony OMNI 19 ALLOY / SKY  S10570-30 Size 7.5,Saucony OMNI 19 ALLOY / SKY  S10570-30 Size 7.5,Default Ridgefield,24,24,0,0,0,0
,Saucony OMNI 19 ALLOY / SKY  S10570-30 Size 8,Saucony OMNI 19 ALLOY / SKY  S10570-30 Size 8,Default Ridgefield,48,48,0,0,0,0
,Saucony OMNI 19 ALLOY / SKY  S10570-30 Size 9,Saucony OMNI 19 ALLOY / SKY  S10570-30 Size 9,Default Ridgefield,48,48,0,0,0,0
,Saucony OMNI 19 ALLOY / SKY  S10570-30 Size 9.5,Saucony OMNI 19 ALLOY / SKY  S10570-30 Size 9.5,Default Ridgefield,54,54,0,0,0,0
,Saucony OMNI 19 BLACK / WHITE S10570-40 Size 6,Saucony OMNI 19 BLACK / WHITE S10570-40 Size 6,Default Ridgefield,12,12,0,0,0,0
,Saucony OMNI 19 BLACK / WHITE S10570-40 Size 6.5,Saucony OMNI 19 BLACK / WHITE S10570-40 Size 6.5,Default Ridgefield,24,24,0,0,0,0
,Saucony OMNI 19 BLACK / WHITE S10570-40 Size 7,Saucony OMNI 19 BLACK / WHITE S10570-40 Size 7,Default Ridgefield,48,48,0,0,0,0
,Saucony OMNI 19 BLACK / WHITE S10570-40 Size 7.5,Saucony OMNI 19 BLACK / WHITE S10570-40 Size 7.5,Default Ridgefield,60,60,0,0,0,0
,Saucony OMNI 19 BLACK / WHITE S10570-40 Size 8,Saucony OMNI 19 BLACK / WHITE S10570-40 Size 8,Default Ridgefield,48,48,0,0,0,0
,Saucony OMNI 19 BLACK / WHITE S10570-40 Size 8.5,Saucony OMNI 19 BLACK / WHITE S10570-40 Size 8.5,Default Ridgefield,60,60,0,0,0,0
,Saucony OMNI 19 BLACK / WHITE S10570-40 Size 9,Saucony OMNI 19 BLACK / WHITE S10570-40 Size 9,Default Ridgefield,24,24,0,0,0,0
,Saucony OMNI 19 BLACK / WHITE S10570-40 Size 9.5,Saucony OMNI 19 BLACK / WHITE S10570-40 Size 9.5,Default Ridgefield,12,12,0,0,0,0
,Saucony OMNI 19 BLACK / WHITE  S20570-40 Size 10,Saucony OMNI 19 BLACK / WHITE  S20570-40 Size 10,Default Ridgefield,24,24,0,0,0,0
,Saucony OMNI 19 BLACK / WHITE  S20570-40 Size 10.5,Saucony OMNI 19 BLACK / WHITE  S20570-40 Size 10.5,Default Ridgefield,36,36,0,0,0,0
,Saucony OMNI 19 BLACK / WHITE  S20570-40 Size 11,Saucony OMNI 19 BLACK / WHITE  S20570-40 Size 11,Default Ridgefield,36,36,0,0,0,0
,Saucony OMNI 19 BLACK / WHITE  S20570-40 Size 11.5,Saucony OMNI 19 BLACK / WHITE  S20570-40 Size 11.5,Default Ridgefield,24,24,0,0,0,0
,Saucony OMNI 19 BLACK / WHITE  S20570-40 Size 12,Saucony OMNI 19 BLACK / WHITE  S20570-40 Size 12,Default Ridgefield,36,36,0,0,0,0
,Saucony OMNI 19 BLACK / WHITE  S20570-40 Size 9.5,Saucony OMNI 19 BLACK / WHITE  S20570-40 Size 9.5,Default Ridgefield,12,12,0,0,0,0
,Saucony OMNI 19 INDIGO / OCEAN S20570-20 Size 10,Saucony OMNI 19 INDIGO / OCEAN S20570-20 Size 10,Default Ridgefield,24,24,0,0,0,0
,Saucony OMNI 19 INDIGO / OCEAN S20570-20 Size 10.5,Saucony OMNI 19 INDIGO / OCEAN S20570-20 Size 10.5,Default Ridgefield,36,36,0,0,0,0
,Saucony OMNI 19 INDIGO / OCEAN S20570-20 Size 11,Saucony OMNI 19 INDIGO / OCEAN S20570-20 Size 11,Default Ridgefield,18,18,0,0,0,0
,Saucony OMNI 19 INDIGO / OCEAN S20570-20 Size 11.5,Saucony OMNI 19 INDIGO / OCEAN S20570-20 Size 11.5,Default Ridgefield,24,24,0,0,0,0
,Saucony OMNI 19 INDIGO / OCEAN S20570-20 Size 9.5,Saucony OMNI 19 INDIGO / OCEAN S20570-20 Size 9.5,Default Ridgefield,12,12,0,0,0,0
,Saucony S10617-35 US Size 10,Saucony FREEDOM 4 Storm/Lilac Women S10617-35 US Size 10,Default,0,0,0,0,0,24
,Saucony S10617-35 US Size 10.5,Saucony FREEDOM 4 Storm/Lilac Women S10617-35 US Size 10.5,Default,0,0,0,0,0,24
,Saucony S10617-35 US Size 11,Saucony FREEDOM 4 Storm/Lilac Women S10617-35 US Size 11,Default,0,0,0,0,0,12
,Saucony S10617-35 US Size 7,Saucony FREEDOM 4 Storm/Lilac Women S10617-35 US Size 7,Default,0,0,0,0,0,12
,Saucony S10617-35 US Size 7.5,Saucony FREEDOM 4 Storm/Lilac Women S10617-35 US Size 7.5,Default,0,0,0,0,0,48
,Saucony S10617-35 US Size 8,Saucony FREEDOM 4 Storm/Lilac Women S10617-35 US Size 8,Default,0,0,0,0,0,24
,Saucony S10617-35 US Size 8.5,Saucony FREEDOM 4 Storm/Lilac Women S10617-35 US Size 8.5,Default,0,0,0,0,0,36
,Saucony S10617-35 US Size 9,Saucony FREEDOM 4 Storm/Lilac Women S10617-35 US Size 9,Default,0,0,0,0,0,36
,Saucony S10617-35 US Size 9.5,Saucony FREEDOM 4 Storm/Lilac Women S10617-35 US Size 9.5,Default,0,0,0,0,0,24
,Saucony S10617-45 US Size 10,Saucony FREEDOM 4 Black/Sunset Women S10617-45 US Size 10,Default,0,0,0,0,0,24
,Saucony S10617-45 US Size 10.5,Saucony FREEDOM 4 Black/Sunset Women S10617-45 US Size 10.5,Default,0,0,0,0,0,24
,Saucony S10617-45 US Size 11,Saucony FREEDOM 4 Black/Sunset Women S10617-45 US Size 11,Default,0,0,0,0,0,12
,Saucony S10617-45 US Size 7,Saucony FREEDOM 4 Black/Sunset Women S10617-45 US Size 7,Default,0,0,0,0,0,12
,Saucony S10617-45 US Size 7.5,Saucony FREEDOM 4 Black/Sunset Women S10617-45 US Size 7.5,Default,0,0,0,0,0,48
,Saucony S10617-45 US Size 8,Saucony FREEDOM 4 Black/Sunset Women S10617-45 US Size 8,Default,0,0,0,0,0,24
,Saucony S10617-45 US Size 8.5,Saucony FREEDOM 4 Black/Sunset Women S10617-45 US Size 8.5,Default,0,0,0,0,0,36
,Saucony S10617-45 US Size 9,Saucony FREEDOM 4 Black/Sunset Women S10617-45 US Size 9,Default,0,0,0,0,0,36
,Saucony S10617-45 US Size 9.5,Saucony FREEDOM 4 Black/Sunset Women S10617-45 US Size 9.5,Default,0,0,0,0,0,24
,Saucony S10617-55 US Size 10,Saucony FREEDOM 4 Rosewater/Sunset Women S10617-55 US Size 10,Default,0,0,0,0,0,24
,Saucony S10617-55 US Size 10.5,Saucony FREEDOM 4 Rosewater/Sunset Women S10617-55 US Size 10.5,Default,0,0,0,0,0,24
,Saucony S10617-55 US Size 11,Saucony FREEDOM 4 Rosewater/Sunset Women S10617-55 US Size 11,Default,0,0,0,0,0,12
,Saucony S10617-55 US Size 7,Saucony FREEDOM 4 Rosewater/Sunset Women S10617-55 US Size 7,Default,0,0,0,0,0,12
,Saucony S10617-55 US Size 7.5,Saucony FREEDOM 4 Rosewater/Sunset Women S10617-55 US Size 7.5,Default,0,0,0,0,0,48
,Saucony S10617-55 US Size 8,Saucony FREEDOM 4 Rosewater/Sunset Women S10617-55 US Size 8,Default,0,0,0,0,0,24
,Saucony S10617-55 US Size 8.5,Saucony FREEDOM 4 Rosewater/Sunset Women S10617-55 US Size 8.5,Default,0,0,0,0,0,36
,Saucony S10617-55 US Size 9,Saucony FREEDOM 4 Rosewater/Sunset Women S10617-55 US Size 9,Default,0,0,0,0,0,36
,Saucony S10617-55 US Size 9.5,Saucony FREEDOM 4 Rosewater/Sunset Women S10617-55 US Size 9.5,Default,0,0,0,0,0,24
,Saucony S20617-45 US Size 12.5,Saucony FREEDOM 4 BLACK/STONE - Men US Size 12.5 S20617-45,Default,0,0,0,0,0,12
,Saucony S20617-45 US Size 9,Saucony FREEDOM 4 BLACK/STONE - Men US Size 9 S20617-45,Default,0,0,0,0,0,12
,Saucony S20617-45 US Size 9.5,Saucony FREEDOM 4 BLACK/STONE - Men US Size 9.5 S20617-45,Default,0,0,0,0,0,24
,Saucony Women's Freedom ISO 2-S10440-37 Peach 10.5,Saucony Women's Freedom ISO 2-S10440-37 Peach 10.5,FBALYB Amazon,-1,-1,0,0,0,0
,Saucony Women's Freedom ISO 2-S10440-37 Peach 11,Saucony Women's Freedom ISO 2-S10440-37 Peach 11,FBALYB Amazon,-1,-1,0,0,0,0
,Saucony Women's Freedom ISO 2-S10440-37 Peach 12,Saucony Women's Freedom ISO 2-S10440-37 Peach 12,FBALYB Amazon,1,1,0,0,0,0
,Saucony Women's Freedom ISO 2-S10440-37 Peach 5,Saucony Women's Freedom ISO 2-S10440-37 Peach 5,FBALYB Amazon,4,4,0,0,0,0
,Saucony Women's Freedom ISO 2-S10440-37 Peach 5.5,Saucony Women's Freedom ISO 2-S10440-37 Peach 5.5,FBALYB Amazon,4,4,0,0,0,0
,Saucony Women's Freedom ISO 2-S10440-37 Peach 9.5,Saucony Women's Freedom ISO 2-S10440-37 Peach 9.5,FBALYB Amazon,-2,-2,0,0,0,0
,Saucony Women's Freedom ISO 2-S10440-411 Blue Shade 6,Saucony Women's Freedom ISO 2-S10440-411 Blue Shade 6,FBALYB Amazon,-2,-2,0,0,0,0
,Saucony Women's Freedom ISO 2-S10440-41 Blue Shade 10,Saucony Women's Freedom ISO 2-S10440-41 Blue Shade 10,FBALYB Amazon,-2,-2,0,0,0,0
,Saucony Women's Freedom ISO 2-S10440-41 Blue Shade 10.5,Saucony Women's Freedom ISO 2-S10440-41 Blue Shade 10.5,FBALYB Amazon,-2,-2,0,0,0,0
,Saucony Women's Freedom ISO 2-S10440-41 Blue Shade 5,Saucony Women's Freedom ISO 2-S10440-41 Blue Shade 5,FBALYB Amazon,-1,-1,0,0,0,0
,Saucony Women's Freedom ISO 2-S10440-41 Blue Shade 5.5,Saucony Women's Freedom ISO 2-S10440-41 Blue Shade 5.5,FBALYB Amazon,-1,-1,0,0,0,0
,Saucony Women's Freedom ISO 2-S10440-41 Blue Shade 6.5,Saucony Women's Freedom ISO 2-S10440-41 Blue Shade 6.5,FBALYB Amazon,-1,-1,0,0,0,0
,Saucony Women's Freedom ISO 2-S10440-41 Blue Shade 7,Saucony Women's Freedom ISO 2-S10440-41 Blue Shade 7,FBALYB Amazon,-3,-3,0,0,0,0
,Saucony Women's Freedom ISO 2-S10440-41 Blue Shade 7.5,Saucony Women's Freedom ISO 2-S10440-41 Blue Shade 7.5,FBALYB Amazon,-4,-4,0,0,0,0
,Saucony Women's Freedom ISO 2-S10440-41 Blue Shade 8,Saucony Women's Freedom ISO 2-S10440-41 Blue Shade 8,FBALYB Amazon,-5,-5,0,0,0,0
,Saucony Women's Freedom ISO 2-S10440-41 Blue Shade 8.5,Saucony Women's Freedom ISO 2-S10440-41 Blue Shade 8.5,FBALYB Amazon,-4,-4,0,0,0,0
,Saucony Women's Freedom ISO 2-S10440-41 Blue Shade 9,Saucony Women's Freedom ISO 2-S10440-41 Blue Shade 9,FBALYB Amazon,1,1,0,0,0,0
,Saucony Women's Freedom ISO 2-S10440-41 Blue Shade 9.5,Saucony Women's Freedom ISO 2-S10440-41 Blue Shade 9.5,FBALYB Amazon,-2,-2,0,0,0,0
,Saucony Women's Freedom ISO 2-S10440-4 Grey/Teal 10,Saucony Women's Freedom ISO 2-S10440-4 Grey/Teal 10,FBALYB Amazon,-2,-2,0,0,0,0
,Saucony Women's Freedom ISO 2-S10440-4 Grey/Teal 10.5,Saucony Women's Freedom ISO 2-S10440-4 Grey/Teal 10.5,FBALYB Amazon,-1,-1,0,0,0,0
,Saucony Women's Freedom ISO 2-S10440-4 Grey/Teal 5,Saucony Women's Freedom ISO 2-S10440-4 Grey/Teal 5,FBALYB Amazon,1,1,0,0,0,0
,Saucony Women's Freedom ISO 2-S10440-4 Grey/Teal 6,Saucony Women's Freedom ISO 2-S10440-4 Grey/Teal 6,FBALYB Amazon,-2,-2,0,0,0,0
,Saucony Women's Freedom ISO 2-S10440-4 Grey/Teal 6.5,Saucony Women's Freedom ISO 2-S10440-4 Grey/Teal 6.5,FBALYB Amazon,-2,-2,0,0,0,0
,Saucony Women's Freedom ISO 2-S10440-4 Grey/Teal 7,Saucony Women's Freedom ISO 2-S10440-4 Grey/Teal 7,FBALYB Amazon,-2,-2,0,0,0,0
,Saucony Women's Freedom ISO 2-S10440-4 Grey/Teal 7.5,Saucony Women's Freedom ISO 2-S10440-4 Grey/Teal 7.5,FBALYB Amazon,-6,-6,0,0,0,0
,Saucony Women's Freedom ISO 2-S10440-4 Grey/Teal 8.5,Saucony Women's Freedom ISO 2-S10440-4 Grey/Teal 8.5,FBALYB Amazon,-1,-1,0,0,0,0
,Saucony Women's Freedom ISO 2-S10440-4Grey/Teal 9,Saucony Women's Freedom ISO 2-S10440-4Grey/Teal 9,FBALYB Amazon,-1,-1,0,0,0,0
,Saucony Women's Freedom ISO 2-S10440-4 Grey/Teal 9.5,Saucony Women's Freedom ISO 2-S10440-4 Grey/Teal 9.5,FBALYB Amazon,-2,-2,0,0,0,0
,Saucony Women's Hurricane 22 Blue Aqua Size 7.5,Saucony Women's Hurricane 22 Blue Aqua Size 7.5,Default,0,0,0,0,0,25
,Saucony Women's Hurricane 22 Blue Aqua Size 7.5,Saucony Women's Hurricane 22 Blue Aqua Size 7.5,Default Ridgefield,25,25,0,0,0,0
,Saucony Women's Hurricane 22 Blue Aqua Size 8.5,Saucony Women's Hurricane 22 Blue Aqua Size 8.5,Default,0,0,0,0,0,25
,Saucony Women's Hurricane 22 Blue Aqua Size 8.5,Saucony Women's Hurricane 22 Blue Aqua Size 8.5,Default Ridgefield,1,1,0,0,0,0
,Saucony Women's Hurricane 22 Blue Aqua Size 9,Saucony Women's Hurricane 22 Blue Aqua Size 9,Default,0,0,0,0,0,45
,Saucony Women's Hurricane 22 Blue Aqua Size 9,Saucony Women's Hurricane 22 Blue Aqua Size 9,Default Ridgefield,12,12,0,0,0,0
,Saucony Women's Hurricane 22 Blue Aqua Size 9,Saucony Women's Hurricane 22 Blue Aqua Size 9,FBALYB Amazon,7,4,3,0,3,0
,Saucony Women's Hurricane 22 Blue Aqua Size 9.5,Saucony Women's Hurricane 22 Blue Aqua Size 9.5,Default,0,0,0,0,0,30
,Saucony Women's Hurricane 22 Blue Aqua Size 9.5,Saucony Women's Hurricane 22 Blue Aqua Size 9.5,Default Ridgefield,13,13,0,0,0,0
,Saucony Women's Hurricane ISO 5-S10460-42 Sage Quake 10,Saucony Women's Hurricane ISO 5-S10460-42 Sage Quake 10,FBALYB Amazon,-1,-1,0,0,0,0
,Saucony Women's Hurricane ISO 5-S10460-42 Sage Quake 10.5,Saucony Women's Hurricane ISO 5-S10460-42 Sage Quake 10.5,FBALYB Amazon,2,2,0,0,0,0
,Saucony Women's Hurricane ISO 5-S10460-42 Sage Quake 11,Saucony Women's Hurricane ISO 5-S10460-42 Sage Quake 11,FBALYB Amazon,6,5,1,0,1,0
,Saucony Women's Hurricane ISO 5-S10460-42 Sage Quake 5,Saucony Women's Hurricane ISO 5-S10460-42 Sage Quake 5,FBALYB Amazon,1,1,0,0,0,0
,Saucony Women's Hurricane ISO 5-S10460-42 Sage Quake 5.5,Saucony Women's Hurricane ISO 5-S10460-42 Sage Quake 5.5,FBALYB Amazon,4,4,0,0,0,0
,Saucony Women's Hurricane ISO 5-S10460-42 Sage Quake 6,Saucony Women's Hurricane ISO 5-S10460-42 Sage Quake 6,FBALYB Amazon,2,2,0,0,0,0
,Saucony Women's Hurricane ISO 5-S10460-42 Sage Quake 6.5,Saucony Women's Hurricane ISO 5-S10460-42 Sage Quake 6.5,FBALYB Amazon,0,0,0,1,0,0
,Saucony Women's Hurricane ISO 5-S10460-42 Sage Quake 7,Saucony Women's Hurricane ISO 5-S10460-42 Sage Quake 7,FBALYB Amazon,-4,-4,0,0,0,0
,Saucony Women's Hurricane ISO 5-S10460-42 Sage Quake 7.5,Saucony Women's Hurricane ISO 5-S10460-42 Sage Quake 7.5,FBALYB Amazon,-6,-6,0,0,0,0
,Saucony Women's Hurricane ISO 5-S10460-42 Sage Quake 9,Saucony Women's Hurricane ISO 5-S10460-42 Sage Quake 9,FBALYB Amazon,-1,-1,0,0,0,0
,Saucony Women's Kinvara 11 Aqua Blue Size 10,Saucony Women's Kinvara 11 Aqua Blue Size 10,Default,0,0,0,0,0,10
,Saucony Women's Kinvara 11 Aqua Blue Size 10,Saucony Women's Kinvara 11 Aqua Blue Size 10,Default Ridgefield,12,12,0,0,0,0
,Saucony Women's Kinvara 11 Aqua Blue Size 10.5,Saucony Women's Kinvara 11 Aqua Blue Size 10.5,Default,0,0,0,0,0,10
,Saucony Women's Kinvara 11 Aqua Blue Size 7.5,Saucony Women's Kinvara 11 Aqua Blue Size 7.5,Default,0,0,0,0,0,1
,Saucony Women's Kinvara 11 Aqua Blue Size 8,Saucony Women's Kinvara 11 Aqua Blue Size 8,Default,0,0,0,0,0,4
,Saucony Women's Kinvara 11 Aqua Blue Size 9,Saucony Women's Kinvara 11 Aqua Blue Size 9,Default,0,0,0,0,0,1
,Saucony Women's Kinvara 11 Blackout Size 6,Saucony Women's Kinvara 11 Blackout Size 6,Default,0,0,0,0,0,10
,Saucony Women's Kinvara 11 Blackout Size 7,Saucony Women's Kinvara 11 Blackout Size 7,Default,0,0,0,0,0,15
,Saucony Women's Kinvara 11 Blackout Size 7.5,Saucony Women's Kinvara 11 Blackout Size 7.5,Default,0,0,0,0,0,15
,Saucony Women's Kinvara 11 Blackout Size 8,Saucony Women's Kinvara 11 Blackout Size 8,Default,0,0,0,0,0,23
,Saucony Women's Kinvara 11 Blackout Size 8.5,Saucony Women's Kinvara 11 Blackout Size 8.5,Default,0,0,0,0,0,1
,Saucony Women's Kinvara 11 Blackout Size 9,Saucony Women's Kinvara 11 Blackout Size 9,Default,0,0,0,0,0,20
,Saucony Women's Kinvara 11 Blackout Size 9.5,Saucony Women's Kinvara 11 Blackout Size 9.5,Default,0,0,0,0,0,20
,Saucony Women's Peregrine 10 Black Bar Size 6.5,Saucony Women's Peregrine 10 Black Bar Size 6.5,Default,0,0,0,0,0,20
,Saucony Women's Peregrine 10 Black Bar Size 6.5,Saucony Women's Peregrine 10 Black Bar Size 6.5,Default Ridgefield,1,1,0,0,0,0
,Saucony Women's Peregrine 10 Black Bar Size 8,Saucony Women's Peregrine 10 Black Bar Size 8,Default,0,0,0,0,0,15
,Saucony Women's Peregrine 10 Black Bar Size 8,Saucony Women's Peregrine 10 Black Bar Size 8,Default Ridgefield,3,3,0,0,0,0
,Saucony Women's Peregrine 10 Black Bar Size 8.5,Saucony Women's Peregrine 10 Black Bar Size 8.5,Default,0,0,0,0,0,1
,Saucony Women's Peregrine 10 Black Bar Size 8.5,Saucony Women's Peregrine 10 Black Bar Size 8.5,Default Ridgefield,1,1,0,0,0,0
,Saucony Women's Peregrine 10 Black Bar Size 9,Saucony Women's Peregrine 10 Black Bar Size 9,Default,0,0,0,0,0,20
,Saucony Women's Peregrine 10 Black Bar Size 9,Saucony Women's Peregrine 10 Black Bar Size 9,Default Ridgefield,2,2,0,0,0,0
,Saucony Women's S10595 Triumph 18 Charcoal/Sky US 10,Saucony Women's S10595 Triumph 18 Charcoal/Sky US 10,FBALYB Amazon,-6,-6,0,0,0,0
,Saucony Women's S10595 Triumph 18 Charcoal/Sky US 10.5,Saucony Women's S10595 Triumph 18 Charcoal/Sky US 10.5,FBALYB Amazon,-4,-4,0,0,0,0
,Saucony Women's S10595 Triumph 18 Charcoal/Sky US 7,Saucony Women's S10595 Triumph 18 Charcoal/Sky US 7,FBALYB Amazon,-4,-4,0,0,0,0
,Saucony Women's S10595 Triumph 18 Charcoal/Sky US 7.5,Saucony Women's S10595 Triumph 18 Charcoal/Sky US 7.5,FBALYB Amazon,-3,-3,0,0,0,0
,Saucony Women's S10595 Triumph 18 Charcoal/Sky US 8,Saucony Women's S10595 Triumph 18 Charcoal/Sky US 8,FBALYB Amazon,-4,-4,0,0,0,0
,Saucony Women's S10595 Triumph 18 Charcoal/Sky US 8.5,Saucony Women's S10595 Triumph 18 Charcoal/Sky US 8.5,FBALYB Amazon,-7,-7,0,0,0,0
,Saucony Women's S10595 Triumph 18 Charcoal/Sky US 9,Saucony Women's S10595 Triumph 18 Charcoal/Sky US 9,FBALYB Amazon,-8,-8,0,0,0,0
,Saucony Women's S10595 Triumph 18 Charcoal/Sky US 9.5,Saucony Women's S10595 Triumph 18 Charcoal/Sky US 9.5,Default,0,0,0,0,0,12
,Saucony Women's S10595 Triumph 18 Lilac/Copper US 10,Saucony Women's S10595 Triumph 18 Lilac/Copper US 10,FBALYB Amazon,17,17,0,0,0,0
,Saucony Women's S10595 Triumph 18 Lilac/Copper US 10.5,Saucony Women's S10595 Triumph 18 Lilac/Copper US 10.5,FBALYB Amazon,10,10,0,0,0,0
,Saucony Women's S10595 Triumph 18 Lilac/Copper US 11,Saucony Women's S10595 Triumph 18 Lilac/Copper US 11,FBALYB Amazon,6,5,1,0,1,0
,Saucony Women's S10595 Triumph 18 Lilac/Copper US 7,Saucony Women's S10595 Triumph 18 Lilac/Copper US 7,FBALYB Amazon,1,1,0,0,0,0
,Saucony Women's S10595 Triumph 18 Lilac/Copper US 7.5,Saucony Women's S10595 Triumph 18 Lilac/Copper US 7.5,FBALYB Amazon,-3,-3,0,0,0,0
,Saucony Women's S10595 Triumph 18 Lilac/Copper US 8,Saucony Women's S10595 Triumph 18 Lilac/Copper US 8,FBALYB Amazon,2,1,1,0,1,0
,Saucony Women's S10595 Triumph 18 Lilac/Copper US 8.5,Saucony Women's S10595 Triumph 18 Lilac/Copper US 8.5,FBALYB Amazon,-10,-10,0,0,0,0
,Saucony Women's S10595 Triumph 18 Lilac/Copper US 9,Saucony Women's S10595 Triumph 18 Lilac/Copper US 9,FBALYB Amazon,-4,-4,0,0,0,0
,Saucony Women's S10595 Triumph 18 Lilac/Copper US 9.5,Saucony Women's S10595 Triumph 18 Lilac/Copper US 9.5,FBALYB Amazon,-1,-1,0,0,0,0
,Saucony Women's S10615 Hurricane 23 Black/Rosewater US 10,Saucony Women's S10615 Hurricane 23 Black/Rosewater US 10,FBALYB Amazon,-2,-2,0,0,0,0
,Saucony Women's S10615 Hurricane 23 Black/Rosewater US 10.5,Saucony Women's S10615 Hurricane 23 Black/Rosewater US 10.5,FBALYB Amazon,4,3,1,0,1,0
,Saucony Women's S10615 Hurricane 23 Black/Rosewater US 11,Saucony Women's S10615 Hurricane 23 Black/Rosewater US 11,FBALYB Amazon,-4,-4,0,0,0,0
,Saucony Women's S10615 Hurricane 23 Black/Rosewater US 7,Saucony Women's S10615 Hurricane 23 Black/Rosewater US 7,FBALYB Amazon,-3,-4,1,0,1,0
,Saucony Women's S10615 Hurricane 23 Black/Rosewater US 7.5,Saucony Women's S10615 Hurricane 23 Black/Rosewater US 7.5,FBALYB Amazon,-5,-5,0,0,0,0
,Saucony Women's S10615 Hurricane 23 Black/Rosewater US 8,Saucony Women's S10615 Hurricane 23 Black/Rosewater US 8,FBALYB Amazon,-5,-5,0,0,0,0
,Saucony Women's S10615 Hurricane 23 Black/Rosewater US 8.5,Saucony Women's S10615 Hurricane 23 Black/Rosewater US 8.5,FBALYB Amazon,-2,-2,0,0,0,0
,Saucony Women's S10615 Hurricane 23 Black/Rosewater US 9,Saucony Women's S10615 Hurricane 23 Black/Rosewater US 9,FBALYB Amazon,3,3,0,0,0,0
,Saucony Women's S10615 Hurricane 23 Black/Rosewater US 9.5,Saucony Women's S10615 Hurricane 23 Black/Rosewater US 9.5,FBALYB Amazon,-3,-3,0,0,0,0
,Saucony Women's S10615 Hurricane 23 Zinc/Midnight US 10,Saucony Women's S10615 Hurricane 23 Zinc/Midnight US 10,FBALYB Amazon,11,11,0,0,0,0
,Saucony Women's S10615 Hurricane 23 Zinc/Midnight US 10.5,Saucony Women's S10615 Hurricane 23 Zinc/Midnight US 10.5,FBALYB Amazon,15,15,0,0,0,0
,Saucony Women's S10615 Hurricane 23 Zinc/Midnight US 11,Saucony Women's S10615 Hurricane 23 Zinc/Midnight US 11,FBALYB Amazon,5,4,1,0,1,0
,Saucony Women's S10615 Hurricane 23 Zinc/Midnight US 7,Saucony Women's S10615 Hurricane 23 Zinc/Midnight US 7,FBALYB Amazon,12,12,0,0,0,0
,Saucony Women's S10615 Hurricane 23 Zinc/Midnight US 7.5,Saucony Women's S10615 Hurricane 23 Zinc/Midnight US 7.5,FBALYB Amazon,-6,-6,0,0,0,0
,Saucony Women's S10615 Hurricane 23 Zinc/Midnight US 8,Saucony Women's S10615 Hurricane 23 Zinc/Midnight US 8,FBALYB Amazon,-3,-3,0,0,0,0
,Saucony Women's S10615 Hurricane 23 Zinc/Midnight US 8.5,Saucony Women's S10615 Hurricane 23 Zinc/Midnight US 8.5,FBALYB Amazon,-7,-7,0,0,0,0
,Saucony Women's S10615 Hurricane 23 Zinc/Midnight US 9,Saucony Women's S10615 Hurricane 23 Zinc/Midnight US 9,FBALYB Amazon,-8,-8,0,0,0,0
,Saucony Women's S10615 Hurricane 23 Zinc/Midnight US 9.5,Saucony Women's S10615 Hurricane 23 Zinc/Midnight US 9.5,FBALYB Amazon,-2,-2,0,0,0,0
,Saucony Women's S10619 Kinvara 12 Black/Silver US 10,Saucony Women's S10619 Kinvara 12 Black/Silver US 10,FBALYB Amazon,11,11,0,0,0,0
,Saucony Women's S10619 Kinvara 12 Black/Silver US 10.5,Saucony Women's S10619 Kinvara 12 Black/Silver US 10.5,FBALYB Amazon,20,20,0,0,0,0
,Saucony Women's S10619 Kinvara 12 Black/Silver US 11,Saucony Women's S10619 Kinvara 12 Black/Silver US 11,FBALYB Amazon,9,9,0,0,0,0
,Saucony Women's S10619 Kinvara 12 Black/Silver US 7,Saucony Women's S10619 Kinvara 12 Black/Silver US 7,FBALYB Amazon,-1,-1,0,0,0,0
,Saucony Women's S10619 Kinvara 12 Black/Silver US 7.5,Saucony Women's S10619 Kinvara 12 Black/Silver US 7.5,FBALYB Amazon,1,1,0,0,0,0
,Saucony Women's S10619 Kinvara 12 Black/Silver US 8,Saucony Women's S10619 Kinvara 12 Black/Silver US 8,FBALYB Amazon,-2,-2,0,0,0,0
,Saucony Women's S10619 Kinvara 12 Black/Silver US 8.5,Saucony Women's S10619 Kinvara 12 Black/Silver US 8.5,FBALYB Amazon,-9,-9,0,0,0,0
,Saucony Women's S10619 Kinvara 12 Black/Silver US 9,Saucony Women's S10619 Kinvara 12 Black/Silver US 9,FBALYB Amazon,-3,-4,1,0,1,0
,Saucony Women's S10619 Kinvara 12 Black/Silver US 9.5,Saucony Women's S10619 Kinvara 12 Black/Silver US 9.5,FBALYB Amazon,-3,-5,2,0,2,0
,Saucony Women's S10619 Kinvara 12 Sky/Storm US 10,Saucony Women's S10619 Kinvara 12 Sky/Storm US 10,FBALYB Amazon,16,16,0,0,0,0
,Saucony Women's S10619 Kinvara 12 Sky/Storm US 10.5,Saucony Women's S10619 Kinvara 12 Sky/Storm US 10.5,FBALYB Amazon,26,26,0,0,0,0
,Saucony Women's S10619 Kinvara 12 Sky/Storm US 11,Saucony Women's S10619 Kinvara 12 Sky/Storm US 11,FBALYB Amazon,12,12,0,0,0,0
,Saucony Women's S10619 Kinvara 12 Sky/Storm US 7,Saucony Women's S10619 Kinvara 12 Sky/Storm US 7,FBALYB Amazon,1,1,0,0,0,0
,Saucony Women's S10619 Kinvara 12 Sky/Storm US 7.5,Saucony Women's S10619 Kinvara 12 Sky/Storm US 7.5,FBALYB Amazon,-5,-5,0,0,0,0
,Saucony Women's S10619 Kinvara 12 Sky/Storm US 8,Saucony Women's S10619 Kinvara 12 Sky/Storm US 8,FBALYB Amazon,11,11,0,0,0,0
,Saucony Women's S10619 Kinvara 12 Sky/Storm US 8.5,Saucony Women's S10619 Kinvara 12 Sky/Storm US 8.5,FBALYB Amazon,18,18,0,0,0,0
,Saucony Women's S10619 Kinvara 12 Sky/Storm US 9,Saucony Women's S10619 Kinvara 12 Sky/Storm US 9,FBALYB Amazon,7,7,0,0,0,0
,Saucony Women's S10619 Kinvara 12 Sky/Storm US 9.5,Saucony Women's S10619 Kinvara 12 Sky/Storm US 9.5,FBALYB Amazon,-2,-2,0,0,0,0
,Saucony Women's S10641 Peregrine 11 ZINC/SKY/LOOM US 10,Saucony Women's S10641 Peregrine 11 ZINC/SKY/LOOM US 10,FBALYB Amazon,5,5,0,0,0,0
,Saucony Women's S10641 Peregrine 11 ZINC/SKY/LOOM US 10.5,Saucony Women's S10641 Peregrine 11 ZINC/SKY/LOOM US 10.5,FBALYB Amazon,-2,-2,0,0,0,0
,Saucony Women's S10641 Peregrine 11 ZINC/SKY/LOOM US 11,Saucony Women's S10641 Peregrine 11 ZINC/SKY/LOOM US 11,FBALYB Amazon,-6,-6,0,0,0,0
,Saucony Women's S10641 Peregrine 11 ZINC/SKY/LOOM US 7,Saucony Women's S10641 Peregrine 11 ZINC/SKY/LOOM US 7,FBALYB Amazon,-4,-4,0,0,0,0
,Saucony Women's S10641 Peregrine 11 ZINC/SKY/LOOM US 7.5,Saucony Women's S10641 Peregrine 11 ZINC/SKY/LOOM US 7.5,FBALYB Amazon,-11,-11,0,0,0,0
,Saucony Women's S10641 Peregrine 11 ZINC/SKY/LOOM US 8,Saucony Women's S10641 Peregrine 11 ZINC/SKY/LOOM US 8,FBALYB Amazon,-11,-11,0,0,0,0
,Saucony Women's S10641 Peregrine 11 ZINC/SKY/LOOM US 8.5,Saucony Women's S10641 Peregrine 11 ZINC/SKY/LOOM US 8.5,FBALYB Amazon,-10,-11,1,0,1,0
,Saucony Women's S10641 Peregrine 11 ZINC/SKY/LOOM US 9,Saucony Women's S10641 Peregrine 11 ZINC/SKY/LOOM US 9,FBALYB Amazon,-10,-10,0,0,0,0
,Saucony Women's S10641 Peregrine 11 ZINC/SKY/LOOM US 9.5,Saucony Women's S10641 Peregrine 11 ZINC/SKY/LOOM US 9.5,FBALYB Amazon,-12,-12,0,0,0,0
,Saucony Women's S10654 Guide 14 Alloy/Cherry US 10,Saucony Women's S10654 Guide 14 Alloy/Cherry US 10,FBALYB Amazon,6,6,0,0,0,0
,Saucony Women's S10654 Guide 14 Alloy/Cherry US 10.5,Saucony Women's S10654 Guide 14 Alloy/Cherry US 10.5,FBALYB Amazon,13,13,0,0,0,0
,Saucony Women's S10654 Guide 14 Alloy/Cherry US 11,Saucony Women's S10654 Guide 14 Alloy/Cherry US 11,FBALYB Amazon,2,2,0,0,0,0
,Saucony Women's S10654 Guide 14 Alloy/Cherry US 7,Saucony Women's S10654 Guide 14 Alloy/Cherry US 7,FBALYB Amazon,1,1,0,0,0,0
,Saucony Women's S10654 Guide 14 Alloy/Cherry US 7.5,Saucony Women's S10654 Guide 14 Alloy/Cherry US 7.5,FBALYB Amazon,3,3,0,0,0,0
,Saucony Women's S10654 Guide 14 Alloy/Cherry US 8,Saucony Women's S10654 Guide 14 Alloy/Cherry US 8,FBALYB Amazon,-4,-4,0,0,0,0
,Saucony Women's S10654 Guide 14 Alloy/Cherry US 8.5,Saucony Women's S10654 Guide 14 Alloy/Cherry US 8.5,FBALYB Amazon,-6,-6,0,0,0,0
,Saucony Women's S10654 Guide 14 Alloy/Cherry US 9,Saucony Women's S10654 Guide 14 Alloy/Cherry US 9,FBALYB Amazon,-3,-3,0,0,0,0
,Saucony Women's S10654 Guide 14 Alloy/Cherry US 9.5,Saucony Women's S10654 Guide 14 Alloy/Cherry US 9.5,FBALYB Amazon,5,5,0,0,0,0
,Saucony Women's S10654 Guide 14 Charcoal/Rose US 10,Saucony Women's S10654 Guide 14 Charcoal/Rose US 10,FBALYB Amazon,-10,-11,1,0,1,0
,Saucony Women's S10654 Guide 14 Charcoal/Rose US 10.5,Saucony Women's S10654 Guide 14 Charcoal/Rose US 10.5,FBALYB Amazon,-4,-4,0,0,0,0
,Saucony Women's S10654 Guide 14 Charcoal/Rose US 11,Saucony Women's S10654 Guide 14 Charcoal/Rose US 11,FBALYB Amazon,-3,-3,0,0,0,0
,Saucony Women's S10654 Guide 14 Charcoal/Rose US 7,Saucony Women's S10654 Guide 14 Charcoal/Rose US 7,FBALYB Amazon,-1,-1,0,0,0,0
,Saucony Women's S10654 Guide 14 Charcoal/Rose US 7.5,Saucony Women's S10654 Guide 14 Charcoal/Rose US 7.5,FBALYB Amazon,-7,-7,0,0,0,0
,Saucony Women's S10654 Guide 14 Charcoal/Rose US 8,Saucony Women's S10654 Guide 14 Charcoal/Rose US 8,FBALYB Amazon,-5,-6,1,0,1,0
,Saucony Women's S10654 Guide 14 Charcoal/Rose US 8.5,Saucony Women's S10654 Guide 14 Charcoal/Rose US 8.5,FBALYB Amazon,-7,-7,0,0,0,0
,Saucony Women's S10654 Guide 14 Charcoal/Rose US 9,Saucony Women's S10654 Guide 14 Charcoal/Rose US 9,FBALYB Amazon,-11,-11,0,0,0,0
,Saucony Women's S10654 Guide 14 Charcoal/Rose US 9.5,Saucony Women's S10654 Guide 14 Charcoal/Rose US 9.5,FBALYB Amazon,-4,-4,0,0,0,0
,Saucony Women's S10654 Guide 14 Lilac/Storm US 10.5,Saucony Women's S10654 Guide 14 Lilac/Storm US 10.5,FBALYB Amazon,10,10,0,0,0,0
,Saucony Women's S10654 Guide 14 Lilac/Storm US 11,Saucony Women's S10654 Guide 14 Lilac/Storm US 11,FBALYB Amazon,4,3,1,0,1,0
,Saucony Women's S10654 Guide 14 Lilac/Storm US 7,Saucony Women's S10654 Guide 14 Lilac/Storm US 7,FBALYB Amazon,-2,-2,0,0,0,0
,Saucony Women's S10654 Guide 14 Lilac/Storm US 7.5,Saucony Women's S10654 Guide 14 Lilac/Storm US 7.5,FBALYB Amazon,-3,-3,0,0,0,0
,Saucony Women's S10654 Guide 14 Lilac/Storm US 8,Saucony Women's S10654 Guide 14 Lilac/Storm US 8,FBALYB Amazon,-9,-9,0,0,0,0
,Saucony Women's S10654 Guide 14 Lilac/Storm US 8.5,Saucony Women's S10654 Guide 14 Lilac/Storm US 8.5,FBALYB Amazon,-3,-3,0,0,0,0
,Saucony Women's S10654 Guide 14 Lilac/Storm US 9,Saucony Women's S10654 Guide 14 Lilac/Storm US 9,FBALYB Amazon,-9,-9,0,0,0,0
,Saucony Women's Triumph ISO 5-S10462-1 Blue/Navy 11,Saucony Women's Triumph ISO 5-S10462-1 Blue/Navy 11,FBALYB Amazon,14,14,0,0,0,0
,Saucony Women's Triumph ISO 5-S10462-1 Blue/Navy 11.5,Saucony Women's Triumph ISO 5-S10462-1 Blue/Navy 11.5,FBALYB Amazon,10,10,0,0,0,0
,Saucony Women's Triumph ISO 5-S10462-1 Blue/Navy 5,Saucony Women's Triumph ISO 5-S10462-1 Blue/Navy 5,FBALYB Amazon,66,66,0,0,0,0
,Saucony Women's Triumph ISO 5-S10462-1 Blue/Navy 5.5,Saucony Women's Triumph ISO 5-S10462-1 Blue/Navy 5.5,FBALYB Amazon,105,105,0,0,0,0
,Saucony Women's Triumph ISO 5-S10462-1 Blue/Navy 6,Saucony Women's Triumph ISO 5-S10462-1 Blue/Navy 6,FBALYB Amazon,-7,-7,0,0,0,0
,Saucony Women's Triumph ISO 5-S10462-1 Blue/Navy 7,Saucony Women's Triumph ISO 5-S10462-1 Blue/Navy 7,FBALYB Amazon,-1,-1,0,0,0,0
,Saucony Women's Xodus Iso 3-S10449-35 Green/Aqua 10,Saucony Women's Xodus Iso 3-S10449-35 Green/Aqua 10,FBALYB Amazon,-2,-2,0,0,0,0
,Saucony Women's Xodus Iso 3-S10449-35 Green/Aqua 10.5,Saucony Women's Xodus Iso 3-S10449-35 Green/Aqua 10.5,FBALYB Amazon,-1,-1,0,0,0,0
,Saucony Women's Xodus Iso 3-S10449-35 Green/Aqua 11.5,Saucony Women's Xodus Iso 3-S10449-35 Green/Aqua 11.5,FBALYB Amazon,-1,-1,0,0,0,0
,Saucony Women's Xodus Iso 3-S10449-35 Green/Aqua 5,Saucony Women's Xodus Iso 3-S10449-35 Green/Aqua 5,FBALYB Amazon,2,2,0,0,0,0
,Saucony Women's Xodus Iso 3-S10449-35 Green/Aqua 5.5,Saucony Women's Xodus Iso 3-S10449-35 Green/Aqua 5.5,FBALYB Amazon,4,4,0,0,0,0
,Saucony Women's Xodus Iso 3-S10449-35 Green/Aqua 6,Saucony Women's Xodus Iso 3-S10449-35 Green/Aqua 6,FBALYB Amazon,5,5,0,0,0,0
,Saucony Women's Xodus Iso 3-S10449-35 Green/Aqua 6.5,Saucony Women's Xodus Iso 3-S10449-35 Green/Aqua 6.5,FBALYB Amazon,-1,-1,0,0,0,0
,Saucony Women's Xodus Iso 3-S10449-35 Green/Aqua 7,Saucony Women's Xodus Iso 3-S10449-35 Green/Aqua 7,FBALYB Amazon,-2,-2,0,0,0,0
,Saucony Women's Xodus Iso 3-S10449-35 Green/Aqua 7.5,Saucony Women's Xodus Iso 3-S10449-35 Green/Aqua 7.5,FBALYB Amazon,-6,-6,0,0,0,0
,Saucony Women's Xodus Iso 3-S10449-35 Green/Aqua 8,Saucony Women's Xodus Iso 3-S10449-35 Green/Aqua 8,FBALYB Amazon,-12,-12,0,0,0,0
,Saucony Women's Xodus Iso 3-S10449-35 Green/Aqua 8.5,Saucony Women's Xodus Iso 3-S10449-35 Green/Aqua 8.5,FBALYB Amazon,-7,-7,0,0,0,0
,Saucony Women's Xodus Iso 3-S10449-35 Green/Aqua 9,Saucony Women's Xodus Iso 3-S10449-35 Green/Aqua 9,FBALYB Amazon,-22,-22,0,0,0,0
,Saucony Women's Xodus Iso 3-S10449-35 Green/Aqua 9.5,Saucony Women's Xodus Iso 3-S10449-35 Green/Aqua 9.5,FBALYB Amazon,-5,-5,0,0,0,0
,Savor 13oz 6pk Bundle,Savor 13oz 6pk Bundle,FBALYB Amazon,1,1,0,0,0,0
,Savor 5.5oz 12pk Bundle,Savor 5.5oz 12pk Bundle,FBALYB Amazon,2,2,0,0,0,0
,Savoy Coconut Cream 400ml 6pk,Savoy Coconut Cream 400ml 6pk,FBALYB Amazon,-2,-2,0,0,0,0
,Sb 11 Oz caramel ground,"Starbucks Starbucks Caramel, Ground Coffee, 11 oz",FBALYB Amazon,0,-3,3,0,3,0
,Sb3821-d6,VIZIO SB3821-D6 SmartCast38 2.1 Sound Bar System (2016 Model),FBALYB Amazon,1,0,1,0,1,0
,Sb breakfast blend grand 12oz 3pk med,"Starbucks Breakfast Blend Coffee, Ground, 12-Ounce Bags (Pack of 3) (Package ...",FBALYB Amazon,3,3,0,0,0,0
,Sb cinnamon dolce 11 oz,"Starbucks Cinnamon Dolce, Ground Coffee, 11 oz",Joes Playground (Testing),10,10,0,0,0,0
,Sb Colombian ground coffee 12oz,"Starbucks Columbian Ground Coffee, 12 oz",FBALYB Amazon,4,4,0,0,0,0
,Sb decaf pike place ground 12 oz,"Starbucks Pike Place Roast Decaf, Ground Coffee, 12 oz",FBALYB Amazon,1,1,0,0,0,0
,Sb expresso whole bean 12 oz 2 pack,"(2 Pack) Starbucks Dark Espresso Roast Whole Bean Coffee, 12 oz",FBALYB Amazon,3,3,0,0,0,0
,Sb express roast gender drk 12 oz,"Starbucks Espresso Roast Coffee, Ground, 12-Ounce Bags",FBALYB Amazon,-2,-2,0,0,0,0
,Sb French roost whole bean 12 oz,Starbucks Whole Bean Coffee Dark French Roast,FBALYB Amazon,9,9,0,0,0,0
,Sb house blend gender 12 oz med 3 pak,"Starbucks House Blend Ground Coffee, 12 Ounce (Pack of 3)",FBALYB Amazon,10,10,0,0,0,0
,Sb Italian roast ground dark 12 Oz 3pk,"Starbucks Italian Roast Coffee (Extra Bold), Ground Coffee, 12 oz Bags, 3 pk",FBALYB Amazon,7,7,0,0,0,0
,Sb Italian roast whole bean 12 Oz,"Starbucks Italian Roast, Whole Bean Coffee, 12 oz",FBALYB Amazon,19,19,0,0,0,0
,Sb pike place ground 12 Oz,"STARBUCKS Medium Pike Place Roast Coffee, Ground, 12 oz",FBALYB Amazon,22,22,0,0,0,0
,Sb sinatra ground dark 12 Oz single orgn,Starbucks Ground Coffee Dark Sumatra Net Wt 12 oz(340g),FBALYB Amazon,1,0,1,0,1,0
,"SBUX Nespresso Variety Pack 50ct (Nespresso Blonde Roast, Verona, House Blend, Pike Place,  Colombia)","SBUX Nespresso Variety Pack 50ct (Nespresso Blonde Roast, Verona, House Blend, Pike Place,  Colombia)",FBALYB Amazon,2821,2561,260,3280,260,0
,"SBUX Nespresso Variety Pack 50ct (Nespresso Blonde Roast, Verona, House Blend, Pike Place,  Colombia)","SBUX Nespresso Variety Pack 50ct (Nespresso Blonde Roast, Verona, House Blend, Pike Place,  Colombia)",WFS,157,157,0,0,0,0
,"SBUX Nespresso Variety Pack 60ct | 2 Starbucks Nespresso Espresso Dark Roast 10 caps, 1 Starbucks Nespresso Blonde Roast Esprsso 10 caps, 1 Starbucks Nespresso SO Colombia 10 caps, 2 Starbucks Nespresso Pike Place Roast 10 caps","SBUX Nespresso Variety Pack 60ct | 2 Starbucks Nespresso Espresso Dark Roast 10 caps, 1 Starbucks Nespresso Blonde Roast Esprsso 10 caps, 1 Starbucks Nespresso SO Colombia 10 caps, 2 Starbucks Nespresso Pike Place Roast 10 caps",FBALYB Canada,3,3,0,108,0,0
,Sb veranda band whole bean 12 oz,"Starbucks Veranda, Whole Bean Coffee, 12 oz",FBALYB Amazon,27,27,0,0,0,0
,Scanpan - Classic 10.25'' Fry Pan (26 cm) - S26001200,Scanpan - Classic 10.25'' Fry Pan (26 cm) - S26001200,FBALYB Amazon,-1,-1,0,2,0,0
,Scanpan - Classic 12.5'' Fry Pan (32 cm) - S32001200,Scanpan - Classic 12.5'' Fry Pan (32 cm) - S32001200,FBALYB Amazon,0,-6,6,2,6,0
,SCANPAN CTX Series Chef Pan w/ Glass Lid 32cm S65113200,SCANPAN CTX Series Chef Pan w/ Glass Lid 32cm S65113200,FBALYB Amazon,1,-1,2,1,2,0
,SCHICK HYDRO 5 DISPOSABLE 3 CT,SCHICK HYDRO 5 DISPOSABLE 3 CT,WFS,-32,-32,0,0,0,0
,SCHICK HYDRO 5 DISPOSABLE 3pk,SCHICK HYDRO 5 DISPOSABLE 3pk,FBALYB Amazon,98,98,0,0,0,0
,Schick Intuition Cartridges + Razor 13 Ct,Schick Intuition Cartridges + Razor 13 Ct,Avrami - Ebay,150,150,0,0,0,0
,Schick Intuition Cartridges + Razor 13 Ct,Schick Intuition Cartridges + Razor 13 Ct,Default,0,0,0,0,0,84
,Schick Intuition Cartridges + Razor 13 Ct,Schick Intuition Cartridges + Razor 13 Ct,Default Ridgefield,1,1,0,0,0,0
,Schick Intuition Cartridges + Razor 13 Ct,Schick Intuition Cartridges + Razor 13 Ct,FBALYB Amazon,167,140,27,98,27,0
,Schick Razzor,Schick Razzor,Avrami - Ebay,150,150,0,0,0,0
,Schick Razzor,Schick Razzor,Default,0,-262,262,0,0,0
,Schick Razzor,Schick Razzor,FBALYB Amazon,-514,-514,0,511,0,0
,Schick Slim Twin ST2 12ct 2pk,Schick Slim Twin ST2 12ct 2pk,FBALYB Amazon,-1,-1,0,0,0,0
,SCHICK XTREME3 DISPOSABLE RAZORS 20,SCHICK XTREME3 DISPOSABLE RAZORS 20,Avrami - Ebay,10,10,0,0,0,0
,SCHICK XTREME3 DISPOSABLE RAZORS 20,SCHICK XTREME3 DISPOSABLE RAZORS 20,FBALYB Amazon,344,344,0,0,0,0
,SCHICK XTREME3 DISPOSABLE RAZORS 20,SCHICK XTREME3 DISPOSABLE RAZORS 20,WFS,-39,-39,0,0,0,0
,Schick Xtreme 3 Sensitive 24 Ct Razors,Schick Xtreme 3 Sensitive 24 Ct Razors,Default Ridgefield,2,2,0,0,0,0
,Schick Xtreme 3 Sensitive 24 Ct Razors,Schick Xtreme 3 Sensitive 24 Ct Razors,FBALYB Amazon,1826,1793,33,0,33,0
,Schiff Digestive Probiotic,Schiff Digestive Advtg Probiotic Gummies 120 Count,FBALYB Amazon,16,15,1,1,1,0
,Schiff Digestive Probiotic 2pk,Schiff Digestive Probiotic 2pk,FBALYB Amazon,-1,-1,0,0,0,0
,Schiff Mega Red Krill Oil 80ct,Schiff Mega Red Krill Oil 80ct,FBALYB Amazon,2,2,0,0,0,0
,Schiff Move Free Ultra 75 2pk,Schiff Move Free Ultra 75 2pk,FBALYB Amazon,-196,-197,1,146,1,0
,Schiff Move Free Ultra 75ct,Schiff Move Free Ultra 75ct,Default,0,-3080,3080,0,0,0
,Schiff Move Free Ultra 75ct,Schiff Move Free Ultra 75ct,FBALYB Amazon,101,100,1,3,1,0
,Schmidts Charcoal Deodorant 3 PK,Schmidts Charcoal Deodorant 3 PK ,FBALYB Amazon,-231,-231,0,129,0,0
,Schmidts Chrc Mg Deodornt 3.25oz 2 pack,Schmidts Chrc Mg Deodornt 3.25oz 2 pack,FBALYB Amazon,162,131,31,0,31,0
,Schmidts Chrc Mg Deodornt 3.25oz 3 PACK,Schmidts Chrc Mg Deodornt 3.25oz 3 PACK,FBALYB Amazon,358,355,3,0,3,0
,Schmidt's Ddrnt Brgmt Lme 3.25oz 2 pack,Schmidt's Ddrnt Brgmt Lme 3.25oz 2 pack,FBALYB Amazon,109,102,7,0,7,0
,Schmidt's Ddrnt Brgmt Lme 3.25oz 3 pack,Schmidt's Ddrnt Brgmt Lme 3.25oz 3 pack,FBALYB Amazon,12,9,3,0,3,0
,Schmidt's Ddrnt Coc Pnpl 3.25oz 3 PACK,Schmidt's Ddrnt Coc Pnpl 3.25oz 3 PACK,FBALYB Amazon,267,261,6,0,6,0
,Schmidts Ddrnt Jasmn Tea 3.25 oz 2pack,Schmidts Ddrnt Jasmn Tea 3.25 oz 2pack,FBALYB Amazon,103,102,1,0,1,0
,Schmidts Ddrnt Jasmn Tea 3.25 oz 3pack,Schmidts Ddrnt Jasmn Tea 3.25 oz 3pack,FBALYB Amazon,549,548,1,0,1,0
,Schmidt's Ddrnt Lav Sage 3.25oz 2pack,Schmidt's Ddrnt Lav Sage 3.25oz 2pack,FBALYB Amazon,108,104,4,0,4,0
,Schmidts Deodorant 3.25 (3 Pack),Schmidts Deodorant 3.25 (3 Pack),FBALYB Amazon,99,99,0,0,0,0
,Schmidt's Deodorant 3.25oz 3ct,Schmidt's Deodorant 3.25oz 3ct,Default,0,0,0,0,0,2
,Schmidt's Deodorant Charcoal/Mag 3.25oz,Schmidt's Deodorant Charcoal/Mag 3.25oz,Default Ridgefield,16,16,0,0,0,0
,Schmidts Natural Deodorant Rose- Vanilla 3 Pack,Schmidts Natural Deodorant Rose- Vanilla 3 Pack,FBALYB Amazon,-1,-1,0,0,0,0
,"Schmidt's Wondermint Toothpaste, 4.7 Oz","Schmidt's Wondermint Toothpaste, 4.7 Oz",Default Ridgefield,6,6,0,0,0,0
,Schwarzkopf BC Hyaluronic Moisture Kick Spray Conditioner 200ml,Schwarzkopf BC Hyaluronic Moisture Kick Spray Conditioner 200ml,FBALYB Amazon,2,2,0,0,0,0
,Schwarzkopf BC Hyaluronic Moisture Kick Spray Conditioner 400ml,Schwarzkopf BC Hyaluronic Moisture Kick Spray Conditioner 400ml,FBALYB Amazon,50,50,0,0,0,0
,"""Schwarzkopf Blondme Bond Enforcing Premium Lightener 9+ 15.9oz + Schwarzkopf BM Premium Oil Developer 6% 1L  ""","""Schwarzkopf Blondme Bond Enforcing Premium Lightener 9+ 15.9oz + Schwarzkopf BM Premium Oil Developer 6% 1L  """,FBALYB Amazon,1,1,0,0,0,0
,Schwarzkopf BM Premium Oil Developer 3% 1L,Schwarzkopf BM Premium Oil Developer 3% 1L,FBALYB Amazon,11,11,0,3,0,0
,Schwarzkopf BM Premium Oil Developer 6% 1L,Schwarzkopf BM Premium Oil Developer 6% 1L,FBALYB Amazon,-3,-3,0,0,0,0
,Schwarzkopf BM Premium Oil Developer 9% 1L,Schwarzkopf BM Premium Oil Developer 9% 1L,FBALYB Amazon,6,6,0,158,0,0
,Schwarzkopf Bonacure Repair Rescue Sealed Ends 5.1 Oz,Schwarzkopf Bonacure Repair Rescue Sealed Ends 5.1 Oz ,FBALYB Amazon,-10,-10,0,0,0,0
,Schwarzkopf Bonacure Repair Rescue Sealed Ends 5.1 Oz 2pk,Schwarzkopf Bonacure Repair Rescue Sealed Ends 5.1 Oz 2pk,FBALYB Amazon,-8,-8,0,0,0,0
,Schwarzkopf Bonavista 1000ml,Schwarzkopf Bonavista 1000ml,Default Ridgefield,12,12,0,0,0,0
,Schwarzkopf Goodbye Yellow Shampoo 300ml,Schwarzkopf Goodbye Yellow Shampoo 300ml ,FBALYB Amazon,-1,-1,0,3,0,0
,"Schwarzkopf Igora Expert Mousse 9,5-1 100 ml","Schwarzkopf Igora Expert Mousse 9,5-1 100 ml ",Default Ridgefield,60,60,0,0,0,0
,Schwarzkopf Igora Royal Oil Developer 6% 1L,Schwarzkopf Igora Royal Oil Developer 6% 1L ,FBALYB Amazon,2,2,0,11,0,0
,Schwarzkopf IG Vario Blond Lightener,Schwarzkopf IG Vario Blond Lightener,FBALYB Amazon,4,1,3,2,3,0
,Schwarzkopf IG Vario Blond Powder Lightener SUPER PLUS 450g,Schwarzkopf IG Vario Blond Powder Lightener SUPER PLUS 450g ,FBALYB Amazon,8,8,0,2,0,0
,Schwarzkopf OSiS+ Dust It Mattifying Powder 10g 2pk,Schwarzkopf OSiS+ Dust It Mattifying Powder 10g 2pk,FBALYB Amazon,-5,-5,0,3,0,0
,Schwarzkopf OSiS+ Dust It Mattifying Powder 10g 3pk,Schwarzkopf OSiS+ Dust It Mattifying Powder 10g 3pk,FBALYB Amazon,-11,-11,0,6,0,0
,Schwarzkopf Osis+ Finish Elastic 500 ML,Schwarzkopf Osis+ Finish Elastic 500 ML,FBALYB Amazon,1,1,0,0,0,0
,Schwarzkopf OSiS+ Freeze Strong Hold Hairspray #2 Medium Control 500ml 16.9 oz,Schwarzkopf OSiS+ Freeze Strong Hold Hairspray #2 Medium Control 500ml 16.9 oz,Default Ridgefield,376,376,0,0,0,0
,Schwarzkopf OSiS+ Freeze Strong Hold Hairspray #2 Medium Control 500ml 16.9 oz,Schwarzkopf OSiS+ Freeze Strong Hold Hairspray #2 Medium Control 500ml 16.9 oz,WFS,-19,-19,0,0,0,0
,Schwarzkopf OSiS+ Freeze Strong Hold Hairspray #2 Medium Control 500ml 16.9 oz 2pk,Schwarzkopf OSiS+ Freeze Strong Hold Hairspray #2 Medium Control 500ml 16.9 oz 2pk,FBALYB Amazon,225,220,5,0,5,0
,Schwarzkopf Osis Magic anti-frizz Serum 50ml,Schwarzkopf Osis Magic anti-frizz Serum 50ml,FBALYB Amazon,4,4,0,0,0,0
,Schwarzkopf Osis+ Mess Up Matt Gum (Medium Control) 100ml,Schwarzkopf Osis+ Mess Up Matt Gum (Medium Control) 100ml,FBALYB Amazon,-2,-2,0,0,0,0
,Schwarzkopf Osis+ Mess Up Matt Gum (Medium Control) 100ml 2pk,Schwarzkopf Osis+ Mess Up Matt Gum (Medium Control) 100ml 2pk,FBALYB Amazon,-1,-2,1,0,1,0
,"Schwarzkopf OSiS+ MIGHTY MATTE Ultra Strong Matte Cream, 2.8-Ounce","Schwarzkopf OSiS+ MIGHTY MATTE Ultra Strong Matte Cream, 2.8-Ounce",Default Ridgefield,108,108,0,0,0,0
,Schwarzkopf Osis+ Style Style Grip Extreme 6.8oz Mousse 3pk,Schwarzkopf Osis+ Style Style Grip Extreme 6.8oz Mousse 3pk,FBALYB Amazon,0,0,0,1,0,0
,Schwarzkopf OSiS+ Thrill Fiber Gum Strong Control 100ml 2pk,Schwarzkopf OSiS+ Thrill Fiber Gum Strong Control 100ml 2pk,FBALYB Amazon,62,62,0,0,0,0
,Schwarzkopf OSiS+ Thrill Fiber Gum Strong Control 100ml 3pk,Schwarzkopf OSiS+ Thrill Fiber Gum Strong Control 100ml 3pk,FBALYB Amazon,1,1,0,0,0,0
,Schwarzkopf Osis+ Volume Up Spray 250ml,Schwarzkopf Osis+ Volume Up Spray 250ml,FBALYB Amazon,0,-2,2,0,2,0
,Schwarzkopf Ph 4.5 Silver Color Freeze Micellar Shampoo 250 ml,Schwarzkopf Ph 4.5 Silver Color Freeze Micellar Shampoo 250 ml ,Default Ridgefield,25,25,0,0,0,0
,Schwarzkopf Ph 4.5 Silver Color Freeze Micellar Shampoo 250 ml,Schwarzkopf Ph 4.5 Silver Color Freeze Micellar Shampoo 250 ml ,FBALYB Amazon,274,274,0,0,0,0
,Schwarzkopf SILH Hairspray flex h 1000ml INT,Schwarzkopf SILH Hairspr flex h 1000ml INT,Default Ridgefield,672,672,0,0,0,0
,Schwarzkopf SILH Hairspr flex h 500ml INT,Schwarzkopf SILH Hairspr flex h 500ml INT,Default Oxford,1,1,0,0,0,0
,Schwarzkopf SILH Hairspr flex h 500ml INT,Schwarzkopf SILH Hairspr flex h 500ml INT,Default Ridgefield,622,622,0,0,0,0
,Schwarzkopf SILH Hairspr flex h 500ml INT,Schwarzkopf SILH Hairspr flex h 500ml INT,FBALYB Amazon,301,287,14,0,14,0
,Schwarzkopf Silhouette Super Hold 750ml,Schwarzkopf Silhouette Super Hold 750ml,FBALYB Amazon,2,2,0,0,0,0
,SC Johnson Cotton Q Tip 625 Ct,SC Johnson Cotton Q Tip 625 Ct,Default,0,-2,2,0,0,0
,SC Johnson Cotton Q Tip 625 Ct,SC Johnson Cotton Q Tip 625 Ct,Default Ridgefield,214,-678,892,0,0,0
,SC Johnson Cotton Q Tip 625 Ct,SC Johnson Cotton Q Tip 625 Ct,FBALYB Amazon,-693,-693,0,889,0,0
,SC Johnson Cotton Q Tip 625 Ct 2pk,SC Johnson Cotton Q Tip 625 Ct 2pk,Default,0,-506,506,0,0,0
,SC Johnson Cotton Q Tip 625 Ct 2pk,SC Johnson Cotton Q Tip 625 Ct 2pk,Default Ridgefield,24,12,12,0,0,0
,SC Johnson Cotton Q Tip 625 Ct 2pk,SC Johnson Cotton Q Tip 625 Ct 2pk,FBALYB Amazon,-64,-78,14,74,2,0
,SC Johnson Cotton Q Tip 625 Ct 3pk,SC Johnson Cotton Q Tip 625 Ct 3pk,Default,0,-2,2,0,0,0
,SC Johnson Cotton Q Tip 625 Ct 3pk,SC Johnson Cotton Q Tip 625 Ct 3pk,Default Ridgefield,8,0,8,0,0,0
,SC Johnson Cotton Q Tip 625 Ct 3pk,SC Johnson Cotton Q Tip 625 Ct 3pk,FBALYB Amazon,-3,-4,1,0,1,0
,SC Johnson Cotton Q Tip 625 Ct 4pk,SC Johnson Cotton Q Tip 625 Ct 4pk,Default,0,-5,5,0,0,0
,SC Johnson Cotton Q Tip 625 Ct 4pk,SC Johnson Cotton Q Tip 625 Ct 4pk,FBALYB Amazon,-44,-44,0,42,0,0
,Scotch Brite Sponges 21ct,Scotch Brite Sponges 21ct,Default,0,0,0,0,0,46
,Scotch Brite Sponges 21ct,Scotch Brite Sponges 21ct,FBALYB Amazon,-17,-17,0,16,0,0
,Scotch Masking Tape 2 pack,Scotch Masking Tape 2 pack,FBALYB Amazon,-2,-3,1,0,1,0
,Scotch Masking Tape 3 pack,Scotch Masking Tape 3 pack,FBALYB Amazon,-2,-2,0,8,0,0
,Scotch Tape 6pk w/ Dispenser Pack of 2,Scotch Tape 6pk w/ Dispenser Pack of 2,FBALYB Amazon,-4,-4,0,3,0,0
,Scott Pet Pork Chomps Bacon Twists,Scott Pet Premium Pork Chomps Bacon Twists,Default,0,0,0,0,0,2
,"Scott Rags in a Box, 300 ct.","Scott Rags in a Box, 300 ct.",Default,0,0,0,0,0,48
,Scott Shop Towels 55 ct.,Scott Shop Towels 55 ct.,FBALYB Amazon,95,95,0,0,0,0
,Scrubbing Bubbles 2pk total 48+8,,FBALYB Amazon,-165,-170,5,0,5,0
,Scrubbing Bubbles 2pk total 48+8,,FBALYB Canada,-14,-14,0,0,0,0
,Scrubbing Bubbles Toilet Cleaning Gel - Value Pack,Scrubbing Bubbles Toilet Cleaning Gel - Value Pack,Default Ridgefield,426,426,0,0,0,0
,Scrubbing Bubbles Toilet Cleaning Gel - Value Pack,Scrubbing Bubbles Toilet Cleaning Gel - Value Pack,FBALYB Amazon,1302,1302,0,29,0,0
,Scrubbing Bubbles Toilet Gel 1 pc (half value pack),Scrubbing Bubbles Toilet Gel 1 pc (half value pack),Avrami - Ebay,1524,1524,0,0,0,0
,Scrubbing Bubbles Toilet Gel 1 pc (half value pack),Scrubbing Bubbles Toilet Gel 1 pc (half value pack),Default Ridgefield,540,540,0,0,0,0
,Scrubbing Bubbles Toilet Gel 1 pc (half value pack),Scrubbing Bubbles Toilet Gel 1 pc (half value pack),FBALYB Amazon,1136,1129,7,109,7,0
,Scrubbing Bubbles Toilet Gel 1 pc (half value pack),Scrubbing Bubbles Toilet Gel 1 pc (half value pack),WFS,786,786,0,0,0,0
,Scrubbing Bubbles Toilet Gel Value Pack 24 Gel Stamps 2 Refills 1 Dispenser,Scrubbing Bubbles Toilet Gel Value Pack 24 Gel Stamps 2 Refills 1 Dispenser,FBALYB Amazon,320,320,0,0,0,0
,Scunci No Damage satin smooth,Scunci No Damage satin smooth,Default,0,-115246,115246,0,0,0
,Scunci No-Slip Grip Jaw Clips 2ct,Scunci No-Slip Grip Jaw Clips 2ct,Default Ridgefield,56,56,0,0,0,0
,"Seachem Flourish Excel, 2 L","Seachem Flourish Excel, 2 L / 67.6 fl. oz.",FBALYB Amazon,20,20,0,0,0,0
,Seachem Flourish Excel 500ml 4pk,Seachem Flourish Excel 500ml 4pk,FBALYB Amazon,4,4,0,0,0,0
,Seachem Kanaplex ‑ 5 G,Seachem Kanaplex ‑ 5 G,FBALYB Amazon,-1,-1,0,0,0,0
,Seachem PhosGuard 2oz 2pk,Seachem PhosGuard 2oz 2pk,FBALYB Amazon,0,-1,1,0,1,0
,Seachem Pristine 500ml/17oz 2pk,Seachem Pristine 500ml/17oz 2pk,FBALYB Amazon,2,2,0,0,0,0
,Seachem Purigen 2oz 2pk,Seachem Purigen 2oz 2pk,FBALYB Amazon,1,1,0,0,0,0
,Seachem Treatment 250 ml,Seachem Pristine Aquarium Treatment 250 ml SEA1241,Default,0,0,0,0,0,27
,Seachem Treatment 250 ml,Seachem Pristine Aquarium Treatment 250 ml SEA1241,FBALYB Amazon,5,5,0,2,0,0
,Seagate Backup Plus Hub,Seagate Backup Plus Hub 8TB,Default,0,0,0,0,0,1
,Season Sardines 10 ct./4 oz.,"Season Brand Imported Sardines in Pure Olive Oil, 10 ct./4 oz.",FBALYB Amazon,1,1,0,0,0,0
,Seattle best breakfast blend 16 ct,Seattle's Best Coffee Breakfast Blend K-cup 16 Packs,FBALYB Amazon,6,6,0,0,0,0
,Sea Wee - Baby - Navy SAW-2007B01 Size: 01 US,Sea Wee - Baby - Navy SAW-2007B01 Size: 01 US,FBALYB Amazon,11,11,0,0,0,0
,Sea Wee - Baby - Navy SAW-2007B02 Size: 02 US,Sea Wee - Baby - Navy SAW-2007B02 Size: 02 US,FBALYB Amazon,40,40,0,0,0,0
,Sea Wee - Baby - Navy SAW-2007B03 Size: 03 US,Sea Wee - Baby - Navy SAW-2007B03 Size: 03 US,FBALYB Amazon,75,75,0,0,0,0
,Sea Wee - Baby - Navy SAW-2007B04 Size: 04 US,Sea Wee - Baby - Navy SAW-2007B04 Size: 04 US,FBALYB Amazon,14,14,0,0,0,0
,Sea Wee - Baby - Tan SAW-2005B00 Size: 00 US,Sea Wee - Baby - Tan SAW-2005B00 Size: 00 US,FBALYB Amazon,-1,-1,0,0,0,0
,Sea Wee - Baby - Tan SAW-2005B01 Size: 01 US,Sea Wee - Baby - Tan SAW-2005B01 Size: 01 US,Default Ridgefield,48,48,0,0,0,0
,Sea Wee - Baby - Tan SAW-2005B01 Size: 01 US,Sea Wee - Baby - Tan SAW-2005B01 Size: 01 US,FBALYB Amazon,-4,-4,0,0,0,0
,Sea Wee - Baby - Tan SAW-2005B02 Size: 02 US,Sea Wee - Baby - Tan SAW-2005B02 Size: 02 US,Default Ridgefield,144,144,0,0,0,0
,Sea Wee - Baby - Tan SAW-2005B02 Size: 02 US,Sea Wee - Baby - Tan SAW-2005B02 Size: 02 US,FBALYB Amazon,7,7,0,1,0,0
,Sea Wee - Baby - Tan SAW-2005B03 Size: 03 US,Sea Wee - Baby - Tan SAW-2005B03 Size: 03 US,FBALYB Amazon,-20,-21,1,0,1,0
,Sea Wee - Baby - Tan SAW-2005B04 Size: 04 US,Sea Wee - Baby - Tan SAW-2005B04 Size: 04 US,FBALYB Amazon,143,143,0,0,0,0
,Sea Wee - Baby - White SAW-2003B00 Size: 00 US,Sea Wee - Baby - White SAW-2003B00 Size: 00 US,Default Ridgefield,36,36,0,0,0,0
,Sea Wee - Baby - White SAW-2003B00 Size: 00 US,Sea Wee - Baby - White SAW-2003B00 Size: 00 US,FBALYB Amazon,8,8,0,0,0,0
,Sea Wee - Baby - White SAW-2003B01 Size: 01 US,Sea Wee - Baby - White SAW-2003B01 Size: 01 US,Default Ridgefield,101,101,0,0,0,0
,Sea Wee - Baby - White SAW-2003B01 Size: 01 US,Sea Wee - Baby - White SAW-2003B01 Size: 01 US,FBALYB Amazon,21,21,0,0,0,0
,Sea Wee - Baby - White SAW-2003B02 Size: 02 US,Sea Wee - Baby - White SAW-2003B02 Size: 02 US,Default Ridgefield,223,223,0,0,0,0
,Sea Wee - Baby - White SAW-2003B02 Size: 02 US,Sea Wee - Baby - White SAW-2003B02 Size: 02 US,FBALYB Amazon,45,45,0,0,0,0
,Sea Wee - Baby - White SAW-2003B03 Size: 03 US,Sea Wee - Baby - White SAW-2003B03 Size: 03 US,Default Ridgefield,150,150,0,0,0,0
,Sea Wee - Baby - White SAW-2003B03 Size: 03 US,Sea Wee - Baby - White SAW-2003B03 Size: 03 US,FBALYB Amazon,170,170,0,0,0,0
,Sea Wee - Baby - White SAW-2003B04 Size: 04 US,Sea Wee - Baby - White SAW-2003B04 Size: 04 US,FBALYB Amazon,62,61,1,0,1,0
,Seeds of Change 8.5 Oz (Pack of 6),"Seeds of Change Quinoa and Brown Rice with garlic , 8.5 Ounce (Pack of 6)",FBALYB Amazon,200,200,0,0,0,0
,Seeds of change organic,Seeds Of Change Organic Chia & Kale Rice 6/8.5 oz (3.188 LBS),FBALYB Amazon,2,2,0,0,0,0
,Senseo Classic -  48 Count,Senseo Classic -  48 Count,Default Ridgefield,25,25,0,0,0,0
,Senseo Classic -  48 Count,Senseo Classic -  48 Count,FBALYB Amazon,98,98,0,0,0,0
,Senseo Classic -  48 Count,Senseo Classic -  48 Count,FBALYB Canada,0,0,0,13,0,0
,Senseo Classic - 48 Count 2pk,Senseo Classic - 48 Count 2pk,FBALYB Amazon,953,916,37,52,37,0
,Senseo Classic - 48 Count 2pk,Senseo Classic - 48 Count 2pk,FBALYB Canada,0,0,0,25,0,0
,Senseo Classic - 48 Count 3pk,Senseo Classic - 48 Count 3pk,FBALYB Amazon,1140,1043,97,54,97,0
,Senseo Classic 48 Ct,Senseo Classic 48 Ct,Avrami - Ebay,49,49,0,0,0,0
,Senseo Classic 48 Ct,Senseo Classic 48 Ct,FBALYB Amazon,465,435,30,82,30,0
,Senseo Classic 48 Ct,Senseo Classic 48 Ct,WFS,1120,1120,0,0,0,0
,Senseo Classic 48 Ct 10PK,Senseo Classic 48 Ct 10PK,FBALYB Amazon,216,216,0,0,0,0
,Senseo Decaf -  48 Count,Senseo Decaf -  48 Count,Avrami - Ebay,3,3,0,0,0,0
,Senseo Decaf -  48 Count,Senseo Decaf -  48 Count,Default,0,-46,46,0,0,0
,Senseo Decaf -  48 Count,Senseo Decaf -  48 Count,Default Ridgefield,53,53,0,0,0,0
,Senseo Decaf -  48 Count,Senseo Decaf -  48 Count,FBALYB Amazon,216,202,14,15,14,0
,Senseo Decaf -  48 Count,Senseo Decaf -  48 Count,WFS,631,631,0,0,0,0
,Senseo Decaf - 48 Count 2pk,Senseo Decaf - 48 Count 2pk,FBALYB Amazon,241,240,1,1,1,0
,Senseo Decaf - 48 Count 3pk,Senseo Decaf - 48 Count 3pk,Default Ridgefield,16,16,0,0,0,0
,Senseo Decaf - 48 Count 3pk,Senseo Decaf - 48 Count 3pk,FBALYB Amazon,511,486,25,6,25,0
,Senseo Espresso -  48 Count,Senseo Espresso -  48 Count,Default Ridgefield,3989,3125,864,0,0,0
,Senseo Espresso -  48 Count,Senseo Espresso -  48 Count,FBALYB Amazon,396,396,0,0,0,0
,Senseo Espresso - 48 Count 3pk,Senseo Espresso - 48 Count 3pk,FBALYB Amazon,732,685,47,0,47,0
,Senseo Espresso 48 ct 2pk,Senseo Espresso 48 ct 2pk,Default Ridgefield,4,4,0,0,0,0
,Senseo Espresso 48 ct 2pk,Senseo Espresso 48 ct 2pk,FBALYB Amazon,226,224,2,0,2,0
,Senseo Extra Strong -  48 Count,Senseo Extra Strong -  48 Count,Avrami - Ebay,6,6,0,0,0,0
,Senseo Extra Strong -  48 Count,Senseo Extra Strong -  48 Count,Default,0,-847,847,0,0,0
,Senseo Extra Strong -  48 Count,Senseo Extra Strong -  48 Count,Default Ridgefield,1457,1457,0,0,0,0
,Senseo Extra Strong -  48 Count,Senseo Extra Strong -  48 Count,FBALYB Amazon,653,627,26,120,26,0
,Senseo Extra Strong -  48 Count,Senseo Extra Strong -  48 Count,WFS,579,579,0,0,0,0
,Senseo Extra Strong - 48 Count 10pk,Senseo Extra Strong - 48 Count 10pk,FBALYB Amazon,65,65,0,0,0,0
,Senseo Extra Strong - 48 Count 3pk,Senseo Extra Strong - 48 Count 3pk,FBALYB Amazon,537,536,1,26,1,0
,Senseo Extra Strong Coffee 2pk,Senseo Extra Strong Coffee 2pk,Default,0,-4,4,0,0,0
,Senseo Extra Strong Coffee 2pk,Senseo Extra Strong Coffee 2pk,FBALYB Amazon,1348,1324,24,34,24,0
,Senseo Mild- 48 Count 2pk,Senseo Mild- 48 Count 2pk,FBALYB Amazon,184,184,0,3,0,0
,Senseo Mocca -  48 Count,Senseo Mocca -  48 Count,Avrami - Ebay,2,2,0,0,0,0
,Senseo Mocca -  48 Count,Senseo Mocca -  48 Count,Default Ridgefield,1398,1398,0,0,0,0
,Senseo Mocca -  48 Count,Senseo Mocca -  48 Count,FBALYB Amazon,640,640,0,3,0,0
,Senseo Mocca -  48 Count,Senseo Mocca -  48 Count,WFS,675,675,0,0,0,0
,Senseo Mocca - 48 Count 10pk,Senseo Mocca - 48 Count 10pk,FBALYB Amazon,100,100,0,0,0,0
,Senseo Mocca 48 ct 3pk,Senseo Mocca 48 ct 3pk,FBALYB Amazon,132,132,0,0,0,0
,Senseo Original XL HD7810/65 II Black,Senseo Original XL HD7810/65 II Black,FBALYB Amazon,1,1,0,0,0,0
,Senseo Strong -  48 Count,Senseo Strong -  48 Count,Default,0,-3750,3750,0,0,0
,Senseo Strong -  48 Count,Senseo Strong -  48 Count,Default Ridgefield,1826,1826,0,0,0,0
,Senseo Strong -  48 Count,Senseo Strong -  48 Count,FBALYB Amazon,637,634,3,151,3,0
,Senseo Strong -  48 Count,Senseo Strong -  48 Count,FBALYB Canada,0,0,0,50,0,0
,Senseo Strong - 48 Count 10PK,Senseo Strong - 48 Count 10PK,FBALYB Amazon,118,116,2,0,2,0
,Senseo Strong - 48 Count 2PK,Senseo Strong - 48 Count 2PK,FBALYB Amazon,284,284,0,7,0,0
,Senseo Strong - 48 Count 3pk,Senseo Strong - 48 Count 3pk,Default,0,-18,18,0,0,0
,Senseo Strong - 48 Count 3pk,Senseo Strong - 48 Count 3pk,FBALYB Amazon,2038,1998,40,897,40,0
,Senseo Strong - 48 Count 3pk,Senseo Strong - 48 Count 3pk,FBALYB Canada,1,1,0,0,0,0
,Sensodyne Daily Repair & Protect Whitening Toothpaste 75ml,Sensodyne Daily Repair & Protect Whitening Toothpaste 75ml,Default CT,40,40,0,0,0,0
,Sensodyne Daily Repair & Protect Whitening Toothpaste 75ml,Sensodyne Daily Repair & Protect Whitening Toothpaste 75ml,FBALYB Amazon,-13,-14,1,90,1,0
,Sensodyne Daily Repair & Protect Whitening Toothpaste 75ml 4PK,Sensodyne Daily Repair & Protect Whitening Toothpaste 75ml 4PK,FBALYB Amazon,-2,-4,2,0,2,0
,Sensodyne Daily Repair & Protect Whitening Toothpaste 75ml 6pk,Sensodyne Daily Repair & Protect Whitening Toothpaste 75ml 6pk,FBALYB Amazon,0,0,0,2,0,0
,Sensodyne Daily Repair & Protect Whitening Toothpaste 75ml Extra Fresh,Sensodyne Daily Repair & Protect Whitening Toothpaste 75ml Extra Fresh,Default CT,4,4,0,0,0,0
,Sensodyne Daily Repair & Protect Whitening Toothpaste 75ml Extra Fresh,Sensodyne Daily Repair & Protect Whitening Toothpaste 75ml Extra Fresh,FBALYB Amazon,-96,-96,0,0,0,0
,Sensodyne Daily Repair & Protect Whitening Toothpaste 75ml Extra Fresh 6pk,Sensodyne Daily Repair & Protect Toothpaste 75ml Extra Fresh 6pk,FBALYB Amazon,-10,-12,2,0,2,0
,SENTRY Calming Collar Dog 3ct,SENTRY Calming Collar Dog 3ct,FBALYB Amazon,1,0,1,0,1,0
,SENTRY DeWormer Large Dogs (6 count),SENTRY Worm X Plus 7 Way DeWormer Large Dogs (6 count),FBALYB Amazon,-16,-16,0,1,0,0
,"SENTRY De-Wormer Small Dog, 2 Tablets","SENTRY HC WormX Plus 7 Way De-Wormer For Small Dog, 2 Chewable Tablets",FBALYB Amazon,-556,-556,0,560,0,0
,SENTRY DeWormer Small Dogs (6 count),SENTRY Worm X Plus 7 Way DeWormer Small Dogs (6 count),Default,0,0,0,0,0,56
,Sentry Earmite Free 3oz,Sentry Earmite Free 3oz,FBALYB Amazon,0,0,0,2,0,0
,SENTRY Flea and Tick Topical 4 Months,"SENTRY Natural Defense Flea and Tick Topical for Dogs and Puppies, Over 40 lbs, 4 Month Supply",FBALYB Amazon,1,1,0,0,0,0
,Sentry Malt Flavor Hairball Treatment for Cats 4.4 oz,Sentry Malt Flavor Hairball Treatment for Cats 4.4 oz,FBALYB Amazon,2,2,0,0,0,0
,SENTRY Petrodex Dental Care Kit,SENTRY Petrodex Dental Care Kit,Default,0,0,0,0,0,16
,Sentry Petrodex Natural Toothpaste,Sentry Petrodex Natural Toothpaste,Default,0,0,0,0,0,152
,Sergeant's Pit'r Pat Liver 0.43oz 2pk,Sergeant's Pit'r Pat Liver 0.43oz 2pk,FBALYB Amazon,-6,-6,0,0,0,0
,Series 2 38mm Gold/Blue,Series 2 38mm Gold Aluminum Case with Midnight Blue Sport Band,Default,0,0,0,0,0,1
,Series 3 38mm Grey/Black,Apple Watch Series 3 38mm Grey/Black,FBALYB Amazon,7,7,0,0,0,0
,Sesame Snaps Snacks,Sesame Snaps Snacks,Default,0,-59,59,0,0,0
,Sesame Snaps Snacks,Sesame Snaps Snacks,FBALYB Amazon,-203,-204,1,6,1,0
,Sexy City Kiss by Parfums Parisienne's Women EDP Perfume Spray 3.3oz,Sexy City Kiss by Parfums Parisienne's Women EDP Perfume Spray 3.3oz,Default Ridgefield,168,168,0,0,0,0
,Shark APEX DuoClean (AX952),Shark APEX DuoClean Powered Lift-Away Vacuum (AX952),Default,0,0,0,0,0,18
,Shark APEX DuoClean (AX952),Shark APEX DuoClean Powered Lift-Away Vacuum (AX952),Default Ridgefield,0,-200,200,0,0,0
,Shark APEX DuoClean (AX952),Shark APEX DuoClean Powered Lift-Away Vacuum (AX952),FBALYB Amazon,0,0,0,3,0,0
,Shark AZ1002C Upright Vacuum with Powered Lift Away,Shark AZ1002C Upright Vacuum with Powered Lift Away,Default,0,0,0,0,0,1
,Shark AZ1002C Upright Vacuum with Powered Lift Away,Shark AZ1002C Upright Vacuum with Powered Lift Away,Default Ridgefield,0,-1,1,0,0,0
,Shark AZ1002C Upright Vacuum with Powered Lift Away,Shark AZ1002C Upright Vacuum with Powered Lift Away,FBALYB Amazon,-5,-5,0,1,0,0
,Shark HV301 Plum,Shark HV301 Plum,Default,0,0,0,0,0,1
,Shark HV302C,Shark HV302C,Default Ridgefield,0,-1010,1010,0,0,0
,Shark HV302C,Shark HV302C,FBALYB Amazon,-22,-22,0,10,0,0
,Shark HV381 Rocket,Shark HV381 Rocket,FBASKCK Amazon,500,500,0,0,0,0
,SHARK HV392,SHARK HV392,FBASKCK Amazon,100,100,0,0,0,0
,Shark IONFlex (IF252),Shark IONFlex 2X DuoClean Cordless Ultra-Light Vacuum (IF252),Default,0,0,0,0,0,25
,Shark ION ROBOT 750,Shark ION ROBOT 750 Robotic Vacuum RV750,FBALYB Amazon,963,963,0,0,0,0
,Shark ION Robot RV720,Shark ION Robot RV720,Default,0,0,0,0,0,6
,Shark ION Robot RV720,Shark ION Robot RV720,FBALYB Amazon,-1,-1,0,0,0,0
,Shark ION Robot RV720,Shark ION Robot RV720,FBASKCK Amazon,700,700,0,0,0,0
,Shark NV360K Navigator Lift-Away Deluxe Professional Bagless Vacuum,Shark NV360K Navigator Lift-Away Deluxe Professional Bagless Vacuum,Default,0,0,0,0,0,1
,Shark NV360K Navigator Lift-Away Deluxe Professional Bagless Vacuum,Shark NV360K Navigator Lift-Away Deluxe Professional Bagless Vacuum,FBALYB Amazon,1,1,0,1,0,0
,Shark Rotator NV752 Powered Lift-Away TruePet Vacuum,Shark Rotator NV752 Powered Lift-Away TruePet Vacuum,Default,0,-56,56,0,0,0
,Shark Rotator NV752 Powered Lift-Away TruePet Vacuum,Shark Rotator NV752 Powered Lift-Away TruePet Vacuum,FBALYB Amazon,-4,-4,0,30,0,0
,Shark Rotator UV560,Shark Rotator UV560 Lift-Away Pro HEPA Vacuum,FBALYB Amazon,1,1,0,0,0,0
,Shark RV1001AEC Robot Self Empty Vacuum,Shark RV1001AEC Robot Self Empty Vacuum,FBALYB Amazon,-5,-9,4,0,4,0
,Shark RV850 Robot Vac,Shark RV850 Robot Vac,FBALYB Amazon,-14,-14,0,0,0,0
,Shark ZS350C Rocket Self-Cleaning Brushroll Corded Stick Vacuum,Shark ZS350C Rocket Self-Cleaning Brushroll Corded Stick Vacuum,FBALYB Amazon,-89,-89,0,80,0,0
,Sharpie Expo Dry Erase Low Odor Chisel Tip Marker,Sharpie Expo Dry Erase Low Odor Chisel Tip Marker,FBALYB Amazon,-8,-8,0,0,0,0
,Sharpie Expo Dry Erase Low Odor Chisel Tip Marker,Sharpie Expo Dry Erase Low Odor Chisel Tip Marker,FBALYB Canada,3,2,1,0,1,0
,Sharpie Expo Dry Erase Low Odor Chisel Tip Marker (12ct) 12pk,Sharpie Expo Dry Erase Low Odor Chisel Tip Marker (12ct) 12pk,FBALYB Amazon,2,2,0,0,0,0
,Sharpie Expo Dry Erase Low Odor Chisel Tip Marker (12ct) 12pk,Sharpie Expo Dry Erase Low Odor Chisel Tip Marker (12ct) 12pk,FBALYB Canada,6,6,0,111,0,0
,Sharpie Expo Dry Erase Low Odor Chisel Tip Marker (12ct) 2pk,Sharpie Expo Dry Erase Low Odor Chisel Tip Marker (12ct) 2pk,FBALYB Amazon,11,8,3,0,3,0
,Sharpie Expo Dry Erase Low Odor Chisel Tip Marker (12ct) 2pk,Sharpie Expo Dry Erase Low Odor Chisel Tip Marker (12ct) 2pk,FBALYB Canada,29,29,0,0,0,0
,Sharpie Expo Dry Erase Low Odor Chisel Tip Marker (12ct) 3pk,Sharpie Expo Dry Erase Low Odor Chisel Tip Marker (12ct) 3pk,FBALYB Amazon,1,1,0,0,0,0
,Sharpie Expo Dry Erase Low Odor Chisel Tip Marker (12ct) 3pk,Sharpie Expo Dry Erase Low Odor Chisel Tip Marker (12ct) 3pk,FBALYB Canada,46,46,0,0,0,0
,Sharpie Expo Dry Erase Low Odor Chisel Tip Marker (12ct) 4pk,Sharpie Expo Dry Erase Low Odor Chisel Tip Marker (12ct) 4pk,FBALYB Canada,10,10,0,0,0,0
,Sharpie Expo Dry Erase Low Odor Chisel Tip Marker (12ct) 6pk,Sharpie Expo Dry Erase Low Odor Chisel Tip Marker (12ct) 6pk,FBALYB Amazon,1,1,0,0,0,0
,Sharpie Marker Retractable Fine Tip Black,Sharpie Marker Retractable Fine Tip Black,Default Ridgefield,0,-1,1,0,0,0
,Sharpie Marker Retractable Fine Tip Black,Sharpie Marker Retractable Fine Tip Black,FBALYB Amazon,2393,2376,17,0,16,0
,Sharpie Marker Retractable Fine Tip Black,Sharpie Marker Retractable Fine Tip Black,FBALYB Canada,22,22,0,20,0,0
,Sharpie Marker Retractable Fine Tip Black 12PK,Sharpie Marker Retractable Fine Tip Black 12PK,FBALYB Amazon,-5,-5,0,5,0,0
,Sharpie Marker Retractable Fine Tip Black 2pk,Sharpie Marker Retractable Fine Tip Black 2pk,FBALYB Amazon,6,1,5,0,5,0
,Shaving Bowl Black, Shaving Bowl Black,FBALYB Amazon,-4,-4,0,0,0,0
,Shaving Bowl White,"Shaving Bowl White	",FBALYB Amazon,-3,-3,0,0,0,0
,"Sherpa Original Deluxe Pet Carrier, Black, Small","Sherpa Original Deluxe Pet Carrier, Black, Small",FBALYB Amazon,-2,-2,0,0,0,0
,Sherpa Original Deluxe Pet Carrier Medium,Sherpa Original Deluxe Pet Carrier Medium,FBALYB Amazon,-2,-2,0,0,0,0
,Shimmer and Shine Toy,Shimmer and Shine Toy,Default Ridgefield,39,39,0,0,0,0
,Shimmer and Shine Toy,Shimmer and Shine Toy,FBALYB Amazon,76,73,3,0,3,0
,Shine Organics On-The-Go 4.22oz 12ct,Shine Organics On-The-Go 4.22oz 12ct,FBALYB Amazon,-72,-72,0,86,0,0
,Shiseido Advanced Super Revitalizer 50ml,Shiseido Advanced Super Revitalizer 50ml,Default Ridgefield,24,24,0,0,0,0
,Shiseido Advanced Super Revitalizer 50ml,Shiseido Advanced Super Revitalizer 50ml,FBALYB Amazon,1,1,0,0,0,0
,Shiseido Bnf Wrnkl Smthng Crm 50ml 50ml,Shiseido Bnf Wrnkl Smthng Crm 50ml 50ml,FBALYB Amazon,1,1,0,0,0,0
,Shiseido Bnf Wrnkl Smthng Day Crm 50ml  50ml,Shiseido Bnf Wrnkl Smthng Day Crm 50ml  50ml,FBALYB Amazon,1,1,0,0,0,0
,Shiseido Bnf W Smooth Eye Crm 15ml 15ml,Shiseido Bnf W Smooth Eye Crm 15ml 15ml,FBALYB Amazon,39,39,0,2,0,0
,Shiseido Bop Advanced Super Revitalizing  Cream 75 ml 75ml,Shiseido Bop Advanced Super Revitalizing  Cream 75 ml 75ml,FBALYB Amazon,-5,-5,0,0,0,0
,Shiseido Bop Liftdynamic Eye Treatment  15ml,Shiseido Bop Liftdynamic Eye Treatment  15ml,FBALYB Amazon,1,1,0,0,0,0
,Shiseido Deep Cleansing Foam 125ml,Shiseido Deep Cleansing Foam 125ml,Default Ridgefield,241,241,0,0,0,0
,Shiseido Deep Cleansing Foam 125ml,Shiseido Deep Cleansing Foam 125ml,FBALYB Amazon,2,0,2,0,2,0
,Shiseido Eye Power Infusing Eye Concentrate 15ml,Shiseido Eye Power Infusing Eye Concentrate 15ml,Default Ridgefield,120,120,0,0,0,0
,Shiseido Eye Power Infusing Eye Concentrate 15ml,Shiseido Eye Power Infusing Eye Concentrate 15ml,FBALYB Amazon,1,1,0,0,0,0
,Shiseido Instant Eye And Lip Mk Remover 125ml,Shiseido Instant Eye And Lip Mk Remover 125ml,Default Ridgefield,60,60,0,0,0,0
,Shiseido Instant Eye And Lip Mk Remover 125ml,Shiseido Instant Eye And Lip Mk Remover 125ml,FBALYB Amazon,100,100,0,0,0,0
,Shiseido Moisturizing Cream 50ml,Shiseido Moisturizing Cream 50ml,Default Ridgefield,240,240,0,0,0,0
,Shiseido Power Infusing Concentrate 50ml,Shiseido Power Infusing Concentrate 50ml,Default Ridgefield,180,180,0,0,0,0
,Shiseido Power Infusing Concentrate 50ml,Shiseido Power Infusing Concentrate 50ml,FBALYB Amazon,143,143,0,0,0,0
,Shiseido Power Infusing Concentrate 75ml,Shiseido Power Infusing Concentrate 75ml,FBALYB Amazon,114,113,1,0,1,0
,Shiseido Smn Cleansing Foam 125ml,Shiseido Smn Cleansing Foam 125ml,FBALYB Amazon,-5,-5,0,0,0,0
,Shiseido Smn Moisturizing Emulsion 100 ml  100ml,Shiseido Smn Moisturizing Emulsion 100 ml  100ml,FBALYB Amazon,1,1,0,0,0,0
,Shiseido Sun Sports Bb Medium N 30ml,Shiseido Sun Sports Bb Medium N 30ml,FBALYB Amazon,1,1,0,0,0,0
,Shiseido Swl Power Brightening Mask 6  Masks 27mlx6Sheets,Shiseido Swl Power Brightening Mask 6  Masks 27mlx6Sheets,FBALYB Amazon,-1,-1,0,0,0,0
,Shiseido Treatment Softener 150ml,Shiseido Treatment Softener 150ml,Default Ridgefield,60,60,0,0,0,0
,Shiseido Treatment Softener 150ml,Shiseido Treatment Softener 150ml,FBALYB Amazon,100,100,0,0,0,0
,Shiseido Treatment Softener Enriched 150ml,Shiseido Treatment Softener Enriched 150ml,Default Ridgefield,26,26,0,0,0,0
,Shiseido Treatment Softener Enriched 150ml,Shiseido Treatment Softener Enriched 150ml,FBALYB Amazon,68,67,1,0,1,0
,Shopkins Season 2 (12 Pack),Shopkins Season 2 (12 Pack),Default,24,24,0,0,0,0
,"SIBERT, BUSHCRAFT, FB","SIBERT, BUSHCRAFT, FB",Default Ridgefield,1,1,0,0,0,0
,"SIBERT, BUSHCRAFT, FB","SIBERT, BUSHCRAFT, FB",FBALYB Amazon,1,-8,9,1,9,0
,Signature Jar  - Blue Jean - Capri Blue Signature Collection,Signature Jar  - Blue Jean - Capri Blue Signature Collection,Avrami - Ebay,8,8,0,0,0,0
,Signature Jar  - Blue Jean - Capri Blue Signature Collection,Signature Jar  - Blue Jean - Capri Blue Signature Collection,Default Ridgefield,14,14,0,0,0,0
,Silk'n Flash & Go Express Hair Removal,Silk'n Flash & Go Express Hair Removal,FBALYB Amazon,6,6,0,0,0,0
,Silver lining zs50,Panasonic LUMIX DMC-ZS50S 30X Travel Zoom with Eye Viewfinder (Silver),FBALYB Amazon,1,1,0,0,0,0
,Simple Age Resisting Face Wipes 25ct 3pk,Simple Age Resisting Face Wipes 25ct 3pk,FBALYB Amazon,3,0,3,0,3,0
,Simple Cleansing Facial Wipes - 25 Pack,Simple Cleansing Facial Wipes - 25ct,Default Ridgefield,96,96,0,0,0,0
,Simple Cleansing Facial Wipes 3pack,Simple Cleansing Facial Wipes 3pack,Default,0,-1,1,0,0,0
,Simple Cleansing Facial Wipes 3pack,Simple Cleansing Facial Wipes 3pack,FBALYB Amazon,20,6,14,24,14,0
,Simple Cleansing Wipes 6pack,Simple Cleansing Wipes 6pack,FBALYB Amazon,-39,-39,0,65,0,0
,Simple Conditioner Gentle Care 200ml,Simple Conditioner Gentle Care 200ml,Default Ridgefield,360,360,0,0,0,0
,Simple Daily Detox Matte Wipes 25s,Simple Daily Detox Matte Wipes 25s,Default Oxford,600,600,0,0,0,0
,Simple Daily Detox Matte Wipes 25s,Simple Daily Detox Matte Wipes 25s,Default Ridgefield,3000,3000,0,0,0,0
,Simple Daily Detox Matte Wipes 25s 6pk,Simple Daily Detox Matte Wipes 25s 6pk,FBALYB Amazon,19,17,2,0,2,0
,Simple Exfoliating Wipes,Simple Exfoliating Wipes,Default Ridgefield,3920,3920,0,0,0,0
,Simple Exfoliating Wipes 2pk,Simple Exfoliating Wipes 2pk,FBALYB Amazon,1,0,1,0,1,0
,Simple Exfoliating Wipes 6pk,Simple Exfoliating Wipes 6pk,FBALYB Amazon,6,0,6,0,6,0
,Simple eye make up remover,Simple eye make up remover ,Default Ridgefield,244,244,0,0,0,0
,Simple eye make up remover,Simple eye make up remover ,FBALYB Amazon,57,57,0,0,0,0
,Simple eye make up remover 2pk,Simple eye make up remover 2pk,FBALYB Amazon,214,204,10,2,10,0
,Simple Face Wash 150ml Refresh 3pk,Simple Face Wash 150ml Refresh 3pk,Default Ridgefield,0,-4,4,0,0,0
,Simple Face Wash 150ml Refresh 3pk,Simple Face Wash 150ml Refresh 3pk,FBALYB Amazon,107,102,5,25,5,0
,Simple Facial Wipes 25count 2pack,Simple Facial Wipes 25count 2pack,Default,0,-18,18,0,0,0
,Simple Facial Wipes 25count 2pack,Simple Facial Wipes 25count 2pack,FBALYB Amazon,80,80,0,20,0,0
,Simple Facial Wipes 4pack,Simple Facial Wipes 4pack,FBALYB Amazon,-170,-173,3,36,3,0
,Simple Hydrating Light Moisturiser 125ml,Simple Hydrating Light Moisturiser 125ml ,FBALYB Amazon,-11,-11,0,10,0,0
,Simple Hydrating Light Moisturizer 12hr Moisturizer,Simple Hydrating Light Moisturizer 12hr Moisturizer,Default Ridgefield,2808,2808,0,0,0,0
,Simple Kind to Skin Protecting Light Moisturizer 125ml,Simple Kind to Skin Protecting Light Moisturizer 125ml,Default Ridgefield,1332,1332,0,0,0,0
,Simple Kind To Skin Replenishing Rich Moisturiser 125ml.,Simple Kind To Skin Replenishing Rich Moisturiser 125ml. ,Default Ridgefield,236,236,0,0,0,0
,Simple Kind To Skin Soothing Facial Toner 200ml,Simple Kind To Skin Soothing Facial Toner 200ml,Default,0,-1800,1800,0,0,0
,Simple Kind To Skin Soothing Facial Toner 200ml,Simple Kind To Skin Soothing Facial Toner 200ml,Default Ridgefield,0,-346,346,0,0,0
,Simple Kind To Skin Soothing Facial Toner 200ml,Simple Kind To Skin Soothing Facial Toner 200ml,FBALYB Amazon,6,6,0,0,0,0
,Simple Kind To Skin Soothing Facial Toner 200ml 2pk,Simple Kind To Skin Soothing Facial Toner 200ml 2pk,FBALYB Amazon,30,30,0,0,0,0
,Simple Micellar Cleansing Makeup Remover,Simple Micellar Cleansing Makeup Remover,Default Ridgefield,218,218,0,0,0,0
,Simple Micellar Cleansing Makeup Remover,Simple Micellar Cleansing Makeup Remover,FBALYB Amazon,66,66,0,40,0,0
,Simple Micellar cleansing wipes 25ct,Simple Micellar cleansing wipes 25ct,Default Ridgefield,429,429,0,0,0,19152
,Simple Micellar Makeup Remover Wipes 3pk,Simple Micellar Makeup Remover Wipes 3pk,FBALYB Amazon,133,102,31,42,31,0
,Simple Micellar Makeup Remover Wipes 4pk,Simple Micellar Makeup Remover Wipes 4pk,FBALYB Amazon,61,61,0,126,0,0
,Simple Micellar Makeup wipes 25 ct 6pk,Simple Micellar Makeup wipes 25 ct 6pk,FBALYB Amazon,179,177,2,302,2,0
,Simple Micellar Water 200 ML,Simple Micellar Water 200 ML,Default,0,-1704,1704,0,0,0
,Simple Micellar Water 200 ML 2pk,Simple Micellar Water 200 ML 2pk,FBALYB Amazon,17,16,1,21,1,0
,Simple Micellar Water 200 ML 3pk,Simple Micellar Water 200 ML 3pk,FBALYB Amazon,18,18,0,69,0,0
,Simple Micellar Wipes 25 ct,Simple Micellar Wipes 25 ct,Default Ridgefield,222,222,0,0,0,9120
,Simple refreshing facial wash,Simple refreshing facial wash,Default Oxford,268,268,0,0,0,0
,Simple refreshing facial wash,Simple refreshing facial wash,Default Ridgefield,254,254,0,0,0,0
,Simple refreshing facial wash,Simple refreshing facial wash,FBALYB Amazon,-1,-2,1,0,1,0
,Simple Refreshing Facial Wash 150ml,Simple Refreshing Facial Wash 150ml,Default,0,-2568,2568,0,0,0
,Simple Refreshing Facial Wash 150ml,Simple Refreshing Facial Wash 150ml,Default Ridgefield,6,6,0,0,0,0
,Simple Refreshing Facial Wash 150ml,Simple Refreshing Facial Wash 150ml,FBALYB Amazon,-2,-2,0,2,0,0
,Simple Refreshing Facial Wash 150ml 2pk,Simple Refreshing Facial Wash 150ml 2pk,FBALYB Amazon,9,9,0,0,0,0
,Simple Regeneration age resisting cleansing facial wipes,Simple Regeneration age resisting cleansing facial wipes,Default Oxford,4,4,0,0,0,0
,Simple Regeneration age resisting cleansing facial wipes,Simple Regeneration age resisting cleansing facial wipes,Default Ridgefield,4662,4662,0,0,0,0
,Simple Replenishing Rich Moisturiser 125ml. 2 pk,Simple Replenishing Rich Moisturiser 125ml. 2 pk,FBALYB Amazon,-16,-20,4,1,4,0
,Simple Revitalising Eye Roll On,Simple Revitalising Eye Roll On,Default Ridgefield,526,526,0,0,0,0
,Simple Revitalising Eye Roll On,Simple Revitalising Eye Roll On,FBALYB Amazon,-1,-1,0,0,0,0
,Simple Skin Quench Sleeping Cream Water Boost,Simple Skin Quench Sleeping Cream Water Boost,Avrami - Ebay,155,155,0,0,0,0
,Simple Skin Quench Sleeping Cream Water Boost,Simple Skin Quench Sleeping Cream Water Boost,WFS,-67,-67,0,0,0,0
,Simple Skin Quench Sleeping Cream Water Boost 2pk,Simple Skin Quench Sleeping Cream Water Boost 2pk,FBALYB Amazon,32,32,0,0,0,0
,Simple Skin Quench Sleeping Cream Water Boost 3pk, Simple Skin Quench Sleeping Cream Water Boost 3pk,FBALYB Amazon,123,123,0,0,0,0
,Simple Solution 1 Gallon Refill,"Simple Solution Extreme Stain + Odor Remover, 1 Gallon Refill",FBALYB Amazon,10,10,0,4,0,0
,Simple Solution Diapers Large 12pk 3pk,Simple Solution Diapers Large 12pk 3pk,FBALYB Amazon,-3,-3,0,0,0,0
,Simple Soothing Facial Toner single,Simple Soothing Facial Toner single,Default Ridgefield,78,78,0,0,0,0
,Simple Soothing Facial Toner single 2pk,Simple Soothing Facial Toner single 2pk,FBALYB Amazon,28,23,5,0,5,0
,"Simple Vital Vitamin Foaming Cleanser, Facial Wash","Simple Vital Vitamin Foaming Cleanser, Facial Wash",Default Ridgefield,114,114,0,0,0,0
,"Simple Vital Vitamin Foaming Cleanser, Facial Wash","Simple Vital Vitamin Foaming Cleanser, Facial Wash",FBALYB Amazon,300,255,45,0,45,0
,"Simple Vital Vitamin Foaming Cleanser, Facial Wash 2 pack","Simple Vital Vitamin Foaming Cleanser, Facial Wash 2 pack",FBALYB Amazon,384,384,0,7,0,0
,Simple Vitamin Foaming Cleanser150ml 2pk,Simple Vitamin Foaming Cleanser150ml 2pk,FBALYB Amazon,14,14,0,0,0,0
,Simple water boost cleansing wipes,Simple water boost cleansing wipes,Default Oxford,1004,1004,0,0,0,0
,Simple water boost cleansing wipes,Simple water boost cleansing wipes,Default Ridgefield,1615,1615,0,0,0,0
,Simple water boost cleansing wipes,Simple water boost cleansing wipes,FBALYB Amazon,143,142,1,0,1,0
,Simple water boost cleansing wipes 6 pack,Simple water boost cleansing wipes 6 pack,FBALYB Amazon,248,247,1,0,1,0
,Simply Organic Cayenne Pepper - 2.89 oz,Simply Organic Cayenne Pepper - 2.89 oz,FBALYB Amazon,4,4,0,0,0,0
,Simply Organic Onion Powder 3 Oz,Simply Organic Onion Powder 3 Oz,Default,0,0,0,0,0,6
,Simply Organic Onion Powder 3 Oz,Simply Organic Onion Powder 3 Oz,FBALYB Amazon,-54,-54,0,54,0,0
,Sisley All Day All Year 50ml,Sisley All Day All Year 50ml,FBALYB Amazon,8,8,0,0,0,0
,Sisley Black Rose Skin Infusion Cream 50ml 17,Sisley Black Rose Skin Infusion Cream 50ml 17,FBALYB Amazon,55,55,0,0,0,0
,Sisley Black Rose Skin Infusion Cream 50ml 17,Sisley Black Rose Skin Infusion Cream 50ml 17,WFS,-18,-18,0,0,0,0
,Sisley Confort Extreme Levres Tarro 9g,Sisley Confort Extreme Lip Balm 9g,FBALYB Amazon,-2,-2,0,0,0,0
,Sisley Crema Colageno Y Malva Tarro 50ml,Sisley Night Cream with Collagen and Woodmallow 50ml,FBALYB Amazon,-2,-2,0,0,0,0
,Sisley Creme Cou Formule Enrichie 50ml,Sisley Creme Cou Formule Enrichie 50ml,FBALYB Amazon,3,3,0,0,0,0
,Sisley Ecological Compound 60ml,Sisley Ecological Compound 60ml,FBALYB Amazon,-2,-2,0,0,0,0
,Sisley Emulsion Ecologica 125ml,Sisley Ecological Compound 125ml,FBALYB Amazon,-3,-3,0,0,0,0
,Sisley Eye & Lip Contour Balm 30ml,Sisley Eye & Lip Contour Balm 30ml,FBALYB Amazon,-1,-1,0,0,0,0
,Sisley Gel Express Aux Fleurs 60ml,Sisley Gel Express Aux Fleurs 60ml,FBALYB Amazon,-1,-1,0,0,0,0
,Sisley Gel Nettoyant Gommant Buff & Wash Facial Gel 100ml,Sisley Gel Nettoyant Gommant Buff & Wash Facial Gel 100ml,FBALYB Amazon,-3,-3,0,2,0,0
,Sisley Global Perfect Pore Minimizer 30ml,Sisley Global Perfect Pore Minimizer 30ml,FBALYB Amazon,18,17,1,0,1,0
,Sisley Huile Precieuse A La Rose Noire 25ml,Sisley Black Rose Face Oil 25ml,FBALYB Amazon,3,3,0,0,0,0
,Sisley Hydra-Flash Visage Form Intensive 60ml,Sisley Hydra-Flash Visage Form Intensive 60ml,FBALYB Amazon,39,38,1,0,1,0
,Sisley Hydra Global 40ml,Sisley Hydra Global 40ml,FBALYB Amazon,-3,-3,0,2,0,0
,Sisley Lightening Toning Lotion 200ml,Sisley Lightening Toning Lotion 200ml,Default Ridgefield,58,58,0,0,0,0
,Sisley Lintegral Eye And Lip 15ml 17,Sisley Lintegral Eye And Lip 15ml 17,FBALYB Amazon,-2,-2,0,0,0,0
,Sisley Locion Tonico Con Flores 250ml,Sisley Floral Toning Lotion 250ml,FBALYB Amazon,-1,-1,0,0,0,0
,Sisley Lotion Pamplemousse 250ml,Sisley Lotion Pamplemousse 250ml,Default Ridgefield,90,90,0,0,0,0
,Sisley Masque Contour Des Yeux Tubo 30ml,Sisley Eye Contour Mask 30ml,FBALYB Amazon,29,29,0,0,0,0
,Sisley Masque Creme A La Rose Noire 60ml,Sisley Black Rose Cream Mask 60ml,FBALYB Amazon,-3,-3,0,0,0,0
,Sisley Neck Cream `16,Sisley Neck Cream `16,Default Ridgefield,27,27,0,0,0,0
,Sisley Neck Cream `16,Sisley Neck Cream `16,FBALYB Amazon,-5,-5,0,0,0,0
,Sisley Restorative Hydrating Body Care 200ml,Sisley Restorative Hydrating Body Care 200ml,FBALYB Amazon,-1,-1,0,0,0,0
,Size 6 women pink Speedo shoe 4.0,"Speedo Women's Hydro Comfort 4.0 Water Shoe, Black/Pink, 6 C/D US",FBALYB Amazon,-1,-1,0,0,0,0
,Size 6 women's blue Speedo shoe 4.0,"Speedo Women's Hydro Comfort 4.0 Water Shoe, Black/Hawaiian Ocean, 6 C/D US",FBALYB Amazon,-3,-3,0,0,0,0
,Skechers 10.5 Charcoal Mens,Skechers 10.5 Charcoal Mens,Default,0,-2,2,0,0,0
,Skechers 10.5 Charcoal Mens,Skechers 10.5 Charcoal Mens,FBALYB Amazon,-1,-1,0,0,0,0
,Skechers Gray Size 9,Skechers Gray Size 9,Default,0,-1,1,0,0,0
,Skechers Gray Size 9,Skechers Gray Size 9,FBALYB Amazon,-17,-17,0,0,0,0
,Skecher's Men's 10.5 Black,Skecher's Men's 10.5 Black,FBALYB Amazon,-2,-2,0,0,0,0
,Skechers Men's Charcoal 10,Skechers Men's Charcoal 10,Default,0,-79,79,0,0,0
,Skechers Men's Charcoal 10,Skechers Men's Charcoal 10,FBALYB Amazon,-3,-3,0,0,0,0
,Skechers Men's Charcoal 8,Skechers Men's Charcoal 8,FBALYB Amazon,-1,-1,0,0,0,0
,Skechers Men's Charcoal 9.5,Skechers Men's Charcoal 9.5,Default Ridgefield,0,-7,7,0,0,0
,Skechers Men's Charcoal 9.5,Skechers Men's Charcoal 9.5,FBALYB Amazon,-1,-1,0,0,0,0
,Skechers Men's Size 8 Black,Skechers Men's Size 8 Black,FBALYB Amazon,-1,-1,0,0,0,0
,Skechers Men's Size 9 Black,Skechers Men's Size 9 Black,FBALYB Amazon,-2,-2,0,0,0,0
,Skechers Navy 6.5,Skechers Navy 6.5,FBALYB Amazon,-2,-2,0,0,0,0
,Skechers Women's Gray 6.5,Skechers Women's Gray 6.5,Default,0,-2,2,0,0,0
,Skechers Women's Gray 6.5,Skechers Women's Gray 6.5,FBALYB Amazon,-23,-24,1,0,1,0
,"Skechers Women Walking Shoe,Black 6.5","Skechers Women Walking Shoe,Black 6.5",FBALYB Amazon,24,23,1,0,1,0
,"Skechers Women Walking Shoe,Black 7","Skechers Women Walking Shoe,Black 7",FBALYB Amazon,41,40,1,0,1,0
,"Skechers Women Walking Shoe,Black/Gray,6","Skechers Women Walking Shoe,Black/Gray,6",Default,0,-1,1,0,0,0
,"Skechers Women Walking Shoe,Black/Gray,6","Skechers Women Walking Shoe,Black/Gray,6",FBALYB Amazon,154,154,0,5,0,0
,Skech Polo Book Wallet Cover Black,Skech Polo Book Wallet Cover with Detachable Case and Stand for iPhone 7 (6/6...,FBAAP Amazon,-1,-1,0,0,0,0
,Skech Polo Book Wallet Cover Brown,Skech Polo Book Wallet Cover with Detachable Case and Stand for iPhone 7 (6/6...,FBAAP Amazon,3,3,0,0,0,0
,Sketchers Go lite walking women Black/Grey 10,Sketchers Go lite walking women Black/Grey 10,Default,7,7,0,0,0,0
,Sketchers Go lite walking women Black/Grey 10,Sketchers Go lite walking women Black/Grey 10,FBALYB Amazon,-13,-15,2,0,2,0
,Sketchers Go lite walking women Black/Grey 7.5,Sketchers Go lite walking women Black/Grey 7.5,FBALYB Amazon,-51,-51,0,0,0,0
,Sketchers Go lite walking women Grey 6,Sketchers Go lite walking women Grey 6,Default Ridgefield,0,-1,1,0,0,0
,Sketchers Go lite walking women Grey 6,Sketchers Go lite walking women Grey 6,FBALYB Amazon,0,-1,1,0,1,0
,Sketchers Gray Size 10 Womens,Sketchers Gray Size 10 Womens,FBALYB Amazon,-8,-8,0,0,0,0
,Sketchers Women Black Size 8,Sketchers Women Black Size 8,Default Ridgefield,24,24,0,0,0,0
,Sketchers Women Black Size 8,Sketchers Women Black Size 8,FBALYB Amazon,-29,-29,0,0,0,0
,Sketchers Women Black Size 8.5,Sketchers Women Black Size 8.5,Default,0,-2,2,0,0,0
,Sketchers Women Black Size 8.5,Sketchers Women Black Size 8.5,Default Ridgefield,15,15,0,0,0,0
,Sketchers Women Black Size 8.5,Sketchers Women Black Size 8.5,FBALYB Amazon,-22,-22,0,0,0,0
,Sketchers Women Black Size 9,Sketchers Women Black Size 9,FBALYB Amazon,-15,-15,0,0,0,0
,Sketchers Women Grey Size 7,Sketchers Women Grey Size 7,Default Ridgefield,17,17,0,0,0,0
,Sketchers Women Grey Size 7,Sketchers Women Grey Size 7,FBALYB Amazon,-20,-20,0,0,0,0
,Sketchers Women Grey Size 7.5,Sketchers Women Grey Size 7.5,Default Ridgefield,-1,-2,1,0,0,0
,Sketchers Women Grey Size 7.5,Sketchers Women Grey Size 7.5,FBALYB Amazon,-11,-11,0,0,0,0
,Sketchers Women Grey Size 8,Sketchers Women Grey Size 8,Default Ridgefield,7,7,0,0,0,0
,Sketchers Women Grey Size 8,Sketchers Women Grey Size 8,FBALYB Amazon,-13,-13,0,88,0,0
,Sketchers Women Grey Size 8.5,Sketchers Women Grey Size 8.5,Default,0,-8,8,0,0,0
,Sketchers Women Grey Size 8.5,Sketchers Women Grey Size 8.5,Default Ridgefield,6,6,0,0,0,0
,Sketchers Women Grey Size 8.5,Sketchers Women Grey Size 8.5,FBALYB Amazon,-10,-10,0,0,0,0
,SK-II Facial Treatment Cleanser Regular Purifying,SK-II Facial Treatment Cleanser Regular Purifying,Avrami - Ebay,67,67,0,0,0,0
,SK-II Facial Treatment Cleanser Regular Purifying,SK-II Facial Treatment Cleanser Regular Purifying,Default Ridgefield,17,17,0,0,0,0
,SK-II Facial Treatment Cleanser Regular Purifying,SK-II Facial Treatment Cleanser Regular Purifying,WFS,-24,-24,0,0,0,0
,SK-II Facial Treatment Clear Lotion Regular 5.4oz  Purifying,SK-II Facial Treatment Clear Lotion Regular 5.4oz  Purifying,FBALYB Amazon,-9,-10,1,4,1,0
,SK-II Facial Treatment Essence Half 2.5oz Renewing,SK-II Facial Treatment Essence Half 2.5oz Renewing,FBALYB Amazon,-11,-11,0,0,0,0
,SK-II Facial Treatment Essence Max 7.7oz Renewing,SK-II Facial Treatment Essence Max 7.7oz Renewing,FBALYB Amazon,18,18,0,14,0,0
,SK-II GenOptics Aura Essence 1.69 oz Brightening,SK-II GenOptics Aura Essence 1.69 oz Brightening,FBALYB Amazon,-2,-2,0,0,0,0
,SK-II LXP Ultimate Revival Cream 1.69 oz LXP Boutique,SK-II LXP Ultimate Revival Cream 1.69 oz LXP Boutique,FBALYB Amazon,1,1,0,0,0,0
,SK-II RNA Cream 2.8oz Anti-Aging,SK-II RNA Cream 2.8oz Anti-Aging,FBALYB Amazon,2,2,0,0,0,0
,SK-II Treatment Mask 10 Count Nourishing,SK-II Treatment Mask 10 Count Nourishing,FBALYB Amazon,-11,-11,0,0,0,0
,Skinneeez Barnyard Series Chicken,Skinneeez Barnyard Series Chicken,Default Ridgefield,13,13,0,0,0,0
,Skinneeez Barnyard Series Chicken,Skinneeez Barnyard Series Chicken,FBALYB Amazon,-1,-1,0,0,0,0
,Skinneeez Exotic Series Pink Flamingo,Skinneeez Exotic Series Pink Flamingo,FBALYB Amazon,-1,-1,0,1,0,0
,Skippy Crunchy 2pk,Skippy Extra Crunchy Peanut Butter Super Chunk Twin Pack Two 48 Ounce Jars,Default,0,0,0,0,0,102
,Skippy Crunchy 2pk,Skippy Extra Crunchy Peanut Butter Super Chunk Twin Pack Two 48 Ounce Jars,FBALYB Amazon,-96,-96,0,0,0,0
,Skittles Tropical Fruit 36ct,Skittles Tropical Fruit 36ct,FBALYB Amazon,47,47,0,0,0,0
,Skout's Honor All-Natural Dog Urine Destroyer,"Skout's Honor Professional Strength, All-Natural Dog Urine Destroyer - Non-Toxic, Biodegradable, and Eco-Friendly - Odor Eliminating Technology Destroys Od",FBALYB Amazon,16,16,0,0,0,0
,Skullcandy Headphones - Black/Coral,Skullcandy - Crusher Wireless Over-the-Ear Headphones - Black/CoralSkullcandy - Crusher Wireless Over-the-Ear Headphones - Black/Coral,Default,0,0,0,0,0,3
,Skullcandy Headphones - Gray/Tan,Skullcandy - Crusher Wireless Over-the-Ear Headphones - Gray/Tan,Default,0,0,0,0,0,3
,Skullcandy Headphones - Gray/Tan,Skullcandy - Crusher Wireless Over-the-Ear Headphones - Gray/Tan,FBALYB Amazon,20,20,0,0,0,0
,Skunks Odor Remover 16.9oz,Skunks Odor Remover 16.9oz,FBALYB Amazon,6,6,0,0,0,0
,Slim Jim 120 count,Slim Jim 120 count,Default,0,0,0,0,0,15
,Small Animal Play Pen,Small Animal Play Pen,FBALYB Amazon,4,4,0,0,0,0
,Smart 4 Life Bars,Smart 4 Life Bars,FBALYB Amazon,-7,-7,0,10,0,0
,SmartBones Calming Chews 16ct 2pk,SmartBones Calming Chews 16ct 2pk,FBALYB Amazon,1,1,0,0,0,0
,SmartBones Chicken Wrapped Mini 15ct 6pk,SmartBones Chicken Wrapped Mini 15ct 6pk,FBALYB Amazon,1,1,0,0,0,0
,SmartBones DoubleTime Mini Chicken 16ct 2pk,SmartBones DoubleTime Mini Chicken 16ct 2pk,FBALYB Amazon,29,29,0,4,0,0
,SmartBones Large P.Butter 3ct 2pk,SmartBones Large P.Butter 3ct 2pk,FBALYB Amazon,1,1,0,0,0,0
,SmartBones Medium Chicken 4ct 2pk,SmartBones Medium Chicken 4ct 2pk,FBALYB Amazon,1,1,0,0,0,0
,SmartBones Mini Chicken 24ct 2pk,SmartBones Mini Chicken 24ct 2pk,FBALYB Amazon,-11,-11,0,0,0,0
,SmartBones PlayTime Small PButter 10ct 2pk,SmartBones PlayTime Small PButter 10ct 2pk,FBALYB Amazon,3,3,0,0,0,0
,SmartBones Small Beef 6ct 2pk,SmartBones Small Beef 6ct 2pk,FBALYB Amazon,1,1,0,0,0,0
,SmartBones Small P.Butter 6ct 2pk,SmartBones Small P.Butter 6ct 2pk,FBALYB Amazon,1,1,0,0,0,0
,SmartBones Twistz P.Butter 6ct 2pk,SmartBones Twistz P.Butter 6ct 2pk ,FBALYB Amazon,5,5,0,5,0,0
,Smart pot crockpot 4 qt,4qt Smrt Pot Slow Cooker,FBALYB Amazon,-1,-1,0,5,0,0
,Smartwool Merino 150 BBrief blk L,Smartwool Men Merino 150 Boxer Briefs black Size L,FBALYB Amazon,24,22,2,0,2,0
,Smartwool Merino 150 BBrief blk M,Smartwool Men Merino 150 Boxer Briefs black Size M,Default Ridgefield,110,110,0,0,0,0
,Smartwool Merino 150 BBrief blk S,Smartwool Men Merino 150 Boxer Briefs black Size S,FBALYB Amazon,8,7,1,0,1,0
,Smartwool Merino 150 BBrief blk XL,Smartwool Men Merino 150 Boxer Briefs black Size XL,FBALYB Amazon,51,50,1,0,1,0
,Smartwool Merino 150 Blayer Lng L,Smartwool Women Merino 150 Baselayer Long Sleeve Black Size L,FBALYB Amazon,28,28,0,0,0,0
,Smartwool Merino 150 Blayer Lng M,Smartwool Women Merino 150 Baselayer Long Sleeve Black Size M,Default Ridgefield,1,1,0,0,0,0
,Smartwool Merino 150 Blayer Lng M,Smartwool Women Merino 150 Baselayer Long Sleeve Black Size M,FBALYB Amazon,39,38,1,0,1,0
,Smartwool Merino 150 Blayer Lng S,Smartwool Women Merino 150 Baselayer Long Sleeve Black Size S,Default Ridgefield,1,1,0,0,0,0
,Smartwool Merino 150 Blayer Lng S,Smartwool Women Merino 150 Baselayer Long Sleeve Black Size S,FBALYB Amazon,8,8,0,0,0,0
,Smartwool Merino 150 Blayer Lng XL,Smartwool Women Merino 150 Baselayer Long Sleeve Black Size XL,FBALYB Amazon,24,24,0,0,0,0
,Smartwool Mrn150 BlayerTnk Bk XL,Smartwool Women Merino 150 Baselayer Tank Top Black Size XL,FBALYB Amazon,6,6,0,0,0,0
,Smartwool Mrno 250 Base 1/4 Charc L,Smartwool Men Merino 250 Baselayer 1/4 Zip CHARCOAL HEATHE Size L,FBALYB Amazon,18,18,0,0,0,0
,Smartwool Mrno 250 Base 1/4 Charc M,Smartwool Men Merino 250 Baselayer 1/4 Zip CHARCOAL HEATHE Size M,FBALYB Amazon,9,7,2,0,2,0
,Smartwool Mrno 250 Base 1/4 H/C L,Smartwool Men Merino 250 BaseLayer 1/4 Zip Woodsmoke Heather/Charcoal Heather Size L,Default Ridgefield,8,8,0,0,0,0
,Smartwool Mrno 250 Base 1/4 H/C M,Smartwool Men Merino 250 BaseLayer 1/4 Zip Woodsmoke Heather/Charcoal Heather Size M,FBALYB Amazon,-1,-1,0,0,0,0
,Smartwool Mrno 250 Base 1/4 Nvy L,Smartwool Men Merino 250 Baselayer 1/4 Zip DEEP NAVY Size L,Default Ridgefield,1,1,0,0,0,0
,Smartwool Mrno 250 Base 1/4 Nvy L,Smartwool Men Merino 250 Baselayer 1/4 Zip DEEP NAVY Size L,FBALYB Amazon,10,9,1,0,1,0
,Smartwool Mrno 250 Base 1/4 Nvy M,Smartwool Men Merino 250 Baselayer 1/4 Zip DEEP NAVY Size M,FBALYB Amazon,10,9,1,0,1,0
,Smartwool Mrno 250 BaseBtm Blk XL,Smartwool Men Merino 250 Base Layer Bottom BLACK Size XL,FBALYB Amazon,22,19,3,0,3,0
,Smartwool Mrno 250 BaseBtm Blk XXL,Smartwool Men Merino 250 Base Layer Bottom BLACK Size XXL,FBALYB Amazon,15,14,1,0,1,0
,SmartYard LED 6 Pack,SmartYard LED 6 Pack,Default,0,0,0,0,0,2
,SmartYard LED 6 Pack,SmartYard LED 6 Pack,FBALYB Amazon,52,52,0,0,0,0
,SMASHBOX CHEEK 15ML O GLOW INTUITUVE CHEEK COLOUR,SMASHBOX CHEEK 15ML O GLOW INTUITUVE CHEEK COLOUR,FBALYB Amazon,-2,-2,0,2,0,0
,SMASHBOX CLR CORRECT STICK 3.5G PEACH LOOK LESS TIRED- LIGHT,SMASHBOX CLR CORRECT STICK 3.5G PEACH LOOK LESS TIRED- LIGHT,Default Ridgefield,2,2,0,0,0,0
,SMASHBOX CLR CORRECT STICK 3.5G PEACH LOOK LESS TIRED- LIGHT,SMASHBOX CLR CORRECT STICK 3.5G PEACH LOOK LESS TIRED- LIGHT,FBALYB Amazon,13,13,0,0,0,0
,SMASHBOX CONTOUR 11.47G STEPBYSTEP KIT,SMASHBOX CONTOUR 11.47G STEPBYSTEP KIT,Default Ridgefield,3,3,0,0,0,0
,SMASHBOX CONTOUR 11.47G STEPBYSTEP KIT,SMASHBOX CONTOUR 11.47G STEPBYSTEP KIT,FBALYB Amazon,369,352,17,0,17,0
,SMASHBOX CONTOUR 11.47G STEPBYSTEP KIT,SMASHBOX CONTOUR 11.47G STEPBYSTEP KIT,FBALYB Canada,5,5,0,0,0,0
,SMASHBOX CONTOUR 20.56G CALI PALETTE,SMASHBOX CONTOUR 20.56G CALI PALETTE,Default Ridgefield,282,282,0,0,0,0
,SMASHBOX CONTOUR 20.56G CALI PALETTE,SMASHBOX CONTOUR 20.56G CALI PALETTE,FBALYB Amazon,2,1,1,0,1,0
,SMASHBOX EYELINER 6G ALWAYS ON LIQUID,SMASHBOX EYELINER 6G ALWAYS ON LIQUID,Default Ridgefield,268,268,0,0,0,0
,SMASHBOX EYELINER 6G ALWAYS ON LIQUID,SMASHBOX EYELINER 6G ALWAYS ON LIQUID,FBALYB Amazon,155,153,2,0,2,0
,SMASHBOX EYESHADOW 3.2G PHO EDT TRI NUDE PIC,SMASHBOX EYESHADOW 3.2G PHO EDT TRI NUDE PIC,Default,0,0,0,0,0,5
,SMASHBOX EYESHADOW 3.2G PHO EDT TRI NUDE PIC,SMASHBOX EYESHADOW 3.2G PHO EDT TRI NUDE PIC,Default Ridgefield,151,151,0,0,0,0
,SMASHBOX EYESHADOW 3.2G PHO EDT TRI NUDE PIC,SMASHBOX EYESHADOW 3.2G PHO EDT TRI NUDE PIC,FBALYB Amazon,-5,-5,0,7,0,0
,SMASHBOX EYESHADOW 3.2G PHO EDT TRI NUDE PIC LIGHT,SMASHBOX EYESHADOW 3.2G PHO EDT TRI NUDE PIC LIGHT,Default Ridgefield,351,351,0,0,0,0
,SMASHBOX EYESHADOW 3.2G PHO EDT TRI NUDE PIC LIGHT,SMASHBOX EYESHADOW 3.2G PHO EDT TRI NUDE PIC LIGHT,FBALYB Amazon,28,24,4,92,4,0
,SMASHBOX EYESHADOW 3.2G PHO EDT TRI NUDE PIC LIGHT,SMASHBOX EYESHADOW 3.2G PHO EDT TRI NUDE PIC LIGHT,FBALYB Canada,8,8,0,0,0,0
,SMASHBOX EYESHADOW 6.2G COVER SHOT PALETTE,SMASHBOX EYESHADOW 6.2G COVER SHOT PALETTE,Default Ridgefield,148,148,0,0,0,0
,SMASHBOX FACE PRIMER N/A TRY ME KIT,SMASHBOX FACE PRIMER N/A TRY ME KIT,Default Ridgefield,1,1,0,0,0,0
,SMASHBOX FACE PRIMER N/A TRY ME KIT,SMASHBOX FACE PRIMER N/A TRY ME KIT,FBALYB Amazon,1,1,0,0,0,0
,"SMASHBOX FOUNDATION 30ML STUDIO 24HR WEAR HYDRATING FOUNDATION, CHESTNUT","SMASHBOX FOUNDATION 30ML STUDIO 24HR WEAR HYDRATING FOUNDATION, CHESTNUT",Default Ridgefield,100,100,0,0,0,0
,"SMASHBOX FOUNDATION 30ML STUDIO 24HR WEAR HYDRATING FOUNDATION, CHESTNUT","SMASHBOX FOUNDATION 30ML STUDIO 24HR WEAR HYDRATING FOUNDATION, CHESTNUT",FBALYB Amazon,32,31,1,0,1,0
,"SMASHBOX FOUNDATION 30ML STUDIO 24HR WEAR HYDRATING FOUNDATION, FAIR LIGHT","SMASHBOX FOUNDATION 30ML STUDIO 24HR WEAR HYDRATING FOUNDATION, FAIR LIGHT",Default Ridgefield,406,406,0,0,0,0
,"SMASHBOX FOUNDATION 30ML STUDIO 24HR WEAR HYDRATING FOUNDATION, FAIR LIGHT","SMASHBOX FOUNDATION 30ML STUDIO 24HR WEAR HYDRATING FOUNDATION, FAIR LIGHT",FBALYB Amazon,-19,-20,1,0,1,0
,"SMASHBOX FOUNDATION 30ML STUDIO 24HR WEAR HYDRATING FOUNDATION, LIGHT BEIGE","SMASHBOX FOUNDATION 30ML STUDIO 24HR WEAR HYDRATING FOUNDATION, LIGHT BEIGE",Default Ridgefield,406,406,0,0,0,0
,"SMASHBOX FOUNDATION 30ML STUDIO 24HR WEAR HYDRATING FOUNDATION, LIGHT BEIGE","SMASHBOX FOUNDATION 30ML STUDIO 24HR WEAR HYDRATING FOUNDATION, LIGHT BEIGE",FBALYB Amazon,42,42,0,74,0,0
,"SMASHBOX FOUNDATION 30ML STUDIO 24HR WEAR HYDRATING FOUNDATION, LIGHT GOLDEN BEIGE","SMASHBOX FOUNDATION 30ML STUDIO 24HR WEAR HYDRATING FOUNDATION, LIGHT GOLDEN BEIGE",Default Ridgefield,204,204,0,0,0,0
,"SMASHBOX FOUNDATION 30ML STUDIO 24HR WEAR HYDRATING FOUNDATION, LIGHT GOLDEN BEIGE","SMASHBOX FOUNDATION 30ML STUDIO 24HR WEAR HYDRATING FOUNDATION, LIGHT GOLDEN BEIGE",FBALYB Amazon,30,30,0,1,0,0
,"SMASHBOX FOUNDATION 30ML STUDIO 24HR WEAR HYDRATING FOUNDATION, MEDIUM BEIGE","SMASHBOX FOUNDATION 30ML STUDIO 24HR WEAR HYDRATING FOUNDATION, MEDIUM BEIGE",Default Ridgefield,166,166,0,0,0,0
,"SMASHBOX FOUNDATION 30ML STUDIO 24HR WEAR HYDRATING FOUNDATION, MEDIUM BEIGE","SMASHBOX FOUNDATION 30ML STUDIO 24HR WEAR HYDRATING FOUNDATION, MEDIUM BEIGE",FBALYB Amazon,32,32,0,0,0,0
,"SMASHBOX FOUNDATION 30ML STUDIO 24HR WEAR HYDRATING FOUNDATION, NEUTRAL BEIGE","SMASHBOX FOUNDATION 30ML STUDIO 24HR WEAR HYDRATING FOUNDATION, NEUTRAL BEIGE",Default,0,0,0,0,0,2
,"SMASHBOX FOUNDATION 30ML STUDIO 24HR WEAR HYDRATING FOUNDATION, NEUTRAL BEIGE","SMASHBOX FOUNDATION 30ML STUDIO 24HR WEAR HYDRATING FOUNDATION, NEUTRAL BEIGE",Default Ridgefield,201,201,0,0,0,0
,"SMASHBOX FOUNDATION 30ML STUDIO 24HR WEAR HYDRATING FOUNDATION, NEUTRAL BEIGE","SMASHBOX FOUNDATION 30ML STUDIO 24HR WEAR HYDRATING FOUNDATION, NEUTRAL BEIGE",FBALYB Amazon,2,2,0,0,0,0
,"SMASHBOX FOUNDATION 30ML STUDIO 24HR WEAR HYDRATING FOUNDATION, NEUTRAL FAIR","SMASHBOX FOUNDATION 30ML STUDIO 24HR WEAR HYDRATING FOUNDATION, NEUTRAL FAIR",Default Ridgefield,155,155,0,0,0,0
,"SMASHBOX FOUNDATION 30ML STUDIO 24HR WEAR HYDRATING FOUNDATION, NEUTRAL FAIR","SMASHBOX FOUNDATION 30ML STUDIO 24HR WEAR HYDRATING FOUNDATION, NEUTRAL FAIR",FBALYB Amazon,62,62,0,0,0,0
,"SMASHBOX FOUNDATION 30ML STUDIO 24HR WEAR HYDRATING FOUNDATION, WARM FAIR","SMASHBOX FOUNDATION 30ML STUDIO 24HR WEAR HYDRATING FOUNDATION, WARM FAIR",Default Ridgefield,406,406,0,0,0,0
,"SMASHBOX FOUNDATION 30ML STUDIO 24HR WEAR HYDRATING FOUNDATION, WARM FAIR","SMASHBOX FOUNDATION 30ML STUDIO 24HR WEAR HYDRATING FOUNDATION, WARM FAIR",FBALYB Amazon,-3,-5,2,0,2,0
,"SMASHBOX FOUNDATION 30ML STUDIO 24H WEAR HYDRATING FOUNDATION, FAIR LIGHT/WARM PEACH","SMASHBOX FOUNDATION 30ML STUDIO 24H WEAR HYDRATING FOUNDATION, FAIR LIGHT/WARM PEACH",Default Ridgefield,136,136,0,0,0,0
,SMASHBOX LINER 0.27G SHARP 3D 3D SPARKS,SMASHBOX LINER 0.27G SHARP 3D 3D SPARKS,Default,0,0,0,0,0,100
,SMASHBOX LINER 0.27G SHARP 3D 3D SPARKS,SMASHBOX LINER 0.27G SHARP 3D 3D SPARKS,Default Ridgefield,304,304,0,0,0,0
,SMASHBOX LINER 0.27G SHARP 3D 3D SPARKS,SMASHBOX LINER 0.27G SHARP 3D 3D SPARKS,FBALYB Amazon,67,64,3,100,3,0
,SMASHBOX LINER 0.28G WATERPROOF KOHL FRENCH NAVY,SMASHBOX LINER 0.28G WATERPROOF KOHL FRENCH NAVY,Default Ridgefield,525,525,0,0,0,0
,SMASHBOX LINER 0.28G WATERPROOF KOHL FRENCH NAVY,SMASHBOX LINER 0.28G WATERPROOF KOHL FRENCH NAVY,FBALYB Amazon,2,0,2,0,2,0
,SMASHBOX LINER 0.28G WATERPROOF KOHL RAVEN,SMASHBOX LINER 0.28G WATERPROOF KOHL RAVEN,Default,0,0,0,0,0,2
,SMASHBOX LINER 0.28G WATERPROOF KOHL RAVEN,SMASHBOX LINER 0.28G WATERPROOF KOHL RAVEN,Default Ridgefield,385,385,0,0,0,0
,SMASHBOX LINER 0.28G WATERPROOF KOHL RAVEN,SMASHBOX LINER 0.28G WATERPROOF KOHL RAVEN,FBALYB Amazon,333,288,45,6,45,0
,SMASHBOX LINER 0.28G WATERPROOF KOHL SUMATRA,SMASHBOX LINER 0.28G WATERPROOF KOHL SUMATRA,Default Ridgefield,309,309,0,0,0,0
,SMASHBOX LINER 0.28G WATERPROOF KOHL SUMATRA,SMASHBOX LINER 0.28G WATERPROOF KOHL SUMATRA,FBALYB Amazon,354,319,35,402,35,0
,SMASHBOX LINER 0.28G WATERPROOF KOHL VIOLETTA,SMASHBOX LINER 0.28G WATERPROOF KOHL VIOLETTA,Default Ridgefield,391,391,0,0,0,0
,SMASHBOX LINER 0.28G WATERPROOF KOHL VIOLETTA,SMASHBOX LINER 0.28G WATERPROOF KOHL VIOLETTA,FBALYB Amazon,158,148,10,2,10,0
,SMASHBOX LINER 1.2G ALWAYS ON GEL BREWED,SMASHBOX LINER 1.2G ALWAYS ON GEL BREWED,Default Ridgefield,600,600,0,0,0,0
,SMASHBOX LINER 1.2G ALWAYS ON GEL BREWED,SMASHBOX LINER 1.2G ALWAYS ON GEL BREWED,FBALYB Amazon,1,1,0,0,0,0
,SMASHBOX LINER 1.2G ALWAYS ON GEL MOODY,SMASHBOX LINER 1.2G ALWAYS ON GEL MOODY,Default Ridgefield,225,225,0,0,0,0
,SMASHBOX LINER 1.2G ALWAYS ON GEL MOODY,SMASHBOX LINER 1.2G ALWAYS ON GEL MOODY,FBALYB Amazon,68,67,1,0,1,0
,SMASHBOX LINER 1.2G ALWAYS ON GEL SHARK,SMASHBOX LINER 1.2G ALWAYS ON GEL SHARK,Default Ridgefield,600,600,0,0,0,0
,SMASHBOX LINER 1.2G ALWAYS ON GEL SHARK,SMASHBOX LINER 1.2G ALWAYS ON GEL SHARK,FBALYB Amazon,47,46,1,0,1,0
,SMASHBOX LIPSTICK 4ML ALWAYS ON BAWSE,SMASHBOX LIPSTICK 4ML ALWAYS ON BAWSE,Default Ridgefield,164,164,0,0,0,0
,SMASHBOX LIPSTICK 4ML ALWAYS ON BAWSE,SMASHBOX LIPSTICK 4ML ALWAYS ON BAWSE,FBALYB Amazon,29,28,1,0,1,0
,SMASHBOX MASCARA 10ML SUPER FAN FANNEDOUT,SMASHBOX MASCARA 10ML SUPER FAN FANNEDOUT,Default,0,0,0,0,0,3
,SMASHBOX MASCARA 10ML SUPER FAN FANNEDOUT,SMASHBOX MASCARA 10ML SUPER FAN FANNEDOUT,Default Ridgefield,2507,2507,0,0,0,0
,SMASHBOX MASCARA 10ML SUPER FAN FANNEDOUT,SMASHBOX MASCARA 10ML SUPER FAN FANNEDOUT,FBALYB Amazon,301,289,12,0,12,0
,SMASHBOX MASCARA 8ML FULL EXPOSURE WATERPROOF MASCARA- JET BLACK,SMASHBOX MASCARA 8ML FULL EXPOSURE WATERPROOF MASCARA- JET BLACK,Default Ridgefield,202,202,0,0,0,0
,SMASHBOX MASCARA 8ML FULL EXPOSURE WATERPROOF MASCARA- JET BLACK,SMASHBOX MASCARA 8ML FULL EXPOSURE WATERPROOF MASCARA- JET BLACK,FBALYB Amazon,68,68,0,0,0,0
,SMASHBOX MASCARA 9.5ML FULL EXPOSURE JET BLACK,SMASHBOX MASCARA 9.5ML FULL EXPOSURE JET BLACK,Default,0,0,0,0,0,1
,SMASHBOX MASCARA 9.5ML FULL EXPOSURE JET BLACK,SMASHBOX MASCARA 9.5ML FULL EXPOSURE JET BLACK,Default Ridgefield,385,385,0,0,0,0
,SMASHBOX MASCARA 9.5ML FULL EXPOSURE JET BLACK,SMASHBOX MASCARA 9.5ML FULL EXPOSURE JET BLACK,FBALYB Amazon,106,106,0,0,0,0
,SMASHBOX PRIMER 10ML PHOTO FINISH HYDR UNDER EYE PRIMER,SMASHBOX PRIMER 10ML PHOTO FINISH HYDR UNDER EYE PRIMER,Default Ridgefield,235,235,0,0,0,0
,SMASHBOX PRIMER 10ML PHOTO FINISH HYDR UNDER EYE PRIMER,SMASHBOX PRIMER 10ML PHOTO FINISH HYDR UNDER EYE PRIMER,FBALYB Amazon,460,420,40,4,40,0
,SMASHBOX PRIMER 12ML PHOTO FINISH 24HR SHADOW PRIMER,SMASHBOX PRIMER 12ML PHOTO FINISH 24HR SHADOW PRIMER,Default,0,0,0,0,0,2
,SMASHBOX PRIMER 12ML PHOTO FINISH 24HR SHADOW PRIMER,SMASHBOX PRIMER 12ML PHOTO FINISH 24HR SHADOW PRIMER,Default Ridgefield,773,773,0,0,0,0
,SMASHBOX PRIMER 12ML PHOTO FINISH 24HR SHADOW PRIMER,SMASHBOX PRIMER 12ML PHOTO FINISH 24HR SHADOW PRIMER,FBALYB Amazon,-9,-9,0,0,0,0
,SMASHBOX PRIMER 2.5ML PHOTO FINISH LID LIGHT,SMASHBOX PRIMER 2.5ML PHOTO FINISH LID LIGHT,Default,0,0,0,0,0,440
,SMASHBOX PRIMER 2.5ML PHOTO FINISH LID LIGHT,SMASHBOX PRIMER 2.5ML PHOTO FINISH LID LIGHT,FBALYB Amazon,-1,-1,0,4,0,0
,SMASHBOX PRIMER 30ML PHOTO FINISH MINIMIZE PORES PRIMER,SMASHBOX PRIMER 30ML PHOTO FINISH MINIMIZE PORES PRIMER,Default Ridgefield,5,5,0,0,0,0
,SMASHBOX PRIMER 30ML PHOTO FINISH MINIMIZE PORES PRIMER,SMASHBOX PRIMER 30ML PHOTO FINISH MINIMIZE PORES PRIMER,FBALYB Amazon,167,147,20,2,20,0
,SMASHBOX PRIMER 30ML PHOTO FINISH OIL SHINE CONTROL PRIMER,SMASHBOX PRIMER 30ML PHOTO FINISH OIL SHINE CONTROL PRIMER,Default Ridgefield,11,11,0,0,0,0
,SMASHBOX PRIMER 30ML PHOTO FINISH OIL SHINE CONTROL PRIMER,SMASHBOX PRIMER 30ML PHOTO FINISH OIL SHINE CONTROL PRIMER,FBALYB Amazon,637,625,12,0,12,0
,SMASHBOX PRIMER 30ML PHOTO FINISH PRIMERIZER,SMASHBOX PRIMER 30ML PHOTO FINISH PRIMERIZER,Default Ridgefield,1021,1021,0,0,0,0
,SMASHBOX PRIMER 30ML PHOTO FINISH PRIMERIZER,SMASHBOX PRIMER 30ML PHOTO FINISH PRIMERIZER,FBALYB Amazon,186,186,0,1,0,0
,SMASHBOX PRIMER 30ML PHOTO FINISH REDUCE REDNESS PRIMER,SMASHBOX PRIMER 30ML PHOTO FINISH REDUCE REDNESS PRIMER,Default Ridgefield,96,96,0,0,0,0
,SMASHBOX PRIMER 30ML PHOTO FINISH REDUCE REDNESS PRIMER,SMASHBOX PRIMER 30ML PHOTO FINISH REDUCE REDNESS PRIMER,FBALYB Amazon,559,547,12,0,12,0
,SMASHBOX PRIMER 30ML PHOTO FINISH SMOOTH BLUR PRIMER,SMASHBOX PRIMER 30ML PHOTO FINISH SMOOTH BLUR PRIMER,Default Ridgefield,3319,3319,0,0,0,0
,SMASHBOX PRIMER 30ML PHOTO FINISH SMOOTH BLUR PRIMER,SMASHBOX PRIMER 30ML PHOTO FINISH SMOOTH BLUR PRIMER,FBALYB Amazon,1200,1101,99,0,99,0
,SMASHBOX PRIMER 30ML PHOTO FINISH SUPER LGHT SMOOTH & BLUR,SMASHBOX PRIMER 30ML PHOTO FINISH SUPER LGHT SMOOTH & BLUR,Default Ridgefield,6,6,0,0,0,0
,SMASHBOX PRIMER 30ML PHOTO FINISH SUPER LGHT SMOOTH & BLUR,SMASHBOX PRIMER 30ML PHOTO FINISH SUPER LGHT SMOOTH & BLUR,FBALYB Amazon,391,389,2,6,2,0
,SMASHBOX PRIMERIZER 15ML PHOTO FINISH TRAVEL SIZE,SMASHBOX PRIMERIZER 15ML PHOTO FINISH TRAVEL SIZE,Default Ridgefield,300,300,0,0,0,0
,SMASHBOX PRIMERIZER 15ML PHOTO FINISH TRAVEL SIZE,SMASHBOX PRIMERIZER 15ML PHOTO FINISH TRAVEL SIZE,FBALYB Amazon,1,1,0,0,0,0
,SMASHBOX SPRAY 116ML PHO FIN PRIMR H2O,SMASHBOX SPRAY 116ML PHO FIN PRIMR H2O,Default Ridgefield,797,797,0,0,0,0
,SMASHBOX SPRAY 116ML PHO FIN PRIMR H2O,SMASHBOX SPRAY 116ML PHO FIN PRIMR H2O,FBALYB Amazon,170,170,0,0,0,0
,Smuckers Creamy Peanut Butter 26oz,Smuckers Creamy Peanut Butter 26oz 2pk,FBALYB Amazon,58,58,0,0,0,0
,Snapware Pyrex 18 pc Glass Food Storage Set,Snapware Pyrex 18 pc Glass Food Storage Set,Default,0,0,0,0,0,2
,Snapware Pyrex 18 pc Glass Food Storage Set,Snapware Pyrex 18 pc Glass Food Storage Set,FBALYB Amazon,1,1,0,0,0,0
,Snapy Fit Bowl 10 oz 2pk,Snapy Fit Bowl 10 oz 2pk,FBALYB Amazon,-20,-20,0,0,0,0
,Snapy Fit Bowl 1 Qt,Snapy Fit Bowl 1 Qt,Default Ridgefield,100,100,0,0,0,0
,Snapy Fit Bowl 1 Qt 2pk,Snapy Fit Bowl 1 Qt 2pk,FBALYB Amazon,-3,-3,0,0,0,0
,Sneaker Ball Fresheners,Sneaker Ball Fresheners,Default,0,-305,305,0,0,0
,Sneaker Ball Fresheners,Sneaker Ball Fresheners,FBALYB Amazon,162,162,0,0,0,0
,Sneaker Ball Fresheners,Sneaker Ball Fresheners,WFS,-76,-76,0,0,0,0
,Snuggle Detergent,Snuggle Detergent,FBALYB Amazon,-180,-184,4,321,4,0
,Snuggle Scentables Liquid Booster 2ct,Snuggle Scentables Liquid Booster 2ct,FBALYB Amazon,1,1,0,0,0,0
,"SOCP DAGGER, FB, SHEATH","SOCP DAGGER, FB, SHEATH",Default,0,-7,7,0,0,0
,"SOCP DAGGER, FB, SHEATH","SOCP DAGGER, FB, SHEATH",FBALYB Amazon,46,24,22,0,22,0
,"SOCP DAGGER, FB, SHEATH 176BK","SOCP DAGGER, FB, SHEATH 176BK",Default,0,0,0,0,0,12
,"SOCP DAGGER, FB, SHEATH 176BK","SOCP DAGGER, FB, SHEATH 176BK",Default Ridgefield,75,75,0,0,0,0
,"SOCP DAGGER, FB, TRNR SHEATH","SOCP DAGGER, FB, TRNR SHEATH",FBALYB Amazon,-7,-9,2,0,2,0
,SOF Almond Gourmande BarSoap 6oz 4 pack,SOF Almond Gourmande BarSoap 6oz 4 pack,FBALYB Amazon,122,120,2,3,2,0
,SOF Bar Soap Blooming Jasmne 6oz 4 pack,SOF Bar Soap Blooming Jasmne 6oz 4 pack,FBALYB Amazon,39,37,2,0,2,0
,SOF Bar Soap Cote D'Azur 6oz 4pack,SOF Bar Soap Cote D'Azur 6oz 4pack,FBALYB Amazon,0,0,0,120,0,0
,SOF Bar Soap Green Tea 6oz 4 pack,SOF Bar Soap Green Tea 6oz 4 pack,FBALYB Amazon,106,101,5,0,5,0
,SOF Bar Soap Lavender Fields 6oz 4 pack,SOF Bar Soap Lavender Fields 6oz 4 pack,FBALYB Amazon,54,53,1,0,1,0
,SOF Foam Hnd Wsh Almnd Grmnd 8oz 3 pack,SOF Foam Hnd Wsh Almnd Grmnd 8oz 3 pack,FBALYB Amazon,142,139,3,0,3,0
,SOF Hand Wash Lemon Verbena 8oz. pack of 2,SOF Hand Wash Lemon Verbena 8oz. pack of 2,FBALYB Amazon,209,205,4,0,4,0
,SOF Hand Wash Orng Blssm Hny 8oz 3 pack,SOF Hand Wash Orng Blssm Hny 8oz 3 pack,FBALYB Amazon,109,108,1,0,1,0
,So French roast ground dark 12 oz,"Starbucks French Roast Ground Coffee, 12 oz",FBALYB Amazon,-2,-2,0,0,0,0
,Soft Scrub 2 pack,Soft Scrub 2 pack,FBALYB Amazon,-147,-149,2,165,2,0
,Soft Scrub 36 oz 3pk,Soft Scrub 36 oz 3pk,FBALYB Amazon,5,5,0,0,0,0
,Soft Scrub 3PK,Soft Scrub 3PK,FBALYB Amazon,41,28,13,7,13,0
,SoftScrub Coconut body wash 2pk,SoftScrub Coconut body wash 2pk,FBALYB Amazon,153,152,1,0,1,0
,Soft Scrub with Bleach Cleanser 36oz 4pk,Soft Scrub with Bleach Cleanser 36oz 4pk,FBALYB Amazon,-15,-18,3,51,3,0
,Softsoap Advanced Clean 40oz 2pk,Softsoap Advanced Clean 40oz 2pk,FBALYB Amazon,2,2,0,25,0,0
,Softsoap Aloe 64oz - 1 pack,Softsoap Aloe 64oz - 1 pack,Default,0,-93,93,0,0,0
,Softsoap Aloe 64oz - 1 pack,Softsoap Aloe 64oz - 1 pack,FBALYB Amazon,-323,-325,2,587,2,0
,Softsoap Aloe 64oz - 2 pk,Softsoap Aloe 64oz - 2 pk,FBALYB Amazon,275,274,1,289,1,0
,Softsoap Aloe 64oz - 3 pack,Softsoap Aloe 64oz - 3 pack,FBALYB Amazon,111,111,0,4,0,0
,Softsoap Aloe 64oz - 4 pack,Softsoap Aloe 64oz - 4 pack,FBALYB Amazon,11,11,0,1,0,0
,Softsoap Aloe 80oz 2pk,Softsoap Aloe 80oz 2pk,Default Ridgefield,894,894,0,0,0,0
,Softsoap Aloe 80oz 2pk,Softsoap Aloe 80oz 2pk,FBALYB Amazon,-176,-181,5,250,5,0
,Softsoap Aquarium Clear 2 Pack,Softsoap Aquarium Clear 2 Pack,FBALYB Amazon,-108,-108,0,239,0,0
,Softsoap Bodyscrub Coconut,Softsoap Bodyscrub Coconut,Default Ridgefield,9094,9094,0,0,0,0
,Softsoap Bodyscrub Coconut,Softsoap Bodyscrub Coconut,FBALYB Amazon,7,7,0,0,0,0
,Softsoap Bodyscrub Coconut 3pk,Softsoap Bodyscrub Coconut 3pk,FBALYB Amazon,-80,-81,1,120,1,0
,Softsoap BodyWash Citrus & Berry 2pk,Softsoap Body Wash Citrus & Berry 2pk,FBALYB Amazon,8,7,1,0,1,0
,Softsoap BodyWash Honey & Orange 2pk,Softsoap BodyWash Honey & Orange 2pk,FBALYB Amazon,10,5,5,0,5,0
,Softsoap Body Wash Pomegranate & Mango,Softsoap Body Wash Pomegranate & Mango,Default,0,-1342,1342,0,0,0
,Softsoap Body Wash Pomegranate & Mango,Softsoap Body Wash Pomegranate & Mango,Default Ridgefield,8613,8613,0,0,0,0
,Softsoap Clear Soap 64oz 1pk,Softsoap Clear Soap 64oz 1pk,Default,0,-448,448,0,0,0
,Softsoap Clear Soap 64oz 1pk,Softsoap Clear Soap 64oz 1pk,FBALYB Amazon,-30,-30,0,9,0,0
,Softsoap Clear Soap 64oz 3pk,Softsoap Clear Soap 64oz 3pk,FBALYB Amazon,99,99,0,0,0,0
,Softsoap Clear Soap 64oz 4pk,Softsoap Clear Soap 64oz 4pk,FBALYB Amazon,-11,-11,0,0,0,0
,Softsoap Handsoap Variety 4pk,Softsoap Handsoap Variety 4pk,FBALYB Amazon,1,1,0,0,0,0
,Softsoap Pomegranate & Mango 3pk,Softsoap Body Wash Pomegranate & Mango 3pk,FBALYB Amazon,98,98,0,0,0,0
,Softsoap Pomegrante Body Wash 2pack,Softsoap Pomegrante Body Wash 2pack,FBALYB Amazon,16,2,14,2,14,0
,Solo Heavyweight Forks 500ct,Solo Heavyweight Forks 500ct,Default,0,0,0,0,0,3
,Solo Heavyweight Forks 500ct,Solo Heavyweight Forks 500ct,FBALYB Amazon,-69,-69,0,90,0,0
,Solo HeavyWeight Knives 500ct,Solo HeavyWeight Knives 500ct,FBALYB Amazon,26,26,0,17,0,0
,Solo HeavyWeight Spoons 500ct,Solo HeavyWeight Spoons 500ct,Default,0,0,0,0,0,3
,Solo HeavyWeight Spoons 500ct,Solo HeavyWeight Spoons 500ct,FBALYB Amazon,-147,-147,0,198,0,0
,Sombra Warm Therapy - 8oz,Sombra Warm Therapy - 8oz,Avrami - Ebay,176,176,0,0,0,0
,Sombra Warm Therapy - 8oz,Sombra Warm Therapy - 8oz,Default Ridgefield,1,-28,29,0,0,0
,Sombra Warm Therapy - 8oz,Sombra Warm Therapy - 8oz,FBALYB Amazon,-98,-135,37,180,37,0
,Sombra Warm Therapy - 8oz,Sombra Warm Therapy - 8oz,WFS,159,159,0,0,0,0
,Sombra Warm Therapy - 8oz 2pk,Sombra Warm Therapy - 8oz 2pk,FBALYB Amazon,7,7,0,1,0,0
,Sombra Warm Therapy - 8oz 2pk,Sombra Warm Therapy - 8oz 2pk,WFS,-33,-33,0,0,0,0
,Sonicare DiamondClean Smart 9700 Lunar Blue,Philips Sonicare - DiamondClean Smart 9700 Rechargeable Toothbrush - Lunar Blue (HX9957/51),Default,0,0,0,0,0,1
,Sonicare E Series 8-Pack Brush Heads,Sonicare E Series 8-Pack Brush Heads,Default,0,0,0,0,0,1
,Sonicare E Series 8-Pack Brush Heads,Sonicare E Series 8-Pack Brush Heads,FBALYB Amazon,-1,-1,0,0,0,0
,Sonos - PLAY1 Black 2pk,Sonos - PLAY1 Black 2pk,FBALYB Amazon,-2,-2,0,0,0,0
,Sonos - PLAY1 White,Sonos - PLAY:1 Wireless Speaker for Streaming Music - White,Default,0,0,0,0,0,1
,Sonos - PLAY1 White 2pk,Sonos - PLAY1 White 2pk,FBALYB Amazon,-3,-3,0,0,0,0
,Sony BDP‑BX370,Sony Blu‑ray Player Bdp‑bx370,FBALYB Amazon,-1,-1,0,0,0,0
,Sony DVD-R 100 pk,Sony DVD-R 100 pk,FBALYB Amazon,-12,-12,0,14,0,0
,Sony MDR-DS6500 Headphones,Sony MDR-DS6500 Digital Wireless 3D Surround Headphones,Default,0,0,0,0,0,2
,Sony MDR-DS6500 Headphones,Sony MDR-DS6500 Digital Wireless 3D Surround Headphones,FBALYB Amazon,-5,-5,0,0,0,0
,Sony PS4 1TB NBA,Sony PS4 1TB NBA,FBALYB Amazon,-1,-1,0,0,0,0
,Sophie La Girafe- Gift Set Award 516510,Sophie La Girafe- Gift Set Award 516510,Default,0,-120,120,0,0,0
,Sophie La Girafe- Gift Set Award 516510,Sophie La Girafe- Gift Set Award 516510,FBALYB Amazon,1818,1788,30,25,30,0
,Sophie La Girafe- Gift Set Award 516510,Sophie La Girafe- Gift Set Award 516510,FBALYB Canada,0,0,0,42,0,0
,Sophie la Girafe So'Pure Coloring Teether 220120,Sophie la Girafe So'Pure Coloring Teether 220120,Default Oxford,2,2,0,0,0,0
,Sophie la Girafe So'Pure Coloring Teether 220120,Sophie la Girafe So'Pure Coloring Teether 220120,Default Ridgefield,663,661,2,0,0,0
,Sophie la Girafe So'Pure Coloring Teether 220120,Sophie la Girafe So'Pure Coloring Teether 220120,FBALYB Amazon,484,484,0,3,0,0
,Sophie la Girafe So'Pure Coloring Teether 220120,Sophie la Girafe So'Pure Coloring Teether 220120,FBALYB Canada,59,59,0,0,0,0
,Sophie La Girafe - So Pure Teether Giraffe 200318,Sophie La Girafe - So Pure Teether Giraffe 200318,Avrami - Ebay,240,240,0,0,0,0
,Sophie La Girafe - So Pure Teether Giraffe 200318,Sophie La Girafe - So Pure Teether Giraffe 200318,Default Ridgefield,692,692,0,0,0,0
,Sophie La Girafe - So Pure Teether Giraffe 200318,Sophie La Girafe - So Pure Teether Giraffe 200318,FBALYB Amazon,1529,1502,27,0,27,0
,Sophie La Girafe - So Pure Teether Giraffe 200318,Sophie La Girafe - So Pure Teether Giraffe 200318,WFS,-143,-143,0,0,0,0
,Sophie The Giraffe Polka Dots 616400,Sophie The Giraffe Polka Dots 616400,FBALYB Amazon,3505,3486,19,174,19,0
,Sophie The Giraffe Polka Dots 616400,Sophie The Giraffe Polka Dots 616400,FBALYB Canada,20,20,0,0,0,0
,Sorel Boot Black 10,Sorel Boot Black 10,FBALYB Amazon,-6,-6,0,0,0,0
,Sorel Boot Black 8,Sorel Boot Black 8,FBALYB Amazon,-4,-4,0,0,0,0
,Sorel Boot Black 9,Sorel Boot Black 9,Default,1,1,0,0,0,0
,Sorel Boot Black 9,Sorel Boot Black 9,FBALYB Amazon,-8,-9,1,0,1,0
,Sorel Boot Shale 10,Sorel Boot Shale 10,FBALYB Amazon,-2,-2,0,2,0,0
,Sorel Boot Shale 11,Sorel Boot Shale 11,Default,2,2,0,0,0,0
,Sorel Boot Shale 11,Sorel Boot Shale 11,FBALYB Amazon,-5,-5,0,0,0,0
,Sorel Boot Shale 8,Sorel Boot Shale 8,FBALYB Amazon,-2,-2,0,0,0,0
,Sorel Boot Shale 9,Sorel Boot Shale 9,FBALYB Amazon,-4,-4,0,0,0,0
,Sorel Emelie Chelsea Boots Black Women's Size 10 1749291-010,Sorel Emelie Chelsea Boots Black Women's Size 10 1749291-010,FBALYB Amazon,-11,-11,0,0,0,0
,Sorel Emelie Chelsea Boots Black Women's Size 10.5 1749291-010,Sorel Emelie Chelsea Boots Black Women's Size 10.5 1749291-010,FBALYB Amazon,-3,-3,0,0,0,0
,Sorel Emelie Chelsea Boots Black Women's Size 11 1749291-010,Sorel Emelie Chelsea Boots Black Women's Size 11 1749291-010,Default Ridgefield,24,24,0,0,0,0
,Sorel Emelie Chelsea Boots Black Women's Size 11 1749291-010,Sorel Emelie Chelsea Boots Black Women's Size 11 1749291-010,FBALYB Amazon,-2,-2,0,0,0,0
,Sorel Emelie Chelsea Boots Black Women's Size 12 1749291-010,Sorel Emelie Chelsea Boots Black Women's Size 12 1749291-010,FBALYB Amazon,-4,-4,0,0,0,0
,Sorel Emelie Chelsea Boots Black Women's Size 6 1749291-010,Sorel Emelie Chelsea Boots Black Women's Size 6 1749291-010,FBALYB Amazon,-2,-2,0,0,0,0
,Sorel Emelie Chelsea Boots Black Women's Size 6.5 1749291-010,Sorel Emelie Chelsea Boots Black Women's Size 6.5 1749291-010,FBALYB Amazon,1,1,0,1,0,0
,Sorel Emelie Chelsea Boots Black Women's Size 7 1749291-010,Sorel Emelie Chelsea Boots Black Women's Size 7 1749291-010,FBALYB Amazon,-5,-6,1,0,1,0
,Sorel Emelie Chelsea Boots Black Women's Size 7.5 1749291-010,Sorel Emelie Chelsea Boots Black Women's Size 7.5 1749291-010,FBALYB Amazon,1,1,0,0,0,0
,Sorel Emelie Chelsea Boots Black Women's Size 8 1749291-010,Sorel Emelie Chelsea Boots Black Women's Size 8 1749291-010,FBALYB Amazon,-10,-10,0,0,0,0
,Sorel Emelie Chelsea Boots Black Women's Size 8.5 1749291-010,Sorel Emelie Chelsea Boots Black Women's Size 8.5 1749291-010,FBALYB Amazon,-18,-18,0,0,0,0
,Sorel Emelie Chelsea Boots Black Women's Size 9 1749291-010,Sorel Emelie Chelsea Boots Black Women's Size 9 1749291-010,FBALYB Amazon,-18,-18,0,0,0,0
,Sorel Emelie Chelsea Boots Black Women's Size 9.5 1749291-010,Sorel Emelie Chelsea Boots Black Women's Size 9.5 1749291-010,FBALYB Amazon,-14,-14,0,0,0,0
,Sorel Emelie Chelsea Boots Cattail Women's Size 10 1749291-908,Sorel Emelie Chelsea Boots Cattail Women's Size 10 1749291-908,FBALYB Amazon,-13,-13,0,0,0,0
,Sorel Emelie Chelsea Boots Cattail Women's Size 10.5 1749291-908,Sorel Emelie Chelsea Boots Cattail Women's Size 10.5 1749291-908,FBALYB Amazon,-3,-3,0,0,0,0
,Sorel Emelie Chelsea Boots Cattail Women's Size 11 1749291-908,Sorel Emelie Chelsea Boots Cattail Women's Size 11 1749291-908,Default Ridgefield,1,1,0,0,0,0
,Sorel Emelie Chelsea Boots Cattail Women's Size 11 1749291-908,Sorel Emelie Chelsea Boots Cattail Women's Size 11 1749291-908,FBALYB Amazon,-5,-5,0,0,0,0
,Sorel Emelie Chelsea Boots Cattail Women's Size 6 1749291-908,Sorel Emelie Chelsea Boots Cattail Women's Size 6 1749291-908,FBALYB Amazon,8,8,0,0,0,0
,Sorel Emelie Chelsea Boots Cattail Women's Size 6.5 1749291-908,Sorel Emelie Chelsea Boots Cattail Women's Size 6.5 1749291-908,Default,1,1,0,0,0,0
,Sorel Emelie Chelsea Boots Cattail Women's Size 6.5 1749291-908,Sorel Emelie Chelsea Boots Cattail Women's Size 6.5 1749291-908,FBALYB Amazon,-6,-6,0,0,0,0
,Sorel Emelie Chelsea Boots Cattail Women's Size 7 1749291-908,Sorel Emelie Chelsea Boots Cattail Women's Size 7 1749291-908,FBALYB Amazon,-8,-8,0,0,0,0
,Sorel Emelie Chelsea Boots Cattail Women's Size 7.5 1749291-908,Sorel Emelie Chelsea Boots Cattail Women's Size 7.5 1749291-908,Default,2,2,0,0,0,0
,Sorel Emelie Chelsea Boots Cattail Women's Size 7.5 1749291-908,Sorel Emelie Chelsea Boots Cattail Women's Size 7.5 1749291-908,FBALYB Amazon,-5,-5,0,0,0,0
,Sorel Emelie Chelsea Boots Cattail Women's Size 8 1749291-908,Sorel Emelie Chelsea Boots Cattail Women's Size 8 1749291-908,FBALYB Amazon,-8,-8,0,0,0,0
,Sorel Emelie Chelsea Boots Cattail Women's Size 8.5 1749291-908,Sorel Emelie Chelsea Boots Cattail Women's Size 8.5 1749291-908,FBALYB Amazon,-3,-3,0,0,0,0
,Sorel Emelie Chelsea Boots Cattail Women's Size 9 1749291-908,Sorel Emelie Chelsea Boots Cattail Women's Size 9 1749291-908,FBALYB Amazon,-22,-22,0,0,0,0
,Sorel Emelie Chelsea Boots Cattail Women's Size 9.5 1749291-908,Sorel Emelie Chelsea Boots Cattail Women's Size 9.5 1749291-908,FBALYB Amazon,-8,-8,0,0,0,0
,Sorel Emelie Chelsea Boots Quarry Women's Size 10 1749291-053,Sorel Emelie Chelsea Boots Quarry Women's Size 10 1749291-053,FBALYB Amazon,-4,-4,0,0,0,0
,Sorel Emelie Chelsea Boots Quarry Women's Size 10.5 1749291-053,Sorel Emelie Chelsea Boots Quarry Women's Size 10.5 1749291-053,FBALYB Amazon,1,1,0,0,0,0
,Sorel Emelie Chelsea Boots Quarry Women's Size 11 1749291-053,Sorel Emelie Chelsea Boots Quarry Women's Size 11 1749291-053,FBALYB Amazon,3,-2,5,0,5,0
,Sorel Emelie Chelsea Boots Quarry Women's Size 12 1749291-053,Sorel Emelie Chelsea Boots Quarry Women's Size 12 1749291-053,FBALYB Amazon,-3,-3,0,0,0,0
,Sorel Emelie Chelsea Boots Quarry Women's Size 6 1749291-053,Sorel Emelie Chelsea Boots Quarry Women's Size 6 1749291-053,FBALYB Amazon,2,2,0,0,0,0
,Sorel Emelie Chelsea Boots Quarry Women's Size 6.5 1749291-053,Sorel Emelie Chelsea Boots Quarry Women's Size 6.5 1749291-053,FBALYB Amazon,3,3,0,1,0,0
,Sorel Emelie Chelsea Boots Quarry Women's Size 7 1749291-053,Sorel Emelie Chelsea Boots Quarry Women's Size 7 1749291-053,FBALYB Amazon,-7,-7,0,0,0,0
,Sorel Emelie Chelsea Boots Quarry Women's Size 7.5 1749291-053,Sorel Emelie Chelsea Boots Quarry Women's Size 7.5 1749291-053,FBALYB Amazon,-1,-1,0,0,0,0
,Sorel Emelie Chelsea Boots Quarry Women's Size 8 1749291-053,Sorel Emelie Chelsea Boots Quarry Women's Size 8 1749291-053,FBALYB Amazon,-5,-5,0,0,0,0
,Sorel Emelie Chelsea Boots Quarry Women's Size 8.5 1749291-053,Sorel Emelie Chelsea Boots Quarry Women's Size 8.5 1749291-053,FBALYB Amazon,-5,-5,0,0,0,0
,Sorel Emelie Chelsea Boots Quarry Women's Size 9 1749291-053,Sorel Emelie Chelsea Boots Quarry Women's Size 9 1749291-053,FBALYB Amazon,-10,-10,0,0,0,0
,Sorel Emelie Chelsea Boots Quarry Women's Size 9.5 1749291-053,Sorel Emelie Chelsea Boots Quarry Women's Size 9.5 1749291-053,FBALYB Amazon,-5,-6,1,0,1,0
,Sorel Joan Of Arctic Wedge Black Women's Size 10 1808551-010,Sorel Joan Of Arctic Wedge Black Women's Size 10 1808551-010,FBALYB Amazon,12,11,1,0,1,0
,Sorel Joan Of Arctic Wedge Black Women's Size 10 1808561010,Sorel Joan Of Arctic Wedge Black Women's Size 10 1808561010,FBALYB Amazon,3,2,1,0,1,0
,Sorel Joan Of Arctic Wedge Black Women's Size 10.5 1808551-010,Sorel Joan Of Arctic Wedge Black Women's Size 10.5 1808551-010,FBALYB Amazon,25,25,0,0,0,0
,Sorel Joan Of Arctic Wedge Black Women's Size 11 1808551-010,Sorel Joan Of Arctic Wedge Black Women's Size 11 1808551-010,FBALYB Amazon,9,9,0,0,0,0
,Sorel Joan Of Arctic Wedge Black Women's Size 5 1808551-010,Sorel Joan Of Arctic Wedge Black Women's Size 5 1808551-010,FBALYB Amazon,-2,-2,0,0,0,0
,Sorel Joan Of Arctic Wedge Black Women's Size 5.5 1808551-010,Sorel Joan Of Arctic Wedge Black Women's Size 5.5 1808551-010,FBALYB Amazon,-1,-1,0,0,0,0
,Sorel Joan Of Arctic Wedge Black Women's Size 6 1808551-010,Sorel Joan Of Arctic Wedge Black Women's Size 6 1808551-010,FBALYB Amazon,43,43,0,0,0,0
,Sorel Joan Of Arctic Wedge Black Women's Size 6 1808561010,Sorel Joan Of Arctic Wedge Black Women's Size 6 1808561010,FBALYB Amazon,3,3,0,0,0,0
,Sorel Joan Of Arctic Wedge Black Women's Size 6.5 1808551-010,Sorel Joan Of Arctic Wedge Black Women's Size 6.5 1808551-010,FBALYB Amazon,-6,-6,0,0,0,0
,Sorel Joan Of Arctic Wedge Black Women's Size 6.5 1808561010,Sorel Joan Of Arctic Wedge Black Women's Size 6.5 1808561010,FBALYB Amazon,-1,-1,0,0,0,0
,Sorel Joan Of Arctic Wedge Black Women's Size 7 1808551-010,Sorel Joan Of Arctic Wedge Black Women's Size 7 1808551-010,FBALYB Amazon,-16,-17,1,0,1,0
,Sorel Joan Of Arctic Wedge Black Women's Size 7 1808561010,Sorel Joan Of Arctic Wedge Black Women's Size 7 1808561010,FBALYB Amazon,-4,-4,0,0,0,0
,Sorel Joan Of Arctic Wedge Black Women's Size 7.5 1808551-010,Sorel Joan Of Arctic Wedge Black Women's Size 7.5 1808551-010,FBALYB Amazon,-3,-5,2,0,2,0
,Sorel Joan Of Arctic Wedge Black Women's Size 7.5 1808561010,Sorel Joan Of Arctic Wedge Black Women's Size 7.5 1808561010,FBALYB Amazon,-5,-5,0,0,0,0
,Sorel Joan Of Arctic Wedge Black Women's Size 8 1808551-010,Sorel Joan Of Arctic Wedge Black Women's Size 8 1808551-010,FBALYB Amazon,-23,-23,0,0,0,0
,Sorel Joan Of Arctic Wedge Black Women's Size 8 1808561010,Sorel Joan Of Arctic Wedge Black Women's Size 8 1808561010,FBALYB Amazon,-2,-2,0,0,0,0
,Sorel Joan Of Arctic Wedge Black Women's Size 8.5 1808551-010,Sorel Joan Of Arctic Wedge Black Women's Size 8.5 1808551-010,FBALYB Amazon,-22,-22,0,0,0,0
,Sorel Joan Of Arctic Wedge Black Women's Size 8.5 1808561010,Sorel Joan Of Arctic Wedge Black Women's Size 8.5 1808561010,FBALYB Amazon,-2,-2,0,0,0,0
,Sorel Joan Of Arctic Wedge Black Women's Size 9 1808551-010,Sorel Joan Of Arctic Wedge Black Women's Size 9 1808551-010,FBALYB Amazon,-3,-6,3,0,3,0
,Sorel Joan Of Arctic Wedge Black Women's Size 9 1808561010,Sorel Joan Of Arctic Wedge Black Women's Size 9 1808561010,FBALYB Amazon,-4,-4,0,0,0,0
,Sorel Joan Of Arctic Wedge Black Women's Size 9.5 1808551-010,Sorel Joan Of Arctic Wedge Black Women's Size 9.5 1808551-010,FBALYB Amazon,-3,-4,1,0,1,0
,Sorel Joan Of Arctic Wedge Black Women's Size 9.5 1808561010,Sorel Joan Of Arctic Wedge Black Women's Size 9.5 1808561010,FBALYB Amazon,6,5,1,0,1,0
,Sorel Mens Caribou Buff Size 10,Sorel Mens Caribou Buff Size 10,FBALYB Amazon,-37,-37,0,3,0,0
,Sorel Mens Caribou Buff Size 10.5,Sorel Mens Caribou Buff Size 10.5,FBALYB Amazon,-14,-14,0,0,0,0
,Sorel Mens Caribou Buff Size 11,Sorel Mens Caribou Buff Size 11,FBALYB Amazon,-40,-40,0,1,0,0
,Sorel Mens Caribou Buff Size 12,Sorel Mens Caribou Buff Size 12,FBALYB Amazon,-8,-8,0,0,0,0
,Sorel Mens Caribou Buff Size 13,Sorel Mens Caribou Buff Size 13,FBALYB Amazon,-7,-7,0,0,0,0
,Sorel Mens Caribou Buff Size 7.5,Sorel Mens Caribou Buff Size 7.5,FBALYB Amazon,-5,-5,0,0,0,0
,Sorel Mens Caribou Buff Size 8,Sorel Mens Caribou Buff Size 8,FBALYB Amazon,-16,-16,0,0,0,0
,Sorel Mens Caribou Buff Size 8.5,Sorel Mens Caribou Buff Size 8.5,Default,0,-1,1,0,0,0
,Sorel Mens Caribou Buff Size 8.5,Sorel Mens Caribou Buff Size 8.5,FBALYB Amazon,-6,-6,0,0,0,0
,Sorel Mens Caribou Buff Size 9,Sorel Mens Caribou Buff Size 9,FBALYB Amazon,-16,-16,0,2,0,0
,Sorel Mens Caribou Buff Size 9.5,Sorel Mens Caribou Buff Size 9.5,FBALYB Amazon,-9,-9,0,0,0,0
,Sorel Out 'N About Plus Boots Elk Women's Size 10 1809121286,Sorel Out 'N About Plus Boots Elk Women's Size 10 1809121286,FBALYB Amazon,-7,-7,0,0,0,0
,Sorel Out 'N About Plus Boots Elk Women's Size 10.5 1809121286,Sorel Out 'N About Plus Boots Elk Women's Size 10.5 1809121286,FBALYB Amazon,-4,-4,0,0,0,0
,Sorel Out 'N About Plus Boots Elk Women's Size 6.5 1809121286,Sorel Out 'N About Plus Boots Elk Women's Size 6.5 1809121286,Default Ridgefield,1,1,0,0,0,0
,Sorel Out 'N About Plus Boots Elk Women's Size 6.5 1809121286,Sorel Out 'N About Plus Boots Elk Women's Size 6.5 1809121286,FBALYB Amazon,-1,-1,0,0,0,0
,Sorel Out 'N About Plus Boots Elk Women's Size 7 1809121286,Sorel Out 'N About Plus Boots Elk Women's Size 7 1809121286,FBALYB Amazon,-3,-3,0,0,0,0
,Sorel Out 'N About Plus Boots Elk Women's Size 7.5 1809121286,Sorel Out 'N About Plus Boots Elk Women's Size 7.5 1809121286,FBALYB Amazon,-7,-7,0,0,0,0
,Sorel Out 'N About Plus Boots Elk Women's Size 8 1809121286,Sorel Out 'N About Plus Boots Elk Women's Size 8 1809121286,FBALYB Amazon,-1,-1,0,0,0,0
,Sorel Out 'N About Plus Boots Elk Women's Size 8.5 1809121286,Sorel Out 'N About Plus Boots Elk Women's Size 8.5 1809121286,FBALYB Amazon,-2,-2,0,0,0,0
,Sorel Out 'N About Plus Boots Elk Women's Size 9 1809121286,Sorel Out 'N About Plus Boots Elk Women's Size 9 1809121286,Default,1,1,0,0,0,0
,Sorel Out 'N About Plus Boots Elk Women's Size 9 1809121286,Sorel Out 'N About Plus Boots Elk Women's Size 9 1809121286,FBALYB Amazon,-2,-2,0,0,0,0
,Sorel Out 'N About Plus Boots Elk Women's Size 9.5 1809121286,Sorel Out 'N About Plus Boots Elk Women's Size 9.5 1809121286,FBALYB Amazon,-3,-3,0,0,0,0
,Sorel Out 'N About Plus Boots Major Women's Size 10 1809121245,Sorel Out 'N About Plus Boots Major Women's Size 10 1809121245,FBALYB Amazon,-3,-3,0,0,0,0
,Sorel Out 'N About Plus Boots Major Women's Size 10.5 1809121245,Sorel Out 'N About Plus Boots Major Women's Size 10.5 1809121245,FBALYB Amazon,-1,-1,0,0,0,0
,Sorel Out 'N About Plus Boots Major Women's Size 6 1809121245,Sorel Out 'N About Plus Boots Major Women's Size 6 1809121245,FBALYB Amazon,-1,-1,0,0,0,0
,Sorel Out 'N About Plus Boots Major Women's Size 6.5 1809121245,Sorel Out 'N About Plus Boots Major Women's Size 6.5 1809121245,FBALYB Amazon,-2,-2,0,0,0,0
,Sorel Out 'N About Plus Boots Major Women's Size 7 1809121245,Sorel Out 'N About Plus Boots Major Women's Size 7 1809121245,FBALYB Amazon,-6,-6,0,0,0,0
,Sorel Out 'N About Plus Boots Major Women's Size 7.5 1809121245,Sorel Out 'N About Plus Boots Major Women's Size 7.5 1809121245,FBALYB Amazon,-11,-11,0,0,0,0
,Sorel Out 'N About Plus Boots Major Women's Size 8 1809121245,Sorel Out 'N About Plus Boots Major Women's Size 8 1809121245,FBALYB Amazon,-11,-11,0,0,0,0
,Sorel Out 'N About Plus Boots Major Women's Size 8.5 1809121245,Sorel Out 'N About Plus Boots Major Women's Size 8.5 1809121245,FBALYB Amazon,-5,-5,0,0,0,0
,Sorel Out 'N About Plus Boots Major Women's Size 9 1809121245,Sorel Out 'N About Plus Boots Major Women's Size 9 1809121245,FBALYB Amazon,-4,-4,0,0,0,0
,Sorel Out 'N About Plus Boots Major Women's Size 9.5 1809121245,Sorel Out 'N About Plus Boots Major Women's Size 9.5 1809121245,FBALYB Amazon,-6,-6,0,0,0,0
,Sorry Not Sorry,Sorry Not Sorry,Default Ridgefield,300,300,0,0,0,0
,"S.O.S. Steel Wool Soap Pads, 50ct","S.O.S. Steel Wool Soap Pads, 50ct",Default,0,-541,541,0,0,104
,"S.O.S. Steel Wool Soap Pads, 50ct","S.O.S. Steel Wool Soap Pads, 50ct",Default Ridgefield,762,762,0,0,0,0
,"S.O.S. Steel Wool Soap Pads, 50ct","S.O.S. Steel Wool Soap Pads, 50ct",FBALYB Amazon,1121,1042,79,366,79,0
,"S.O.S. Steel Wool Soap Pads, 50ct","S.O.S. Steel Wool Soap Pads, 50ct",FBALYB Canada,0,0,0,50,0,0
,"S.O.S. Steel Wool Soap Pads, 50ct 2pk","S.O.S. Steel Wool Soap Pads, 50ct 2pk",FBALYB Amazon,14,14,0,4,0,0
,"S.O.S. Steel Wool Soap Pads, 50ct 2pk","S.O.S. Steel Wool Soap Pads, 50ct 2pk",FBALYB Canada,0,0,0,25,0,0
,"Spangler Dum Dums Original Pops, 360ct","Spangler Dum Dums Original Pops, 360ct",FBALYB Amazon,-239,-264,25,91,25,0
,SPECIALK_2PK,SPECIALK_2PK,FBALYB Amazon,3,0,3,0,3,0
,Special K Bars,Special K Bars,FBALYB Amazon,-36,-36,0,48,0,0
,Spectrastone Green Aquarium Gravel 5lb,Spectrastone Green Aquarium Gravel 5lb,FBALYB Amazon,-7,-7,0,7,0,0
,Spectrastone Shallow Creek Gravel 5lb,Spectrastone Shallow Creek Gravel 5lb,Default,0,0,0,0,0,150
,Spectrastone Shallow Creek Gravel 5lb,Spectrastone Shallow Creek Gravel 5lb,FBALYB Amazon,-4,-4,0,0,0,0
,Speedo Adult Swim Googles,Speedo Adult Swim Googles,FBALYB Amazon,-5,-5,0,0,0,0
,Speedo Bathing Suit blue with color stripes Style #8776779 Size 10,Speedo Bathing Suit blue with color stripes Style #8776779 Size 10,Default Ridgefield,4,4,0,0,0,0
,Speedo Bathing Suit blue with color stripes Style #8776779 Size 8,Speedo Bathing Suit blue with color stripes Style #8776779 Size 8,Default Ridgefield,3,3,0,0,0,0
,Speedo Bathing Suit light blue with birds Costco D31 657899 Size 10,Speedo Bathing Suit light blue with birds Costco D31 657899 Size 10,Default Ridgefield,1,1,0,0,0,0
,Speedo Bathing Suit light blue with birds Costco D31 657899 Size 7,Speedo Bathing Suit light blue with birds Costco D31 657899 Size 7,Default Ridgefield,2,2,0,0,0,0
,Speedo Bathing Suit light blue with color stripes Costco D31 8776778 Size 5,Speedo Bathing Suit light blue with color stripes Costco D31 8776778 Size 5,Default Ridgefield,7,7,0,0,0,0
,Speedo Bathing Suit light blue with color stripes Costco D31 8776778 Size 6,Speedo Bathing Suit light blue with color stripes Costco D31 8776778 Size 6,Default Ridgefield,12,12,0,0,0,0
,Speedo Bathing Suit light blue with color stripes Costco D31 8776779 Size 12,Speedo Bathing Suit light blue with color stripes Costco D31 8776779 Size 12,Default Ridgefield,1,1,0,0,0,0
,Speedo Bathing Suit light blue with color stripes Costco D31 8776779 Size 14,Speedo Bathing Suit light blue with color stripes Costco D31 8776779 Size 14,Default Ridgefield,1,1,0,0,0,0
,Speedo Bathing Suit light blue with color stripes Costco D31 8776779 Size 7,Speedo Bathing Suit light blue with color stripes Costco D31 8776779 Size 7,Default Ridgefield,15,15,0,0,0,0
,Speedo Bathing Suit Master,Speedo Bathing Suit Master,Avrami - Ebay,230,230,0,0,0,0
,Speedo Bathing Suit Purple with color spots Costco D31 657899 Size 10,Speedo Bathing Suit Purple with color spots Costco D31 657899 Size 10,Default Ridgefield,63,63,0,0,0,0
,Speedo Bathing Suit ultra black Purple Size 6 Styke 7722136,Speedo Bathing Suit ultra black Purple Size 6 Styke 7722136,Default Ridgefield,1,1,0,0,0,0
,Speedo Blue and Purple Bathing Suit Costco D31 657899 Size 10,Speedo Blue and Purple Bathing Suit Costco D31 657899 Size 10,Default Ridgefield,71,71,0,0,0,0
,Speedo Blue and Purple Bathing Suit Costco D31 657899 Size 12,Speedo Blue and Purple Bathing Suit Costco D31 657899 Size 12,Default Ridgefield,69,69,0,0,0,0
,Speedo Blue and Purple Bathing Suit Costco D31 657899 Size 14,Speedo Blue and Purple Bathing Suit Costco D31 657899 Size 14,Default Ridgefield,34,34,0,0,0,0
,Speedo Blue and Purple Bathing Suit Costco D31 657899 Size 16,Speedo Blue and Purple Bathing Suit Costco D31 657899 Size 16,Default Ridgefield,30,30,0,0,0,0
,Speedo Blue and Purple Bathing Suit Costco D31 657899 Size 5,Speedo Blue and Purple Bathing Suit Costco D31 657899 Size 5,Default Ridgefield,64,64,0,0,0,0
,Speedo Blue and Purple Bathing Suit Costco D31 657899 Size 6,Speedo Blue and Purple Bathing Suit Costco D31 657899 Size 6,Default Ridgefield,40,40,0,0,0,0
,Speedo Blue and Purple Bathing Suit Costco D31 657899 Size 7,Speedo Blue and Purple Bathing Suit Costco D31 657899 Size 7,Default Ridgefield,39,39,0,0,0,0
,Speedo Blue and Purple Bathing Suit Costco D31 657899 Size 8,Speedo Blue and Purple Bathing Suit Costco D31 657899 Size 8,Default Ridgefield,39,39,0,0,0,0
,Speedo Blue/Leaves Size 10 Style # 8776777,Speedo Blue/Leaves Size 10 Style # 8776777,Default Ridgefield,54,54,0,0,0,0
,Speedo Blue/Leaves Size 16 Style # 8776777,Speedo Blue/Leaves Size 16 Style # 8776777,FBALYB Amazon,1,1,0,0,0,0
,Speedo Blue/Leaves Size 8 Style # 8776777,Speedo Blue/Leaves Size 8 Style # 8776777,FBALYB Amazon,-2,-2,0,0,0,0
,Speedo Blue/Stripes Size 10 Style # 8776779,Speedo Blue/Stripes Size 10 Style # 8776779,Default Ridgefield,9,9,0,0,0,0
,Speedo Blue/Stripes Size 10 Style # 8776779,Speedo Blue/Stripes Size 10 Style # 8776779,FBALYB Amazon,-5,-5,0,0,0,0
,Speedo Blue/Stripes Size 12 Style # 8776779,Speedo Blue/Stripes Size 12 Style # 8776779,Default Ridgefield,3,3,0,0,0,0
,Speedo Blue/Stripes Size 12 Style # 8776779,Speedo Blue/Stripes Size 12 Style # 8776779,FBALYB Amazon,-7,-7,0,0,0,0
,Speedo Blue/Stripes Size 14 Style # 8776779,Speedo Blue/Stripes Size 14 Style # 8776779,Default Ridgefield,4,4,0,0,0,0
,Speedo Blue/Stripes Size 14 Style # 8776779,Speedo Blue/Stripes Size 14 Style # 8776779,FBALYB Amazon,-3,-3,0,0,0,0
,Speedo Blue/Stripes Size 16 Style # 8776779,Speedo Blue/Stripes Size 16 Style # 8776779,Default Ridgefield,2,2,0,0,0,0
,Speedo Blue/Stripes Size 16 Style # 8776779,Speedo Blue/Stripes Size 16 Style # 8776779,FBALYB Amazon,-1,-1,0,0,0,0
,Speedo Blue/Stripes Size 5 Style # 8776778,Speedo Blue/Stripes Size 5 Style # 8776778,FBALYB Amazon,48,48,0,0,0,0
,Speedo Blue/Stripes Size 6 Style # 8776778,Speedo Blue/Stripes Size 6 Style # 8776778,FBALYB Amazon,19,19,0,0,0,0
,Speedo Blue/Stripes Size 7 Style # 8776779,Speedo Blue/Stripes Size 7 Style # 8776779,Default Ridgefield,5,5,0,0,0,0
,Speedo Blue/Stripes Size 7 Style # 8776779,Speedo Blue/Stripes Size 7 Style # 8776779,FBALYB Amazon,119,119,0,0,0,0
,Speedo Blue/Stripes Size 8 Style # 8776779,Speedo Blue/Stripes Size 8 Style # 8776779,Default Ridgefield,6,6,0,0,0,0
,Speedo Blue/Stripes Size 8 Style # 8776779,Speedo Blue/Stripes Size 8 Style # 8776779,FBALYB Amazon,3,3,0,0,0,0
,Speedo front Shirred Blue Size 6 Style#  7722094,Speedo front Shirred Blue Size 6 Style#  7722094,Default Ridgefield,1,1,0,0,0,0
,Speedo Goggles Blue Blue Green,Speedo Goggles Blue Blue Green,FBALYB Amazon,-2,-3,1,0,1,0
,Speedo Goggles Multi Stripe,Speedo Goggles Multi Stripe,Default,0,-70,70,0,0,0
,Speedo Goggles Multi Stripe,Speedo Goggles Multi Stripe,FBALYB Amazon,-24,-29,5,0,5,0
,Speedo Junior Swim Goggles 6-14,Speedo Junior Swim Goggles 6-14,FBALYB Amazon,-1,-1,0,0,0,0
,Speedo Kids Goggles Blue,Speedo Kids Goggles Blue,FBALYB Amazon,2,2,0,0,0,0
,Speedo Kids Goggles Pink,Speedo Kids Goggles Pink,FBALYB Amazon,9,9,0,0,0,0
,Speedo Purple/Pink Size 5 Style # 8776768,Speedo Purple/Pink Size 5 Style # 8776768,FBALYB Amazon,-2,-2,0,0,0,0
,Speedo Purple/Pink Size 8 Style # 8776769,Speedo Purple/Pink Size 8 Style # 8776769,FBALYB Amazon,-1,-1,0,0,0,0
,Speedo Shirred Princess Teal One-Piece Swim Suit Size 10 Style # 7722132,Speedo Shirred Princess Teal One-Piece Swim Suit Size 10 Style # 7722132,Default Ridgefield,1,1,0,0,0,0
,Speedo Size 10 Style # 8776771,Speedo Size 10 Style # 8776771,Default Ridgefield,58,58,0,0,0,0
,Speedo Size 10 Style # 8776773,Speedo Size 10 Style # 8776773,Default Ridgefield,187,187,0,0,0,0
,Speedo Size 10 Style # 8776775,Speedo Size 10 Style # 8776775,Default Ridgefield,133,133,0,0,0,0
,Speedo Size 10 Style # 8776781,Speedo Size 10 Style # 8776781,Default Ridgefield,70,70,0,0,0,0
,Speedo Size 10 Style # 8776783,Speedo Size 10 Style # 8776783,Default Ridgefield,3,3,0,0,0,0
,Speedo Size 12 Style # 8776771,Speedo Size 12 Style # 8776771,Default Ridgefield,58,58,0,0,0,0
,Speedo Size 12 Style # 8776773,Speedo Size 12 Style # 8776773,Default Ridgefield,177,177,0,0,0,0
,Speedo Size 12 Style # 8776775,Speedo Size 12 Style # 8776775,Default Ridgefield,127,127,0,0,0,0
,Speedo Size 12 Style # 8776781,Speedo Size 12 Style # 8776781,Default Ridgefield,161,161,0,0,0,0
,Speedo Size 12 Style # 8776783,Speedo Size 12 Style # 8776783,Default Ridgefield,13,13,0,0,0,0
,Speedo Size 14 Style # 8776771,Speedo Size 14 Style # 8776771,Default Ridgefield,29,29,0,0,0,0
,Speedo Size 14 Style # 8776773,Speedo Size 14 Style # 8776773,Default Ridgefield,60,60,0,0,0,0
,Speedo Size 14 Style # 8776775,Speedo Size 14 Style # 8776775,Default Ridgefield,147,147,0,0,0,0
,Speedo Size 14 Style # 8776781,Speedo Size 14 Style # 8776781,Default Ridgefield,168,168,0,0,0,0
,Speedo Size 14 Style # 8776783,Speedo Size 14 Style # 8776783,Default Ridgefield,77,77,0,0,0,0
,Speedo Size 16 Style # 8776771,Speedo Size 16 Style # 8776771,Default Ridgefield,29,29,0,0,0,0
,Speedo Size 16 Style # 8776773,Speedo Size 16 Style # 8776773,Default Ridgefield,29,29,0,0,0,0
,Speedo Size 16 Style # 8776775,Speedo Size 16 Style # 8776775,Default Ridgefield,67,67,0,0,0,0
,Speedo Size 16 Style # 8776781,Speedo Size 16 Style # 8776781,Default Ridgefield,99,99,0,0,0,0
,Speedo Size 16  Style # 8776783,Speedo Size 16  Style # 8776783,Default Ridgefield,93,93,0,0,0,0
,Speedo Size 5 Style # 8776770,Speedo Size 5 Style # 8776770,Default Ridgefield,24,24,0,0,0,0
,Speedo Size 5 Style # 8776772,Speedo Size 5 Style # 8776772,Default Ridgefield,63,63,0,0,0,0
,Speedo Size 5 Style # 8776774,Speedo Size 5 Style # 8776774,Default Ridgefield,24,24,0,0,0,0
,Speedo Size 5 Style # 8776775,Speedo Size 5 Style # 8776775,Default Ridgefield,45,45,0,0,0,0
,Speedo Size 5 Style # 8776780,Speedo Size 5 Style # 8776780,Default Ridgefield,47,47,0,0,0,0
,Speedo Size 5 Style # 8776783,Speedo Size 5 Style # 8776783,Default Ridgefield,5,5,0,0,0,0
,Speedo Size 6 Style # 8776770,Speedo Size 6 Style # 8776770,Default Ridgefield,24,24,0,0,0,0
,Speedo Size 6 Style # 8776772,Speedo Size 6 Style # 8776772,Default Ridgefield,61,61,0,0,0,0
,Speedo Size 6 Style # 8776774,Speedo Size 6 Style # 8776774,Default Ridgefield,136,136,0,0,0,0
,Speedo Size 6 Style # 8776780,Speedo Size 6 Style # 8776780,Default Ridgefield,75,75,0,0,0,0
,Speedo Size 6 Style # 8776783,Speedo Size 6 Style # 8776783,Default Ridgefield,45,45,0,0,0,0
,Speedo Size 7 Style # 8776771,Speedo Size 7 Style # 8776771,Default Ridgefield,29,29,0,0,0,0
,Speedo Size 7 Style # 8776773,Speedo Size 7 Style # 8776773,Default Ridgefield,134,134,0,0,0,0
,Speedo Size 7 Style # 8776775,Speedo Size 7 Style # 8776775,Default Ridgefield,136,136,0,0,0,0
,Speedo Size 7 Style # 8776781,Speedo Size 7 Style # 8776781,Default Ridgefield,37,37,0,0,0,0
,Speedo Size 7 Style # 8776783,Speedo Size 7 Style # 8776783,Default Ridgefield,69,69,0,0,0,0
,Speedo Size 8 Style # 8776771,Speedo Size 8 Style # 8776771,Default Ridgefield,29,29,0,0,0,0
,Speedo Size 8 Style # 8776773,Speedo Size 8 Style # 8776773,Default Ridgefield,125,125,0,0,0,0
,Speedo Size 8 Style # 8776775,Speedo Size 8 Style # 8776775,Default Ridgefield,153,153,0,0,0,0
,Speedo Size 8 Style # 8776779,Speedo Size 8 Style # 8776779,Default Ridgefield,5,5,0,0,0,0
,Speedo Size 8 Style # 8776781,Speedo Size 8 Style # 8776781,Default Ridgefield,120,120,0,0,0,0
,Speedo Size 8 Style # 8776783,Speedo Size 8 Style # 8776783,Default Ridgefield,19,19,0,0,0,0
,Speedo Women Black/Purple 10,Speedo Women Black/Purple 10,FBALYB Amazon,-1,-1,0,0,0,0
,Speedo Women Black/Purple 12,Speedo Women Black/Purple 12,FBALYB Amazon,-1,-1,0,0,0,0
,Speedo Women Black/Purple 8,Speedo Women Black/Purple 8,FBALYB Amazon,-3,-3,0,0,0,0
,Speedo Women Blue Texture 10,Speedo Women Blue Texture 10,FBALYB Amazon,-1,-1,0,0,0,0
,Speedo Women Blue Texture 12,Speedo Women Blue Texture 12,FBALYB Amazon,-3,-3,0,0,0,0
,Speedo Women Blue Texture 6,Speedo Women Blue Texture 6,FBALYB Amazon,-11,-11,0,0,0,0
,Speedo Women Blue Texture 8,Speedo Women Blue Texture 8,FBALYB Amazon,-5,-5,0,0,0,0
,Speedo Women Heather Grey 10,Speedo Women Heather Grey 10,FBALYB Amazon,-2,-2,0,0,0,0
,Speedo Women Heather Grey 12,Speedo Women Heather Grey 12,FBALYB Amazon,-1,-1,0,0,0,0
,Speedo Women Heather Grey 14,Speedo Women Heather Grey 14,FBALYB Amazon,-3,-3,0,0,0,0
,Speedo Women Heather Grey 8,Speedo Women Heather Grey 8,FBALYB Amazon,-3,-3,0,0,0,0
,Speedo Women Purple Texture 10,Speedo Women Purple Texture 10,FBALYB Amazon,-3,-3,0,0,0,0
,Speedo Women Purple Texture 12,Speedo Women Purple Texture 12,FBALYB Amazon,-5,-5,0,0,0,0
,Speedo Women Purple Texture 14,Speedo Women Purple Texture 14,Default,0,0,0,0,0,5
,Speedo Women Purple Texture 16,Speedo Women Purple Texture 16,FBALYB Amazon,-1,-1,0,0,0,0
,Speedo Women Purple Texture 6,Speedo Women Purple Texture 6,FBALYB Amazon,-4,-4,0,0,0,0
,Speedo Women Purple Texture 8,Speedo Women Purple Texture 8,FBALYB Amazon,-3,-3,0,0,0,0
,Speedo Women Teal Texture 10,Speedo Women Teal Texture 10,FBALYB Amazon,-2,-2,0,0,0,0
,Speedo Women Teal Texture 16,Speedo Women Teal Texture 16,FBALYB Amazon,-1,-1,0,0,0,0
,Speedo Women Teal Texture 6,Speedo Women Teal Texture 6,FBALYB Amazon,-2,-2,0,0,0,0
,Speedo Women Teal Texture 8,Speedo Women Teal Texture 8,FBALYB Amazon,-6,-6,0,0,0,0
,Sperry BillFish Shoe Dark Tan 10.5 M,Sperry Men BillFish Shoe Dark Tan 10.5 M,FBALYB Amazon,-20,-20,0,0,0,0
,Sperry BillFish Shoe Dark Tan 10 M,Sperry Men BillFish Shoe Dark Tan 10 M,FBALYB Amazon,-13,-13,0,1,0,0
,Sperry BillFish Shoe Dark Tan 11.5 M,Sperry Men BillFish Shoe Dark Tan 11.5 M,FBALYB Amazon,-9,-9,0,0,0,0
,Sperry BillFish Shoe Dark Tan 11 M,Sperry BillFish Shoe Dark Tan 11 M,FBALYB Amazon,-15,-16,1,0,1,0
,Sperry BillFish Shoe Dark Tan 11 W,Sperry Men BillFish Shoe Dark Tan 11 W,Default Ridgefield,55,55,0,0,0,0
,Sperry BillFish Shoe Dark Tan 11 W,Sperry Men BillFish Shoe Dark Tan 11 W,FBALYB Amazon,-8,-9,1,0,1,0
,Sperry BillFish Shoe Dark Tan 12 M,Sperry BillFish Shoe Dark Tan 12 M,FBALYB Amazon,-16,-16,0,0,0,0
,Sperry BillFish Shoe Dark Tan 12 W,Sperry BillFish Shoe Dark Tan 12 W,Default Ridgefield,50,50,0,0,0,0
,Sperry BillFish Shoe Dark Tan 12 W,Sperry BillFish Shoe Dark Tan 12 W,FBALYB Amazon,-4,-4,0,0,0,0
,Sperry BillFish Shoe Dark Tan 13 M,Sperry Men BillFish Shoe Dark Tan 13 M,FBALYB Amazon,-14,-14,0,0,0,0
,Sperry BillFish Shoe Dark Tan 8.5 M,Sperry Men BillFish Shoe Dark Tan 8.5 M,FBALYB Amazon,1,0,1,13,1,0
,Sperry BillFish Shoe Dark Tan 8 M,Sperry Men BillFish Shoe Dark Tan 8 M,FBALYB Amazon,36,35,1,45,1,0
,Sperry BillFish Shoe Dark Tan 9.5 M,Sperry BillFish Shoe Dark Tan 9.5 M,Default Ridgefield,39,39,0,0,0,0
,Sperry BillFish Shoe Dark Tan 9.5 M,Sperry BillFish Shoe Dark Tan 9.5 M,FBALYB Amazon,22,16,6,0,6,0
,Sperry BillFish Shoe Dark Tan 9 M,Sperry Men BillFish Shoe Dark Tan 9 M,Default Ridgefield,6,6,0,0,0,0
,Sperry BillFish Shoe Dark Tan 9 M,Sperry Men BillFish Shoe Dark Tan 9 M,FBALYB Amazon,-29,-29,0,7,0,0
,Sperry BillFish Shoe Tan Beige 10.5 M,Sperry BillFish Shoe Tan Beige 10.5 M,FBALYB Amazon,48,44,4,0,4,0
,Sperry BillFish Shoe Tan Beige 10 M,Sperry BillFish Shoe Tan Beige 10 M,Default Ridgefield,18,18,0,0,0,0
,Sperry BillFish Shoe Tan Beige 10 M,Sperry BillFish Shoe Tan Beige 10 M,FBALYB Amazon,51,50,1,37,1,0
,Sperry BillFish Shoe Tan Beige 11.5 M,Sperry BillFish Shoe Tan Beige 11.5 M,Default Oxford,6,6,0,0,0,0
,Sperry BillFish Shoe Tan Beige 11.5 M,Sperry BillFish Shoe Tan Beige 11.5 M,FBALYB Amazon,-6,-6,0,20,0,0
,Sperry BillFish Shoe Tan Beige 11 M,Sperry BillFish Shoe Tan Beige 11 M,Default Ridgefield,20,20,0,0,0,0
,Sperry BillFish Shoe Tan Beige 11 M,Sperry BillFish Shoe Tan Beige 11 M,FBALYB Amazon,-11,-11,0,61,0,0
,Sperry BillFish Shoe Tan Beige 11 W,,FBALYB Amazon,8,8,0,0,0,0
,Sperry BillFish Shoe Tan Beige 12 M,Sperry BillFish Shoe Tan Beige 12 M,Default Ridgefield,50,7,43,0,0,0
,Sperry BillFish Shoe Tan Beige 12 M,Sperry BillFish Shoe Tan Beige 12 M,FBALYB Amazon,-10,-10,0,0,0,0
,Sperry BillFish Shoe Tan Beige 12 W,,FBALYB Amazon,-1,-1,0,0,0,0
,Sperry BillFish Shoe Tan Beige 13 M,Sperry BillFish Shoe Tan Beige 13 M,Default,10,10,0,0,0,0
,Sperry BillFish Shoe Tan Beige 13 M,Sperry BillFish Shoe Tan Beige 13 M,Default Ridgefield,29,29,0,0,0,0
,Sperry BillFish Shoe Tan Beige 13 M,Sperry BillFish Shoe Tan Beige 13 M,FBALYB Amazon,-18,-18,0,0,0,0
,Sperry BillFish Shoe Tan Beige 8.5 M,Sperry BillFish Shoe Tan Beige 8.5 M,FBALYB Amazon,-2,-2,0,0,0,0
,Sperry BillFish Shoe Tan Beige 8 M,Sperry BillFish Shoe Tan Beige 8 M,FBALYB Amazon,-6,-6,0,0,0,0
,Sperry BillFish Shoe Tan Beige 9.5 M,Sperry BillFish Shoe Tan Beige 9.5 M,FBALYB Amazon,-15,-15,0,0,0,0
,Sperry BillFish Shoe Tan Beige 9 M,Sperry BillFish Shoe Tan Beige 9 M,FBALYB Amazon,-17,-17,0,0,0,0
,SPERRY EMBOSS STS82473 OFF WHITE 10,SPERRY EMBOSS STS82473 OFF WHITE 10,FBALYB Amazon,-4,-4,0,0,0,0
,SPERRY EMBOSS STS82473 OFF WHITE 11,SPERRY EMBOSS STS82473 OFF WHITE 11,FBALYB Amazon,15,15,0,0,0,0
,SPERRY EMBOSS STS82473 OFF WHITE 12,SPERRY EMBOSS STS82473 OFF WHITE 12,FBALYB Amazon,12,12,0,0,0,0
,SPERRY EMBOSS STS82473 OFF WHITE 5.5,SPERRY EMBOSS STS82473 OFF WHITE 5.5,FBALYB Amazon,23,23,0,0,0,0
,SPERRY EMBOSS STS82473 OFF WHITE 6,SPERRY EMBOSS STS82473 OFF WHITE 6,FBALYB Amazon,-3,-3,0,0,0,0
,SPERRY EMBOSS STS82473 OFF WHITE 6.5,SPERRY EMBOSS STS82473 OFF WHITE 6.5,FBALYB Amazon,-14,-14,0,0,0,0
,SPERRY EMBOSS STS82473 OFF WHITE 7,SPERRY EMBOSS STS82473 OFF WHITE 7,FBALYB Amazon,-22,-22,0,0,0,0
,SPERRY EMBOSS STS82473 OFF WHITE 7.5,SPERRY EMBOSS STS82473 OFF WHITE 7.5,FBALYB Amazon,-14,-14,0,0,0,0
,SPERRY EMBOSS STS82473 OFF WHITE 8,SPERRY EMBOSS STS82473 OFF WHITE 8,FBALYB Amazon,-22,-22,0,0,0,0
,SPERRY EMBOSS STS82473 OFF WHITE 8.5,SPERRY EMBOSS STS82473 OFF WHITE 8.5,FBALYB Amazon,-8,-8,0,0,0,0
,SPERRY EMBOSS STS82473 OFF WHITE 9,SPERRY EMBOSS STS82473 OFF WHITE 9,FBALYB Amazon,-15,-15,0,0,0,0
,SPERRY EMBOSS STS82473 OFF WHITE 9.5,SPERRY EMBOSS STS82473 OFF WHITE 9.5,FBALYB Amazon,-8,-8,0,0,0,0
,SPERRY EMBOSS STS82475 DARK GREY 10,SPERRY EMBOSS STS82475 DARK GREY 10,FBALYB Amazon,18,17,1,0,1,0
,SPERRY EMBOSS STS82475 DARK GREY 11,SPERRY EMBOSS STS82475 DARK GREY 11,FBALYB Amazon,-19,-19,0,1,0,0
,SPERRY EMBOSS STS82475 DARK GREY 12,SPERRY EMBOSS STS82475 DARK GREY 12,FBALYB Amazon,-3,-3,0,31,0,0
,SPERRY EMBOSS STS82475 DARK GREY 5,SPERRY EMBOSS STS82475 DARK GREY 5,FBALYB Amazon,-2,-2,0,0,0,0
,SPERRY EMBOSS STS82475 DARK GREY 5.5,SPERRY EMBOSS STS82475 DARK GREY 5.5,Default Oxford,1,1,0,0,0,0
,SPERRY EMBOSS STS82475 DARK GREY 5.5,SPERRY EMBOSS STS82475 DARK GREY 5.5,FBALYB Amazon,-17,-17,0,0,0,0
,SPERRY EMBOSS STS82475 DARK GREY 6,SPERRY EMBOSS STS82475 DARK GREY 6,Default Oxford,1,1,0,0,0,0
,SPERRY EMBOSS STS82475 DARK GREY 6,SPERRY EMBOSS STS82475 DARK GREY 6,FBALYB Amazon,-9,-9,0,0,0,0
,SPERRY EMBOSS STS82475 DARK GREY 6.5,SPERRY EMBOSS STS82475 DARK GREY 6.5,Default Oxford,5,5,0,0,0,0
,SPERRY EMBOSS STS82475 DARK GREY 6.5,SPERRY EMBOSS STS82475 DARK GREY 6.5,FBALYB Amazon,-47,-47,0,0,0,0
,SPERRY EMBOSS STS82475 DARK GREY 7,SPERRY EMBOSS STS82475 DARK GREY 7,FBALYB Amazon,-44,-44,0,0,0,0
,SPERRY EMBOSS STS82475 DARK GREY 7.5,SPERRY EMBOSS STS82475 DARK GREY 7.5,Default Oxford,6,6,0,0,0,0
,SPERRY EMBOSS STS82475 DARK GREY 7.5,SPERRY EMBOSS STS82475 DARK GREY 7.5,FBALYB Amazon,-13,-15,2,0,2,0
,SPERRY EMBOSS STS82475 DARK GREY 8,SPERRY EMBOSS STS82475 DARK GREY 8,Default Oxford,1,1,0,0,0,0
,SPERRY EMBOSS STS82475 DARK GREY 8,SPERRY EMBOSS STS82475 DARK GREY 8,Default Ridgefield,1,1,0,0,0,0
,SPERRY EMBOSS STS82475 DARK GREY 8,SPERRY EMBOSS STS82475 DARK GREY 8,FBALYB Amazon,58,49,9,0,9,0
,SPERRY EMBOSS STS82475 DARK GREY 8.5,SPERRY EMBOSS STS82475 DARK GREY 8.5,Default Ridgefield,21,21,0,0,0,0
,SPERRY EMBOSS STS82475 DARK GREY 8.5,SPERRY EMBOSS STS82475 DARK GREY 8.5,FBALYB Amazon,-1,-5,4,0,4,0
,SPERRY EMBOSS STS82475 DARK GREY 9,SPERRY EMBOSS STS82475 DARK GREY 9,FBALYB Amazon,9,4,5,0,5,0
,SPERRY EMBOSS STS82475 DARK GREY 9.5,SPERRY EMBOSS STS82475 DARK GREY 9.5,FBALYB Amazon,-26,-26,0,1,0,0
,Sperry M Amaretto Mako 2 Eye Size 10,Sperry M Amaretto Mako 2 Eye Size 10,FBALYB Amazon,-17,-17,0,0,0,0
,Sperry M Amaretto Mako 2 Eye Size 10.5,Sperry M Amaretto Mako 2 Eye Size 10.5,Default Oxford,6,6,0,0,0,0
,Sperry M Amaretto Mako 2 Eye Size 10.5,Sperry M Amaretto Mako 2 Eye Size 10.5,FBALYB Amazon,-11,-11,0,0,0,0
,Sperry M Amaretto Mako 2 Eye Size 11,Sperry M Amaretto Mako 2 Eye Size 11,FBALYB Amazon,-6,-6,0,0,0,0
,Sperry M Amaretto Mako 2 Eye Size 11.5,Sperry M Amaretto Mako 2 Eye Size 11.5,FBALYB Amazon,-9,-9,0,0,0,0
,Sperry M Amaretto Mako 2 Eye Size 12,Sperry M Amaretto Mako 2 Eye Size 12,FBALYB Amazon,-4,-4,0,0,0,0
,Sperry M Amaretto Mako 2 Eye Size 13,Sperry M Amaretto Mako 2 Eye Size 13,FBALYB Amazon,-5,-5,0,0,0,0
,Sperry M Amaretto Mako 2 Eye Size 15,Sperry M Amaretto Mako 2 Eye Size 15,FBALYB Amazon,-2,-2,0,0,0,0
,Sperry M Amaretto Mako 2 Eye Size 8.5,Sperry M Amaretto Mako 2 Eye Size 8.5,FBALYB Amazon,-4,-4,0,0,0,0
,Sperry M Amaretto Mako 2 Eye Size 9,Sperry M Amaretto Mako 2 Eye Size 9,FBALYB Amazon,-13,-14,1,0,1,0
,Sperry M Amaretto Mako 2 Eye Size 9.5,Sperry M Amaretto Mako 2 Eye Size 9.5,FBALYB Amazon,-6,-6,0,0,0,0
,Sperry M Black Patent Seaport Size 10,Sperry M Black Patent Seaport Size 10,Default Oxford,2,2,0,0,0,0
,Sperry M Black Patent Seaport Size 12,Sperry M Black Patent Seaport Size 12,FBALYB Amazon,-1,-1,0,0,0,0
,Sperry M Black Patent Seaport Size 6.5,Sperry M Black Patent Seaport Size 6.5,FBALYB Amazon,-3,-3,0,0,0,0
,Sperry M Black Patent Seaport Size 7,Sperry M Black Patent Seaport Size 7,FBALYB Amazon,-2,-2,0,0,0,0
,Sperry M Black Patent Seaport Size 7.5,Sperry M Black Patent Seaport Size 7.5,FBALYB Amazon,-2,-2,0,0,0,0
,Sperry M Black Patent Seaport Size 8,Sperry M Black Patent Seaport Size 8,FBALYB Amazon,-1,-1,0,0,0,0
,Sperry Men 0764027 Sz 11,Sperry Men 0764027 MAKO 2 EYE MOC AMARETTO 11,Default Ridgefield,18,18,0,0,0,0
,Sperry Men's Authentic Original Richtown Boat Shoe - M 080 Tan,,FBALYB Amazon,-1,-1,0,0,0,0
,Sperry Men's Bahama II Boat Washed Sneaker - M 085 White,,FBALYB Amazon,-1,-1,0,0,0,0
,Sperry Men's Hamilton II 1-Eye Driver - M 075 Tan,,FBALYB Amazon,6,6,0,0,0,0
,Sperry Men's Hamilton II 1-Eye Driver - M 090 Tan,,FBALYB Amazon,-2,-2,0,0,0,0
,Sperry Men's Hamilton II 1-Eye Driver - M 095 Tan,,FBALYB Amazon,-3,-3,0,0,0,0
,Sperry Men's Hamilton II 1-Eye Driver - M 105 Tan,,FBALYB Amazon,-4,-4,0,4,0,0
,Sperry Men's Hamilton II 1-Eye Driver - M 115 Tan,,FBALYB Amazon,-3,-3,0,0,0,0
,Sperry Men's Hamilton II 1-Eye Driver - M 120 Tan,,FBALYB Amazon,-8,-8,0,0,0,0
,Sperry Men's Hamilton II 1-Eye Driver - M 130 Tan,,FBALYB Amazon,-1,-1,0,0,0,0
,Sperry Men's Hampden Venetian Loafer - M 085 Black,Sperry Men's Hampden Venetian Loafer - M 085 Black,FBALYB Amazon,-1,-1,0,0,0,0
,Sperry Men's Hampden Venetian Loafer - M 085 Sahara Leather,,Default Ridgefield,65,65,0,0,0,0
,Sperry Men's Hampden Venetian Loafer - M 085 Sahara Leather,,FBALYB Amazon,4,3,1,0,1,0
,Sperry Men's Hampden Venetian Loafer - M 090 Amaretto,,FBALYB Amazon,-6,-6,0,0,0,0
,Sperry Men's Hampden Venetian Loafer - M 090 Black,Sperry Men's Hampden Venetian Loafer - M 090 Black,FBALYB Amazon,-7,-7,0,0,0,0
,Sperry Men's Hampden Venetian Loafer - M 090 Sahara Leather,,FBALYB Amazon,-12,-12,0,0,0,0
,Sperry Men's Hampden Venetian Loafer - M 095 Amaretto,,FBALYB Amazon,-1,-1,0,0,0,0
,Sperry Men's Hampden Venetian Loafer - M 095 Black,Sperry Men's Hampden Venetian Loafer - M 095 Black,FBALYB Amazon,-1,-1,0,0,0,0
,Sperry Men's Hampden Venetian Loafer - M 095 Sahara Leather,,Default Ridgefield,16,16,0,0,0,0
,Sperry Men's Hampden Venetian Loafer - M 095 Sahara Leather,,FBALYB Amazon,-5,-5,0,0,0,0
,Sperry Men's Hampden Venetian Loafer - M 100 Amaretto,,FBALYB Amazon,-2,-2,0,0,0,0
,Sperry Men's Hampden Venetian Loafer - M 100 Black,Sperry Men's Hampden Venetian Loafer - M 100 Black,FBALYB Amazon,-3,-3,0,15,0,0
,Sperry Men's Hampden Venetian Loafer - M 100 Sahara Leather,,FBALYB Amazon,-4,-4,0,0,0,0
,Sperry Men's Hampden Venetian Loafer - M 105 Black,Sperry Men's Hampden Venetian Loafer - M 105 Black,FBALYB Amazon,-3,-3,0,0,0,0
,Sperry Men's Hampden Venetian Loafer - M 105 Sahara Leather,,FBALYB Amazon,-7,-7,0,15,0,0
,Sperry Men's Hampden Venetian Loafer - M 110 Sahara Leather,,FBALYB Amazon,-3,-3,0,15,0,0
,Sperry Men's Hampden Venetian Loafer - M 115 Black,Sperry Men's Hampden Venetian Loafer - M 115 Black,FBALYB Amazon,-3,-3,0,0,0,0
,Sperry Men's Hampden Venetian Loafer - M 115 Sahara Leather,,FBALYB Amazon,-4,-4,0,15,0,0
,Sperry Men's Hampden Venetian Loafer - M 120 Black,,Default Ridgefield,19,19,0,0,0,0
,Sperry Men's Hampden Venetian Loafer - M 120 Black,,FBALYB Amazon,1,1,0,0,0,0
,Sperry Men's Hampden Venetian Loafer - M 120 Sahara Leather,,FBALYB Amazon,-2,-2,0,0,0,0
,Sperry Men's Hampden Venetian Loafer - M 130 Amaretto,,FBALYB Amazon,0,0,0,1,0,0
,Sperry Men's Hampden Venetian Loafer - M 130 Black,Sperry Men's Hampden Venetian Loafer - M 130 Black,FBALYB Amazon,-1,-1,0,15,0,0
,Sperry Men's Hampden Venetian Loafer - M 130 Sahara Leather,,FBALYB Amazon,-3,-3,0,15,0,0
,Sperry Men's Sea Kite Sport Moc Boat Shoe - M 080 Dark Tan,,FBALYB Amazon,-12,-12,0,12,0,0
,Sperry Men's Sea Kite Sport Moc Boat Shoe - M 085 Dark Tan,,FBALYB Amazon,-16,-16,0,15,0,0
,Sperry Men's Sea Kite Sport Moc Boat Shoe - M 085 Gray,,FBALYB Amazon,-2,-2,0,0,0,0
,Sperry Men's Sea Kite Sport Moc Boat Shoe - M 090 Dark Tan,Sperry Men's Sea Kite Sport Moc Boat Shoe - M 090 Dark Tan,FBALYB Amazon,-9,-10,1,30,1,0
,Sperry Men's Sea Kite Sport Moc Boat Shoe - M 090 Gray,,FBALYB Amazon,-1,-1,0,0,0,0
,Sperry Men's Sea Kite Sport Moc Boat Shoe - M 095 Dark Tan,Sperry Men's Sea Kite Sport Moc Boat Shoe - M 095 Dark Tan,FBALYB Amazon,-21,-21,0,40,0,0
,Sperry Men's Sea Kite Sport Moc Boat Shoe - M 095 Gray,,FBALYB Amazon,-2,-2,0,0,0,0
,Sperry Men's Sea Kite Sport Moc Boat Shoe - M 105 Dark Tan,Sperry Men's Sea Kite Sport Moc Boat Shoe - M 105 Dark Tan,FBALYB Amazon,2,2,0,15,0,0
,Sperry Men's Sea Kite Sport Moc Boat Shoe - M 105 Gray,,FBALYB Amazon,-1,-1,0,0,0,0
,Sperry Men's Sea Kite Sport Moc Boat Shoe - M 110 Dark Tan,Sperry Men's Sea Kite Sport Moc Boat Shoe - M 110 Dark Tan,FBALYB Amazon,-26,-26,0,46,0,0
,Sperry Men's Sea Kite Sport Moc Boat Shoe - M 110 Gray,,FBALYB Amazon,-2,-2,0,0,0,0
,Sperry Men's Sea Kite Sport Moc Boat Shoe - M 115 Dark Tan,Sperry Men's Sea Kite Sport Moc Boat Shoe - M 115 Dark Tan,FBALYB Amazon,-12,-12,0,27,0,0
,Sperry Men's Sea Kite Sport Moc Boat Shoe - M 120 Dark Tan,Sperry Men's Sea Kite Sport Moc Boat Shoe - M 120 Dark Tan,Default Ridgefield,15,15,0,0,0,0
,Sperry Men's Sea Kite Sport Moc Boat Shoe - M 120 Dark Tan,Sperry Men's Sea Kite Sport Moc Boat Shoe - M 120 Dark Tan,FBALYB Amazon,-8,-8,0,15,0,0
,Sperry Men's Sea Kite Sport Moc Boat Shoe - M 120 Gray,,Default Ridgefield,12,12,0,0,0,0
,Sperry Men's Sea Kite Sport Moc Boat Shoe - M 120 Gray,,FBALYB Amazon,-1,-1,0,0,0,0
,Sperry Men's Sea Kite Sport Moc Boat Shoe - W 130 Gray,,Default Ridgefield,1,1,0,0,0,0
,Sperry Men's Sea Kite Sport Moc Boat Shoe - W 130 Gray,,FBALYB Amazon,0,0,0,1,0,0
,Sperry Men's Striper CVO Sneaker - M 080 Navy,,FBALYB Amazon,1,1,0,0,0,0
,Sperry Men's Striper CVO Sneaker - M 085 Navy,,FBALYB Amazon,20,20,0,0,0,0
,Sperry Men's Striper CVO Sneaker - M 085 White,,FBALYB Amazon,-1,-1,0,0,0,0
,Sperry Men's Striper CVO Sneaker - M 090 Navy,,FBALYB Amazon,-5,-5,0,0,0,0
,Sperry Men's Striper CVO Sneaker - M 090 White,,FBALYB Amazon,-3,-3,0,0,0,0
,Sperry Men's Striper CVO Sneaker - M 095 Chino,,FBALYB Amazon,-1,-1,0,0,0,0
,Sperry Men's Striper CVO Sneaker - M 100 Chino,,FBALYB Amazon,-2,-2,0,0,0,0
,Sperry Men's Striper CVO Sneaker - M 100 Navy,,FBALYB Amazon,-5,-5,0,0,0,0
,Sperry Men's Striper CVO Sneaker - M 105 White,,FBALYB Amazon,-3,-3,0,0,0,0
,Sperry Men's Striper CVO Sneaker - M 110 Navy,,FBALYB Amazon,-2,-2,0,0,0,0
,Sperry Men's Striper CVO Sneaker - M 115 Navy,,FBALYB Amazon,-1,-1,0,0,0,0
,Sperry Men's Striper CVO Sneaker - M 120 Navy,,FBALYB Amazon,-2,-2,0,0,0,0
,Sperry Men's Striper CVO Sneaker - M 120 White,,FBALYB Amazon,-1,-1,0,0,0,0
,Sperry Men's Striper CVO Sneaker - M 130 Navy,,FBALYB Amazon,-1,-1,0,0,0,0
,Sperry Men's Striper CVO Sneaker - M 150 Navy,,FBALYB Amazon,-1,-1,0,1,0,0
,Sperry Men's Striper CVO Sneaker - W 110 Navy,,FBALYB Amazon,-1,-1,0,0,0,0
,Sperry Men's Striper II Salt Washed CVO Sneaker Chino 7.5,Sperry Men's Striper II Salt Washed CVO Sneaker Chino 7.5,FBALYB Amazon,-1,-1,0,0,0,0
,Sperry Men's Striper II Salt Washed CVO Sneaker - M 070 Black STS16795,Sperry Men's Striper II Salt Washed CVO Sneaker - M 070 Black STS16795,FBALYB Amazon,8,8,0,0,0,0
,Sperry Men's Striper II Salt Washed CVO Sneaker- M 070 White,,FBALYB Amazon,24,24,0,0,0,0
,Sperry Men's Striper II Salt Washed CVO Sneaker - M 080 Grey,,FBALYB Amazon,-2,-3,1,0,1,0
,Sperry Men's Striper II Salt Washed CVO Sneaker- M 080 White,,FBALYB Amazon,33,33,0,0,0,0
,Sperry Men's Striper II Salt Washed CVO Sneaker- M 085 White,,FBALYB Amazon,-1,-1,0,0,0,0
,Sperry Men's Striper II Salt Washed CVO Sneaker - M 090 Grey,,FBALYB Amazon,-4,-4,0,0,0,0
,Sperry Men's Striper II Salt Washed CVO Sneaker - M 110 Navy STS16797,Sperry Men's Striper II Salt Washed CVO Sneaker - M 110 Navy STS16797,Default Oxford,198,198,0,0,0,0
,Sperry Men's Striper II Salt Washed CVO Sneaker - M 160 Chino STS16796,Sperry Men's Striper II Salt Washed CVO Sneaker - M 160 Chino STS16796,FBALYB Amazon,2,2,0,0,0,0
,Sperry Men's Striper II Salt Washed CVO Sneaker - W 090 Navy STS16797,Sperry Men's Striper II Salt Washed CVO Sneaker - W 090 Navy STS16797,FBALYB Amazon,-4,-4,0,0,0,0
,Sperry Men's Striper II Salt Washed CVO Sneaker White 7.5,Sperry Men's Striper II Salt Washed CVO Sneaker White 7.5,FBALYB Amazon,36,36,0,0,0,0
,Sperry Men's Striper II Salt Washed CVO Sneaker White 8W,Sperry Men's Striper II Salt Washed CVO Sneaker White 8W,FBALYB Amazon,-1,-1,0,0,0,0
,Sperry Men's Striper II Washed CVO Sneaker - M 070 Navy,,FBALYB Amazon,104,104,0,1,0,0
,Sperry Men's Striper II Washed CVO Sneaker - M 075 Navy,,FBALYB Amazon,-3,-3,0,0,0,0
,Sperry Men's Striper II Washed CVO Sneaker - M 080 Chino,,FBALYB Amazon,14,14,0,0,0,0
,Sperry Men's Striper II Washed CVO Sneaker - M 080 Navy,,FBALYB Amazon,179,179,0,0,0,0
,Sperry Men's Striper II Washed CVO Sneaker - M 085 Chino,,FBALYB Amazon,18,18,0,0,0,0
,Sperry Men's Striper II Washed CVO Sneaker - M 085 Navy,,Default Oxford,112,112,0,0,0,0
,Sperry Men's Striper II Washed CVO Sneaker - M 085 Navy,,FBALYB Amazon,104,104,0,0,0,0
,Sperry Men's Striper II Washed CVO Sneaker - M 090 Chino,,FBALYB Amazon,5,5,0,0,0,0
,Sperry Men's Striper II Washed CVO Sneaker - M 090 Navy,,Default Oxford,205,205,0,0,0,0
,Sperry Men's Striper II Washed CVO Sneaker - M 090 Navy,,FBALYB Amazon,157,157,0,0,0,0
,Sperry Men's Striper II Washed CVO Sneaker - M 095 Navy,,Default Oxford,112,112,0,0,0,0
,Sperry Men's Striper II Washed CVO Sneaker - M 095 Navy,,FBALYB Amazon,4,3,1,0,1,0
,Sperry Men's Striper II Washed CVO Sneaker - M 100 Chino,,FBALYB Amazon,20,20,0,0,0,0
,Sperry Men's Striper II Washed CVO Sneaker - M 100 Navy,,Default Oxford,47,47,0,0,0,0
,Sperry Men's Striper II Washed CVO Sneaker - M 100 Navy,,FBALYB Amazon,85,84,1,0,1,0
,Sperry Men's Striper II Washed CVO Sneaker - M 105 Chino,,Default Ridgefield,2,2,0,0,0,0
,Sperry Men's Striper II Washed CVO Sneaker - M 105 Chino,,FBALYB Amazon,2,2,0,3,0,0
,Sperry Men's Striper II Washed CVO Sneaker - M 105 Navy,,FBALYB Amazon,-6,-6,0,0,0,0
,Sperry Men's Striper II Washed CVO Sneaker - M 110 Navy,,FBALYB Amazon,-17,-17,0,2,0,0
,Sperry Men's Striper II Washed CVO Sneaker - M 115 Chino,,FBALYB Amazon,-1,-1,0,0,0,0
,Sperry Men's Striper II Washed CVO Sneaker - M 115 Navy,,FBALYB Amazon,-2,-2,0,0,0,0
,Sperry Men's Striper II Washed CVO Sneaker - M 120 Navy,,FBALYB Amazon,-11,-11,0,0,0,0
,Sperry Men's Striper II Washed CVO Sneaker - M 130 Navy,,FBALYB Amazon,-10,-10,0,1,0,0
,Sperry Men's Striper II Washed CVO Sneaker - W 085 Navy,,FBALYB Amazon,-9,-9,0,0,0,0
,Sperry Men's Striper II Washed CVO Sneaker - W 100 Navy,,FBALYB Amazon,-2,-2,0,0,0,0
,Sperry Men's Striper II Washed CVO Sneaker - W 105 Navy,,FBALYB Amazon,-6,-6,0,0,0,0
,Sperry Men's Striper II Washed CVO Sneaker - W 110 Navy,,FBALYB Amazon,-4,-4,0,0,0,0
,Sperry M Linen Oat Womens Bluefish Size 10,Sperry M Linen Oat Womens Bluefish Size 10,FBALYB Amazon,-8,-8,0,15,0,0
,Sperry M Linen Oat Womens Bluefish Size 11,Sperry M Linen Oat Womens Bluefish Size 11,Default Ridgefield,15,15,0,0,0,0
,Sperry M Linen Oat Womens Bluefish Size 11,Sperry M Linen Oat Womens Bluefish Size 11,FBALYB Amazon,-4,-4,0,0,0,0
,Sperry M Linen Oat Womens Bluefish Size 6,Sperry M Linen Oat Womens Bluefish Size 6,FBALYB Amazon,-19,-19,0,0,0,0
,Sperry M Linen Oat Womens Bluefish Size 6.5,Sperry M Linen Oat Womens Bluefish Size 6.5,Default,8,8,0,0,0,0
,Sperry M Linen Oat Womens Bluefish Size 6.5,Sperry M Linen Oat Womens Bluefish Size 6.5,Default Ridgefield,9,9,0,0,0,0
,Sperry M Linen Oat Womens Bluefish Size 6.5,Sperry M Linen Oat Womens Bluefish Size 6.5,FBALYB Amazon,-21,-21,0,39,0,0
,Sperry M Linen Oat Womens Bluefish Size 7,Sperry M Linen Oat Womens Bluefish Size 7,FBALYB Amazon,-32,-32,0,80,0,0
,Sperry M Linen Oat Womens Bluefish Size 7.5,Sperry M Linen Oat Womens Bluefish Size 7.5,Default,0,-1,1,0,0,0
,Sperry M Linen Oat Womens Bluefish Size 7.5,Sperry M Linen Oat Womens Bluefish Size 7.5,Default Ridgefield,9,9,0,0,0,0
,Sperry M Linen Oat Womens Bluefish Size 7.5,Sperry M Linen Oat Womens Bluefish Size 7.5,FBALYB Amazon,-11,-11,0,41,0,0
,Sperry M Linen Oat Womens Bluefish Size 8,Sperry M Linen Oat Womens Bluefish Size 8,Default Ridgefield,50,50,0,0,0,0
,Sperry M Linen Oat Womens Bluefish Size 8,Sperry M Linen Oat Womens Bluefish Size 8,FBALYB Amazon,-19,-19,0,0,0,0
,Sperry M Linen Oat Womens Bluefish Size 8.5,Sperry M Linen Oat Womens Bluefish Size 8.5,Default Ridgefield,27,27,0,0,0,0
,Sperry M Linen Oat Womens Bluefish Size 8.5,Sperry M Linen Oat Womens Bluefish Size 8.5,FBALYB Amazon,-14,-14,0,95,0,0
,Sperry M Linen Oat Womens Bluefish Size 9,Sperry M Linen Oat Womens Bluefish Size 9,Default,4,4,0,0,0,0
,Sperry M Linen Oat Womens Bluefish Size 9,Sperry M Linen Oat Womens Bluefish Size 9,Default Ridgefield,100,100,0,0,0,0
,Sperry M Linen Oat Womens Bluefish Size 9,Sperry M Linen Oat Womens Bluefish Size 9,FBALYB Amazon,-8,-8,0,0,0,0
,Sperry M Linen Oat Womens Bluefish Size 9.5,Sperry M Linen Oat Womens Bluefish Size 9.5,Default Ridgefield,15,15,0,0,0,0
,Sperry M Linen Oat Womens Bluefish Size 9.5,Sperry M Linen Oat Womens Bluefish Size 9.5,FBALYB Amazon,-2,-2,0,0,0,0
,Sperry M Tan Mens Mako 2 Tan Size 10,Sperry M Tan Mens Mako 2 Tan Size 10,FBALYB Amazon,-1,-1,0,0,0,0
,Sperry M Tan Mens Mako 2 Tan Size 10.5,Sperry M Tan Mens Mako 2 Tan Size 10.5,FBALYB Amazon,-1,-1,0,0,0,0
,Sperry M Tan Mens Mako 2 Tan Size 11,Sperry M Tan Mens Mako 2 Tan Size 11,FBALYB Amazon,2,2,0,0,0,0
,Sperry M Tan Mens Mako 2 Tan Size 11.5,Sperry M Tan Mens Mako 2 Tan Size 11.5,FBALYB Amazon,-1,-1,0,0,0,0
,Sperry M Tan Mens Mako 2 Tan Size 13,Sperry M Tan Mens Mako 2 Tan Size 13,FBALYB Amazon,-5,-5,0,0,0,0
,Sperry M Tan Mens Mako 2 Tan Size 7,Sperry M Tan Mens Mako 2 Tan Size 7,FBALYB Amazon,-2,-2,0,0,0,0
,Sperry M Tan Mens Mako 2 Tan Size 8.5,Sperry M Tan Mens Mako 2 Tan Size 8.5,FBALYB Amazon,12,12,0,0,0,0
,Sperry M Tan Mens Mako 2 Tan Size 9,Sperry M Tan Mens Mako 2 Tan Size 9,Default Ridgefield,3,3,0,0,0,0
,Sperry M Tan Mens Mako 2 Tan Size 9,Sperry M Tan Mens Mako 2 Tan Size 9,FBALYB Amazon,-2,-2,0,0,0,0
,Sperry M Tan Mens Mako 2 Tan Size 9.5,Sperry M Tan Mens Mako 2 Tan Size 9.5,FBALYB Amazon,11,11,0,0,0,0
,Sperry M Tan Womens Seaport Size 10,Sperry M Tan Womens Seaport Size 10,FBALYB Amazon,-37,-38,1,0,1,0
,Sperry M Tan Womens Seaport Size 6.5,Sperry M Tan Womens Seaport Size 6.5,FBALYB Amazon,-13,-13,0,0,0,0
,Sperry M Tan Womens Seaport Size 7,Sperry M Tan Womens Seaport Size 7,FBALYB Amazon,-35,-36,1,0,1,0
,Sperry M Tan Womens Seaport Size 7.5,Sperry M Tan Womens Seaport Size 7.5,Default Ridgefield,70,70,0,0,0,0
,Sperry M Tan Womens Seaport Size 7.5,Sperry M Tan Womens Seaport Size 7.5,FBALYB Amazon,71,71,0,0,0,0
,Sperry M Tan Womens Seaport Size 8,Sperry M Tan Womens Seaport Size 8,FBALYB Amazon,-31,-32,1,0,1,0
,Sperry M Tan Womens Seaport Size 8.5,Sperry M Tan Womens Seaport Size 8.5,FBALYB Amazon,-25,-25,0,0,0,0
,Sperry M Tan Womens Seaport Size 9,Sperry M Tan Womens Seaport Size 9,FBALYB Amazon,-17,-17,0,0,0,0
,Sperry M Tan Womens Seaport Size 9.5,Sperry M Tan Womens Seaport Size 9.5,FBALYB Amazon,-29,-29,0,0,0,0
,Sperry Navy Honey Mens Halyard Size 10,Sperry Navy Honey Mens Halyard Size 10,FBALYB Amazon,-1,-1,0,0,0,0
,Sperry Navy Honey Mens Halyard Size 10.5,Sperry Navy Honey Mens Halyard Size 10.5,FBALYB Amazon,-3,-3,0,0,0,0
,Sperry Navy Honey Mens Halyard Size 11,Sperry Navy Honey Mens Halyard Size 11,FBALYB Amazon,-1,-1,0,0,0,0
,Sperry Navy Honey Mens Halyard Size 12,Sperry Navy Honey Mens Halyard Size 12,FBALYB Amazon,-1,-1,0,0,0,0
,Sperry Navy Honey Mens Halyard Size 13,Sperry Navy Honey Mens Halyard Size 13,Default Ridgefield,0,-102,102,0,0,0
,Sperry Navy Honey Mens Halyard Size 13,Sperry Navy Honey Mens Halyard Size 13,FBALYB Amazon,-3,-3,0,0,0,0
,Sperry Navy Honey Mens Halyard Size 9,Sperry Navy Honey Mens Halyard Size 9,Default Ridgefield,0,-2,2,0,0,0
,Sperry Navy Honey Mens Halyard Size 9,Sperry Navy Honey Mens Halyard Size 9,FBALYB Amazon,-2,-2,0,0,0,0
,Sperry Navy Womens Crest Vibe Size 10,Sperry Navy Womens Crest Vibe Size 10,Default Ridgefield,2,2,0,0,0,0
,Sperry Navy Womens Crest Vibe Size 10,Sperry Navy Womens Crest Vibe Size 10,FBALYB Amazon,-5,-5,0,20,0,0
,Sperry Navy Womens Crest Vibe Size 7,Sperry Navy Womens Crest Vibe Size 7,FBALYB Amazon,-1,-1,0,2,0,0
,Sperry Navy Womens Crest Vibe Size 7.5,Sperry Navy Womens Crest Vibe Size 7.5,Default Ridgefield,28,28,0,0,0,0
,Sperry Navy Womens Crest Vibe Size 7.5,Sperry Navy Womens Crest Vibe Size 7.5,FBALYB Amazon,-4,-4,0,0,0,0
,Sperry Navy Womens Crest Vibe Size 8,Sperry Navy Womens Crest Vibe Size 8,Default Ridgefield,44,44,0,0,0,0
,Sperry Navy Womens Crest Vibe Size 8,Sperry Navy Womens Crest Vibe Size 8,FBALYB Amazon,-6,-11,5,0,5,0
,Sperry Navy Womens Crest Vibe Size 8.5,Sperry Navy Womens Crest Vibe Size 8.5,FBALYB Amazon,8,6,2,50,2,0
,Sperry Navy Womens Crest Vibe Size 9,Sperry Navy Womens Crest Vibe Size 9,Default Ridgefield,3,3,0,0,0,0
,Sperry Navy Womens Crest Vibe Size 9,Sperry Navy Womens Crest Vibe Size 9,FBALYB Amazon,5,5,0,4,0,0
,Sperry Oat Womens Crest Vibe Size 10,Sperry Oat Womens Crest Vibe Size 10,Default Ridgefield,3,3,0,0,0,0
,Sperry Oat Womens Crest Vibe Size 10,Sperry Oat Womens Crest Vibe Size 10,FBALYB Amazon,-4,-4,0,5,0,0
,Sperry Oat Womens Crest Vibe Size 11,Sperry Oat Womens Crest Vibe Size 11,FBALYB Amazon,-3,-3,0,0,0,0
,Sperry Oat Womens Crest Vibe Size 12,Sperry Oat Womens Crest Vibe Size 12,FBALYB Amazon,-4,-4,0,0,0,0
,Sperry Oat Womens Crest Vibe Size 6,Sperry Oat Womens Crest Vibe Size 6,FBALYB Amazon,-4,-4,0,65,0,0
,Sperry Oat Womens Crest Vibe Size 7,Sperry Oat Womens Crest Vibe Size 7,Default Ridgefield,63,63,0,0,0,0
,Sperry Oat Womens Crest Vibe Size 7,Sperry Oat Womens Crest Vibe Size 7,FBALYB Amazon,33,33,0,0,0,0
,Sperry Oat Womens Crest Vibe Size 7.5,Sperry Oat Womens Crest Vibe Size 7.5,Default,1,1,0,0,0,0
,Sperry Oat Womens Crest Vibe Size 7.5,Sperry Oat Womens Crest Vibe Size 7.5,Default Ridgefield,14,14,0,0,0,0
,Sperry Oat Womens Crest Vibe Size 7.5,Sperry Oat Womens Crest Vibe Size 7.5,FBALYB Amazon,-6,-6,0,0,0,0
,Sperry Oat Womens Crest Vibe Size 8,Sperry Oat Womens Crest Vibe Size 8,Default Ridgefield,26,26,0,0,0,0
,Sperry Oat Womens Crest Vibe Size 8,Sperry Oat Womens Crest Vibe Size 8,FBALYB Amazon,35,33,2,0,2,0
,Sperry Oat Womens Crest Vibe Size 8.5,Sperry Oat Womens Crest Vibe Size 8.5,FBALYB Amazon,-11,-11,0,0,0,0
,Sperry Oat Womens Crest Vibe Size 9,Sperry Oat Womens Crest Vibe Size 9,Default Ridgefield,47,47,0,0,0,0
,Sperry Oat Womens Crest Vibe Size 9,Sperry Oat Womens Crest Vibe Size 9,FBALYB Amazon,-30,-30,0,0,0,0
,Sperry Oat Womens Crest Vibe Size 9.5,Sperry Oat Womens Crest Vibe Size 9.5,Default Ridgefield,15,15,0,0,0,0
,Sperry Oat Womens Crest Vibe Size 9.5,Sperry Oat Womens Crest Vibe Size 9.5,FBALYB Amazon,7,4,3,0,3,0
,Sperry Original 2-Eye Boat Shoe - M 105 Navy STS10405,Sperry Original 2-Eye Boat Shoe - M 105 Navy STS10405,FBALYB Amazon,-1,-1,0,0,0,0
,Sperry Original 2-Eye Boat Shoe - M 110 Navy STS10405,Sperry Original 2-Eye Boat Shoe - M 110 Navy STS10405,FBALYB Amazon,7,7,0,0,0,0
,Sperry Original 2-Eye Boat Shoe - M 120 Navy STS10405,Sperry Original 2-Eye Boat Shoe - M 120 Navy STS10405,FBALYB Amazon,1,1,0,0,0,0
,Sperry Original Boat Shoe Amaretto 11.5 M,,FBALYB Amazon,-2,-2,0,0,0,0
,Sperry Original Boat Shoe Amaretto 13 M,Sperry Original Boat Shoe Amaretto 13 M,Default Ridgefield,1,1,0,0,0,0
,Sperry Original Boat Shoe Amaretto 13 M,Sperry Original Boat Shoe Amaretto 13 M,FBALYB Amazon,-3,-3,0,0,0,0
,Sperry Original Boat Shoe Amaretto 8.5 M,,Default Ridgefield,15,15,0,0,0,0
,Sperry Original Boat Shoe Amaretto 8 M,Sperry Original Boat Shoe Amaretto 8 M,FBALYB Amazon,-5,-5,0,0,0,0
,Sperry Original Boat Shoe Brown Buck 10.5 M,Sperry Original Boat Shoe Brown Buck 10.5 M,Default Ridgefield,2,2,0,0,0,0
,Sperry Original Boat Shoe Brown Buck 10.5 M,Sperry Original Boat Shoe Brown Buck 10.5 M,FBALYB Amazon,1,1,0,0,0,0
,Sperry Original Boat Shoe Brown Buck 10 M,Sperry Original Boat Shoe Brown Buck 10 M,Default Ridgefield,55,55,0,0,0,0
,Sperry Original Boat Shoe Brown Buck 10 M,Sperry Original Boat Shoe Brown Buck 10 M,FBALYB Amazon,40,40,0,0,0,0
,Sperry Original Boat Shoe Brown Buck 11.5 M,Sperry Original Boat Shoe Brown Buck 11.5 M,FBALYB Amazon,16,16,0,0,0,0
,Sperry Original Boat Shoe Brown Buck 11 M,Sperry Original Boat Shoe Brown Buck 11 M,FBALYB Amazon,-7,-8,1,5,1,0
,Sperry Original Boat Shoe Brown Buck 12 M,Sperry Original Boat Shoe Brown Buck 12 M,Default Ridgefield,12,12,0,0,0,0
,Sperry Original Boat Shoe Brown Buck 12 M,Sperry Original Boat Shoe Brown Buck 12 M,FBALYB Amazon,-7,-7,0,0,0,0
,Sperry Original Boat Shoe Brown Buck 13 M,Sperry Original Boat Shoe Brown Buck 13 M,Default Ridgefield,25,25,0,0,0,0
,Sperry Original Boat Shoe Brown Buck 13 M,Sperry Original Boat Shoe Brown Buck 13 M,FBALYB Amazon,23,23,0,0,0,0
,Sperry Original Boat Shoe Brown Buck 8.5 M,Sperry Original Boat Shoe Brown Buck 8.5 M,FBALYB Amazon,-4,-4,0,0,0,0
,Sperry Original Boat Shoe Brown Buck 8 M,Sperry Original Boat Shoe Brown Buck 8 M,Default Ridgefield,13,13,0,0,0,0
,Sperry Original Boat Shoe Brown Buck 8 M,Sperry Original Boat Shoe Brown Buck 8 M,FBALYB Amazon,50,50,0,0,0,0
,Sperry Original Boat Shoe Brown Buck 9.5 M,Sperry Original Boat Shoe Brown Buck 9.5 M,Default Ridgefield,25,25,0,0,0,0
,Sperry Original Boat Shoe Brown Buck 9.5 M,Sperry Original Boat Shoe Brown Buck 9.5 M,FBALYB Amazon,23,23,0,0,0,0
,Sperry Original Boat Shoe Brown Buck 9 M,Sperry Original Boat Shoe Brown Buck 9 M,FBALYB Amazon,-13,-14,1,0,1,0
,Sperry Original Boat Shoe Classic 10.5 M,Sperry Original Boat Shoe Classic 10.5 M,Default Ridgefield,15,15,0,0,0,0
,Sperry Original Boat Shoe Classic 10.5 M,Sperry Original Boat Shoe Classic 10.5 M,FBALYB Amazon,-2,-2,0,0,0,0
,Sperry Original Boat Shoe Classic 10 M,Sperry Original Boat Shoe Classic 10 M,Default Ridgefield,1,1,0,0,0,0
,Sperry Original Boat Shoe Classic 10 M,Sperry Original Boat Shoe Classic 10 M,FBALYB Amazon,12,11,1,0,1,0
,Sperry Original Boat Shoe Classic 11.5 M,Sperry Original Boat Shoe Classic 11.5 M,FBALYB Amazon,22,22,0,0,0,0
,Sperry Original Boat Shoe Classic 11 M,Sperry Original Boat Shoe Classic 11 M,FBALYB Amazon,-7,-7,0,0,0,0
,Sperry Original Boat Shoe Classic 12 M,Sperry Original Boat Shoe Classic 12 M,FBALYB Amazon,17,17,0,0,0,0
,Sperry Original Boat Shoe Classic 13 M,Sperry Original Boat Shoe Classic 13 M,Default Oxford,5,5,0,0,0,0
,Sperry Original Boat Shoe Classic 13 M,Sperry Original Boat Shoe Classic 13 M,Default Ridgefield,1,1,0,0,0,0
,Sperry Original Boat Shoe Classic 13 M,Sperry Original Boat Shoe Classic 13 M,FBALYB Amazon,28,28,0,0,0,0
,Sperry Original Boat Shoe Classic 8.5 M,Sperry Original Boat Shoe Classic 8.5 M,Default Ridgefield,10,10,0,0,0,0
,Sperry Original Boat Shoe Classic 8.5 M,Sperry Original Boat Shoe Classic 8.5 M,FBALYB Amazon,34,34,0,0,0,0
,Sperry Original Boat Shoe Classic 8 M,Sperry Original Boat Shoe Classic 8 M,FBALYB Amazon,-3,-3,0,0,0,0
,Sperry Original Boat Shoe Classic 9.5 M,Sperry Original Boat Shoe Classic 9.5 M,FBALYB Amazon,20,20,0,0,0,0
,Sperry Original Boat Shoe Classic 9 M,Sperry Original Boat Shoe Classic 9 M,Default Ridgefield,1,1,0,0,0,0
,Sperry Original Boat Shoe Classic 9 M,Sperry Original Boat Shoe Classic 9 M,FBALYB Amazon,14,14,0,0,0,0
,Sperry Original Boat Shoe Sahara 10.5 M,Sperry Original Boat Shoe Sahara 10.5 M,FBALYB Amazon,-6,-6,0,0,0,0
,Sperry Original Boat Shoe Sahara 10 M,Sperry Original Boat Shoe Sahara 10 M,FBALYB Amazon,-10,-10,0,1,0,0
,Sperry Original Boat Shoe Sahara 11.5 M,Sperry Original Boat Shoe Sahara 11.5 M,FBALYB Amazon,-3,-3,0,0,0,0
,Sperry Original Boat Shoe Sahara 11 M,Sperry Original Boat Shoe Sahara 11 M,FBALYB Amazon,-6,-6,0,0,0,0
,Sperry Original Boat Shoe Sahara 12 M,Sperry Original Boat Shoe Sahara 12 M,FBALYB Amazon,-12,-12,0,0,0,0
,Sperry Original Boat Shoe Sahara 13 M,Sperry Original Boat Shoe Sahara 13 M,FBALYB Amazon,-5,-5,0,0,0,0
,Sperry Original Boat Shoe Sahara 8.5 M,Sperry Original Boat Shoe Sahara 8.5 M,FBALYB Amazon,-7,-7,0,0,0,0
,Sperry Original Boat Shoe Sahara 8M,Sperry Original Boat Shoe Sahara 8M,FBALYB Amazon,-1,-1,0,0,0,0
,Sperry Original Boat Shoe Sahara 9.5 M,Sperry Original Boat Shoe Sahara 9.5 M,FBALYB Amazon,-13,-13,0,0,0,0
,Sperry Original Boat Shoe Sahara 9 M,Sperry Original Boat Shoe Sahara 9 M,FBALYB Amazon,-10,-10,0,0,0,0
,Sperry Top Sider Linen Oat Womens Songfish Size 10,Sperry Top Sider Linen Oat Womens Songfish Size 10,FBALYB Amazon,-5,-5,0,15,0,0
,Sperry Top Sider Linen Oat Womens Songfish Size 11,Sperry Top Sider Linen Oat Womens Songfish Size 11,FBALYB Amazon,-4,-4,0,0,0,0
,Sperry Top Sider Linen Oat Womens Songfish Size 6.5,Sperry Top Sider Linen Oat Womens Songfish Size 6.5,Default,7,7,0,0,0,0
,Sperry Top Sider Linen Oat Womens Songfish Size 6.5,Sperry Top Sider Linen Oat Womens Songfish Size 6.5,FBALYB Amazon,-13,-13,0,15,0,0
,Sperry Top Sider Linen Oat Womens Songfish Size 7,Sperry Top Sider Linen Oat Womens Songfish Size 7,FBALYB Amazon,-10,-10,0,15,0,0
,Sperry Top Sider Linen Oat Womens Songfish Size 7.5,Sperry Top Sider Linen Oat Womens Songfish Size 7.5,FBALYB Amazon,-18,-18,0,35,0,0
,Sperry Top Sider Linen Oat Womens Songfish Size 8,Sperry Top Sider Linen Oat Womens Songfish Size 8,Default Ridgefield,1,1,0,0,0,0
,Sperry Top Sider Linen Oat Womens Songfish Size 8,Sperry Top Sider Linen Oat Womens Songfish Size 8,FBALYB Amazon,-10,-10,0,9,0,0
,Sperry Top Sider Linen Oat Womens Songfish Size 8.5,Sperry Top Sider Linen Oat Womens Songfish Size 8.5,FBALYB Amazon,-9,-9,0,38,0,0
,Sperry Top Sider Linen Oat Womens Songfish Size 9,Sperry Top Sider Linen Oat Womens Songfish Size 9,FBALYB Amazon,-17,-17,0,43,0,0
,Sperry Top Sider Linen Oat Womens Songfish Size 9.5,Sperry Top Sider Linen Oat Womens Songfish Size 9.5,Default,6,6,0,0,0,0
,Sperry Top Sider Linen Oat Womens Songfish Size 9.5,Sperry Top Sider Linen Oat Womens Songfish Size 9.5,FBALYB Amazon,-8,-8,0,15,0,0
,Sperry Top Siders Brown Mens Gold Size 10,Sperry Top Siders Brown Mens Gold Size 10,Default Ridgefield,15,15,0,0,0,0
,Sperry Top Siders Brown Mens Gold Size 10,Sperry Top Siders Brown Mens Gold Size 10,FBALYB Amazon,1,1,0,0,0,0
,Sperry Top Siders Brown Mens Gold Size 10.5,Sperry Top Siders Brown Mens Gold Size 10.5,FBALYB Amazon,-9,-9,0,0,0,0
,Sperry Top Siders Brown Mens Gold Size 11,Sperry Top Siders Brown Mens Gold Size 11,Default Ridgefield,15,15,0,0,0,0
,Sperry Top Siders Brown Mens Gold Size 11,Sperry Top Siders Brown Mens Gold Size 11,FBALYB Amazon,-2,-2,0,0,0,0
,Sperry Top Siders Brown Mens Gold Size 11.5,Sperry Top Siders Brown Mens Gold Size 11.5,FBALYB Amazon,9,9,0,0,0,0
,Sperry Top Siders Brown Mens Gold Size 8,Sperry Top Siders Brown Mens Gold Size 8,FBALYB Amazon,-1,-1,0,0,0,0
,Sperry Top Siders Brown Mens Gold Size 9,Sperry Top Siders Brown Mens Gold Size 9,Default Ridgefield,15,15,0,0,0,0
,Sperry Top Siders Brown Mens Gold Size 9,Sperry Top Siders Brown Mens Gold Size 9,FBALYB Amazon,1,1,0,0,0,0
,Sperry Top Siders Brown Mens Gold Size 9.5,Sperry Top Siders Brown Mens Gold Size 9.5,Default Ridgefield,15,15,0,0,0,0
,Sperry Top Siders Brown Mens Gold Size 9.5,Sperry Top Siders Brown Mens Gold Size 9.5,FBALYB Amazon,-4,-4,0,0,0,0
,Sperry Top-Sider Women's Seaside Fashion Sneaker Black 5.0, Sperry Top-Sider Women's Seaside Fashion Sneaker Black 5.0,FBALYB Amazon,12,12,0,0,0,0
,Sperry Top-Sider Women's Seaside Fashion Sneaker Black 6.5,Sperry Top-Sider Women's Seaside Fashion Sneaker Black 6.5,FBALYB Amazon,8,8,0,1,0,0
,Sperry Top-Sider Women's Seaside Fashion Sneaker Black 9.0, Sperry Top-Sider Women's Seaside Fashion Sneaker Black 9.0,FBALYB Amazon,-1,-1,0,0,0,0
,Sperry W Amaretto Mako 2 Eye Size 10,Sperry W Amaretto Mako 2 Eye Size 10,FBALYB Amazon,-11,-11,0,0,0,0
,Sperry W Amaretto Mako 2 Eye Size 10.5,Sperry W Amaretto Mako 2 Eye Size 10.5,FBALYB Amazon,-2,-2,0,0,0,0
,Sperry W Amaretto Mako 2 Eye Size 11.5,Sperry W Amaretto Mako 2 Eye Size 11.5,Default Ridgefield,3,3,0,0,0,0
,Sperry W Amaretto Mako 2 Eye Size 11.5,Sperry W Amaretto Mako 2 Eye Size 11.5,FBALYB Amazon,-2,-2,0,0,0,0
,Sperry W Amaretto Mako 2 Eye Size 12,Sperry W Amaretto Mako 2 Eye Size 12,FBALYB Amazon,-9,-9,0,0,0,0
,Sperry W Amaretto Mako 2 Eye Size 13,Sperry W Amaretto Mako 2 Eye Size 13,FBALYB Amazon,-5,-5,0,0,0,0
,Sperry W Amaretto Mako 2 Eye Size 8.5,Sperry W Amaretto Mako 2 Eye Size 8.5,FBALYB Amazon,-1,-1,0,0,0,0
,Sperry W Amaretto Mako 2 Eye Size 9,Sperry W Amaretto Mako 2 Eye Size 9,FBALYB Amazon,-2,-2,0,0,0,0
,Sperry W Amaretto Mako 2 Eye Size 9.5,Sperry W Amaretto Mako 2 Eye Size 9.5,FBALYB Amazon,-8,-8,0,0,0,0
,Sperry W Black Patent Seaport Size 10,Sperry W Black Patent Seaport Size 10,FBALYB Amazon,-1,-1,0,0,0,0
,Sperry W Black Patent Seaport Size 6.5,Sperry W Black Patent Seaport Size 6.5,FBALYB Amazon,-2,-2,0,0,0,0
,Sperry W Black Patent Seaport Size 9.5,Sperry W Black Patent Seaport Size 9.5,FBALYB Amazon,-1,-1,0,0,0,0
,Sperry White Womens Crest Vibe Size 10,Sperry White Womens Crest Vibe Size 10,FBALYB Amazon,-3,-3,0,0,0,0
,Sperry White Womens Crest Vibe Size 12,Sperry White Womens Crest Vibe Size 12,FBALYB Amazon,-2,-2,0,0,0,0
,Sperry White Womens Crest Vibe Size 6,Sperry White Womens Crest Vibe Size 6,Default Oxford,18,18,0,0,0,0
,Sperry White Womens Crest Vibe Size 7,Sperry White Womens Crest Vibe Size 7,FBALYB Amazon,-4,-4,0,0,0,0
,Sperry White Womens Crest Vibe Size 7.5,Sperry White Womens Crest Vibe Size 7.5,FBALYB Amazon,-4,-4,0,0,0,0
,Sperry White Womens Crest Vibe Size 8,Sperry White Womens Crest Vibe Size 8,FBALYB Amazon,-10,-10,0,0,0,0
,Sperry White Womens Crest Vibe Size 8.5,Sperry White Womens Crest Vibe Size 8.5,FBALYB Amazon,-15,-15,0,0,0,0
,Sperry White Womens Crest Vibe Size 9,Sperry White Womens Crest Vibe Size 9,FBALYB Amazon,-11,-11,0,0,0,0
,Sperry White Womens Crest Vibe Size 9.5,Sperry White Womens Crest Vibe Size 9.5,FBALYB Amazon,-6,-6,0,0,0,0
,Sperry W Linen Oat Womens Bluefish Size 8,Sperry W Linen Oat Womens Bluefish Size 8,FBALYB Amazon,-6,-6,0,0,0,0
,Sperry W Linen Oat Womens Bluefish Size 9,Sperry W Linen Oat Womens Bluefish Size 9,Default Oxford,13,13,0,0,0,0
,Sperry W Linen Oat Womens Bluefish Size 9,Sperry W Linen Oat Womens Bluefish Size 9,FBALYB Amazon,-12,-12,0,0,0,0
,Sperry Wmn STS84618 Sz 10,Sperry Women STS84618 SALTWATER WINTER LUX BLACK QUILT 10,FBALYB Amazon,43,43,0,0,0,0
,Sperry Wmn STS84618 Sz 6,Sperry Women STS84618 SALTWATER WINTER LUX BLACK QUILT 6,FBALYB Amazon,44,44,0,0,0,0
,Sperry Wmn STS84618 Sz 6.5,Sperry Women STS84618 SALTWATER WINTER LUX BLACK QUILT 6.5,FBALYB Amazon,6,6,0,0,0,0
,Sperry Wmn STS84618 Sz 7,Sperry Women STS84618 SALTWATER WINTER LUX BLACK QUILT 7,FBALYB Amazon,109,109,0,0,0,0
,Sperry Wmn STS84618 Sz 8,Sperry Women STS84618 SALTWATER WINTER LUX BLACK QUILT 8,FBALYB Amazon,34,34,0,0,0,0
,Sperry Wmn STS84618 Sz 8.5,Sperry Women STS84618 SALTWATER WINTER LUX BLACK QUILT 8.5,FBALYB Amazon,10,10,0,0,0,0
,Sperry Wmn STS84618 Sz 9,Sperry Women STS84618 SALTWATER WINTER LUX BLACK QUILT 9,FBALYB Amazon,87,87,0,0,0,0
,Sperry Womans Saltwater Boots Black/Grey Size 10,Sperry Womans Saltwater Boots Black/Grey Size 10,FBALYB Amazon,-16,-16,0,0,0,0
,Sperry Womans Saltwater Boots Black/Grey Size 11,Sperry Womans Saltwater Boots Black/Grey Size 11,Default Ridgefield,11,11,0,0,0,0
,Sperry Womans Saltwater Boots Black/Grey Size 11,Sperry Womans Saltwater Boots Black/Grey Size 11,FBALYB Amazon,-15,-15,0,0,0,0
,Sperry Womans Saltwater Boots Black/Grey Size 12,Sperry Womans Saltwater Boots Black/Grey Size 12,Default Oxford,6,6,0,0,0,0
,Sperry Womans Saltwater Boots Black/Grey Size 12,Sperry Womans Saltwater Boots Black/Grey Size 12,FBALYB Amazon,-6,-6,0,0,0,0
,Sperry Womans Saltwater Boots Black/Grey Size 5,Sperry Womans Saltwater Boots Black/Grey Size 5,Default Ridgefield,2,2,0,0,0,0
,Sperry Womans Saltwater Boots Black/Grey Size 6,Sperry Womans Saltwater Boots Black/Grey Size 6,FBALYB Amazon,34,34,0,0,0,0
,Sperry Womans Saltwater Boots Black/Grey Size 6.5,Sperry Womans Saltwater Boots Black/Grey Size 6.5,FBALYB Amazon,-20,-20,0,0,0,0
,Sperry Womans Saltwater Boots Black/Grey Size 7,Sperry Womans Saltwater Boots Black/Grey Size 7,Default,0,-1,1,0,0,1
,Sperry Womans Saltwater Boots Black/Grey Size 7,Sperry Womans Saltwater Boots Black/Grey Size 7,FBALYB Amazon,81,78,3,0,3,0
,Sperry Womans Saltwater Boots Black/Grey Size 7.5,Sperry Womans Saltwater Boots Black/Grey Size 7.5,Default Oxford,1,1,0,0,0,0
,Sperry Womans Saltwater Boots Black/Grey Size 7.5,Sperry Womans Saltwater Boots Black/Grey Size 7.5,FBALYB Amazon,-53,-53,0,0,0,0
,Sperry Womans Saltwater Boots Black/Grey Size 8,Sperry Womans Saltwater Boots Black/Grey Size 8,FBALYB Amazon,-14,-19,5,1,5,0
,Sperry Womans Saltwater Boots Black/Grey Size 8.5,Sperry Womans Saltwater Boots Black/Grey Size 8.5,Default Oxford,5,5,0,0,0,0
,Sperry Womans Saltwater Boots Black/Grey Size 8.5,Sperry Womans Saltwater Boots Black/Grey Size 8.5,Default Ridgefield,1,1,0,0,0,0
,Sperry Womans Saltwater Boots Black/Grey Size 8.5,Sperry Womans Saltwater Boots Black/Grey Size 8.5,FBALYB Amazon,152,149,3,0,3,0
,Sperry Womans Saltwater Boots Black/Grey Size 9,Sperry Womans Saltwater Boots Black/Grey Size 9,Default Oxford,7,7,0,0,0,0
,Sperry Womans Saltwater Boots Black/Grey Size 9,Sperry Womans Saltwater Boots Black/Grey Size 9,FBALYB Amazon,-21,-21,0,0,0,0
,Sperry Womans Saltwater Boots Black/Grey Size 9.5,Sperry Womans Saltwater Boots Black/Grey Size 9.5,FBALYB Amazon,-26,-28,2,0,2,0
,Sperry Womans Saltwater Boots Black/Quilted Nylon Size 10,Sperry Womans Saltwater Boots Black/Quilted Nylon Size 10,Default Ridgefield,6,6,0,0,0,0
,Sperry Womans Saltwater Boots Black/Quilted Nylon Size 10,Sperry Womans Saltwater Boots Black/Quilted Nylon Size 10,FBALYB Amazon,36,33,3,0,3,0
,Sperry Womans Saltwater Boots Black/Quilted Nylon Size 11,Sperry Womans Saltwater Boots Black/Quilted Nylon Size 11,Default Oxford,1,1,0,0,0,0
,Sperry Womans Saltwater Boots Black/Quilted Nylon Size 11,Sperry Womans Saltwater Boots Black/Quilted Nylon Size 11,FBALYB Amazon,-24,-24,0,0,0,0
,Sperry Womans Saltwater Boots Black/Quilted Nylon Size 12,Sperry Womans Saltwater Boots Black/Quilted Nylon Size 12,Default Oxford,2,2,0,0,0,0
,Sperry Womans Saltwater Boots Black/Quilted Nylon Size 12,Sperry Womans Saltwater Boots Black/Quilted Nylon Size 12,FBALYB Amazon,-6,-6,0,0,0,0
,Sperry Womans Saltwater Boots Black/Quilted Nylon Size 6,Sperry Womans Saltwater Boots Black/Quilted Nylon Size 6,Default Ridgefield,180,180,0,0,0,0
,Sperry Womans Saltwater Boots Black/Quilted Nylon Size 6,Sperry Womans Saltwater Boots Black/Quilted Nylon Size 6,FBALYB Amazon,73,73,0,0,0,0
,Sperry Womans Saltwater Boots Black/Quilted Nylon Size 6.5,Sperry Womans Saltwater Boots Black/Quilted Nylon Size 6.5,Default Ridgefield,168,168,0,0,0,0
,Sperry Womans Saltwater Boots Black/Quilted Nylon Size 6.5,Sperry Womans Saltwater Boots Black/Quilted Nylon Size 6.5,FBALYB Amazon,88,86,2,0,2,0
,Sperry Womans Saltwater Boots Black/Quilted Nylon Size 7,Sperry Womans Saltwater Boots Black/Quilted Nylon Size 7,Default Oxford,6,6,0,0,0,0
,Sperry Womans Saltwater Boots Black/Quilted Nylon Size 7,Sperry Womans Saltwater Boots Black/Quilted Nylon Size 7,Default Ridgefield,196,196,0,0,0,0
,Sperry Womans Saltwater Boots Black/Quilted Nylon Size 7,Sperry Womans Saltwater Boots Black/Quilted Nylon Size 7,FBALYB Amazon,27,26,1,1,1,0
,Sperry Womans Saltwater Boots Black/Quilted Nylon Size 7.5,Sperry Womans Saltwater Boots Black/Quilted Nylon Size 7.5,Default Oxford,42,42,0,0,0,0
,Sperry Womans Saltwater Boots Black/Quilted Nylon Size 7.5,Sperry Womans Saltwater Boots Black/Quilted Nylon Size 7.5,Default Ridgefield,302,302,0,0,0,0
,Sperry Womans Saltwater Boots Black/Quilted Nylon Size 7.5,Sperry Womans Saltwater Boots Black/Quilted Nylon Size 7.5,FBALYB Amazon,58,57,1,1,1,0
,Sperry Womans Saltwater Boots Black/Quilted Nylon Size 8,Sperry Womans Saltwater Boots Black/Quilted Nylon Size 8,FBALYB Amazon,-58,-60,2,0,2,0
,Sperry Womans Saltwater Boots Black/Quilted Nylon Size 8.5,Sperry Womans Saltwater Boots Black/Quilted Nylon Size 8.5,Default Oxford,18,18,0,0,0,0
,Sperry Womans Saltwater Boots Black/Quilted Nylon Size 8.5,Sperry Womans Saltwater Boots Black/Quilted Nylon Size 8.5,Default Ridgefield,82,82,0,0,0,0
,Sperry Womans Saltwater Boots Black/Quilted Nylon Size 8.5,Sperry Womans Saltwater Boots Black/Quilted Nylon Size 8.5,FBALYB Amazon,140,137,3,2,3,0
,Sperry Womans Saltwater Boots Black/Quilted Nylon Size 9,Sperry Womans Saltwater Boots Black/Quilted Nylon Size 9,Default Oxford,6,6,0,0,0,0
,Sperry Womans Saltwater Boots Black/Quilted Nylon Size 9,Sperry Womans Saltwater Boots Black/Quilted Nylon Size 9,Default Ridgefield,1,1,0,0,0,0
,Sperry Womans Saltwater Boots Black/Quilted Nylon Size 9,Sperry Womans Saltwater Boots Black/Quilted Nylon Size 9,FBALYB Amazon,113,104,9,0,9,0
,Sperry Womans Saltwater Boots Black/Quilted Nylon Size 9.5,Sperry Womans Saltwater Boots Black/Quilted Nylon Size 9.5,Default Oxford,12,12,0,0,0,0
,Sperry Womans Saltwater Boots Black/Quilted Nylon Size 9.5,Sperry Womans Saltwater Boots Black/Quilted Nylon Size 9.5,FBALYB Amazon,89,86,3,0,3,0
,Sperry Womans Saltwater Boots Brown/Olive Size 10,Sperry Womans Saltwater Boots Brown/Olive Size 10,FBALYB Amazon,-14,-14,0,0,0,0
,Sperry Womans Saltwater Boots Brown/Olive Size 11,Sperry Womans Saltwater Boots Brown/Olive Size 11,FBALYB Amazon,25,25,0,0,0,0
,Sperry Womans Saltwater Boots Brown/Olive Size 12,Sperry Womans Saltwater Boots Brown/Olive Size 12,FBALYB Amazon,-2,-2,0,0,0,0
,Sperry Womans Saltwater Boots Brown/Olive Size 6,Sperry Womans Saltwater Boots Brown/Olive Size 6,FBALYB Amazon,3,3,0,0,0,0
,Sperry Womans Saltwater Boots Brown/Olive Size 6.5,Sperry Womans Saltwater Boots Brown/Olive Size 6.5,FBALYB Amazon,-3,-3,0,0,0,0
,Sperry Womans Saltwater Boots Brown/Olive Size 7,Sperry Womans Saltwater Boots Brown/Olive Size 7,Default Oxford,6,6,0,0,0,0
,Sperry Womans Saltwater Boots Brown/Olive Size 7,Sperry Womans Saltwater Boots Brown/Olive Size 7,FBALYB Amazon,-14,-14,0,0,0,0
,Sperry Womans Saltwater Boots Brown/Olive Size 7.5,Sperry Womans Saltwater Boots Brown/Olive Size 7.5,FBALYB Amazon,-10,-10,0,0,0,0
,Sperry Womans Saltwater Boots Brown/Olive Size 8,Sperry Womans Saltwater Boots Brown/Olive Size 8,FBALYB Amazon,-27,-27,0,0,0,0
,Sperry Womans Saltwater Boots Brown/Olive Size 8.5,Sperry Womans Saltwater Boots Brown/Olive Size 8.5,Default Ridgefield,0,-500,500,0,0,0
,Sperry Womans Saltwater Boots Brown/Olive Size 8.5,Sperry Womans Saltwater Boots Brown/Olive Size 8.5,FBALYB Amazon,-15,-15,0,0,0,0
,Sperry Womans Saltwater Boots Brown/Olive Size 9,Sperry Womans Saltwater Boots Brown/Olive Size 9,FBALYB Amazon,-16,-16,0,0,0,0
,Sperry Womans Saltwater Boots Brown/Olive Size 9.5,Sperry Womans Saltwater Boots Brown/Olive Size 9.5,FBALYB Amazon,-22,-22,0,0,0,0
,Sperry Womans Saltwater Boots Tan/Brown Size 10,Sperry Womans Saltwater Boots Tan/Brown Size 10,FBALYB Amazon,-41,-44,3,1,3,0
,Sperry Womans Saltwater Boots Tan/Brown Size 11,Sperry Womans Saltwater Boots Tan/Brown Size 11,Default Oxford,6,6,0,0,0,0
,Sperry Womans Saltwater Boots Tan/Brown Size 11,Sperry Womans Saltwater Boots Tan/Brown Size 11,FBALYB Amazon,-23,-23,0,1,0,0
,Sperry Womans Saltwater Boots Tan/Brown Size 12,Sperry Womans Saltwater Boots Tan/Brown Size 12,FBALYB Amazon,46,46,0,0,0,0
,Sperry Womans Saltwater Boots Tan/Brown Size 6,Sperry Womans Saltwater Boots Tan/Brown Size 6,Default Ridgefield,18,18,0,0,0,0
,Sperry Womans Saltwater Boots Tan/Brown Size 6,Sperry Womans Saltwater Boots Tan/Brown Size 6,FBALYB Amazon,-21,-21,0,1,0,0
,Sperry Womans Saltwater Boots Tan/Brown Size 6.5,Sperry Womans Saltwater Boots Tan/Brown Size 6.5,Default Ridgefield,3,3,0,0,0,0
,Sperry Womans Saltwater Boots Tan/Brown Size 6.5,Sperry Womans Saltwater Boots Tan/Brown Size 6.5,FBALYB Amazon,200,199,1,0,1,0
,Sperry Womans Saltwater Boots Tan/Brown Size 7,Sperry Womans Saltwater Boots Tan/Brown Size 7,Default Oxford,4,4,0,0,0,0
,Sperry Womans Saltwater Boots Tan/Brown Size 7,Sperry Womans Saltwater Boots Tan/Brown Size 7,FBALYB Amazon,151,147,4,0,4,0
,Sperry Womans Saltwater Boots Tan/Brown Size 7.5,Sperry Womans Saltwater Boots Tan/Brown Size 7.5,Default Oxford,5,5,0,0,0,0
,Sperry Womans Saltwater Boots Tan/Brown Size 7.5,Sperry Womans Saltwater Boots Tan/Brown Size 7.5,Default Ridgefield,1,1,0,0,0,0
,Sperry Womans Saltwater Boots Tan/Brown Size 7.5,Sperry Womans Saltwater Boots Tan/Brown Size 7.5,FBALYB Amazon,41,32,9,0,9,0
,Sperry Womans Saltwater Boots Tan/Brown Size 8,Sperry Womans Saltwater Boots Tan/Brown Size 8,FBALYB Amazon,-95,-95,0,0,0,0
,Sperry Womans Saltwater Boots Tan/Brown Size 8.5,Sperry Womans Saltwater Boots Tan/Brown Size 8.5,Default Oxford,3,3,0,0,0,0
,Sperry Womans Saltwater Boots Tan/Brown Size 8.5,Sperry Womans Saltwater Boots Tan/Brown Size 8.5,FBALYB Amazon,40,38,2,0,2,0
,Sperry Womans Saltwater Boots Tan/Brown Size 9,Sperry Womans Saltwater Boots Tan/Brown Size 9,FBALYB Amazon,-91,-92,1,0,1,0
,Sperry Womans Saltwater Boots Tan/Brown Size 9.5,Sperry Womans Saltwater Boots Tan/Brown Size 9.5,FBALYB Amazon,154,151,3,1,3,0
,Sperry Womans Saltwater Boots Tan/Navy Size 10,Sperry Womans Saltwater Boots Tan/Navy Size 10,Default Oxford,4,4,0,0,0,0
,Sperry Womans Saltwater Boots Tan/Navy Size 10,Sperry Womans Saltwater Boots Tan/Navy Size 10,FBALYB Amazon,-42,-42,0,0,0,0
,Sperry Womans Saltwater Boots Tan/Navy Size 11,Sperry Womans Saltwater Boots Tan/Navy Size 11,FBALYB Amazon,-21,-21,0,2,0,0
,Sperry Womans Saltwater Boots Tan/Navy Size 12,Sperry Womans Saltwater Boots Tan/Navy Size 12,FBALYB Amazon,-19,-19,0,0,0,0
,Sperry Womans Saltwater Boots Tan/Navy Size 6,Sperry Womans Saltwater Boots Tan/Navy Size 6,FBALYB Amazon,-14,-14,0,0,0,0
,Sperry Womans Saltwater Boots Tan/Navy Size 6.5,Sperry Womans Saltwater Boots Tan/Navy Size 6.5,FBALYB Amazon,70,68,2,1,2,0
,Sperry Womans Saltwater Boots Tan/Navy Size 7,Sperry Womans Saltwater Boots Tan/Navy Size 7,FBALYB Amazon,-42,-50,8,0,8,0
,Sperry Womans Saltwater Boots Tan/Navy Size 7.5,Sperry Womans Saltwater Boots Tan/Navy Size 7.5,FBALYB Amazon,-63,-63,0,1,0,0
,Sperry Womans Saltwater Boots Tan/Navy Size 8,Sperry Womans Saltwater Boots Tan/Navy Size 8,Default Ridgefield,25,25,0,0,0,0
,Sperry Womans Saltwater Boots Tan/Navy Size 8,Sperry Womans Saltwater Boots Tan/Navy Size 8,FBALYB Amazon,11,-2,13,0,13,0
,Sperry Womans Saltwater Boots Tan/Navy Size 8.5,Sperry Womans Saltwater Boots Tan/Navy Size 8.5,FBALYB Amazon,196,184,12,0,12,0
,Sperry Womans Saltwater Boots Tan/Navy Size 9,Sperry Womans Saltwater Boots Tan/Navy Size 9,FBALYB Amazon,-92,-92,0,11,0,0
,Sperry Womans Saltwater Boots Tan/Navy Size 9.5,Sperry Womans Saltwater Boots Tan/Navy Size 9.5,Default,0,0,0,0,0,3
,Sperry Womans Saltwater Boots Tan/Navy Size 9.5,Sperry Womans Saltwater Boots Tan/Navy Size 9.5,FBALYB Amazon,-33,-34,1,0,1,0
,Sperry Womans Saltwater Heel Fashion Olive Size 10 STS85480,Sperry Womans Saltwater Heel Fashion Olive Size 10 STS85480,FBALYB Amazon,7,7,0,0,0,0
,Sperry Womans Saltwater Heel Fashion Olive Size 11 STS85480,Sperry Womans Saltwater Heel Fashion Olive Size 11 STS85480,FBALYB Amazon,13,13,0,0,0,0
,Sperry Womans Saltwater Heel Fashion Olive Size 6.5 STS85480,Sperry Womans Saltwater Heel Fashion Olive Size 6.5 STS85480,FBALYB Amazon,46,46,0,0,0,0
,Sperry Womans Saltwater Heel Fashion Olive Size 8 STS85480,Sperry Womans Saltwater Heel Fashion Olive Size 8 STS85480,FBALYB Amazon,87,87,0,1,0,0
,Sperry Womans Saltwater Heel Fashion Olive Size 9.5 STS85480,Sperry Womans Saltwater Heel Fashion Olive Size 9.5 STS85480,Default Ridgefield,0,-100,100,0,0,0
,Sperry Womans Saltwater Heel Fashion Olive Size 9.5 STS85480,Sperry Womans Saltwater Heel Fashion Olive Size 9.5 STS85480,FBALYB Amazon,24,24,0,0,0,0
,Sperry Women's Angelfish Boat Shoe - M 050 Linen Oat,,FBALYB Amazon,-8,-8,0,0,0,0
,Sperry Women's Angelfish Boat Shoe - M 060 Linen Oat,Sperry Women's Angelfish Boat Shoe - M 060 Linen Oat,FBALYB Amazon,-7,-7,0,28,0,0
,Sperry Women's Angelfish Boat Shoe - M 065 Linen Oat,,FBALYB Amazon,-5,-5,0,18,0,0
,Sperry Women's Angelfish Boat Shoe - M 070 Linen Oat,Sperry Women's Angelfish Boat Shoe - M 070 Linen Oat,FBALYB Amazon,-8,-8,0,50,0,0
,Sperry Women's Angelfish Boat Shoe - M 075 Linen Oat,,FBALYB Amazon,-20,-20,0,35,0,0
,Sperry Women's Angelfish Boat Shoe - M 080 Linen Oat,,FBALYB Amazon,-8,-8,0,19,0,0
,Sperry Women's Angelfish Boat Shoe - M 085 Linen Oat,Sperry Women's Angelfish Boat Shoe - M 085 Linen Oat,FBALYB Amazon,-6,-6,0,55,0,0
,Sperry Women's Angelfish Boat Shoe - M 090 Linen Oat,,FBALYB Amazon,-91,-91,0,123,0,0
,Sperry Women's Angelfish Boat Shoe - M 095 Linen Oat,,FBALYB Amazon,-5,-5,0,15,0,0
,Sperry Women's Angelfish Boat Shoe - M 100  Linen Oat,,FBALYB Amazon,0,-6,6,35,6,0
,Sperry Women's Angelfish Boat Shoe - M 110 Linen Oat,,FBALYB Amazon,-3,-3,0,15,0,0
,Sperry Women's Angelfish Boat Shoe - M 120 Linen Oat,,FBALYB Amazon,-3,-3,0,0,0,0
,Sperry Women's Angelfish Metallic Boat Shoe - M 065 Linen Metallic,Sperry Women's Angelfish Metallic Boat Shoe - M 065 Linen Metallic,FBALYB Amazon,-5,-5,0,0,0,0
,Sperry Women's Angelfish Metallic Boat Shoe - M 070 Linen Metallic,,Default Ridgefield,15,15,0,0,0,0
,Sperry Women's Angelfish Metallic Boat Shoe - M 075 Linen Metallic,,Default Ridgefield,65,65,0,0,0,0
,Sperry Women's Angelfish Metallic Boat Shoe - M 075 Linen Metallic,,FBALYB Amazon,55,54,1,0,1,0
,Sperry Women's Angelfish Metallic Boat Shoe - M 085 Linen Metallic,Sperry Women's Angelfish Metallic Boat Shoe - M 085 Linen Metallic,Default Ridgefield,17,17,0,0,0,0
,Sperry Women's Angelfish Metallic Boat Shoe - M 085 Linen Metallic,Sperry Women's Angelfish Metallic Boat Shoe - M 085 Linen Metallic,FBALYB Amazon,-3,-3,0,0,0,0
,Sperry Women's Angelfish Metallic Boat Shoe - M 090 Linen Metallic,Sperry Women's Angelfish Metallic Boat Shoe - M 090 Linen Metallic,FBALYB Amazon,-4,-4,0,0,0,0
,Sperry Women's Angelfish Metallic Boat Shoe - M 100 Linen Metallic,Sperry Women's Angelfish Metallic Boat Shoe - M 100 Linen Metallic,FBALYB Amazon,-11,-12,1,13,1,0
,Sperry Women's Angelfish Varsity Boat Shoe Grey/Silver 5.0,Sperry Women's Angelfish Varsity Boat Shoe Grey/Silver 5.0,FBALYB Amazon,-1,-1,0,0,0,0
,Sperry Women's Angelfish Varsity Boat Shoe Grey/Silver 5.5,Sperry Women's Angelfish Varsity Boat Shoe Grey/Silver 5.5,FBALYB Amazon,-7,-7,0,0,0,0
,Sperry Women's Angelfish Varsity Boat Shoe - M 060 Grey/Silver,,FBALYB Amazon,-4,-4,0,0,0,0
,Sperry Women's Angelfish Varsity Boat Shoe - M 065 Grey/Silver,,FBALYB Amazon,-5,-5,0,0,0,0
,Sperry Women's Angelfish Varsity Boat Shoe - M 070 Grey/Silver,,FBALYB Amazon,-12,-12,0,0,0,0
,Sperry Women's Angelfish Varsity Boat Shoe - M 075 Grey/Silver,,FBALYB Amazon,-10,-10,0,0,0,0
,Sperry Women's Angelfish Varsity Boat Shoe - M 085 Grey/Silver,,FBALYB Amazon,-1,-1,0,0,0,0
,Sperry Women's Angelfish Varsity Boat Shoe - M 090 Grey/Silver,,FBALYB Amazon,-3,-3,0,0,0,0
,Sperry Women's Angelfish Varsity Boat Shoe - M 095 Linen,,FBALYB Amazon,-1,-1,0,0,0,0
,Sperry Women's Authentic Original Boat Shoe - M 050 Sahara Leather,,Default Oxford,12,12,0,0,0,0
,Sperry Women's Authentic Original Boat Shoe - M 060 Classic Brown Leather,,Default Oxford,17,17,0,0,0,0
,Sperry Women's Authentic Original Boat Shoe - M 060 Sahara Leather,,Default Oxford,25,25,0,0,0,0
,Sperry Women's Authentic Original Boat Shoe - M 070 Classic Brown Leather,,Default Oxford,25,25,0,0,0,0
,Sperry Women's Authentic Original Boat Shoe - M 070 Sahara Leather,,Default Oxford,38,38,0,0,0,0
,Sperry Women's Authentic Original Boat Shoe - M 075 Sahara Leather,,Default Oxford,12,12,0,0,0,0
,Sperry Women's Authentic Original Boat Shoe - M 080 Classic Brown Leather,,Default Oxford,25,25,0,0,0,0
,Sperry Women's Authentic Original Boat Shoe - M 080 Sahara Leather,,Default Oxford,37,37,0,0,0,0
,Sperry Women's Authentic Original Boat Shoe - M 080 Sahara Leather,,Default Ridgefield,1,1,0,0,0,0
,Sperry Women's Authentic Original Boat Shoe - M 100 Classic Brown Leather,,Default Oxford,25,25,0,0,0,0
,Sperry Women's Authentic Original Boat Shoe - M 100 Sahara Leather,,Default Oxford,38,38,0,0,0,0
,Sperry Women's Authentic Original Boat Shoe - M 110 Sahara Leather,,Default Oxford,12,12,0,0,0,0
,Sperry Women's Authentic Original Boat Shoe - W 075 Classic Brown Leather,,Default Oxford,17,17,0,0,0,0
,Sperry Women's Authentic Original Boat Shoe - W 090 Classic Brown Leather,,Default Oxford,13,13,0,0,0,0
,Sperry Women's Authentic Original Boat Shoe - W 090 Classic Brown Leather,,Default Ridgefield,4,4,0,0,0,0
,Sperry Womens Black Crest Vibe Size 6,,FBALYB Amazon,-1,-1,0,0,0,0
,Sperry Womens Black Crest Vibe Size 8.5,,FBALYB Amazon,28,28,0,0,0,0
,Sperry Womens Black Crest Vibe Size 9,,Default Ridgefield,3,3,0,0,0,0
,Sperry Womens Black Crest Vibe Size 9,,FBALYB Amazon,-2,-2,0,0,0,0
,Sperry Womens Black Seaport Penny Loafer Size 6.5,,FBALYB Amazon,-4,-4,0,0,0,0
,Sperry Womens Black Seaport Penny Loafer Size 7,Sperry Womens Black Seaport Penny Loafer Size 7,FBALYB Amazon,-11,-11,0,15,0,0
,Sperry Womens Black Seaport Penny Loafer Size 7.5,Sperry Womens Black Seaport Penny Loafer Size 7.5,Default Ridgefield,9,9,0,0,0,0
,Sperry Womens Black Seaport Penny Loafer Size 7.5,Sperry Womens Black Seaport Penny Loafer Size 7.5,FBALYB Amazon,-8,-9,1,55,1,0
,Sperry Womens Black Seaport Penny Loafer Size 8,Sperry Womens Black Seaport Penny Loafer Size 8,FBALYB Amazon,-8,-8,0,15,0,0
,Sperry Womens Black Seaport Penny Loafer Size 9.5,Sperry Womens Black Seaport Penny Loafer Size 9.5,Default Ridgefield,6,6,0,0,0,0
,Sperry Women's Crest Twin Gore Linen Sneaker - M 055 Champagne,,FBALYB Amazon,-2,-2,0,0,0,0
,Sperry Women's Crest Twin Gore Linen Sneaker - M 065 Silver,,FBALYB Amazon,-2,-2,0,0,0,0
,Sperry Women's Crest Twin Gore Linen Sneaker - M 085 Silver,,FBALYB Amazon,-1,-1,0,0,0,0
,Sperry Women's Crest Twin Gore Linen Sneaker - M 095 Champagne,,FBALYB Amazon,-3,-3,0,0,0,0
,Sperry Womens Crest Vibe Grey Size 10,Sperry Womens Crest Vibe Grey Size 10,FBALYB Amazon,-9,-9,0,2,0,0
,Sperry Womens Crest Vibe Grey Size 6,Sperry Womens Crest Vibe Grey Size 6,Default Ridgefield,1,1,0,0,0,0
,Sperry Womens Crest Vibe Grey Size 7,Sperry Womens Crest Vibe Grey Size 7,Default Oxford,34,34,0,0,0,0
,Sperry Womens Crest Vibe Grey Size 7,Sperry Womens Crest Vibe Grey Size 7,FBALYB Amazon,4,4,0,0,0,0
,Sperry Womens Crest Vibe Grey Size 7.5,Sperry Womens Crest Vibe Grey Size 7.5,Default Ridgefield,14,14,0,0,0,0
,Sperry Womens Crest Vibe Grey Size 7.5,Sperry Womens Crest Vibe Grey Size 7.5,FBALYB Amazon,16,16,0,0,0,0
,Sperry Womens Crest Vibe Grey Size 8,Sperry Womens Crest Vibe Grey Size 8,Default Ridgefield,10,10,0,0,0,0
,Sperry Womens Crest Vibe Grey Size 8,Sperry Womens Crest Vibe Grey Size 8,FBALYB Amazon,12,12,0,0,0,0
,Sperry Womens Crest Vibe Grey Size 8.5,Sperry Womens Crest Vibe Grey Size 8.5,FBALYB Amazon,-3,-3,0,1,0,0
,Sperry Womens Crest Vibe Grey Size 9,Sperry Womens Crest Vibe Grey Size 9,Default Oxford,42,42,0,0,0,0
,Sperry Womens Crest Vibe Grey Size 9,Sperry Womens Crest Vibe Grey Size 9,FBALYB Amazon,-49,-55,6,3,6,0
,Sperry Womens Crest Vibe Grey Size 9.5,Sperry Womens Crest Vibe Grey Size 9.5,FBALYB Amazon,10,10,0,0,0,0
,Sperry Women's Lounge Away Boat Shoe - M 060 Rose,,FBALYB Amazon,-2,-2,0,0,0,0
,Sperry Women's Lounge Away Boat Shoe - M 065 Rose,,FBALYB Amazon,-1,-1,0,0,0,0
,Sperry Women's Lounge Away Boat Shoe - M 070 Rose,,FBALYB Amazon,-50,-50,0,47,0,0
,Sperry Women's Lounge Away Boat Shoe - M 075 Rose,,FBALYB Amazon,-6,-6,0,0,0,0
,Sperry Women's Lounge Away Boat Shoe - M 080 Rose,,FBALYB Amazon,-8,-8,0,0,0,0
,Sperry Women's Lounge Away Boat Shoe - M 085 Rose,,FBALYB Amazon,-6,-6,0,0,0,0
,Sperry Women's Lounge Away Boat Shoe - M 090 Rose,,FBALYB Amazon,-23,-23,0,19,0,0
,Sperry Women's Lounge Away Boat Shoe - M 095 Rose,,FBALYB Amazon,-16,-16,0,7,0,0
,Sperry Women's Lounge Away Boat Shoe - M 100 Rose,,FBALYB Amazon,-1,-1,0,0,0,0
,Sperry Women's Lounge LTT Shoes - M 065 Grey,,FBALYB Amazon,-1,-1,0,0,0,0
,Sperry Women's Lounge LTT Shoes - M 075 Grey,,FBALYB Amazon,-4,-4,0,0,0,0
,Sperry Women's Lounge LTT Shoes - M 080 Grey,,FBALYB Amazon,-2,-2,0,0,0,0
,Sperry Women's Lounge LTT Shoes - M 095 Grey,,FBALYB Amazon,-2,-2,0,0,0,0
,Sperry Women's Lounge LTT Shoes - M 095 White,,Default Ridgefield,1,1,0,0,0,0
,Sperry Women's Lounge LTT Shoes - M 095 White,,FBALYB Amazon,12,12,0,0,0,0
,Sperry Women's Pier View Slip-On Sneaker - M 055 Grey,,FBALYB Amazon,8,8,0,0,0,0
,Sperry Women's Pier View Slip-On Sneaker - M 055 White,,Default Ridgefield,15,15,0,0,0,0
,Sperry Women's Pier View Slip-On Sneaker - M 055 White,,FBALYB Amazon,-2,-2,0,0,0,0
,Sperry Women's Pier View Slip-On Sneaker - M 060 Grey,,FBALYB Amazon,0,0,0,1,0,0
,Sperry Women's Pier View Slip-On Sneaker - M 065 Grey,,FBALYB Amazon,-2,-2,0,2,0,0
,Sperry Women's Pier View Slip-On Sneaker - M 065 Navy,,FBALYB Amazon,-2,-2,0,0,0,0
,Sperry Women's Pier View Slip-On Sneaker - M 070 Grey,,FBALYB Amazon,-4,-4,0,0,0,0
,Sperry Women's Pier View Slip-On Sneaker - M 075 Grey,,FBALYB Amazon,-4,-4,0,0,0,0
,Sperry Women's Pier View Slip-On Sneaker - M 075 Navy,,FBALYB Amazon,-1,-1,0,0,0,0
,Sperry Women's Pier View Slip-On Sneaker - M 080 Grey,,FBALYB Amazon,-8,-8,0,0,0,0
,Sperry Women's Pier View Slip-On Sneaker - M 080 White,44214984381,Default Ridgefield,2,2,0,0,0,0
,Sperry Women's Pier View Slip-On Sneaker - M 080 White,44214984381,FBALYB Amazon,-2,-3,1,0,1,0
,Sperry Women's Pier View Slip-On Sneaker - M 085 Grey,,FBALYB Amazon,-2,-2,0,0,0,0
,Sperry Women's Pier View Slip-On Sneaker - M 085 Navy,,FBALYB Amazon,-1,-1,0,0,0,0
,Sperry Women's Pier View Slip-On Sneaker - M 085 White,,FBALYB Amazon,-4,-4,0,4,0,0
,Sperry Women's Pier View Slip-On Sneaker - M 090 Grey,,Default Ridgefield,-1,-1,0,0,0,0
,Sperry Women's Pier View Slip-On Sneaker - M 090 Grey,,FBALYB Amazon,-6,-6,0,0,0,0
,Sperry Women's Pier View Slip-On Sneaker - M 090 Navy,,FBALYB Amazon,-7,-7,0,1,0,0
,Sperry Women's Pier View Slip-On Sneaker - M 090 White,,FBALYB Amazon,-4,-4,0,4,0,0
,Sperry Women's Pier View Slip-On Sneaker - M 095 Grey,,FBALYB Amazon,-7,-7,0,0,0,0
,Sperry Women's Pier View Slip-On Sneaker - M 095 Navy,,FBALYB Amazon,-2,-2,0,0,0,0
,Sperry Women's Pier View Slip-On Sneaker - M 100 Grey,,FBALYB Amazon,-7,-7,0,0,0,0
,Sperry Women's Pier View Slip-On Sneaker - M 110 Grey,,FBALYB Amazon,0,0,0,22,0,0
,Sperry Women's Pier View Slip-On Sneaker - M 110 Navy,,FBALYB Amazon,-2,-2,0,0,0,0
,Sperry Women's Pier View Slip-On Sneaker - M 110 White,,FBALYB Amazon,-3,-3,0,0,0,0
,Sperry Women's Pier View Slip-On Sneaker - M 120 Grey,,FBALYB Amazon,-1,-1,0,0,0,0
,Sperry Women's Pier View Slip-On Sneaker - M 120 White,,FBALYB Amazon,-2,-2,0,0,0,0
,Sperry Women's Pier View Sneaker - M 075 Sand,,Default Ridgefield,8,8,0,0,0,0
,Sperry Women's Pier View Sneaker - M 075 Sand,,FBALYB Amazon,2,1,1,0,1,0
,Sperry Women's Pier View Sneaker - M 080 Sand,,Default Ridgefield,17,17,0,0,0,0
,Sperry Women's Pier View Sneaker - M 080 Sand,,FBALYB Amazon,6,6,0,0,0,0
,Sperry Women's Pier View Sneaker - M 090 Sand,,FBALYB Amazon,-2,-2,0,0,0,0
,Sperry Women's Pier View Sneaker Navy 12,Sperry Women's Pier View Sneaker Navy 12,FBALYB Amazon,28,27,1,0,1,0
,Sperry Women's Pier View Sneaker Navy 6.0,Sperry Women's Pier View Sneaker Navy 6.0,FBALYB Amazon,-1,-1,0,0,0,0
,Sperry Women's Rosefish Boat Shoe - M 050 Grey Oat Sparkle STS83340,Sperry Women's Rosefish Boat Shoe - M 050 Grey Oat Sparkle STS83340,FBALYB Amazon,17,17,0,0,0,0
,Sperry Women's Rosefish Boat Shoe - M 055 Grey Oat Sparkle STS83340,Sperry Women's Rosefish Boat Shoe - M 055 Grey Oat Sparkle STS83340,FBALYB Amazon,47,47,0,0,0,0
,Sperry Women's Rosefish Boat Shoe - M 060 Grey Oat Sparkle STS83340,Sperry Women's Rosefish Boat Shoe - M 060 Grey Oat Sparkle STS83340,FBALYB Amazon,-3,-3,0,0,0,0
,Sperry Women's Rosefish Boat Shoe - M 065 Grey Oat Sparkle STS83340,Sperry Women's Rosefish Boat Shoe - M 065 Grey Oat Sparkle STS83340,FBALYB Amazon,3,3,0,0,0,0
,Sperry Women's Rosefish Boat Shoe - M 075 Linen Oat Sparkle,,FBALYB Amazon,-1,-1,0,0,0,0
,Sperry Women's Seaport Penny Loafer - M 050 Black Patent STS81926,Sperry Women's Seaport Penny Loafer - M 050 Black Patent STS81926,FBALYB Amazon,13,13,0,0,0,0
,Sperry Women's Seaport Penny Loafer - M 055 Black Patent STS81926,Sperry Women's Seaport Penny Loafer - M 055 Black Patent STS81926,FBALYB Amazon,36,36,0,4,0,0
,Sperry Women STS95588 Sz 12,Sperry Women STS95588 SONGFISH LINEN OAT 12,Default Ridgefield,5,5,0,0,0,0
,Sperry Womens White Crest Vibe Size 11,Sperry Womens White Crest Vibe Size 11,Default Oxford,18,18,0,0,0,0
,Sperry Womens White Crest Vibe Size 11,Sperry Womens White Crest Vibe Size 11,Default Ridgefield,4,4,0,0,0,0
,Sperry W Sltwtr Boot Blck/QNyln 5,Sperry Womans Saltwater Boots Black/Quilted Nylon STS94063 Size 5,FBALYB Amazon,3,3,0,0,0,0
,Sperry W Sltwtr Boot Tan/Nvy 5.5,Sperry Womans Saltwater Boots Tan/Navy STS91175 Size 5.5,Default Ridgefield,55,55,0,0,0,0
,Sperry W Sltwtr Boot Tan/Nvy 5.5,Sperry Womans Saltwater Boots Tan/Navy STS91175 Size 5.5,FBALYB Amazon,19,19,0,0,0,0
,Sperry W Tan Mens Mako 2 Tan Size 10,Sperry W Tan Mens Mako 2 Tan Size 10,FBALYB Amazon,-7,-7,0,0,0,0
,Sperry W Tan Womens Seaport Size 9,Sperry W Tan Womens Seaport Size 9,FBALYB Amazon,-11,-11,0,0,0,0
,Sperry W Tan Womens Seaport Size 9.5,Sperry W Tan Womens Seaport Size 9.5,Default Oxford,2,2,0,0,0,0
,Sperry W Tan Womens Seaport Size 9.5,Sperry W Tan Womens Seaport Size 9.5,FBALYB Amazon,-14,-14,0,0,0,0
,SPEY WHISKY,SPEY WHISKY,FBALYB Amazon,15,15,0,0,0,0
,Spiderman Titan Hero FX Power 2.0,,Default,0,-8,8,0,0,0
,Spiderman Titan Hero FX Power 2.0,,FBALYB Amazon,1,1,0,1,0,0
,Spirit Riding Horse Collection Figure Set,Spirit Riding Horse Collection Figure Set,FBALYB Amazon,-1,-1,0,0,0,0
,Splenda Sweetener ‑ 1200 pack,"Splenda Sweetener ‑ 1200 pack, 2.56 lb box",FBALYB Amazon,66,65,1,0,1,0
,Splenda Sweetener ‑ 1200 pack,"Splenda Sweetener ‑ 1200 pack, 2.56 lb box",WFS,-81,-81,0,0,0,0
,Sporn Double Dog Leash Black,Sporn Double Dog Leash Black,Default Ridgefield,30,30,0,0,0,0
,Sporn Halter Black Small,Sporn Halter Black Small,Default,0,0,0,0,0,71
,Sporn Halter Black Small,Sporn Halter Black Small,Default Ridgefield,60,60,0,0,0,0
,Sporn Halter Black Small,Sporn Halter Black Small,FBALYB Amazon,-2,-2,0,0,0,0
,Sporn Head Halter - Black Medium,Sporn Head Halter - Black Medium,Default Ridgefield,1,1,0,0,0,0
,Sporn Head Halter - Black Medium,Sporn Head Halter - Black Medium,FBALYB Amazon,111,111,0,1,0,0
,Sporn Marrow Bone Large,Sporn Marrow Bone Large,FBALYB Amazon,1,1,0,0,0,0
,Sporn No Pull Halter - Black Medium,Sporn No Pull Halter - Black Medium,Default,0,0,0,0,0,12
,Sporn No Pull Halter Red Large,Sporn No Pull Halter Red Large,Default,0,0,0,0,0,18
,Sporn No Pull Halter Red Large,Sporn No Pull Halter Red Large,Default Ridgefield,36,36,0,0,0,0
,Sporn No Pull Halter Red Large,Sporn No Pull Halter Red Large,FBALYB Amazon,-1,-1,0,0,0,0
,Sportstape Hockey Tape Multipack Black 6 Roll,Sportstape Hockey Tape Multipack Black 6 Roll,Default,0,-189,189,0,0,10
,Sportstape Hockey Tape Multipack Black 6 Roll,Sportstape Hockey Tape Multipack Black 6 Roll,Default Oxford,-194,-194,0,0,0,0
,Sportstape Hockey Tape Multipack Black 6 Roll,Sportstape Hockey Tape Multipack Black 6 Roll,Default Ridgefield,76,75,1,0,0,0
,Sportstape Hockey Tape Multipack Black 6 Roll,Sportstape Hockey Tape Multipack Black 6 Roll,FBALYB Amazon,-199,-205,6,3,6,0
,Sportstape Hockey Tape Multipack Black 6 Roll,Sportstape Hockey Tape Multipack Black 6 Roll,FBALYB Canada,11,10,1,0,1,0
,Sportstape Hockey Tape Multipack Clear 6 Roll,Sportstape Hockey Tape Multipack Clear 6 Roll,FBALYB Amazon,-112,-139,27,91,27,0
,Sportstape Hockey Tape Multipack Clear 6 Roll,Sportstape Hockey Tape Multipack Clear 6 Roll,WFS,-6,-6,0,0,0,0
,SportsTape Hockey Tape Multipack White 6 Roll,SportsTape Hockey Tape Multipack White 6 Roll,Default Ridgefield,570,570,0,0,0,0
,SportsTape Hockey Tape Multipack White 6 Roll,SportsTape Hockey Tape Multipack White 6 Roll,FBALYB Amazon,-743,-746,3,710,3,0
,Squishmallow Christmas 2020 Ornaments Collection 4” Mini Plush Doll Toy Set Of 6,Squishmallow Christmas 2020 Ornaments Collection 4” Mini Plush Doll Toy Set Of 6,FBALYB Amazon,37,37,0,0,0,0
,"Squishmallow Holiday 2020 Mini Plush Ornament 4"" Set Of 6 Kelly Toys","Squishmallow Holiday 2020 Mini Plush Ornament 4"" Set Of 6 Kelly Toys",Default Ridgefield,37,37,0,0,0,0
,"Squishmallow Holiday 2020 Plush Ornament 4"" Set Of 6 Kelly Toys","Squishmallow Holiday 2020 Plush Ornament 4"" Set Of 6 Kelly Toys",FBALYB Amazon,18,18,0,0,0,0
,Squishmallow Holiday assorted Master,Squishmallow Holiday assorted Master,Default,0,0,0,0,0,15
,Squishmallows - 8 Ct Plush Set,Squishmallows - 8 Ct Plush Set,FBALYB Amazon,-6,-6,0,0,0,0
,Squishmallow Xmas 6pk,Squishmallow Xmas 6pk,FBALYB Amazon,-2,-2,0,1,0,0
,Stack-On PS-1508 Safe,Stack-On PS-1508 Extra Wide Strong Box Safe with Electronic Lock,FBALYB Amazon,1,1,0,0,0,0
,Staedler Markers,Staedler Markers,FBALYB Amazon,1,1,0,0,0,0
,Staedler Math Essentials,Staedler Math Essentials,FBALYB Amazon,53,53,0,0,0,0
,Staedtler 52pcs Colouring Set,Staedtler 52pcs Colouring Set,Default,0,0,0,0,0,4
,Staedtler 52pcs Colouring Set,Staedtler 52pcs Colouring Set,Default Ridgefield,20,20,0,0,0,0
,Staedtler 52pcs Colouring Set,Staedtler 52pcs Colouring Set,FBALYB Amazon,271,271,0,1,0,0
,Staedtler 52pcs Colouring Set,Staedtler 52pcs Colouring Set,FBALYB Canada,-1,-3,2,20,2,0
,Starbucks 2 pack 30oz hot cocoa,Starbucks 2 pack 30oz hot cocoa,FBALYB Amazon,4,3,1,0,1,0
,"Starbucks 30 ct Variety Pack French, Sumatra, and Verona","Starbucks 30 ct Variety Pack French, Sumatra, and Verona",FBALYB Amazon,3,3,0,0,0,0
,Starbucks 40oz House Blend,Starbucks 40oz House Blend,FBALYB Amazon,1,1,0,2,0,0
,"Starbucks All Varieties Blonde, Verona, Pike, Colombia, Decaf Espresso, Sumatra, Espresso 80 Caps","Starbucks All Variety Blonde, Verona, Pike, Colombia, Decaf Espresso, Sumatra, Espresso 80 Caps",FBALYB Amazon,46,44,2,0,2,0
,Starbucks Caffe Verona 24ct,Starbucks Caffe Verona 24ct,FBALYB Amazon,6,6,0,1,0,0
,Starbucks Caffe Verona 24ct 2pk,Starbucks Caffe Verona 24ct 2pk,FBALYB Amazon,69,69,0,0,0,0
,Starbucks Caffe Verona 24ct 3pk,Starbucks Caffe Verona 24ct 3pk,FBALYB Amazon,-19,-20,1,23,1,0
,Starbucks Caffe Verona 24ct 4PK,Starbucks Caffe Verona 24ct 4PK,FBALYB Amazon,-67,-67,0,84,0,0
,Starbucks Caffe Verona Dark 2.5lb,Starbucks Caffe Verona Dark Whole Bean 2.5lb,FBALYB Amazon,-8,-8,0,0,0,0
,"Starbucks Caffe Verona Ground Coffee, Dark Roast (40 oz.)","Starbucks Caffe Verona Ground Coffee, Dark Roast (40 oz.)",FBALYB Amazon,1,1,0,0,0,0
,Starbucks French 40 Whole Bean 2 Pack,Starbucks French Roast Coffee 40oz 2pk,FBALYB Amazon,-117,-117,0,133,0,0
,Starbucks French Roast 24ct 3pk,Starbucks French Roast 24ct 3pk,FBALYB Amazon,-2,-2,0,3,0,0
,Starbucks French Roast 24ct 4pk,Starbucks French Roast 24ct 4pk,FBALYB Amazon,-66,-66,0,76,0,0
,Starbucks French Roast 48,Starbucks French Roast 48,FBALYB Amazon,-7,-7,0,6,0,0
,Starbucks French Roast Coffee,"Starbucks French Roast Whole Bean Coffee, 40 Ounce",Default,3,-1511,1514,0,0,7
,Starbucks French Roast Coffee,"Starbucks French Roast Whole Bean Coffee, 40 Ounce",FBALYB Amazon,-7,-7,0,0,0,0
,"Starbucks Lungo Variety 2 House, 1 Pike, 1 Colombia 40 caps","Starbucks Lungo Variety 2 House, 1 Pike, 1 Colombia 40 caps ",FBALYB Amazon,135,134,1,4,1,0
,Starbucks Medium House Blend 2pk 102g,Starbucks Medium House Blend 2pk 102g,Default Ridgefield,624,624,0,0,0,0
,Starbucks  Nescafe DG Blonde Espresso Roast 12 caps,Starbucks  Nescafe DG Blonde Espresso Roast 12 caps,Default Ridgefield,1916,1916,0,0,0,0
,Starbucks  Nescafe DG Blonde Espresso Roast 12 caps 3pk,Starbucks  Nescafe DG Blonde Espresso Roast 12 caps 3pk,FBALYB Amazon,298,298,0,0,0,0
,Starbucks Nescafe DG Caramel Macchiato 12 caps,Starbucks Nescafe DG Caramel Macchiato 12 caps,Default Ridgefield,1173,1173,0,0,0,0
,Starbucks Nescafe DG Caramel Macchiato 12 caps 3pk,Starbucks Nescafe DG Caramel Macchiato 12 caps 3pk,Default Ridgefield,50,0,50,0,0,0
,Starbucks Nescafe DG Caramel Macchiato 12 caps 3pk,Starbucks Nescafe DG Caramel Macchiato 12 caps 3pk,FBALYB Amazon,780,748,32,4,32,0
,Starbucks  Nescafe DG Latte Macchiato 12 caps 3pk,Starbucks  Nescafe DG Latte Macchiato 12 caps 3pk,FBALYB Amazon,63,63,0,0,0,0
,Starbucks Nescafe DG Veranda 12 caps,Starbucks Nescafe DG Veranda 12 caps,Default Ridgefield,2,2,0,0,0,0
,Starbucks Nescafe DG Veranda 12 caps 3pk,Starbucks Nescafe DG Veranda 12 caps 3pk,FBALYB Amazon,291,290,1,2,1,0
,Starbucks Nespresso Blonde Roast Esprsso 10 caps 5PK,Starbucks Nespresso Blonde Roast Esprsso 10 caps 5PK,FBALYB Amazon,584,404,180,326,180,0
,Starbucks  Nespresso Caffè Verona 10 caps,Starbucks  Nespresso Caffè Verona 10 caps,Default Ridgefield,6139,6139,0,0,0,0
,Starbucks  Nespresso Caffè Verona 10 caps 5PK,Starbucks  Nespresso Caffè Verona 10 caps 5PK,Default Ridgefield,2,0,2,0,0,0
,Starbucks  Nespresso Caffè Verona 10 caps 5PK,Starbucks  Nespresso Caffè Verona 10 caps 5PK,FBALYB Amazon,-796,-804,8,835,8,0
,Starbucks  Nespresso Decaf Espresso Dark Roast 10 caps,Starbucks  Nespresso Decaf Espresso Dark Roast 10 caps,Default Ridgefield,19602,19602,0,0,0,0
,Starbucks  Nespresso Decaf Espresso Dark Roast 10 caps 5PK,Starbucks  Nespresso Decaf Espresso Dark Roast 10 caps 5PK,FBALYB Amazon,2509,2428,81,230,81,0
,Starbucks  Nespresso Decaf Espresso Dark Roast 10 caps 5PK,Starbucks  Nespresso Decaf Espresso Dark Roast 10 caps 5PK,FBALYB Canada,17,17,0,0,0,0
,Starbucks  Nespresso Espresso Dark Roast 10 caps,Starbucks  Nespresso Espresso Dark Roast 10 caps,Default Ridgefield,235,235,0,0,0,0
,Starbucks  Nespresso Espresso Dark Roast 10 caps 5PK,Starbucks  Nespresso Espresso Dark Roast 10 caps 5PK,FBALYB Amazon,23,20,3,12,3,0
,Starbucks  Nespresso Espresso Dark Roast 10 caps 5PK,Starbucks  Nespresso Espresso Dark Roast 10 caps 5PK,FBALYB Canada,35,35,0,0,0,0
,Starbucks  Nespresso House Blend 10 caps,Starbucks  Nespresso House Blend 10 caps,Default Ridgefield,10452,10452,0,0,0,0
,Starbucks  Nespresso House Blend 10 caps 5PK,Starbucks  Nespresso House Blend 10 caps 5PK,FBALYB Amazon,1566,1550,16,0,16,0
,"Starbucks Nespresso Intense Variety Pack 50ct (1Columbia,2Verona,1Pike,1Espress Dark Roast)","Starbucks Nespresso Intense Variety Pack 50ct (1Columbia,2Verona,1Pike,1Espress Dark Roast)",FBALYB Amazon,185,161,24,0,24,0
,"Starbucks Nespresso Mild Variety Pack 50ct (1 Blonde, 2 House, 1 SO Colombia, 1 Pike)","Starbucks Nespresso Mild Variety Pack 50ct (1 Blonde, 2 House, 1 SO Colombia, 1 Pike)",FBALYB Amazon,226,224,2,100,2,0
,Starbucks  Nespresso Pike Place Roast 10 caps,Starbucks  Nespresso Pike Place Roast 10 caps,Default Ridgefield,7802,7802,0,0,0,0
,Starbucks  Nespresso Pike Place Roast 10 caps 5PK,Starbucks  Nespresso Pike Place Roast 10 caps 5PK,FBALYB Amazon,33,29,4,0,4,0
,Starbucks  Nespresso SO Colombia 10 caps,Starbucks  Nespresso SO Colombia 10 caps,Default Ridgefield,15452,15452,0,0,0,0
,Starbucks  Nespresso SO Colombia 10 caps 5PK,Starbucks  Nespresso SO Colombia 10 caps 5PK,FBALYB Amazon,588,559,29,598,29,0
,Starbucks  Nespresso SO Colombia 10 caps 5PK,Starbucks  Nespresso SO Colombia 10 caps 5PK,FBALYB Canada,0,0,0,50,0,0
,Starbucks Nespresso Sumatra 10 caps,Starbucks Nespresso Sumatra 10 caps,Default Ridgefield,2779,2779,0,0,0,0
,Starbucks  Nespresso Sumatra Dark Roast 10 caps 5PK,Starbucks  Nespresso Sumatra Dark Roast 10 caps 5PK,FBALYB Amazon,669,643,26,1,26,0
,Starbucks Pike MR 60ct K-Cup,Starbucks Pike Place Medium Roast 60 Count K-Cup Pods,FBALYB Amazon,1,1,0,0,0,0
,Starbucks Pike Place 24ct 2pk,Starbucks Pike Place 24ct 2pk,FBALYB Amazon,180,180,0,1,0,0
,Starbucks Pike Place 24ct 4pk,Starbucks Pike Place 24ct 4pk,FBALYB Amazon,8,8,0,0,0,0
,starbucks pike place 72 count,starbucks pike place k cups 72 count,FBALYB Amazon,5,5,0,0,0,0
,Starbucks Pike Place Decaf 24ct 2pk,Starbucks Pike Place Decaf 24ct 2pk,FBALYB Amazon,1,1,0,0,0,0
,Starbucks Pike Place Medium Roast 40oz,Starbucks Pike Place Medium Roast 40oz,FBALYB Amazon,2,2,0,0,0,0
,Starbucks Sumatra 24ct,Starbucks Sumatra 24ct,FBALYB Amazon,38,38,0,2,0,0
,Starbucks Sumatra 24ct 2pk,Starbucks Sumatra 24ct 2pk,FBALYB Amazon,-1,-1,0,4,0,0
,Starbucks Sumatra 24ct 4pk,Starbucks Sumatra 24ct 4pk,FBALYB Amazon,-14,-14,0,14,0,0
,Starbucks Sumatra 72 K Cups ((3 pk)),Starbucks Sumatra 72 K Cups ((3 pk)),FBALYB Amazon,0,0,0,1,0,0
,Starbucks Sumatra Coffee 72ct,Starbucks Sumatra Coffee (72 K‑Cups),Default,0,0,0,0,0,5
,Starbucks True North 24ct,Starbucks True North 24ct,Default,0,0,0,0,0,220
,Starbucks Variety Pack 96Ct,"Starbucks Pike Place ,French ,Breakfast ,Verona Variety Pack 96Ct",FBALYB Amazon,29,29,0,0,0,0
,Starbucks Via Instant 26 Count,"Starbucks Via Instant Medium Roast Colombia Coffee, 26 Count",FBALYB Amazon,2,2,0,0,0,0
,Starbucks Via Instant 26 Count 2 Pack,Starbucks Via Instant 26 Count 2 Pack,FBALYB Amazon,2,2,0,0,0,0
,Starbucks White Cappuccino 12 Caps,Starbucks White Cappuccino 12 Caps,Default Ridgefield,624,624,0,0,0,0
,Starbucks White Latte Macchiato 12 Caps,Starbucks White Latte Macchiato 12 Caps,Default Ridgefield,1869,1869,0,0,0,0
,Starbucks Winter Blend 40oz,Starbucks Winter Blend Whole Bean Coffee 40oz,FBALYB Amazon,-54,-54,0,64,0,0
,STARDROPS PINK STUFF BATHROOM FOAM CLEANER 750ML,STARDROPS PINK STUFF BATHROOM FOAM CLEANER 750ML,Default Ridgefield,40,40,0,0,0,5040
,STARDROPS PINK STUFF BATHROOM FOAM CLEANER 750ML,STARDROPS PINK STUFF BATHROOM FOAM CLEANER 750ML,FBALYB Canada,-2,-2,0,0,0,0
,STARDROPS PINK STUFF BATHROOM FOAM CLEANER 750ML 3PK,STARDROPS PINK STUFF BATHROOM FOAM CLEANER 750ML 3PK,FBALYB Amazon,18,18,0,0,0,0
,STARDROPS PINK STUFF CREAM CLEANER 500ML,STARDROPS PINK STUFF CREAM CLEANER 500ML,Default Ridgefield,5804,5804,0,0,0,0
,STARDROPS PINK STUFF CREAM CLEANER 500ML,STARDROPS PINK STUFF CREAM CLEANER 500ML,FBALYB Amazon,4141,4112,29,24,29,0
,STARDROPS PINK STUFF CREAM CLEANER 500ML,STARDROPS PINK STUFF CREAM CLEANER 500ML,FBALYB Canada,0,0,0,50,0,0
,STARDROPS PINK STUFF MULTI-PURPOSE CLEANER 750ML,STARDROPS PINK STUFF MULTI-PURPOSE CLEANER 750ML,Default Ridgefield,853,853,0,0,0,6300
,STARDROPS PINK STUFF MULTI-PURPOSE CLEANER 750ML,STARDROPS PINK STUFF MULTI-PURPOSE CLEANER 750ML,FBALYB Amazon,1034,992,42,2,42,0
,STARDROPS PINK STUFF MULTI-PURPOSE CLEANER 750ML,STARDROPS PINK STUFF MULTI-PURPOSE CLEANER 750ML,FBALYB Canada,5,5,0,385,0,0
,Stardrops Pink Stuff Paste,Stardrops Pink Stuff Paste,Default Ridgefield,25255,25255,0,0,0,21840
,Stardrops Pink Stuff Paste,Stardrops Pink Stuff Paste,FBALYB Amazon,12881,11007,1874,2627,1874,0
,Stardrops Pink Stuff Paste,Stardrops Pink Stuff Paste,FBALYB Canada,0,0,0,50,0,0
,Stardrops Pink Stuff Paste 2 pack,Stardrops Pink Stuff Paste 2 pack,Default Ridgefield,2050,2050,0,0,0,0
,Stardrops Pink Stuff Paste 2 pack,Stardrops Pink Stuff Paste 2 pack,FBALYB Amazon,3034,3027,7,0,7,0
,Stardrops Pink Stuff Paste 2 pack,Stardrops Pink Stuff Paste 2 pack,FBALYB Canada,0,0,0,50,0,0
,Stardrops Pink Stuff Paste 3 pack,Stardrops Pink Stuff Paste 3 pack,FBALYB Amazon,3934,3853,81,0,81,0
,Stardrops Pink Stuff Paste + MULTI-PURPOSE CLEANER 750ML + BATHROOM FOAM CLEANER 750ML,Stardrops Pink Stuff Paste + MULTI-PURPOSE CLEANER 750ML + BATHROOM FOAM CLEANER 750ML ,FBALYB Amazon,2239,2226,13,17,13,0
,"Stardrops The Pink Stuff - The Miracle Cleaning Paste, Multi-Purpose Spray And Cream Cleaner 3-Pack Bundle","Stardrops The Pink Stuff - The Miracle Cleaning Paste, Multi-Purpose Spray And Cream Cleaner 3-Pack Bundle ",FBALYB Amazon,707,622,85,28,85,0
,"Stardrops The Pink Stuff - Ultimate Bundle 4 pack- The Miracle Cleaning Paste, Multi-Purpose Spray, Cream Cleaner, Bathroom Spray","Stardrops The Pink Stuff - Ultimate Bundle 4 pack- The Miracle Cleaning Paste, Multi-Purpose Spray, Cream Cleaner, Bathroom Spray",FBALYB Amazon,68,55,13,0,13,0
,Starmark Chicken Large Dental 2ct 2pk,Starmark Chicken Large Dental 2ct 2pk,Default,-1,-1,0,0,0,0
,Starmark Chicken Medium Dental 2ct,Starmark Chicken Medium Dental 2ct,Default,0,-138,138,0,0,0
,Starmark Chicken Medium Dental 2ct 2pk,Starmark Chicken Medium Dental 2ct 2pk,Default,-69,-69,0,0,0,0
,Starmark Chicken Medium Dental 2ct 2pk,Starmark Chicken Medium Dental 2ct 2pk,FBALYB Amazon,26,26,0,0,0,0
,Starmark Edible Treat Rings - Chicken Flavor,Starmark Edible Treat Rings - Chicken Flavor,Default,0,0,0,0,0,49
,Starmark Edible Treat Rings - Chicken Flavor 4pk,Starmark Edible Treat Rings - Chicken Flavor 4pk,FBALYB Amazon,-6,-6,0,0,0,0
,Starmark Everlasting Bacon Large 2ct 6pk,Starmark Everlasting Bacon Large 2ct 6pk,FBALYB Amazon,-2,-2,0,6,0,0
,Starmark Everlasting Chicken Medium,Starmark Everlasting Chicken Medium,Default,0,0,0,0,0,10
,Starmark Everlasting Chicken Medium 4pk,Starmark Everlasting Chicken Medium 4pk,FBALYB Amazon,-6,-6,0,4,0,0
,StarMark Everlasting Liver Medium 2ct,StarMark Everlasting Liver Medium 2ct,Default,0,0,0,0,0,379
,Starmark Liver Large Dental 2ct 2pk,Starmark Liver Large Dental 2ct 2pk,FBALYB Amazon,1,1,0,0,0,0
,"Starmark Pro‑Training Dog Collar, Large","Starmark Pro‑Training Dog Collar, Large",FBALYB Amazon,-6,-6,0,0,0,0
,Star Wars 3.75 Inch Figure Set,"Star Wars: The Force Awakens, Takodana Encounter 3.75 Inch Action Figure Set [Maz Kanata, Finn, Rey, and BB-8]",FBALYB Amazon,-4,-4,0,2,0,0
,"Star Wars 6"" Cassian Andor",Star Wars The Black Series Rogue One Captain Cassian Andor,FBALYB Amazon,4,4,0,0,0,0
,"Star Wars 6"" Director Krennic",Star Wars The Black Series Director Krennic,FBALYB Amazon,4,4,0,0,0,0
,"Star Wars 6"" Sergeant Jyn Erso",Star Wars The Black Series Rogue One Sergeant Jyn Erso,FBALYB Amazon,4,4,0,0,0,0
,Star Wars Battlefront Game,Star Wars Battlefront - Standard Edition,Default,0,0,0,0,0,1
,Star Wars Battlefront Game,Star Wars Battlefront - Standard Edition,FBALYB Amazon,-2,-2,0,0,0,0
,Star Wars First Order Fighter,Star Wars The Force Awakens First Order,FBALYB Amazon,2,2,0,0,0,0
,Star wars hotwheels,HotWheels Flight Controller 10 Die-Cast Starships,FBALYB Amazon,1,1,0,0,0,0
,Star Wars kids refill 4pc,Star Wars kids refill 4pc,Avrami - Ebay,200,200,0,0,0,0
,Star Wars kids refill 4pc,Star Wars kids refill 4pc,FBALYB Amazon,-36,-36,0,13,0,0
,Star Wars kids refill 4pc,Star Wars kids refill 4pc,WFS,-2,-2,0,0,0,0
,Star Wars Lightsaber,Star Wars The Force Awakens Kylo Ren Deluxe Electronic Lightsaber,FBALYB Amazon,-1,-1,0,0,0,0
,Star Wars Rebels Ghost Vehicle,Star Wars Starship Rebels Ghost Vehicle,FBALYB Amazon,1,1,0,0,0,0
,Steel Coop Cup Hanger 10oz 2pk,Steel Coop Cup Hanger 10oz 2pk,FBALYB Amazon,-1,-1,0,1,0,0
,Steel Coop Cup Hanger 20oz,Steel Coop Cup Hanger 20oz,FBALYB Amazon,-2,-2,0,0,0,0
,Steep - Xbox One,Steep - Xbox One,Default,0,0,0,0,0,2
,Steep - Xbox One,Steep - Xbox One,FBALYB Amazon,-6,-6,0,0,0,0
,Stella and Chewy's Chicken Meal 3.5 oz pouch,Stella and Chewy's Chicken Meal Mixers ‑ 3.5 oz pouch,FBALYB Amazon,-1,-1,0,0,0,0
,Stella & Chewy's 14oz Variety 4pk,Stella & Chewy's 14oz Variety 4pk,FBALYB Amazon,-2,-2,0,0,0,0
,Stella & Chewy's 14oz Variety 5pk,Stella & Chewy's 14oz Variety 5pk,FBALYB Amazon,-3,-3,0,0,0,0
,Stella & Chewy's Carnivore Beef 3.25oz 3pk,Stella & Chewy's Carnivore Beef 3.25oz 3pk,FBALYB Amazon,1,1,0,0,0,0
,Stella & Chewy's Chewy's Chicken Meal 18oz,Stella & Chewy's Chewy's Chicken Meal Mixer 18oz,Default,0,0,0,0,0,34
,Stella & Chewy's Chicken16oz 2pk,Stella & Chewy's SuperBlends Chicken16oz 2pk,FBALYB Amazon,-1,-1,0,0,0,0
,"Stella & Chewys Chicken Dinner, 5.5 Oz.","Stella & Chewys Chicken Dinner, 5.5 Oz.",FBALYB Amazon,1,1,0,0,0,0
,Stella & Chewy's Chicken Dinner Patties 14oz 2pk,Stella & Chewy's Chicken Dinner Patties 14oz 2pk,FBALYB Amazon,-2,-2,0,0,0,0
,Stella & Chewy's Dandy Lamb 18oz 2pk,Stella & Chewy's Dandy Lamb 18oz 2pk,Default,-12,-12,0,0,0,0
,Stella & Chewy's Dandy Lamb 18oz 4pk,Stella & Chewy's Dandy Lamb 18oz 4pk,Default,1,1,0,0,0,0
,Stella & Chewy's Dandy Lamb 18oz 4pk,Stella & Chewy's Dandy Lamb 18oz 4pk,FBALYB Amazon,-1,-1,0,0,0,0
,Stella & Chewy's Duck Duck Goose Dinner Patties 14oz 2pk,Stella & Chewy's Duck Duck Goose Dinner Patties 14oz 2pk,FBALYB Amazon,1,1,0,0,0,0
,Stella & Chewy's Freeze-Dried Beef 2pk,Stella & Chewy's Freeze-Dried Beef 2pk,FBALYB Amazon,3,3,0,1,0,0
,Stella & Chewy's Freeze‑dried Turkey 3pk,Stella & Chewy's Freeze‑dried Turkey 3pk,FBALYB Amazon,-1,-1,0,0,0,0
,Stella & Chewy's Freeze‑dried Turkey Meal 3.5oz,Stella & Chewy's Freeze‑dried Turkey Meal 3.5oz,Default,0,0,0,0,0,3
,Stella & Chewy's Lamb Patties 14oz 3pk,Stella & Chewy's Dandy Lamb Dinner Patties 14oz 3pk,FBALYB Amazon,1,1,0,0,0,0
,Stella & Chewy's Pheasant Dinner Patties 15oz,Stella & Chewy's Phenomenal Pheasant Dinner Patties 15oz,Default,0,0,0,0,0,4
,Stella & Chewy's  Rabbit 14oz 2pk,Stella & Chewy's Absolutely Rabbit 14oz 2pk,FBALYB Amazon,-9,-9,0,0,0,0
,Stella & Chewy's Raw Coated Duck 9 oz,Stella & Chewy's Raw Coated Duck 9 oz,FBALYB Amazon,-1,-1,0,0,0,0
,Stella & Chewy's Salmon & Cod 18oz 3pk,Stella & Chewy's Salmon & Cod 18oz 3pk,Default,-7,-7,0,0,0,0
,Stella & Chewy's Salmon & Cod 18oz 3pk,Stella & Chewy's Salmon & Cod 18oz 3pk,FBALYB Amazon,1,1,0,0,0,0
,Stella & Chewy's Stella's Beef Meal 3pk,Stella & Chewy's Stella's Beef Meal 3pk,Default,-5,-5,0,0,0,0
,Stella & Chewy's Super Beef Patties 25oz,Stella & Chewy's Super Beef Patties 25oz,Default,0,0,0,0,0,1
,Stella & Chewy's Super Beef Patties 25oz 2pk,Stella & Chewy's Super Beef Patties 25oz 2pk,FBALYB Amazon,2,2,0,0,0,0
,Stinger Detox 5X 7-Day Extra Strength Permanent Drink - Lime Flavor - 8 FL OZ,Stinger Detox 5X 7-Day Extra Strength Permanent Drink - Lime Flavor - 8 FL OZ,Default,0,0,0,0,0,488
,Stinger Detox 5X 7-Day Extra Strength Permanent Drink - Lime Flavor - 8 FL OZ,Stinger Detox 5X 7-Day Extra Strength Permanent Drink - Lime Flavor - 8 FL OZ,Default Ridgefield,12,12,0,0,0,0
,Stinger Detox Whole Body Cleanser 1 Hour Extra Strength Drink - Fruit Punch - 8 FL OZ,Stinger Detox Whole Body Cleanser 1 Hour Extra Strength Drink - Fruit Punch - 8 FL OZ,FBALYB Amazon,-31,-31,0,0,0,0
,Stinger Detox Whole Body Cleanser 1 Hour Extra Strength Drink - Fruit Punch - 8 FL OZ 4pk,Stinger Detox Whole Body Cleanser 1 Hour Extra Strength Drink - Fruit Punch - 8 FL OZ 4pk,FBALYB Amazon,25,25,0,0,0,0
,St Ives Pink Lemon and Melon Exfoliating Body Wash,St Ives Pink Lemon and Melon Exfoliating Body Wash,Default Ridgefield,128,128,0,0,0,0
,St Ives Pink Lemon and Melon Exfoliating Body Wash,St Ives Pink Lemon and Melon Exfoliating Body Wash,FBALYB Amazon,150,144,6,0,6,0
,STP 5.25oz Octane Booster 12pk,STP 5.25oz Octane Booster 12pk,Default Ridgefield,0,-2,2,0,0,0
,STP 5.25oz Octane Booster 12pk,STP 5.25oz Octane Booster 12pk,FBALYB Amazon,2,0,2,0,2,0
,Strider Bikes Strider 12 Sport Blue,Strider Bikes Strider 12 Sport Blue,Default Ridgefield,2,2,0,0,0,0
,Strider Bikes Strider 12 Sport Blue,Strider Bikes Strider 12 Sport Blue,FBALYB Amazon,13,13,0,0,0,0
,Strider Bikes Strider 12 Sport Blue,Strider Bikes Strider 12 Sport Blue,WFS,-40,-40,0,0,0,0
,Strider Bikes Strider 12 Sport Green,Strider Bikes Strider 12 Sport Green*,FBALYB Amazon,-5,-5,0,0,0,0
,Strider Bikes Strider 12 Sport Red,Strider Bikes Strider 12 Sport Red,FBALYB Amazon,-4,-4,0,0,0,0
,Strider Bikes Strider 12 Sport Yellow,Strider Bikes Strider 12 Sport Yellow,FBALYB Amazon,-2,-2,0,0,0,0
,Suave Coconut Oil Sham+Cond 80oz,Suave Coconut Oil Sham+Cond 80oz,Default,0,0,0,0,0,1
,Suave Coconut Oil Sham+Cond 80oz,Suave Coconut Oil Sham+Cond 80oz,FBALYB Amazon,1,1,0,0,0,0
,Suave Kids Watermelon 3in1,Suave Kids Watermelon 3in1,Default,0,0,0,0,0,627
,Suave Kids Watermelon 3in1 2pk,Suave Kids Watermelon 3in1 2pk,FBALYB Amazon,17,17,0,7,0,0
,Suave Kids Watermelon 3in1 3pk,Suave Kids Watermelon 3in1 3pk,FBALYB Amazon,22,22,0,0,0,0
,Suave Men Bodywash Refreshing Splash 12oz 3pk,Suave Men Bodywash Refreshing Splash 12oz 3pk,FBALYB Amazon,-1,-1,0,1,0,0
,Subzero 3pk Waterbottles,Subzero 3pk Waterbottles,FBALYB Amazon,-7,-7,0,0,0,0
,Sugar Bear Hair Vita 60ct,Sugar Bear Hair Hair Vitamin 60ct,FBALYB Amazon,1702,1398,304,0,304,0
,Sugar Bear Sleep Vita 60ct,Sugar Bear Hair Sleep Vitamin 60ct,FBALYB Amazon,960,955,5,0,5,0
,Sunbeam LED Power Failure Light (3 Pack),Sunbeam LED Power Failure Light (3 Pack),Default,0,0,0,0,0,397
,Sunbeam LED Power Failure Light (3 Pack),Sunbeam LED Power Failure Light (3 Pack),FBALYB Amazon,22,8,14,397,14,0
,SunButter Sunflower Butter 16oz,SunButter Organic Sunflower Butter 16oz,Default Ridgefield,6,6,0,0,0,0
,Sunforce Solar Light 1500 Lumens,Sunforce Solar Light 1500 Lumens,FBALYB Amazon,2,2,0,0,0,0
,Sunkist 2pk,Sunkist 2pk,FBALYB Amazon,-8,-8,0,11,0,0
,Sunkist Fruit Gems ‑ 32 oz bag,Sunkist Fruit Gems ‑ 32 oz bag,FBALYB Amazon,-184,-185,1,192,1,0
,"Sun‑Maid Natural California Raisins, 64 Oz Box","Sun‑Maid Natural California Raisins, 64 Oz Box",FBALYB Amazon,1,1,0,0,0,0
,Sunrype Fruit Source 3 Flavours,Sunrype Fruit Source 3 Flavours,FBALYB Amazon,1,1,0,0,0,0
,SunRype Fruitsource Fruit Bars 30ct,SunRype Fruitsource Fruit Bars 30ct,FBALYB Amazon,77,77,0,0,0,0
,SunRype Fruit to Go 72ct,SunRype Fruit to Go 72ct,Default Ridgefield,380,380,0,0,0,0
,SunRype Fruit to Go 72ct,SunRype Fruit to Go 72ct,FBALYB Amazon,99,99,0,0,0,0
,SunRype Fruit to Go Snack 72pk,SunRype Fruit to Go Snack 72pk,Default,33,33,0,0,0,0
,SunRype Fruit to Go Snack 72pk,SunRype Fruit to Go Snack 72pk,FBALYB Amazon,-82,-82,0,125,0,0
,Sunseed Vita Hedgehog 25oz,Sunseed Vita Hedgehog 25oz,FBALYB Amazon,-1,-1,0,0,0,0
,SunSeed Vita Sugar Glider 28oz 2pk,SunSeed Vita Sugar Glider 28oz 2pk,FBALYB Amazon,20,19,1,0,1,0
,Sunwarrior Warrior Blend Choc 750g,Sunwarrior Warrior Blend Organic Plant Protein Powder Non GMO 750g,Default Ridgefield,4,4,0,0,0,0
,Sunwarrior Warrior Blend Choc 750g,Sunwarrior Warrior Blend Organic Plant Protein Powder Non GMO 750g,FBALYB Amazon,53,29,24,0,24,0
,Super Mario Bros 2 Nintendo DS,Super Mario Bros 2 Nintendo DS,FBALYB Amazon,-1,-1,0,0,0,0
,Super Pet Chinchill Lava Ledge 2pk,Super Pet Chinchill Lava Ledge 2pk,FBALYB Amazon,-1,-1,0,0,0,0
,Super Pet Hi-Corner Litter Pan 2pk,Super Pet Hi-Corner Litter Pan 2pk,FBALYB Amazon,-1,-1,0,1,0,0
,Super pet potty litter 16 oz,Super pet potty litter 16 oz,FBALYB Amazon,-2,-2,0,0,0,0
,Super Pets Apple Orchard Sticks,Super Pets Apple Orchard Sticks,FBALYB Amazon,1,1,0,0,0,0
,Surface Book Power Supply,Surface Book Power Supply,FBALYB Amazon,18,18,0,0,0,0
,Surface Fingerprint Type Cover,Surface Fingerprint Type Cover,FBALYB Amazon,-1,-1,0,20,0,0
,Surfer - Child - Brown SAW-1702C09 Size: 09 US,Surfer - Child - Brown SAW-1702C09 Size: 09 US,FBALYB Amazon,27,27,0,1,0,0
,Surfer - Child - Brown SAW-1702C10 Size: 10 US,Surfer - Child - Brown SAW-1702C10 Size: 10 US,FBALYB Amazon,-1,-1,0,0,0,0
,Surfer - Child - Brown SAW-1702C12 Size: 12 US,Surfer - Child - Brown SAW-1702C12 Size: 12 US,FBALYB Amazon,-1,-1,0,0,0,0
,Surfer - Child - Gold SAW-1720C09 Size: 09 US,Surfer - Child - Gold SAW-1720C09 Size: 09 US,FBALYB Amazon,67,67,0,0,0,0
,Surfer - Child - Gold SAW-1720C10 Size: 10 US,Surfer - Child - Gold SAW-1720C10 Size: 10 US,FBALYB Amazon,51,51,0,0,0,0
,Surfer - Child - Gold SAW-1720C11 Size: 11 US,Surfer - Child - Gold SAW-1720C11 Size: 11 US,FBALYB Amazon,17,17,0,0,0,0
,Surfer - Child - Gold SAW-1720C12 Size: 12 US,Surfer - Child - Gold SAW-1720C12 Size: 12 US,FBALYB Amazon,34,34,0,0,0,0
,Surfer - Child - Navy SAW-1707C09 Size: 09 US,Surfer - Child - Navy SAW-1707C09 Size: 09 US,FBALYB Amazon,72,72,0,0,0,0
,Surfer - Child - Navy SAW-1707C10 Size: 10 US,Surfer - Child - Navy SAW-1707C10 Size: 10 US,FBALYB Amazon,24,24,0,0,0,0
,Surfer - Child - Navy SAW-1707C11 Size: 11 US,Surfer - Child - Navy SAW-1707C11 Size: 11 US,FBALYB Amazon,44,44,0,0,0,0
,Surfer - Child - Navy SAW-1707C12 Size: 12 US,Surfer - Child - Navy SAW-1707C12 Size: 12 US,FBALYB Amazon,-2,-2,0,0,0,0
,Surfer - Child - Red SAW-1704C09 Size: 09 US,Surfer - Child - Red SAW-1704C09 Size: 09 US,FBALYB Amazon,26,26,0,0,0,0
,Surfer - Child - Red SAW-1704C10 Size: 10 US,Surfer - Child - Red SAW-1704C10 Size: 10 US,FBALYB Amazon,32,32,0,0,0,0
,Surfer - Child - Red SAW-1704C11 Size: 11 US,Surfer - Child - Red SAW-1704C11 Size: 11 US,FBALYB Amazon,39,39,0,0,0,0
,Surfer - Child - Red SAW-1704C12 Size: 12 US,Surfer - Child - Red SAW-1704C12 Size: 12 US,FBALYB Amazon,-3,-3,0,0,0,0
,Surfer - Child - Silver SAW-1712C09 Size: 09 US,Surfer - Child - Silver SAW-1712C09 Size: 09 US,FBALYB Amazon,33,33,0,0,0,0
,Surfer - Child - Silver SAW-1712C10 Size: 10 US,Surfer - Child - Silver SAW-1712C10 Size: 10 US,FBALYB Amazon,15,15,0,0,0,0
,Surfer - Child - Silver SAW-1712C11 Size: 11 US,Surfer - Child - Silver SAW-1712C11 Size: 11 US,FBALYB Amazon,29,29,0,0,0,0
,Surfer - Child - Silver SAW-1712C12 Size: 12 US,Surfer - Child - Silver SAW-1712C12 Size: 12 US,FBALYB Amazon,31,31,0,0,0,0
,Surfer - Child - Tan SAW-1705C09 Size: 09 US,Surfer - Child - Tan SAW-1705C09 Size: 09 US,FBALYB Amazon,15,15,0,0,0,0
,Surfer - Child - Tan SAW-1705C10 Size: 10 US,Surfer - Child - Tan SAW-1705C10 Size: 10 US,FBALYB Amazon,-16,-16,0,0,0,0
,Surfer - Child - Tan SAW-1705C11 Size: 11 US,Surfer - Child - Tan SAW-1705C11 Size: 11 US,FBALYB Amazon,21,20,1,0,1,0
,Surfer - Child - Tan SAW-1705C12 Size: 12 US,Surfer - Child - Tan SAW-1705C12 Size: 12 US,Default Ridgefield,120,120,0,0,0,0
,Surfer - Child - Tan SAW-1705C12 Size: 12 US,Surfer - Child - Tan SAW-1705C12 Size: 12 US,FBALYB Amazon,-15,-15,0,0,0,0
,Surfer - Child - White SAW-1703C09 Size: 09 US,Surfer - Child - White SAW-1703C09 Size: 09 US,FBALYB Amazon,1,1,0,0,0,0
,Surfer - Child - White SAW-1703C10 Size: 10 US,Surfer - Child - White SAW-1703C10 Size: 10 US,FBALYB Amazon,46,46,0,0,0,0
,Surfer - Child - White SAW-1703C11 Size: 11 US,Surfer - Child - White SAW-1703C11 Size: 11 US,FBALYB Amazon,13,12,1,0,1,0
,Surfer - Child - White SAW-1703C12 Size: 12 US,Surfer - Child - White SAW-1703C12 Size: 12 US,FBALYB Amazon,26,26,0,0,0,0
,Surfer - Infant - Brown SAW-1702B04 Size: 04 US,Surfer - Infant - Brown SAW-1702B04 Size: 04 US,FBALYB Amazon,-4,-4,0,0,0,0
,Surfer - Infant - Brown SAW-1702B05 Size: 05 US,Surfer - Infant - Brown SAW-1702B05 Size: 05 US,FBALYB Amazon,-3,-3,0,0,0,0
,Surfer - Infant - Brown SAW-1702B06 Size: 06 US,Surfer - Infant - Brown SAW-1702B06 Size: 06 US,FBALYB Amazon,26,26,0,0,0,0
,Surfer - Infant - Brown SAW-1702B07 Size: 07 US,Surfer - Infant - Brown SAW-1702B07 Size: 07 US,FBALYB Amazon,5,5,0,0,0,0
,Surfer - Infant - Brown SAW-1702B08 Size: 08 US,Surfer - Infant - Brown SAW-1702B08 Size: 08 US,FBALYB Amazon,6,6,0,0,0,0
,Surfer - Infant - Gold SAW-1720B04 Size: 04 US,Surfer - Infant - Gold SAW-1720B04 Size: 04 US,FBALYB Amazon,13,13,0,0,0,0
,Surfer - Infant - Gold SAW-1720B05 Size: 05 US,Surfer - Infant - Gold SAW-1720B05 Size: 05 US,FBALYB Amazon,2,1,1,0,1,0
,Surfer - Infant - Gold SAW-1720B06 Size: 06 US,Surfer - Infant - Gold SAW-1720B06 Size: 06 US,FBALYB Amazon,58,58,0,0,0,0
,Surfer - Infant - Gold SAW-1720B07 Size: 07 US,Surfer - Infant - Gold SAW-1720B07 Size: 07 US,FBALYB Amazon,41,41,0,0,0,0
,Surfer - Infant - Gold SAW-1720B08 Size: 08 US,Surfer - Infant - Gold SAW-1720B08 Size: 08 US,FBALYB Amazon,23,23,0,0,0,0
,Surfer - Infant - Navy SAW-1707B04 Size: 04 US,Surfer - Infant - Navy SAW-1707B04 Size: 04 US,FBALYB Amazon,12,12,0,1,0,0
,Surfer - Infant - Navy SAW-1707B05 Size: 05 US,Surfer - Infant - Navy SAW-1707B05 Size: 05 US,FBALYB Amazon,81,81,0,0,0,0
,Surfer - Infant - Navy SAW-1707B06 Size: 06 US,Surfer - Infant - Navy SAW-1707B06 Size: 06 US,FBALYB Amazon,76,75,1,1,1,0
,Surfer - Infant - Navy SAW-1707B07 Size: 07 US,Surfer - Infant - Navy SAW-1707B07 Size: 07 US,FBALYB Amazon,-15,-15,0,0,0,0
,Surfer - Infant - Navy SAW-1707B08 Size: 08 US,Surfer - Infant - Navy SAW-1707B08 Size: 08 US,FBALYB Amazon,43,43,0,0,0,0
,Surfer - Infant - Red SAW-1704B05 Size: 05 US,Surfer - Infant - Red SAW-1704B05 Size: 05 US,FBALYB Amazon,28,28,0,0,0,0
,Surfer - Infant - Red SAW-1704B06 Size: 06 US,Surfer - Infant - Red SAW-1704B06 Size: 06 US,Default Ridgefield,36,36,0,0,0,0
,Surfer - Infant - Red SAW-1704B06 Size: 06 US,Surfer - Infant - Red SAW-1704B06 Size: 06 US,FBALYB Amazon,19,19,0,0,0,0
,Surfer - Infant - Red SAW-1704B07 Size: 07 US,Surfer - Infant - Red SAW-1704B07 Size: 07 US,FBALYB Amazon,52,52,0,0,0,0
,Surfer - Infant - Red SAW-1704B08 Size: 08 US,Surfer - Infant - Red SAW-1704B08 Size: 08 US,FBALYB Amazon,19,19,0,0,0,0
,Surfer - Infant - Silver SAW-1712B04 Size: 04 US,Surfer - Infant - Silver SAW-1712B04 Size: 04 US,FBALYB Amazon,15,15,0,0,0,0
,Surfer - Infant - Silver SAW-1712B05 Size: 05 US,Surfer - Infant - Silver SAW-1712B05 Size: 05 US,FBALYB Amazon,43,43,0,0,0,0
,Surfer - Infant - Silver SAW-1712B06 Size: 06 US,Surfer - Infant - Silver SAW-1712B06 Size: 06 US,FBALYB Amazon,75,75,0,0,0,0
,Surfer - Infant - Silver SAW-1712B07 Size: 07 US,Surfer - Infant - Silver SAW-1712B07 Size: 07 US,FBALYB Amazon,54,54,0,0,0,0
,Surfer - Infant - Silver SAW-1712B08 Size: 08 US,Surfer - Infant - Silver SAW-1712B08 Size: 08 US,FBALYB Amazon,53,53,0,0,0,0
,Surfer - Infant - Tan SAW-1705B04 Size: 04 US,Surfer - Infant - Tan SAW-1705B04 Size: 04 US,FBALYB Amazon,39,39,0,0,0,0
,Surfer - Infant - Tan SAW-1705B06 Size: 06 US,Surfer - Infant - Tan SAW-1705B06 Size: 06 US,FBALYB Amazon,263,261,2,1,2,0
,Surfer - Infant - Tan SAW-1705B07 Size: 07 US,Surfer - Infant - Tan SAW-1705B07 Size: 07 US,FBALYB Amazon,534,534,0,0,0,0
,Surfer - Infant - Tan SAW-1705B08 Size: 08 US,Surfer - Infant - Tan SAW-1705B08 Size: 08 US,FBALYB Amazon,148,147,1,0,1,0
,Surfer - Infant - White SAW-1703B04 Size: 04 US,Surfer - Infant - White SAW-1703B04 Size: 04 US,Default Ridgefield,10,10,0,0,0,0
,Surfer - Infant - White SAW-1703B04 Size: 04 US,Surfer - Infant - White SAW-1703B04 Size: 04 US,FBALYB Amazon,13,13,0,0,0,0
,Surfer - Infant - White SAW-1703B05 Size: 05 US,Surfer - Infant - White SAW-1703B05 Size: 05 US,FBALYB Amazon,78,77,1,0,1,0
,Surfer - Infant - White SAW-1703B06 Size: 06 US,Surfer - Infant - White SAW-1703B06 Size: 06 US,FBALYB Amazon,97,96,1,0,1,0
,Surfer - Infant - White SAW-1703B07 Size: 07 US,Surfer - Infant - White SAW-1703B07 Size: 07 US,FBALYB Amazon,27,27,0,0,0,0
,Surfer - Infant - White SAW-1703B08 Size: 08 US,Surfer - Infant - White SAW-1703B08 Size: 08 US,FBALYB Amazon,92,91,1,0,1,0
,Surfer - Youth - Brown SAW-1702M13 Size: 13 US,Surfer - Youth - Brown SAW-1702M13 Size: 13 US,FBALYB Amazon,4,4,0,0,0,0
,Surfer - Youth - Gold SAW-1720M01 Size: 01 US,Surfer - Youth - Gold SAW-1720M01 Size: 01 US,FBALYB Amazon,9,9,0,0,0,0
,Surfer - Youth - Gold SAW-1720M13 Size: 13 US,Surfer - Youth - Gold SAW-1720M13 Size: 13 US,FBALYB Amazon,16,16,0,0,0,0
,Surfer - Youth - Navy SAW-1707M01 Size: 01 US,Surfer - Youth - Navy SAW-1707M01 Size: 01 US,FBALYB Amazon,-4,-4,0,0,0,0
,Surfer - Youth - Navy SAW-1707M03 Size: 03 US,Surfer - Youth - Navy SAW-1707M03 Size: 03 US,FBALYB Amazon,6,6,0,0,0,0
,Surfer - Youth - Navy SAW-1707M13 Size: 13 US,Surfer - Youth - Navy SAW-1707M13 Size: 13 US,FBALYB Amazon,-3,-4,1,0,1,0
,Surfer - Youth - Red SAW-1704M13 Size: 13 US,Surfer - Youth - Red SAW-1704M13 Size: 13 US,FBALYB Amazon,-13,-13,0,0,0,0
,Surfer - Youth - Silver SAW-1712M01 Size: 01 US,Surfer - Youth - Silver SAW-1712M01 Size: 01 US,FBALYB Amazon,-7,-7,0,0,0,0
,Surfer - Youth - Silver SAW-1712M13 Size: 13 US,Surfer - Youth - Silver SAW-1712M13 Size: 13 US,FBALYB Amazon,-1,-1,0,0,0,0
,Surfer - Youth - Tan SAW-1705M01 Size: 01 US,Surfer - Youth - Tan SAW-1705M01 Size: 01 US,FBALYB Amazon,-6,-6,0,0,0,0
,Surfer - Youth - Tan SAW-1705M02 Size: 02 US,Surfer - Youth - Tan SAW-1705M02 Size: 02 US,FBALYB Amazon,-1,-1,0,0,0,0
,Surfer - Youth - Tan SAW-1705M03 Size: 03 US,Surfer - Youth - Tan SAW-1705M03 Size: 03 US,FBALYB Amazon,-10,-10,0,0,0,0
,Surfer - Youth - Tan SAW-1705M13 Size: 13 US,Surfer - Youth - Tan SAW-1705M13 Size: 13 US,FBALYB Amazon,9,8,1,0,1,0
,Surfer - Youth - White SAW-1703M01 Size: 01 US,Surfer - Youth - White SAW-1703M01 Size: 01 US,FBALYB Amazon,-11,-11,0,0,0,0
,Surfer - Youth - White SAW-1703M03 Size: 03 US,Surfer - Youth - White SAW-1703M03 Size: 03 US,FBALYB Amazon,-4,-4,0,0,0,0
,Surfer - Youth - White SAW-1703M13 Size: 13 US,Surfer - Youth - White SAW-1703M13 Size: 13 US,FBALYB Amazon,4,4,0,0,0,0
,Surya Brasil - Color Fixation - Restorative  Conditioner 250Ml/8.45 Oz,Surya Brasil - Color Fixation - Restorative  Conditioner 250Ml/8.45 Oz,Default Ridgefield,373,373,0,0,0,0
,Surya Brasil - Color Fixation - Restorative  Conditioner 250Ml/8.45 Oz,Surya Brasil - Color Fixation - Restorative  Conditioner 250Ml/8.45 Oz,FBALYB Amazon,-6,-8,2,0,2,0
,Surya Brasil - Color Fixation - Restorative  Shampoo 250Ml/8.45 Oz,Surya Brasil - Color Fixation - Restorative  Shampoo 250Ml/8.45 Oz,Default Ridgefield,452,452,0,0,0,10
,Surya Brasil - Color Fixation - Restorative  Shampoo 250Ml/8.45 Oz,Surya Brasil - Color Fixation - Restorative  Shampoo 250Ml/8.45 Oz,FBALYB Amazon,14,11,3,0,3,0
,Surya Brasil Henna Cream Black 3pk,Surya Brasil Henna Cream Black 3pk,FBALYB Amazon,-3,-3,0,0,0,0
,Surya Brasil Henna Cream Black 6pk,Surya Brasil Henna Cream Black 6pk,FBALYB Amazon,-2,-2,0,0,0,0
,Surya Brasil - Surya Henna Cream - Ash Blonde 70Ml/2.31 Oz / 2.37 Oz,Surya Brasil - Surya Henna Cream - Ash Blonde 70Ml/2.31 Oz / 2.37 Oz,FBALYB Amazon,-7,-8,1,1,1,0
,Surya Brasil - Surya Henna Cream - Ash Blonde 70Ml/2.31 Oz / 2.37 Oz,Surya Brasil - Surya Henna Cream - Ash Blonde 70Ml/2.31 Oz / 2.37 Oz,FBALYB Canada,7,7,0,0,0,0
,Surya Brasil - Surya Henna Cream - Black  70Ml/2.31 Oz / 2.37 Oz,Surya Brasil - Surya Henna Cream - Black  70Ml/2.31 Oz / 2.37 Oz,Default Ridgefield,60,60,0,0,0,0
,Surya Brasil - Surya Henna Cream - Black  70Ml/2.31 Oz / 2.37 Oz,Surya Brasil - Surya Henna Cream - Black  70Ml/2.31 Oz / 2.37 Oz,FBALYB Amazon,794,766,28,1,28,0
,Surya Brasil - Surya Henna Cream - Burgundy  70Ml/2.31 Oz / 2.37 Oz,Surya Brasil - Surya Henna Cream - Burgundy  70Ml/2.31 Oz / 2.37 Oz,Default Ridgefield,86,86,0,0,0,0
,Surya Brasil - Surya Henna Cream - Burgundy  70Ml/2.31 Oz / 2.37 Oz,Surya Brasil - Surya Henna Cream - Burgundy  70Ml/2.31 Oz / 2.37 Oz,FBALYB Amazon,-6,-9,3,0,3,0
,Surya Brasil - Surya Henna Cream - Burgundy  70Ml/2.31 Oz / 2.37 Oz,Surya Brasil - Surya Henna Cream - Burgundy  70Ml/2.31 Oz / 2.37 Oz,FBALYB Canada,20,20,0,0,0,0
,Surya Brasil - Surya Henna Cream - Burgundy 70Ml/2.31 Oz / 2.37 Oz 2PK,Surya Brasil - Surya Henna Cream - Burgundy 70Ml/2.31 Oz / 2.37 Oz 2PK,FBALYB Amazon,-1,-1,0,0,0,0
,Surya Brasil - Surya Henna Cream - Chocolate  70Ml/2.31 Oz / 2.37 Oz,Surya Brasil - Surya Henna Cream - Chocolate  70Ml/2.31 Oz / 2.37 Oz,Default Ridgefield,0,-214,214,0,0,10
,Surya Brasil - Surya Henna Cream - Chocolate  70Ml/2.31 Oz / 2.37 Oz,Surya Brasil - Surya Henna Cream - Chocolate  70Ml/2.31 Oz / 2.37 Oz,FBALYB Amazon,-88,-90,2,48,2,0
,Surya Brasil - Surya Henna Cream - Copper  70Ml/2.31 Oz / 2.37 Oz,Surya Brasil - Surya Henna Cream - Copper  70Ml/2.31 Oz / 2.37 Oz,Default Ridgefield,3,3,0,0,0,15
,Surya Brasil - Surya Henna Cream - Copper  70Ml/2.31 Oz / 2.37 Oz,Surya Brasil - Surya Henna Cream - Copper  70Ml/2.31 Oz / 2.37 Oz,FBALYB Amazon,2,-4,6,3,6,0
,Surya Brasil - Surya Henna Cream - Copper  70Ml/2.31 Oz / 2.37 Oz,Surya Brasil - Surya Henna Cream - Copper  70Ml/2.31 Oz / 2.37 Oz,FBALYB Canada,5,5,0,0,0,0
,Surya Brasil - Surya Henna Cream - Copper 70Ml/2.31 Oz / 2.37 Oz 2PK,Surya Brasil - Surya Henna Cream - Copper 70Ml/2.31 Oz / 2.37 Oz 2PK,FBALYB Amazon,126,126,0,0,0,0
,Surya Brasil - Surya Henna Cream - Dark Brown 70Ml/2.31 Oz / 2.37 Oz,Surya Brasil - Surya Henna Cream - Dark Brown 70Ml/2.31 Oz / 2.37 Oz,Default Ridgefield,3,3,0,0,0,0
,Surya Brasil - Surya Henna Cream - Dark Brown 70Ml/2.31 Oz / 2.37 Oz,Surya Brasil - Surya Henna Cream - Dark Brown 70Ml/2.31 Oz / 2.37 Oz,FBALYB Amazon,-473,-481,8,8,8,0
,Surya Brasil - Surya Henna Cream - Dark Brown 70Ml/2.31 Oz / 2.37 Oz,Surya Brasil - Surya Henna Cream - Dark Brown 70Ml/2.31 Oz / 2.37 Oz,FBALYB Canada,8,8,0,0,0,0
,Surya Brasil - Surya Henna Cream - Golden Blonde 70Ml/2.31 Oz / 2.37 Oz,Surya Brasil - Surya Henna Cream - Golden Blonde 70Ml/2.31 Oz / 2.37 Oz,Default Ridgefield,253,253,0,0,0,0
,Surya Brasil - Surya Henna Cream - Golden Blonde 70Ml/2.31 Oz / 2.37 Oz,Surya Brasil - Surya Henna Cream - Golden Blonde 70Ml/2.31 Oz / 2.37 Oz,FBALYB Amazon,899,896,3,2,3,0
,Surya Brasil - Surya Henna Cream - Golden Blonde 70Ml/2.31 Oz / 2.37 Oz,Surya Brasil - Surya Henna Cream - Golden Blonde 70Ml/2.31 Oz / 2.37 Oz,FBALYB Canada,14,13,1,0,1,0
,Surya Brasil - Surya Henna Cream - Light Blonde 70Ml/2.31 Oz / 2.37 Oz,Surya Brasil - Surya Henna Cream - Light Blonde 70Ml/2.31 Oz / 2.37 Oz,FBALYB Amazon,56,56,0,0,0,0
,Surya Brasil - Surya Henna Cream - Light Blonde 70Ml/2.31 Oz / 2.37 Oz,Surya Brasil - Surya Henna Cream - Light Blonde 70Ml/2.31 Oz / 2.37 Oz,FBALYB Canada,16,16,0,0,0,0
,Surya Brasil - Surya Henna Cream - Light Brown 70Ml/2.31 Oz / 2.37 Oz,Surya Brasil - Surya Henna Cream - Light Brown 70Ml/2.31 Oz / 2.37 Oz,Default,0,-43,43,0,0,0
,Surya Brasil - Surya Henna Cream - Light Brown 70Ml/2.31 Oz / 2.37 Oz,Surya Brasil - Surya Henna Cream - Light Brown 70Ml/2.31 Oz / 2.37 Oz,Default Ridgefield,577,577,0,0,0,0
,Surya Brasil - Surya Henna Cream - Light Brown 70Ml/2.31 Oz / 2.37 Oz,Surya Brasil - Surya Henna Cream - Light Brown 70Ml/2.31 Oz / 2.37 Oz,FBALYB Amazon,527,498,29,118,29,0
,Surya Brasil - Surya Henna Cream - Mahogany 70Ml/2.31 Oz / 2.37 Oz,Surya Brasil - Surya Henna Cream - Mahogany 70Ml/2.31 Oz / 2.37 Oz,Default,0,-3,3,0,0,0
,Surya Brasil - Surya Henna Cream - Mahogany 70Ml/2.31 Oz / 2.37 Oz,Surya Brasil - Surya Henna Cream - Mahogany 70Ml/2.31 Oz / 2.37 Oz,Default Ridgefield,50,50,0,0,0,0
,Surya Brasil - Surya Henna Cream - Mahogany 70Ml/2.31 Oz / 2.37 Oz,Surya Brasil - Surya Henna Cream - Mahogany 70Ml/2.31 Oz / 2.37 Oz,FBALYB Amazon,101,90,11,28,11,0
,Surya Brasil - Surya Henna Cream - Mahogany 70Ml/2.31 Oz / 2.37 Oz,Surya Brasil - Surya Henna Cream - Mahogany 70Ml/2.31 Oz / 2.37 Oz,FBALYB Canada,18,18,0,0,0,0
,Surya Brasil - Surya Henna Cream - Red  70Ml/2.31 Oz / 2.37 Oz,Surya Brasil - Surya Henna Cream - Red  70Ml/2.31 Oz / 2.37 Oz,Default Ridgefield,0,0,0,0,0,12
,Surya Brasil - Surya Henna Cream - Red  70Ml/2.31 Oz / 2.37 Oz,Surya Brasil - Surya Henna Cream - Red  70Ml/2.31 Oz / 2.37 Oz,FBALYB Amazon,12,4,8,10,8,0
,Surya Brasil - Surya Henna Cream - Red  70Ml/2.31 Oz / 2.37 Oz,Surya Brasil - Surya Henna Cream - Red  70Ml/2.31 Oz / 2.37 Oz,FBALYB Canada,8,8,0,0,0,0
,Surya Brasil - Surya Henna Cream - Swedish Blonde  70Ml/2.31 Oz / 2.37 Oz,Surya Brasil - Surya Henna Cream - Swedish Blonde  70Ml/2.31 Oz / 2.37 Oz,Default Ridgefield,96,96,0,0,0,0
,Surya Brasil - Surya Henna Cream - Swedish Blonde  70Ml/2.31 Oz / 2.37 Oz,Surya Brasil - Surya Henna Cream - Swedish Blonde  70Ml/2.31 Oz / 2.37 Oz,FBALYB Amazon,37,37,0,0,0,0
,Surya Henna Chocolate Cream 2pk,Surya Henna Chocolate Cream 2pk,Default Ridgefield,0,-1,1,0,0,0
,Surya Henna Chocolate Cream 2pk,Surya Henna Chocolate Cream 2pk,FBALYB Amazon,85,73,12,0,12,0
,Surya Henna Dark Brown Cream 4pk,Surya Henna Dark Brown Cream 4pk,FBALYB Amazon,121,120,1,0,1,0
,Surya Henna Dark Brown Cream 4pk,Surya Henna Dark Brown Cream 4pk,FBALYB Canada,10,10,0,0,0,0
,Suunto Core All Black,Suunto Core All Black,FBALYB Amazon,813,809,4,2,4,0
,Suunto Core All Black,Suunto Core All Black,FBALYB Canada,0,0,0,4,0,0
,SV-U9I4-42QY,Mohawk Sunflower Vista 1-Foot 6-Inch x 2-Foot 3-Inch Rug,FBALYB Amazon,2,2,0,0,0,0
,Swedish Fish 3.5lb,Swedish Fish Soft & Chewy Candy 3.5lb,FBALYB Amazon,20,20,0,6,0,0
,Sweetheart - Child - Gold SAW-1420C09 Size: 09 US,Sweetheart - Child - Gold SAW-1420C09 Size: 09 US,FBALYB Amazon,30,30,0,0,0,0
,Sweetheart - Child - Gold SAW-1420C10 Size: 10 US,Sweetheart - Child - Gold SAW-1420C10 Size: 10 US,FBALYB Amazon,21,20,1,0,1,0
,Sweetheart - Child - Gold SAW-1420C11 Size: 11 US,Sweetheart - Child - Gold SAW-1420C11 Size: 11 US,FBALYB Amazon,14,14,0,0,0,0
,Sweetheart - Child - Gold SAW-1420C12 Size: 12 US,Sweetheart - Child - Gold SAW-1420C12 Size: 12 US,FBALYB Amazon,-21,-21,0,0,0,0
,Sweetheart - Child - Red SAW-1404C09 Size: 09 US,Sweetheart - Child - Red SAW-1404C09 Size: 09 US,FBALYB Amazon,28,28,0,0,0,0
,Sweetheart - Child - Red SAW-1404C10 Size: 10 US,Sweetheart - Child - Red SAW-1404C10 Size: 10 US,FBALYB Amazon,16,16,0,0,0,0
,Sweetheart - Child - Red SAW-1404C11 Size: 11 US,Sweetheart - Child - Red SAW-1404C11 Size: 11 US,FBALYB Amazon,25,25,0,0,0,0
,Sweetheart - Child - Red SAW-1404C12 Size: 12 US,Sweetheart - Child - Red SAW-1404C12 Size: 12 US,Default Ridgefield,48,48,0,0,0,0
,Sweetheart - Child - Red SAW-1404C12 Size: 12 US,Sweetheart - Child - Red SAW-1404C12 Size: 12 US,FBALYB Amazon,-5,-5,0,0,0,0
,Sweetheart - Child - Rose Gold SAW-1421C09 Size: 09 US,Sweetheart - Child - Rose Gold SAW-1421C09 Size: 09 US,FBALYB Amazon,36,36,0,0,0,0
,Sweetheart - Child - Rose Gold SAW-1421C11 Size: 11 US,Sweetheart - Child - Rose Gold SAW-1421C11 Size: 11 US,FBALYB Amazon,-4,-4,0,0,0,0
,Sweetheart - Child - Rose Gold SAW-1421C12 Size: 12 US,Sweetheart - Child - Rose Gold SAW-1421C12 Size: 12 US,FBALYB Amazon,-5,-5,0,0,0,0
,Sweetheart - Child - Silver SAW-1412C09 Size: 09 US,Sweetheart - Child - Silver SAW-1412C09 Size: 09 US,FBALYB Amazon,-4,-4,0,0,0,0
,Sweetheart - Child - Silver SAW-1412C10 Size: 10 US,Sweetheart - Child - Silver SAW-1412C10 Size: 10 US,FBALYB Amazon,-5,-5,0,0,0,0
,Sweetheart - Child - Silver SAW-1412C11 Size: 11 US,Sweetheart - Child - Silver SAW-1412C11 Size: 11 US,FBALYB Amazon,-2,-2,0,0,0,0
,Sweetheart - Child - White SAW-1403C09 Size: 09 US,Sweetheart - Child - White SAW-1403C09 Size: 09 US,FBALYB Amazon,143,142,1,15,1,0
,Sweetheart - Child - White SAW-1403C10 Size: 10 US,Sweetheart - Child - White SAW-1403C10 Size: 10 US,FBALYB Amazon,-62,-62,0,0,0,0
,Sweetheart - Child - White SAW-1403C11 Size: 11 US,Sweetheart - Child - White SAW-1403C11 Size: 11 US,FBALYB Amazon,13,13,0,0,0,0
,Sweetheart - Child - White SAW-1403C12 Size: 12 US,Sweetheart - Child - White SAW-1403C12 Size: 12 US,FBALYB Amazon,35,35,0,0,0,0
,Sweetheart - Infant - Gold SAW-1420B05 Size: 05 US,Sweetheart - Infant - Gold SAW-1420B05 Size: 05 US,FBALYB Amazon,5,5,0,0,0,0
,Sweetheart - Infant - Gold SAW-1420B06 Size: 06 US,Sweetheart - Infant - Gold SAW-1420B06 Size: 06 US,FBALYB Amazon,66,66,0,0,0,0
,Sweetheart - Infant - Gold SAW-1420B07 Size: 07 US,Sweetheart - Infant - Gold SAW-1420B07 Size: 07 US,FBALYB Amazon,-3,-4,1,0,1,0
,Sweetheart - Infant - Gold SAW-1420B08 Size: 08 US,Sweetheart - Infant - Gold SAW-1420B08 Size: 08 US,FBALYB Amazon,153,152,1,0,1,0
,Sweetheart - Infant - Red SAW-1404B05 Size: 05 US,Sweetheart - Infant - Red SAW-1404B05 Size: 05 US,FBALYB Amazon,38,38,0,0,0,0
,Sweetheart - Infant - Red SAW-1404B06 Size: 06 US,Sweetheart - Infant - Red SAW-1404B06 Size: 06 US,FBALYB Amazon,-9,-9,0,0,0,0
,Sweetheart - Infant - Red SAW-1404B07 Size: 07 US,Sweetheart - Infant - Red SAW-1404B07 Size: 07 US,FBALYB Amazon,-6,-6,0,0,0,0
,Sweetheart - Infant - Red SAW-1404B08 Size: 08 US,Sweetheart - Infant - Red SAW-1404B08 Size: 08 US,FBALYB Amazon,1,1,0,0,0,0
,Sweetheart - Infant - Rose Gold SAW-1421B05 Size: 05 US,Sweetheart - Infant - Rose Gold SAW-1421B05 Size: 05 US,FBALYB Amazon,-10,-10,0,0,0,0
,Sweetheart - Infant - Rose Gold SAW-1421B06 Size: 06 US,Sweetheart - Infant - Rose Gold SAW-1421B06 Size: 06 US,Default Ridgefield,48,48,0,0,0,0
,Sweetheart - Infant - Rose Gold SAW-1421B06 Size: 06 US,Sweetheart - Infant - Rose Gold SAW-1421B06 Size: 06 US,FBALYB Amazon,-9,-9,0,0,0,0
,Sweetheart - Infant - Rose Gold SAW-1421B07 Size: 07 US,Sweetheart - Infant - Rose Gold SAW-1421B07 Size: 07 US,FBALYB Amazon,-3,-3,0,0,0,0
,Sweetheart - Infant - Rose Gold SAW-1421B08 Size: 08 US,Sweetheart - Infant - Rose Gold SAW-1421B08 Size: 08 US,FBALYB Amazon,40,40,0,0,0,0
,Sweetheart - Infant - Silver SAW-1412B05 Size: 05 US,Sweetheart - Infant - Silver SAW-1412B05 Size: 05 US,FBALYB Amazon,-5,-5,0,0,0,0
,Sweetheart - Infant - Silver SAW-1412B06 Size: 06 US,Sweetheart - Infant - Silver SAW-1412B06 Size: 06 US,FBALYB Amazon,13,13,0,0,0,0
,Sweetheart - Infant - Silver SAW-1412B07 Size: 07 US,Sweetheart - Infant - Silver SAW-1412B07 Size: 07 US,FBALYB Amazon,-6,-6,0,0,0,0
,Sweetheart - Infant - Silver SAW-1412B08 Size: 08 US,Sweetheart - Infant - Silver SAW-1412B08 Size: 08 US,FBALYB Amazon,-13,-13,0,0,0,0
,Sweetheart - Infant - White SAW-1403B05 Size: 05 US,Sweetheart - Infant - White SAW-1403B05 Size: 05 US,FBALYB Amazon,177,177,0,0,0,0
,Sweetheart - Infant - White SAW-1403B06 Size: 06 US,Sweetheart - Infant - White SAW-1403B06 Size: 06 US,FBALYB Amazon,78,78,0,4,0,0
,Sweetheart - Infant - White SAW-1403B07 Size: 07 US,Sweetheart - Infant - White SAW-1403B07 Size: 07 US,FBALYB Amazon,191,191,0,0,0,0
,Sweetheart - Infant - White SAW-1403B08 Size: 08 US,Sweetheart - Infant - White SAW-1403B08 Size: 08 US,FBALYB Amazon,139,139,0,0,0,0
,Sweetheart - Youth - Gold SAW-1420M01 Size: 01 US,Sweetheart - Youth - Gold SAW-1420M01 Size: 01 US,FBALYB Amazon,35,35,0,0,0,0
,Sweetheart - Youth - Gold SAW-1420M02 Size: 02 US,Sweetheart - Youth - Gold SAW-1420M02 Size: 02 US,Default Ridgefield,18,18,0,0,0,0
,Sweetheart - Youth - Gold SAW-1420M02 Size: 02 US,Sweetheart - Youth - Gold SAW-1420M02 Size: 02 US,FBALYB Amazon,34,34,0,0,0,0
,Sweetheart - Youth - Gold SAW-1420M03 Size: 03 US,Sweetheart - Youth - Gold SAW-1420M03 Size: 03 US,FBALYB Amazon,29,29,0,0,0,0
,Sweetheart - Youth - Gold SAW-1420M13 Size: 13 US,Sweetheart - Youth - Gold SAW-1420M13 Size: 13 US,Default Ridgefield,24,24,0,0,0,0
,Sweetheart - Youth - Gold SAW-1420M13 Size: 13 US,Sweetheart - Youth - Gold SAW-1420M13 Size: 13 US,FBALYB Amazon,8,8,0,0,0,0
,Sweetheart - Youth - Red SAW-1404M01 Size: 01 US,Sweetheart - Youth - Red SAW-1404M01 Size: 01 US,FBALYB Amazon,20,20,0,0,0,0
,Sweetheart - Youth - Red SAW-1404M02 Size: 02 US,Sweetheart - Youth - Red SAW-1404M02 Size: 02 US,FBALYB Amazon,11,11,0,0,0,0
,Sweetheart - Youth - Red SAW-1404M03 Size: 03 US,Sweetheart - Youth - Red SAW-1404M03 Size: 03 US,FBALYB Amazon,12,12,0,0,0,0
,Sweetheart - Youth - Red SAW-1404M13 Size: 13 US,Sweetheart - Youth - Red SAW-1404M13 Size: 13 US,FBALYB Amazon,30,29,1,0,1,0
,Sweetheart - Youth - Rose Gold SAW-1421M02 Size: 02 US,Sweetheart - Youth - Rose Gold SAW-1421M02 Size: 02 US,FBALYB Amazon,-1,-1,0,0,0,0
,Sweetheart - Youth - Silver SAW-1412M02 Size: 02 US,Sweetheart - Youth - Silver SAW-1412M02 Size: 02 US,FBALYB Amazon,7,7,0,0,0,0
,Sweetheart - Youth - Silver SAW-1412M03 Size: 03 US,Sweetheart - Youth - Silver SAW-1412M03 Size: 03 US,FBALYB Amazon,8,8,0,0,0,0
,Sweetheart - Youth - White SAW-1403M01 Size: 01 US,Sweetheart - Youth - White SAW-1403M01 Size: 01 US,Default Ridgefield,36,36,0,0,0,0
,Sweetheart - Youth - White SAW-1403M01 Size: 01 US,Sweetheart - Youth - White SAW-1403M01 Size: 01 US,FBALYB Amazon,-10,-10,0,0,0,0
,Sweetheart - Youth - White SAW-1403M02 Size: 02 US,Sweetheart - Youth - White SAW-1403M02 Size: 02 US,FBALYB Amazon,67,66,1,0,1,0
,Sweetheart - Youth - White SAW-1403M03 Size: 03 US,Sweetheart - Youth - White SAW-1403M03 Size: 03 US,FBALYB Amazon,12,12,0,0,0,0
,Sweetheart - Youth - White SAW-1403M13 Size: 13 US,Sweetheart - Youth - White SAW-1403M13 Size: 13 US,FBALYB Amazon,24,24,0,0,0,0
,Swiffer Cleaner 60 ct,Swiffer Cleaner 60 ct,Default Oxford,20,20,0,0,0,0
,Swiffer Cleaner 60 ct,Swiffer Cleaner 60 ct,FBALYB Amazon,261,260,1,353,1,0
,Swiffer Cleaner 60 ct,Swiffer Cleaner 60 ct,FBALYB Canada,41,41,0,0,0,0
,Swiffer Duster Handle Plus 28 Refills,Swiffer Duster Handle Plus 28 Refills,Default,0,0,0,0,0,3
,Swiffer Duster Handle Plus 28 Refills,Swiffer Duster Handle Plus 28 Refills,FBALYB Amazon,1,0,1,0,1,0
,Swift Creek Gravel 5 Lb,Swift Creek Gravel 5 Lb,FBALYB Amazon,-5,-5,0,0,0,0
,Swimmer - Child - Navy SAW-8007C10 Size: 10 US,Swimmer - Child - Navy SAW-8007C10 Size: 10 US,FBALYB Amazon,36,36,0,0,0,0
,Swimmer - Child - Navy SAW-8007C11 Size: 11 US,Swimmer - Child - Navy SAW-8007C11 Size: 11 US,FBALYB Amazon,-1,-1,0,0,0,0
,Swimmer - Child - Navy SAW-8007C12 Size: 12 US,Swimmer - Child - Navy SAW-8007C12 Size: 12 US,FBALYB Amazon,30,30,0,0,0,0
,Swimmer - Child - Red SAW-8004C10 Size: 10 US,Swimmer - Child - Red SAW-8004C10 Size: 10 US,FBALYB Amazon,33,33,0,0,0,0
,Swimmer - Child - Red SAW-8004C11 Size: 11 US,Swimmer - Child - Red SAW-8004C11 Size: 11 US,FBALYB Amazon,24,24,0,0,0,0
,Swimmer - Child - Red SAW-8004C12 Size: 12 US,Swimmer - Child - Red SAW-8004C12 Size: 12 US,FBALYB Amazon,22,22,0,0,0,0
,Swimmer - Child - White SAW-8003C09 Size: 09 US,Swimmer - Child - White SAW-8003C09 Size: 09 US,FBALYB Amazon,34,34,0,0,0,0
,Swimmer - Child - White SAW-8003C10 Size: 10 US,Swimmer - Child - White SAW-8003C10 Size: 10 US,FBALYB Amazon,34,34,0,0,0,0
,Swimmer - Child - White SAW-8003C11 Size: 11 US,Swimmer - Child - White SAW-8003C11 Size: 11 US,FBALYB Amazon,36,36,0,0,0,0
,Swimmer - Child - White SAW-8003C12 Size: 12 US,Swimmer - Child - White SAW-8003C12 Size: 12 US,FBALYB Amazon,17,17,0,0,0,0
,Swimmer - Infant - Navy SAW-8007B05 Size: 05 US,Swimmer - Infant - Navy SAW-8007B05 Size: 05 US,FBALYB Amazon,46,46,0,0,0,0
,Swimmer - Infant - Navy SAW-8007B06 Size: 06 US,Swimmer - Infant - Navy SAW-8007B06 Size: 06 US,FBALYB Amazon,34,34,0,0,0,0
,Swimmer - Infant - Navy SAW-8007B07 Size: 07 US,Swimmer - Infant - Navy SAW-8007B07 Size: 07 US,FBALYB Amazon,36,36,0,0,0,0
,Swimmer - Infant - Navy SAW-8007B08 Size: 08 US,Swimmer - Infant - Navy SAW-8007B08 Size: 08 US,FBALYB Amazon,36,36,0,0,0,0
,Swimmer - Infant - Red SAW-8004B05 Size: 05 US,Swimmer - Infant - Red SAW-8004B05 Size: 05 US,FBALYB Amazon,6,6,0,0,0,0
,Swimmer - Infant - Red SAW-8004B06 Size: 06 US,Swimmer - Infant - Red SAW-8004B06 Size: 06 US,FBALYB Amazon,5,5,0,0,0,0
,Swimmer - Infant - Red SAW-8004B07 Size: 07 US,Swimmer - Infant - Red SAW-8004B07 Size: 07 US,FBALYB Amazon,45,45,0,0,0,0
,Swimmer - Infant - Red SAW-8004B08 Size: 08 US,Swimmer - Infant - Red SAW-8004B08 Size: 08 US,FBALYB Amazon,43,43,0,0,0,0
,Swimmer - Infant - White SAW-8003B05 Size: 05 US,Swimmer - Infant - White SAW-8003B05 Size: 05 US,FBALYB Amazon,71,71,0,0,0,0
,Swimmer - Infant - White SAW-8003B06 Size: 06 US,Swimmer - Infant - White SAW-8003B06 Size: 06 US,FBALYB Amazon,26,26,0,0,0,0
,Swimmer - Infant - White SAW-8003B07 Size: 07 US,Swimmer - Infant - White SAW-8003B07 Size: 07 US,FBALYB Amazon,40,40,0,0,0,0
,Swimmer - Infant - White SAW-8003B08 Size: 08 US,Swimmer - Infant - White SAW-8003B08 Size: 08 US,FBALYB Amazon,10,10,0,0,0,0
,Swimmer - Youth - Navy SAW-8007M02 Size: 02 US,Swimmer - Youth - Navy SAW-8007M02 Size: 02 US,FBALYB Amazon,-1,-1,0,0,0,0
,Swimmer - Youth - Navy SAW-8007M03 Size: 03 US,Swimmer - Youth - Navy SAW-8007M03 Size: 03 US,FBALYB Amazon,-1,-1,0,0,0,0
,Swimmer - Youth - Navy SAW-8007M13 Size: 13 US,Swimmer - Youth - Navy SAW-8007M13 Size: 13 US,FBALYB Amazon,-5,-5,0,0,0,0
,Swimmer - Youth - Red SAW-8004M03 Size: 03 US,Swimmer - Youth - Red SAW-8004M03 Size: 03 US,FBALYB Amazon,44,44,0,0,0,0
,Swimmer - Youth - Red SAW-8004M13 Size: 13 US,Swimmer - Youth - Red SAW-8004M13 Size: 13 US,FBALYB Amazon,24,24,0,0,0,0
,Swimmer - Youth - White SAW-8003M02 Size: 02 US,Swimmer - Youth - White SAW-8003M02 Size: 02 US,FBALYB Amazon,10,10,0,0,0,0
,Swimmer - Youth - White SAW-8003M03 Size: 03 US,Swimmer - Youth - White SAW-8003M03 Size: 03 US,FBALYB Amazon,-5,-5,0,0,0,0
,Swimmer - Youth - White SAW-8003M13 Size: 13 US,Swimmer - Youth - White SAW-8003M13 Size: 13 US,FBALYB Amazon,52,52,0,0,0,0
,SWIRL RED WINE,SWIRL RED WINE 2pcs,Default,0,-136,136,0,0,4
,SWIRL RED WINE,SWIRL RED WINE 2pcs,Default CT,4,4,0,0,0,0
,SWIRL RED WINE,SWIRL RED WINE 2pcs,Default Ridgefield,1850,1850,0,0,0,0
,SWIRL RED WINE,SWIRL RED WINE 2pcs,FBALYB Amazon,206,203,3,2,3,0
,Swiss mill peppermint coca 12 pack,"Swiss Miss ""LIMITED EDITION"" Peppermint Hot Cocoa 12 K-Cups",FBALYB Amazon,-4,-4,0,0,0,0
,Swiss o Par Brown,Swiss O par Eyelash And Brow Dye Black,Default,0,0,0,0,0,49
,Swiss o Par Brown,Swiss O par Eyelash And Brow Dye Black,FBALYB Amazon,1,1,0,0,0,0
,Systane Complete 3x10 ml,Systane Complete 3x10 ml (Purple Package),Avrami - Ebay,720,720,0,0,0,0
,Systane Complete 3x10 ml,Systane Complete 3x10 ml (Purple Package),Default Oxford,75,75,0,0,0,0
,Systane Complete 3x10 ml,Systane Complete 3x10 ml (Purple Package),Default Ridgefield,1841,1841,0,0,0,0
,Systane Complete 3x10 ml,Systane Complete 3x10 ml (Purple Package),FBALYB Amazon,2104,2036,68,218,68,0
,Systane Complete 3x10 ml,Systane Complete 3x10 ml (Purple Package),WFS,-31,-31,0,0,0,0
,Systane Ultra Eye Drops 3pk,Systane Ultra Eye Drops 3pk (Green package),Avrami - Ebay,801,801,0,0,0,0
,Systane Ultra Eye Drops 3pk,Systane Ultra Eye Drops 3pk (Green package),Default,0,-116,116,0,0,0
,Systane Ultra Eye Drops 3pk,Systane Ultra Eye Drops 3pk (Green package),Default Oxford,0,-1,1,0,0,0
,Systane Ultra Eye Drops 3pk,Systane Ultra Eye Drops 3pk (Green package),Default Ridgefield,245,245,0,0,0,0
,Systane Ultra Eye Drops 3pk,Systane Ultra Eye Drops 3pk (Green package),FBAAP Amazon,0,-1,1,0,0,0
,Systane Ultra Eye Drops 3pk,Systane Ultra Eye Drops 3pk (Green package),FBALYB Amazon,7969,7585,384,1862,384,0
,Systane Ultra Eye Drops 3pk,Systane Ultra Eye Drops 3pk (Green package),FBALYB Canada,0,0,0,40,0,0
,Systane Ultra Eye Drops 3pk,Systane Ultra Eye Drops 3pk (Green package),WFS,-1002,-1004,2,0,2,0
,T3-AAYS-H1HA,Microsoft Type Cover for Surface Pro 4 - Teal (QC7-00006),FBALYB Amazon,-2,-2,0,0,0,0
,T52 5 color Bundle,T52 5 color Bundle ,FBALYB Amazon,-18,-18,0,16,0,0
,Taco Holder 1 pc,Taco Holder 1 pc,Default Ridgefield,84,84,0,0,0,0
,Taco Holder 1pc 6pk,Taco Holder 1pc 6pk,FBALYB Amazon,-16,-17,1,1,1,0
,Taco Holder 6 ct,Taco Holder 6 ct,Default Ridgefield,38,38,0,0,0,0
,Taco Holder 6 ct,Taco Holder 6 ct,FBALYB Amazon,7,7,0,0,0,0
,"Taco holder 6 ct, 2pk","Taco holder 6 ct, 2pk",FBALYB Amazon,63,63,0,0,0,0
,Takealongs Mini 0.5 Cup/118ml 6Ct,Takealongs Mini 0.5 Cup/118ml (6 Count),Default Ridgefield,869,869,0,0,0,0
,Takealongs Mini 0.5 Cup/118ml 6Ct,Takealongs Mini 0.5 Cup/118ml (6 Count),FBALYB Amazon,0,0,0,475,0,0
,Tampax Pearl Super 96ct,Tampax Pearl Super 96ct,Default,0,0,0,0,0,1
,"Tampax Pearl Tampons, 96 ct.","Tampax Pearl Tampons Super Plus, 96 ct.",Default,0,0,0,0,0,2
,"Tampax Pearl Tampons, 96 ct.","Tampax Pearl Tampons Super Plus, 96 ct.",FBALYB Amazon,11,11,0,0,0,0
,Tampax Radiant 84ct,Tampax Radiant 84ct,FBALYB Amazon,6,6,0,0,0,0
,Tassimo Maxwell House Blend 4.45oz 2pk,Tassimo Maxwell House Blend 4.45oz 2pk,FBALYB Amazon,1,1,0,0,0,0
,"Taster's Coffee, House Blend, 14oz","Taster's Coffee, House Blend, 14oz",Default,0,0,0,0,0,2
,"Taster's Coffee, House Blend, 14oz 3pk","Taster's Coffee, House Blend, 14oz 3pk",FBALYB Amazon,-1,-1,0,0,0,0
,TAYLOR OOBS Almond Shaving Cream Bowl 150g,TAYLOR OOBS Almond Shaving Cream Bowl 150g,FBALYB Amazon,-2,-7,5,0,5,0
,TAYLOR OOBS Avocado Shaving Cream Bowl 150g,TAYLOR OOBS Avocado Shaving Cream Bowl 150g,FBALYB Amazon,-2,-5,3,0,3,0
,TAYLOR OOBS Coconut Shaving Cream Bowl 150g,TAYLOR OOBS Coconut Shaving Cream Bowl 150g,FBALYB Amazon,-1,-3,2,0,2,0
,TAYLOR OOBS Eton College Shaving Cream Bowl 150g,TAYLOR OOBS Eton College Shaving Cream Bowl 150g,FBALYB Amazon,2,-4,6,0,6,0
,TAYLOR OOBS Grapefruit Shaving Cream Bowl 150g,TAYLOR OOBS Grapefruit Shaving Cream Bowl 150g,FBALYB Amazon,2,-1,3,3,3,0
,TAYLOR OOBS Lavender Shaving Cream Bowl 150,TAYLOR OOBS Lavender Shaving Cream Bowl 150,FBALYB Amazon,-4,-8,4,5,4,0
,TAYLOR OOBS Lemon & Lime Shaving Cream Bowl 150g,TAYLOR OOBS Lemon & Lime Shaving Cream Bowl 150g,FBALYB Amazon,1,-1,2,0,2,0
,TAYLOR OOBS Mr. Taylor Shaving Cream Bowl 150g,TAYLOR OOBS Mr. Taylor Shaving Cream Bowl 150g,FBALYB Amazon,1,1,0,0,0,0
,TAYLOR OOBS Peppermint Shaving Cream Bowl 150g,TAYLOR OOBS Peppermint Shaving Cream Bowl 150g,FBALYB Amazon,-2,-3,1,2,1,0
,TAYLOR OOBS Rose Shaving Cream Bowl 150g,TAYLOR OOBS Rose Shaving Cream Bowl 150g,FBALYB Amazon,1,-5,6,0,6,0
,TAYLOR OOBS Sandalwood Shaving Cream Bowl 150g,TAYLOR OOBS Sandalwood Shaving Cream Bowl 150g,FBALYB Amazon,75,66,9,0,9,0
,TAYLOR OOBS Sandalwood Shaving Cream Bowl 150g 2pk,TAYLOR OOBS Sandalwood Shaving Cream Bowl 150g 2pk,FBALYB Amazon,1,-1,2,0,2,0
,TAYLOR OOBS Sandalwood Shaving Cream Bowl 150g 3pk,TAYLOR OOBS Sandalwood Shaving Cream Bowl 150g 3pk,FBALYB Amazon,-1,-2,1,0,1,0
,TAYLOR OOBS St James Shaving Cream Bowl 150g,TAYLOR OOBS St James Shaving Cream Bowl 150g,FBALYB Amazon,-2,-11,9,0,9,0
,Tazo Chai Latte 946ml 2pk,Tazo Chai Latte 946ml 2pk,FBALYB Amazon,100,97,3,24,3,0
,Tender & True Chicken & Liver Dog Food 4lb,Tender & True Chicken & Liver Dog Food 4lb,Default,0,-1,1,0,0,0
,Teras Whey Goat Plain Unswtnd 2 pack,Teras Whey Goat Plain Unswtnd 2 pack,FBALYB Amazon,1,1,0,0,0,0
,teraswhey Whey Protein DrkChc 24oz,teraswhey Simply Pure Whey Protein Dark Choc 24 oz,Default Ridgefield,1,1,0,0,0,0
,teraswhey Whey Protein DrkChc 24oz,teraswhey Simply Pure Whey Protein Dark Choc 24 oz,FBALYB Amazon,7,1,6,0,6,0
,Terra Chips 2 pack,Terra Chips 2 pack,FBALYB Amazon,11,11,0,0,0,0
,Terro Ant/Termite Killer 32oz,Terro Ant/Termite Killer 32oz,FBALYB Amazon,1,1,0,0,0,0
,"Tetley Tea, Orange Pekoe 300g","Tetley Tea, Orange Pekoe 300g",Default Ridgefield,232,232,0,0,0,0
,"Tetley Tea, Orange Pekoe 300g","Tetley Tea, Orange Pekoe 300g",FBALYB Amazon,259,232,27,2,27,0
,TETRA 2 PACK whisper,TETRA 2 PACK whisper,FBALYB Amazon,361,341,20,29,20,0
,Tetra 77256 TetraBetta 1.2oz 2pk,Tetra 77256 TetraBetta 1.2oz 2pk,FBALYB Amazon,1,1,0,2,0,0
,Tetra 77256 TetraBetta PLUS Mini Pellets 1.2oz,Tetra 77256 TetraBetta PLUS Mini Pellets 1.2oz,Default,0,0,0,0,0,30
,Tetra 77852 Air Pump,Tetra 77852 Whisper Air Pump 20 Gallon,FBALYB Amazon,1,1,0,1,0,0
,"Tetra Anti‑Algae Blocks for Fountains, 6 ct","Tetra Anti‑Algae Blocks for Fountains, 6 count",Default,0,0,0,0,0,50
,"Tetra Anti‑Algae Blocks for Fountains, 6 ct","Tetra Anti‑Algae Blocks for Fountains, 6 count",FBALYB Amazon,-49,-49,0,0,0,0
,Tetra Bio-Bag Unassembled Med 12ct,Tetra Bio-Bag Unassembled Med 12ct,Default,0,0,0,0,0,2
,Tetra Bio-Bag Unassembled Med 12ct,Tetra Bio-Bag Unassembled Med 12ct,Default Ridgefield,2695,2695,0,0,0,0
,Tetra Bio-Bag Unassembled Med 12ct,Tetra Bio-Bag Unassembled Med 12ct,FBALYB Amazon,225,214,11,363,11,0
,Tetra Bio-Bag Unassembled Med 12ct 2pk,Tetra Bio-Bag Unassembled Med 12ct 2pk,FBALYB Amazon,230,230,0,0,0,0
,Tetra Cichlid Color Pellets X-Large 7.48oz,Tetra Cichlid Color Pellets X-Large 7.48oz,FBALYB Amazon,-1,-1,0,0,0,0
,Tetra Cichlid Floating Pellets 6oz 2pk,Tetra Cichlid Floating Pellets 6oz 2pk,FBALYB Amazon,-1,-1,0,0,0,0
,Tetra EasyBalance PLUS 16.9oz 2pk,Tetra EasyBalance PLUS 16.9oz 2pk,FBALYB Amazon,1,1,0,0,0,0
,TetraFauna Turtle Block 2pk,TetraFauna Turtle Block 2pk,FBALYB Amazon,-1,-1,0,0,0,0
,TetraFauna Turtle Health Conditioner Block 4pk,TetraFauna Turtle Health Conditioner Block 4pk,FBALYB Amazon,-1,-1,0,0,0,0
,Tetrafin Floating Variety Pellets 1.87oz 2pk,Tetrafin Floating Variety Pellets 1.87oz 2pk,FBALYB Amazon,2,2,0,0,0,0
,Tetrafin Floating Variety Pellets 1.87oz 4pk,Tetrafin Floating Variety Pellets 1.87oz 4pk,FBALYB Amazon,1,1,0,0,0,0
,Tetra Glofish Water Cond 4oz,Tetra Glofish Water Conditioner 4 Ounce,Default,0,0,0,0,0,684
,Tetra Glofish Water Cond 4oz,Tetra Glofish Water Conditioner 4 Ounce,Default Oxford,4,4,0,0,0,0
,Tetra Glofish Water Cond 4oz,Tetra Glofish Water Conditioner 4 Ounce,Default Ridgefield,2850,2850,0,0,0,0
,Tetra Glofish Water Cond 4oz,Tetra Glofish Water Conditioner 4 Ounce,FBALYB Amazon,82,82,0,40,0,0
,Tetra Goldfish Granules 3.52oz,"Tetra 16441 TetraColor Goldfish Granules, 3.52-Ounce",FBALYB Amazon,-2,-2,0,0,0,0
,Tetra Lifeguard All-in-One Treatment 32ct 2pk,Tetra Lifeguard All-in-One Treatment 32ct 2pk,FBALYB Amazon,-1,-1,0,0,0,0
,TetraMin Large Flakes 5.65oz,TetraMin Large Flakes 5.65oz,Default Ridgefield,0,-122,122,0,0,0
,"TetraPRO Goldfish Crisps for Fishes, 375ml","TetraPRO Goldfish Crisps for Fishes, 375ml",FBALYB Amazon,2,2,0,0,0,0
,Tetra ReptoFilter Cartridges Large 3ct 4pk,Tetra ReptoFilter Cartridges Large 3ct 4pk,FBALYB Amazon,-1,-1,0,0,0,0
,Tetra ReptoMin Baby Sticks .92oz,Tetra ReptoMin Baby Sticks .92oz,FBALYB Amazon,3,3,0,0,0,0
,Tetra ReptoMin Floating Food Sticks Jumbo 10.32oz,Tetra ReptoMin Floating Food Sticks Jumbo 10.32oz,FBALYB Amazon,-2,-2,0,0,0,0
,Tetra ReptoTreat Suprema Sticks 4pk,Tetra ReptoTreat Suprema Sticks 4pk,FBALYB Amazon,-8,-9,1,9,1,0
,Tetra Slow-Release Feeder,Tetra 77151 TetraWeekend Tropical Slow-Release 5-Day Feeder,FBALYB Amazon,1,1,0,1,0,0
,Tetra Slow-Release Feeder 2pk,Tetra Slow-Release Feeder 2pk,FBALYB Amazon,-2,-2,0,133,0,0
,Tetravacation 14-Day Feeder 4pk,Tetravacation 14-Day Feeder 4pk,FBALYB Amazon,-2,-2,0,0,0,0
,"Tetra Water Conditioner, 8.45oz 2pk","Tetra Water Conditioner, 8.45oz 2pk",FBALYB Amazon,2,2,0,0,0,0
,Tetra Whisper Bio-Bag Cartridge Large 3ct,Tetra Whisper Bio-Bag Cartridge Large 3ct,Default Ridgefield,661,661,0,0,0,0
,Tetra Whisper Bio-Bag Cartridge Large 3ct,Tetra Whisper Bio-Bag Cartridge Large 3ct,FBALYB Amazon,65,44,21,200,21,0
,Tetra Whisper Bio-Bag Cartridge Large 3ct,Tetra Whisper Bio-Bag Cartridge Large 3ct,FBALYB Canada,0,0,0,50,0,0
,Tetra Whisper Bio-Bag Cartridge Large 3ct 2pk,Tetra Whisper Bio-Bag Cartridge Large 3ct 2pk,FBALYB Amazon,-127,-135,8,117,8,0
,Tetra Whisper Bio-Bags Small 2pk,"Tetra Whisper Bio-Bags Small Filter Cartridge, 2ct 2pk",FBALYB Amazon,96,96,0,0,0,0
,Tetra Whisper Bio-Bags Small 3pk,Tetra Whisper Bio-Bags Small 3pk,FBALYB Amazon,-17,-17,0,9,0,0
,"Tetra Whisper Bio-Bags Small Filter Cartridge, 2ct","Tetra Whisper Bio-Bags Small Filter Cartridge, 2ct",Default,0,-3468,3468,0,0,0
,"Tetra Whisper Bio-Bags Small Filter Cartridge, 2ct","Tetra Whisper Bio-Bags Small Filter Cartridge, 2ct",Default Ridgefield,3962,3962,0,0,0,0
,Tetra Whisper Bio-Bag Unassembled Large 12ct 2pk,Tetra Whisper Bio-Bag Unassembled Large 12ct 2pk,FBALYB Amazon,255,255,0,1,0,0
,Tetra Whisper Cartridges 6 Pack x 2,Tetra Whisper Cartridges 6 Pack x 2,Default Ridgefield,201,0,201,0,0,0
,Tetra Whisper Cartridges 6 Pack x 2,Tetra Whisper Cartridges 6 Pack x 2,FBALYB Amazon,-61,-69,8,1,8,0
,Tetra Whisper EX20 Medium 4ct 2pk,Tetra Whisper EX20 Medium 4ct 2pk,FBALYB Amazon,-32,-32,0,30,0,0
,Tetra Whisper EX Carbon Filter Large 4ct,Tetra Whisper EX Carbon Filter Large 4ct,Default,0,0,0,0,0,1
,Tetra Whisper EX Carbon Filter Large 4ct,Tetra Whisper EX Carbon Filter Large 4ct,Default Ridgefield,21,21,0,0,0,0
,Tetra Whisper EX Carbon Filter Large 4ct,Tetra Whisper EX Carbon Filter Large 4ct,FBALYB Amazon,278,276,2,0,2,0
,Tetra Whisper EX Carbon Filter Large 4ct,Tetra Whisper EX Carbon Filter Large 4ct,FBALYB Canada,96,95,1,0,1,0
,Tetra Whisper EX Carbon Filter Large 4ct 2pk,Tetra Whisper EX Carbon Filter Large 4ct 2pk,FBALYB Amazon,231,230,1,4,1,0
,Tetra Whisper EX Carbon Filter Large 4ct 2pk,Tetra Whisper EX Carbon Filter Large 4ct 2pk,FBALYB Canada,23,23,0,1,0,0
,Tetra Whisper EX Carbon Filter Large 4ct 3pk,Tetra Whisper EX Carbon Filter Large 4ct 3pk,FBALYB Amazon,21,21,0,0,0,0
,Teva 1003987 Sandal -BLK-050,Teva 1003987 Sandal -BLK-050,Default Ridgefield,89,89,0,0,0,0
,Teva 1003987 Sandal -BLK-050,Teva 1003987 Sandal -BLK-050,FBALYB Amazon,52,50,2,0,2,0
,Teva 1003987 Sandal -BLK-060,Teva 1003987 Sandal -BLK-060,Default Ridgefield,267,267,0,0,0,0
,Teva 1003987 Sandal -BLK-060,Teva 1003987 Sandal -BLK-060,FBALYB Amazon,-23,-23,0,0,0,0
,Teva 1003987 Sandal -BLK-070,Teva 1003987 Sandal -BLK-070,Default Oxford,18,18,0,0,0,0
,Teva 1003987 Sandal -BLK-070,Teva 1003987 Sandal -BLK-070,Default Ridgefield,1018,1018,0,0,0,0
,Teva 1003987 Sandal -BLK-070,Teva 1003987 Sandal -BLK-070,FBALYB Amazon,-34,-34,0,100,0,0
,Teva 1003987 Sandal -BLK-080,Teva 1003987 Sandal -BLK-080,Default Oxford,18,18,0,0,0,0
,Teva 1003987 Sandal -BLK-080,Teva 1003987 Sandal -BLK-080,Default Ridgefield,499,499,0,0,0,0
,Teva 1003987 Sandal -BLK-080,Teva 1003987 Sandal -BLK-080,FBALYB Amazon,-85,-85,0,101,0,0
,Teva 1003987 Sandal -BLK-090,Teva 1003987 Sandal -BLK-090,Default Oxford,55,55,0,0,0,0
,Teva 1003987 Sandal -BLK-090,Teva 1003987 Sandal -BLK-090,Default Ridgefield,242,242,0,0,0,0
,Teva 1003987 Sandal -BLK-090,Teva 1003987 Sandal -BLK-090,FBALYB Amazon,-33,-33,0,62,0,0
,Teva 1003987 Sandal -BLK-100,Teva 1003987 Sandal -BLK-100,Default Ridgefield,125,125,0,0,0,0
,Teva 1003987 Sandal -BLK-100,Teva 1003987 Sandal -BLK-100,FBALYB Amazon,-26,-26,0,0,0,0
,Teva 1003987 Sandal -BLK-110,Teva 1003987 Sandal -BLK-110,Default Ridgefield,18,18,0,0,0,0
,Teva 1003987 Sandal -BLK-110,Teva 1003987 Sandal -BLK-110,FBALYB Amazon,-1,-1,0,0,0,0
,Teva 1003987 Sandal -SAMIB-050,Teva 1003987 Sandal -SAMIB-050,FBALYB Amazon,2,2,0,0,0,0
,Teva 1003987 Sandal -SAMIB-060,Teva 1003987 Sandal -SAMIB-060,Default Oxford,12,12,0,0,0,0
,Teva 1003987 Sandal -SAMIB-060,Teva 1003987 Sandal -SAMIB-060,FBALYB Amazon,38,38,0,0,0,0
,Teva 1003987 Sandal -SAMIB-070,Teva 1003987 Sandal -SAMIB-070,FBALYB Amazon,-11,-11,0,0,0,0
,Teva 1003987 Sandal -SAMIB-080,Teva 1003987 Sandal -SAMIB-080,Default Oxford,29,29,0,0,0,0
,Teva 1003987 Sandal -SAMIB-080,Teva 1003987 Sandal -SAMIB-080,FBALYB Amazon,-22,-22,0,0,0,0
,Teva 1003987 Sandal -SAMIB-090,Teva 1003987 Sandal -SAMIB-090,FBALYB Amazon,-14,-14,0,1,0,0
,Teva 1003987 Sandal -SAMIB-110,Teva 1003987 Sandal -SAMIB-110,FBALYB Amazon,-4,-4,0,0,0,0
,Teva 1004010 Sandal -BLK-070,Teva 1004010 Sandal -BLK-070,Default Ridgefield,303,303,0,0,0,0
,Teva 1004010 Sandal -BLK-070,Teva 1004010 Sandal -BLK-070,FBALYB Amazon,-9,-9,0,50,0,0
,Teva 1004010 Sandal -BLK-080,Teva 1004010 Sandal -BLK-080,Default Ridgefield,388,388,0,0,0,0
,Teva 1004010 Sandal -BLK-080,Teva 1004010 Sandal -BLK-080,FBALYB Amazon,-17,-17,0,0,0,0
,Teva 1004010 Sandal -BLK-090,Teva 1004010 Sandal -BLK-090,Default Ridgefield,645,645,0,0,0,0
,Teva 1004010 Sandal -BLK-090,Teva 1004010 Sandal -BLK-090,FBALYB Amazon,-28,-28,0,96,0,0
,Teva 1004010 Sandal -BLK-100,Teva 1004010 Sandal -BLK-100,Default Ridgefield,1068,1068,0,0,0,0
,Teva 1004010 Sandal -BLK-100,Teva 1004010 Sandal -BLK-100,FBALYB Amazon,-33,-33,0,100,0,0
,Teva 1004010 Sandal -BLK-110,Teva 1004010 Sandal -BLK-110,Default Ridgefield,500,500,0,0,0,0
,Teva 1004010 Sandal -BLK-110,Teva 1004010 Sandal -BLK-110,FBALYB Amazon,-14,-14,0,100,0,0
,Teva 1004010 Sandal -BLK-120,Teva 1004010 Sandal -BLK-120,Default Ridgefield,141,141,0,0,0,0
,Teva 1004010 Sandal -BLK-120,Teva 1004010 Sandal -BLK-120,FBALYB Amazon,-4,-4,0,0,0,0
,Teva 1004010 Sandal -BLK-130,Teva 1004010 Sandal -BLK-130,Default Ridgefield,141,141,0,0,0,0
,Teva 1004010 Sandal -BLK-130,Teva 1004010 Sandal -BLK-130,FBALYB Amazon,-5,-5,0,0,0,0
,Teva 1004010 Sandal -BLK-140,Teva 1004010 Sandal -BLK-140,Default Ridgefield,71,71,0,0,0,0
,Teva 1004010 Sandal -BLK-140,Teva 1004010 Sandal -BLK-140,FBALYB Amazon,-2,-2,0,0,0,0
,Teva 1008844 Flatform Sandal -BLK-050,Teva 1008844 Flatform Sandal -BLK-050,FBALYB Amazon,-5,-5,0,0,0,0
,Teva 1008844 Flatform Sandal -BLK-060,Teva 1008844 Flatform Sandal -BLK-060,FBALYB Amazon,-22,-22,0,0,0,0
,Teva 1008844 Flatform Sandal -BLK-070,Teva 1008844 Flatform Sandal -BLK-070,FBALYB Amazon,-13,-13,0,0,0,0
,Teva 1008844 Flatform Sandal -BLK-080,Teva 1008844 Flatform Sandal -BLK-080,Default Oxford,7,7,0,0,0,0
,Teva 1008844 Flatform Sandal -BLK-080,Teva 1008844 Flatform Sandal -BLK-080,FBALYB Amazon,-17,-17,0,1,0,0
,Teva 1008844 Flatform Sandal -BLK-090,Teva 1008844 Flatform Sandal -BLK-090,FBALYB Amazon,-20,-20,0,0,0,0
,Teva 1008844 Flatform Sandal -BLK-100,Teva 1008844 Flatform Sandal -BLK-100,FBALYB Amazon,-6,-6,0,0,0,0
,Teva 1008844 Flatform Sandal -BLK-110,Teva 1008844 Flatform Sandal -BLK-110,FBALYB Amazon,-3,-3,0,0,0,0
,Teva 1008844 Flatform Sandal-BRWH-060,Teva 1008844 Flatform Sandal-BRWH-060,FBALYB Amazon,-3,-3,0,0,0,0
,Teva 1008844 Flatform Sandal-BRWH-070,Teva 1008844 Flatform Sandal-BRWH-070,FBALYB Amazon,-3,-3,0,0,0,0
,Teva 1008844 Flatform Sandal-BRWH-080,Teva 1008844 Flatform Sandal-BRWH-080,FBALYB Amazon,-3,-3,0,0,0,0
,Teva 1008844 Flatform Sandal-BRWH-090,Teva 1008844 Flatform Sandal-BRWH-090,FBALYB Amazon,-3,-3,0,0,0,0
,Teva 1008844 Flatform Sandal-BRWH-100,Teva 1008844 Flatform Sandal-BRWH-100,FBALYB Amazon,-3,-3,0,1,0,0
,Teva 1008844 Flatform Sandal-BRWH-110,Teva 1008844 Flatform Sandal-BRWH-110,FBALYB Amazon,-1,-1,0,0,0,0
,Teva 1019040 Voya Flip-BSBLC-060,Teva 1019040 Voya Flip-BSBLC-060,FBALYB Amazon,-2,-2,0,0,0,0
,Teva 1019040 Voya Flip-BSBLC-070,Teva 1019040 Voya Flip-BSBLC-070,FBALYB Amazon,-7,-7,0,0,0,0
,Teva 1019040 Voya Flip-BSBLC-080,Teva 1019040 Voya Flip-BSBLC-080,FBALYB Amazon,-14,-14,0,0,0,0
,Teva 1019040 Voya Flip-BSBLC-090,Teva 1019040 Voya Flip-BSBLC-090,FBALYB Amazon,-6,-6,0,0,0,0
,Teva 1019040 Voya Flip-BSBLC-100,Teva 1019040 Voya Flip-BSBLC-100,FBALYB Amazon,-15,-15,0,0,0,0
,Teva 1019040 Voya Flip-BSBLC-110,Teva 1019040 Voya Flip-BSBLC-110,FBALYB Amazon,-2,-2,0,0,0,0
,Teva-1019180 Omnium Sandal-BNGC-070,Teva-1019180 Omnium Sandal-BNGC-070,FBALYB Amazon,-9,-9,0,0,0,0
,Teva-1019180 Omnium Sandal-BNGC-080,Teva-1019180 Omnium Sandal-BNGC-080,FBALYB Amazon,4,4,0,0,0,0
,Teva-1019180 Omnium Sandal-BNGC-090,Teva-1019180 Omnium Sandal-BNGC-090,FBALYB Amazon,22,22,0,0,0,0
,Teva-1019180 Omnium Sandal-BNGC-100,Teva-1019180 Omnium Sandal-BNGC-100,FBALYB Amazon,20,20,0,0,0,0
,Teva-1019180 Omnium Sandal-BNGC-110,Teva-1019180 Omnium Sandal-BNGC-110,FBALYB Amazon,24,24,0,0,0,0
,Teva 1019234 Hurricane Sandal-BLK-070,Teva 1019234 Hurricane Sandal-BLK-070,Default,0,-1,1,0,0,0
,Teva 1019234 Hurricane Sandal-BLK-070,Teva 1019234 Hurricane Sandal-BLK-070,Default Ridgefield,18,18,0,0,0,0
,Teva 1019234 Hurricane Sandal-BLK-080,Teva 1019234 Hurricane Sandal-BLK-080,FBALYB Amazon,68,68,0,0,0,0
,Teva 1019234 Hurricane Sandal-BLK-090,Teva 1019234 Hurricane Sandal-BLK-090,FBALYB Amazon,88,87,1,0,1,0
,Teva 1019234 Hurricane Sandal-BLK-100,Teva 1019234 Hurricane Sandal-BLK-100,FBALYB Amazon,222,220,2,0,2,0
,Teva 1019234 Hurricane Sandal-BLK-110,Teva 1019234 Hurricane Sandal-BLK-110,FBALYB Amazon,160,160,0,0,0,0
,Teva 1019234 Hurricane Sandal-BLK-120,Teva 1019234 Hurricane Sandal-BLK-120,FBALYB Amazon,129,126,3,0,3,0
,Teva 1019234 Hurricane Sandal-BLK-130,Teva 1019234 Hurricane Sandal-BLK-130,FBALYB Amazon,57,57,0,0,0,0
,Teva 1019234 Hurricane Sandal-BLK-140,Teva 1019234 Hurricane Sandal-BLK-140,Default Ridgefield,46,46,0,0,0,0
,Teva-1019234 Hurricane Sandal-RINB-070,Teva-1019234 Hurricane Sandal-RINB-071,FBALYB Amazon,-1,-1,0,0,0,0
,Teva-1019234 Hurricane Sandal-RINB-080,Teva-1019234 Hurricane Sandal-RINB-081,FBALYB Amazon,-2,-2,0,0,0,0
,Teva-1019234 Hurricane Sandal-RINB-090,Teva-1019234 Hurricane Sandal-RINB-091,FBALYB Amazon,-3,-3,0,0,0,0
,Teva-1019234 Hurricane Sandal-RINB-100,Teva-1019234 Hurricane Sandal-RINB-101,FBALYB Amazon,-1,-1,0,0,0,0
,Teva-1019234 Hurricane Sandal-RINB-110,Teva-1019234 Hurricane Sandal-RINB-111,FBALYB Amazon,-1,-1,0,0,0,0
,Teva-1019234 Hurricane Sandal-RINB-120,Teva-1019234 Hurricane Sandal-RINB-121,FBALYB Amazon,-3,-3,0,0,0,0
,Teva-1019235 Womens Hurricane Sandal-BLK-050,Teva-1019235 Womens Hurricane Sandal-BLK-050,Default Ridgefield,9,9,0,0,0,0
,Teva-1019235 Womens Hurricane Sandal-BLK-050,Teva-1019235 Womens Hurricane Sandal-BLK-050,FBALYB Amazon,1,1,0,0,0,0
,Teva-1019235 Womens Hurricane Sandal-BLK-060,Teva-1019235 Womens Hurricane Sandal-BLK-061,Default Ridgefield,79,79,0,0,0,0
,Teva-1019235 Womens Hurricane Sandal-BLK-060,Teva-1019235 Womens Hurricane Sandal-BLK-061,FBALYB Amazon,-7,-7,0,0,0,0
,Teva-1019235 Womens Hurricane Sandal-BLK-070,Teva-1019235 Womens Hurricane Sandal-BLK-071,Default Ridgefield,67,67,0,0,0,0
,Teva-1019235 Womens Hurricane Sandal-BLK-070,Teva-1019235 Womens Hurricane Sandal-BLK-071,FBALYB Amazon,44,39,5,0,5,0
,Teva-1019235 Womens Hurricane Sandal-BLK-080,Teva-1019235 Womens Hurricane Sandal-BLK-081,Default Ridgefield,98,98,0,0,0,0
,Teva-1019235 Womens Hurricane Sandal-BLK-080,Teva-1019235 Womens Hurricane Sandal-BLK-081,FBALYB Amazon,44,43,1,0,1,0
,Teva-1019235 Womens Hurricane Sandal-BLK-090,Teva-1019235 Womens Hurricane Sandal-BLK-091,Default Ridgefield,130,130,0,0,0,0
,Teva-1019235 Womens Hurricane Sandal-BLK-090,Teva-1019235 Womens Hurricane Sandal-BLK-091,FBALYB Amazon,-4,-4,0,0,0,0
,Teva-1019235 Womens Hurricane Sandal-BLK-100,Teva-1019235 Womens Hurricane Sandal-BLK-101,Default Ridgefield,35,35,0,0,0,0
,Teva-1019235 Womens Hurricane Sandal-BLK-100,Teva-1019235 Womens Hurricane Sandal-BLK-101,FBALYB Amazon,-1,-1,0,0,0,0
,Teva-1019235 Womens Hurricane Sandal-BLK-110,Teva-1019235 Womens Hurricane Sandal-BLK-110,FBALYB Amazon,29,29,0,5,0,0
,Teva 1019240 Sirra Sandal -DTS-050,Teva 1019240 Sirra Sandal -DTS-050,FBALYB Amazon,-1,-1,0,0,0,0
,Teva 1019240 Sirra Sandal -DTS-060,Teva 1019240 Sirra Sandal -DTS-060,FBALYB Amazon,-4,-4,0,0,0,0
,Teva 1019240 Sirra Sandal -DTS-070,Teva 1019240 Sirra Sandal -DTS-070,FBALYB Amazon,-9,-9,0,0,0,0
,Teva 1019240 Sirra Sandal -DTS-080,Teva 1019240 Sirra Sandal -DTS-080,FBALYB Amazon,-20,-20,0,0,0,0
,Teva 1019240 Sirra Sandal -DTS-090,Teva 1019240 Sirra Sandal -DTS-090,FBALYB Amazon,-17,-17,0,0,0,0
,Teva 1019240 Sirra Sandal -DTS-100,Teva 1019240 Sirra Sandal -DTS-100,FBALYB Amazon,-4,-4,0,0,0,0
,Teva 1019622 Voya Infinity -BLK-050,Teva 1019622 Voya Infinity -BLK-050,FBALYB Amazon,10,10,0,0,0,0
,Teva 1019622 Voya Infinity -BLK-060,Teva 1019622 Voya Infinity -BLK-060,FBALYB Amazon,22,22,0,0,0,0
,Teva 1019622 Voya Infinity -BLK-070,Teva 1019622 Voya Infinity -BLK-070,FBALYB Amazon,62,62,0,0,0,0
,Teva 1019622 Voya Infinity -BLK-080,Teva 1019622 Voya Infinity -BLK-080,FBALYB Amazon,138,138,0,0,0,0
,Teva 1019622 Voya Infinity -BLK-090,Teva 1019622 Voya Infinity -BLK-090,Default Ridgefield,138,138,0,0,0,0
,Teva 1019622 Voya Infinity -BLK-090,Teva 1019622 Voya Infinity -BLK-090,FBALYB Amazon,-27,-27,0,0,0,0
,Teva 1019622 Voya Infinity -BLK-100,Teva 1019622 Voya Infinity -BLK-100,FBALYB Amazon,39,39,0,0,0,0
,Teva 1019622 Voya Infinity -BLK-110,Teva 1019622 Voya Infinity -BLK-110,Default Ridgefield,1,1,0,0,0,0
,Teva 1019622 Voya Infinity -BLK-110,Teva 1019622 Voya Infinity -BLK-110,FBALYB Amazon,19,19,0,0,0,0
,Teva 1090969 Midform Sandal-BLK-050,Teva 1090969 Midform Sandal-BLK-050,Default Ridgefield,49,49,0,0,0,0
,Teva 1090969 Midform Sandal-BLK-050,Teva 1090969 Midform Sandal-BLK-050,FBALYB Amazon,-3,-3,0,0,0,0
,Teva 1090969 Midform Sandal-BLK-060,Teva 1090969 Midform Sandal-BLK-060,Default Ridgefield,293,293,0,0,0,0
,Teva 1090969 Midform Sandal-BLK-060,Teva 1090969 Midform Sandal-BLK-060,FBALYB Amazon,-2,-2,0,0,0,0
,Teva 1090969 Midform Sandal-BLK-070,Teva 1090969 Midform Sandal-BLK-070,Default Ridgefield,195,195,0,0,0,0
,Teva 1090969 Midform Sandal-BLK-070,Teva 1090969 Midform Sandal-BLK-070,FBALYB Amazon,-7,-7,0,0,0,0
,Teva 1090969 Midform Sandal-BLK-080,Teva 1090969 Midform Sandal-BLK-080,Default Ridgefield,364,364,0,0,0,0
,Teva 1090969 Midform Sandal-BLK-080,Teva 1090969 Midform Sandal-BLK-080,FBALYB Amazon,-17,-17,0,75,0,0
,Teva 1090969 Midform Sandal-BLK-090,Teva 1090969 Midform Sandal-BLK-090,Default Ridgefield,294,294,0,0,0,0
,Teva 1090969 Midform Sandal-BLK-090,Teva 1090969 Midform Sandal-BLK-090,FBALYB Amazon,-13,-13,0,72,0,0
,Teva 1090969 Midform Sandal-BLK-100,Teva 1090969 Midform Sandal-BLK-100,Default Oxford,12,12,0,0,0,0
,Teva 1090969 Midform Sandal-BLK-100,Teva 1090969 Midform Sandal-BLK-100,Default Ridgefield,220,220,0,0,0,0
,Teva 1090969 Midform Sandal-BLK-100,Teva 1090969 Midform Sandal-BLK-100,FBALYB Amazon,-5,-5,0,0,0,0
,Teva 1090969 Midform Sandal-BLK-110,Teva 1090969 Midform Sandal-BLK-110,Default Oxford,8,8,0,0,0,0
,Teva 1093379 Hurricane 4 -BLK-070,Teva 1093379 Hurricane 4 -BLK-070,FBALYB Amazon,-5,-5,0,0,0,0
,Teva 1093379 Hurricane 4 -BLK-080,Teva 1093379 Hurricane 4 -BLK-080,FBALYB Amazon,-7,-7,0,0,0,0
,Teva 1093379 Hurricane 4 -BLK-090,Teva 1093379 Hurricane 4 -BLK-090,FBALYB Amazon,-4,-4,0,0,0,0
,Teva 1093379 Hurricane 4 -BLK-100,Teva 1093379 Hurricane 4 -BLK-100,FBALYB Amazon,-9,-9,0,0,0,0
,Teva 1093379 Hurricane 4 -BLK-110,Teva 1093379 Hurricane 4 -BLK-110,FBALYB Amazon,-2,-2,0,0,0,0
,Teva 1093379 Hurricane 4 -BLK-120,Teva 1093379 Hurricane 4 -BLK-120,FBALYB Amazon,-1,-1,0,0,0,0
,Teva 1093379 Hurricane 4 -BLK-130,Teva 1093379 Hurricane 4 -BLK-130,FBALYB Amazon,-3,-3,0,0,0,0
,Teva 1102390 Hurricane Drift Sandal-BLK-050,Teva 1102390 Hurricane Drift Sandal-BLK-050,Default Ridgefield,8,8,0,0,0,0
,Teva 1102390 Hurricane Drift Sandal-BLK-050,Teva 1102390 Hurricane Drift Sandal-BLK-050,FBALYB Amazon,-12,-12,0,0,0,0
,Teva 1102390 Hurricane Drift Sandal-BLK-060,Teva 1102390 Hurricane Drift Sandal-BLK-060,Default Ridgefield,22,22,0,0,0,0
,Teva 1102390 Hurricane Drift Sandal-BLK-060,Teva 1102390 Hurricane Drift Sandal-BLK-060,FBALYB Amazon,5,5,0,0,0,0
,Teva 1102390 Hurricane Drift Sandal-BLK-070,Teva 1102390 Hurricane Drift Sandal-BLK-070,Default,6,6,0,0,0,0
,Teva 1102390 Hurricane Drift Sandal-BLK-070,Teva 1102390 Hurricane Drift Sandal-BLK-070,Default Ridgefield,1,1,0,0,0,0
,Teva 1102390 Hurricane Drift Sandal-BLK-070,Teva 1102390 Hurricane Drift Sandal-BLK-070,FBALYB Amazon,118,118,0,0,0,0
,Teva 1102390 Hurricane Drift Sandal-BLK-080,Teva 1102390 Hurricane Drift Sandal-BLK-080,Default Ridgefield,180,180,0,0,0,0
,Teva 1102390 Hurricane Drift Sandal-BLK-080,Teva 1102390 Hurricane Drift Sandal-BLK-080,FBALYB Amazon,-57,-57,0,0,0,0
,Teva 1102390 Hurricane Drift Sandal-BLK-090,Teva 1102390 Hurricane Drift Sandal-BLK-090,FBALYB Amazon,74,73,1,0,1,0
,Teva 1102390 Hurricane Drift Sandal-BLK-100,Teva 1102390 Hurricane Drift Sandal-BLK-100,Default Ridgefield,1,1,0,0,0,0
,Teva 1102390 Hurricane Drift Sandal-BLK-100,Teva 1102390 Hurricane Drift Sandal-BLK-100,FBALYB Amazon,-18,-18,0,178,0,0
,Teva 1102390 Hurricane Drift Sandal-BLK-110,Teva 1102390 Hurricane Drift Sandal-BLK-110,Default Ridgefield,1,1,0,0,0,0
,Teva 1102390 Hurricane Drift Sandal-BLK-110,Teva 1102390 Hurricane Drift Sandal-BLK-110,FBALYB Amazon,-1,-1,0,0,0,0
,Teva 1102390 Hurricane Drift Sandal -WFAL-050,Teva 1102390 Hurricane Drift Sandal -WFAL-050,FBALYB Amazon,-6,-6,0,0,0,0
,Teva 1102390 Hurricane Drift Sandal -WFAL-060,Teva 1102390 Hurricane Drift Sandal -WFAL-060,FBALYB Amazon,-4,-4,0,0,0,0
,Teva 1102390 Hurricane Drift Sandal -WFAL-070,Teva 1102390 Hurricane Drift Sandal -WFAL-070,FBALYB Amazon,-16,-16,0,0,0,0
,Teva 1102390 Hurricane Drift Sandal -WFAL-080,Teva 1102390 Hurricane Drift Sandal -WFAL-080,FBALYB Amazon,-9,-9,0,0,0,0
,Teva 1102390 Hurricane Drift Sandal -WFAL-090,Teva 1102390 Hurricane Drift Sandal -WFAL-090,FBALYB Amazon,-13,-13,0,0,0,0
,Teva 1102390 Hurricane Drift Sandal -WFAL-100,Teva 1102390 Hurricane Drift Sandal -WFAL-100,FBALYB Amazon,-9,-9,0,0,0,0
,Teva 1102390 Hurricane Drift Sandal -WFAL-110,Teva 1102390 Hurricane Drift Sandal -WFAL-110,FBALYB Amazon,-6,-6,0,0,0,0
,Teva 1102390 Hurricane Drift Sandal -WHT-050,Teva 1102390 Hurricane Drift Sandal -WHT-050,Default,1,1,0,0,0,0
,Teva 1102390 Hurricane Drift Sandal -WHT-050,Teva 1102390 Hurricane Drift Sandal -WHT-050,FBALYB Amazon,-7,-7,0,0,0,0
,Teva 1102390 Hurricane Drift Sandal -WHT-060,Teva 1102390 Hurricane Drift Sandal -WHT-060,FBALYB Amazon,28,27,1,0,1,0
,Teva 1102390 Hurricane Drift Sandal -WHT-070,Teva 1102390 Hurricane Drift Sandal -WHT-070,FBALYB Amazon,192,192,0,0,0,0
,Teva 1102390 Hurricane Drift Sandal -WHT-080,Teva 1102390 Hurricane Drift Sandal -WHT-080,Default Ridgefield,35,35,0,0,0,0
,Teva 1102390 Hurricane Drift Sandal -WHT-080,Teva 1102390 Hurricane Drift Sandal -WHT-080,FBALYB Amazon,161,158,3,0,3,0
,Teva 1102390 Hurricane Drift Sandal -WHT-090,Teva 1102390 Hurricane Drift Sandal -WHT-090,FBALYB Amazon,139,138,1,0,1,0
,Teva 1102390 Hurricane Drift Sandal -WHT-100,Teva 1102390 Hurricane Drift Sandal -WHT-100,Default Ridgefield,70,70,0,0,0,0
,Teva 1102390 Hurricane Drift Sandal -WHT-100,Teva 1102390 Hurricane Drift Sandal -WHT-100,FBALYB Amazon,126,126,0,0,0,0
,Teva 1102390 Hurricane Drift Sandal -WHT-110,Teva 1102390 Hurricane Drift Sandal -WHT-110,FBALYB Amazon,20,20,0,0,0,0
,Teva 1106329 Maressa-MBKM-070,Teva 1106329 Maressa-MBKM-070,FBALYB Amazon,-10,-11,1,0,1,0
,Teva 1106329 Maressa-MBKM-080,Teva 1106329 Maressa-MBKM-080,FBALYB Amazon,-19,-19,0,0,0,0
,Teva 1106329 Maressa-MBKM-090,Teva 1106329 Maressa-MBKM-090,FBALYB Amazon,58,58,0,0,0,0
,Teva 1106329 Maressa-MBKM-100,Teva 1106329 Maressa-MBKM-100,FBALYB Amazon,-8,-8,0,0,0,0
,Teva 1106329 Maressa-MSML-070,Teva 1106329 Maressa-MSML-070,FBALYB Amazon,-2,-2,0,0,0,0
,Teva 1106329 Maressa-MSML-080,Teva 1106329 Maressa-MSML-080,FBALYB Amazon,-8,-8,0,0,0,0
,Teva 1106329 Maressa-MSML-090,Teva 1106329 Maressa-MSML-090,FBALYB Amazon,-8,-8,0,1,0,0
,Teva 1106329 Maressa-MSML-100,Teva 1106329 Maressa-MSML-100,FBALYB Amazon,-1,-1,0,0,0,0
,Teva 1106329 Maressa-MSML-110,Teva 1106329 Maressa-MSML-110,FBALYB Amazon,-3,-3,0,0,0,0
,Teva 4266 Tirra Sandal-BKGY-050,Teva 4266 Tirra Sandal-BKGY-050,Default Ridgefield,10,10,0,0,0,0
,Teva 4266 Tirra Sandal-BKGY-050,Teva 4266 Tirra Sandal-BKGY-050,FBALYB Amazon,9,9,0,0,0,0
,Teva 4266 Tirra Sandal-BKGY-055,Teva 4266 Tirra Sandal-BKGY-055,FBALYB Amazon,-2,-2,0,0,0,0
,Teva 4266 Tirra Sandal-BKGY-060,Teva 4266 Tirra Sandal-BKGY-060,FBALYB Amazon,-3,-3,0,0,0,0
,Teva 4266 Tirra Sandal-BKGY-065,Teva 4266 Tirra Sandal-BKGY-065,Default,0,0,0,0,0,1
,Teva 4266 Tirra Sandal-BKGY-065,Teva 4266 Tirra Sandal-BKGY-065,FBALYB Amazon,-4,-4,0,0,0,0
,Teva 4266 Tirra Sandal-BKGY-070,Teva 4266 Tirra Sandal-BKGY-070,FBALYB Amazon,-21,-21,0,0,0,0
,Teva 4266 Tirra Sandal-BKGY-075,Teva 4266 Tirra Sandal-BKGY-075,FBALYB Amazon,-17,-17,0,0,0,0
,Teva 4266 Tirra Sandal-BKGY-080,Teva 4266 Tirra Sandal-BKGY-080,FBALYB Amazon,-32,-32,0,0,0,0
,Teva 4266 Tirra Sandal-BKGY-085,Teva 4266 Tirra Sandal-BKGY-085,FBALYB Amazon,-10,-10,0,1,0,0
,Teva 4266 Tirra Sandal-BKGY-090,Teva 4266 Tirra Sandal-BKGY-090,FBALYB Amazon,-18,-18,0,0,0,0
,Teva 4266 Tirra Sandal-BKGY-095,Teva 4266 Tirra Sandal-BKGY-095,FBALYB Amazon,-4,-4,0,0,0,0
,Teva 4266 Tirra Sandal-BKGY-100,Teva 4266 Tirra Sandal-BKGY-100,FBALYB Amazon,-10,-10,0,0,0,0
,Teva 4266 Tirra Sandal-BKGY-110,Teva 4266 Tirra Sandal-BKGY-110,FBALYB Amazon,-2,-2,0,0,0,0
,Teva 4266 Tirra Sandal-BNS-050,Teva 4266 Tirra Sandal-BNS-050,FBALYB Amazon,-3,-3,0,0,0,0
,Teva 4266 Tirra Sandal-BNS-055,Teva 4266 Tirra Sandal-BNS-055,FBALYB Amazon,-1,-1,0,0,0,0
,Teva 4266 Tirra Sandal-BNS-060,Teva 4266 Tirra Sandal-BNS-060,FBALYB Amazon,-6,-6,0,0,0,0
,Teva 4266 Tirra Sandal-BNS-065,Teva 4266 Tirra Sandal-BNS-065,FBALYB Amazon,-6,-6,0,0,0,0
,Teva 4266 Tirra Sandal-BNS-070,Teva 4266 Tirra Sandal-BNS-070,FBALYB Amazon,-11,-11,0,0,0,0
,Teva 4266 Tirra Sandal-BNS-075,Teva 4266 Tirra Sandal-BNS-075,FBALYB Amazon,-18,-18,0,0,0,0
,Teva 4266 Tirra Sandal-BNS-080,Teva 4266 Tirra Sandal-BNS-080,FBALYB Amazon,-26,-26,0,0,0,0
,Teva 4266 Tirra Sandal-BNS-085,Teva 4266 Tirra Sandal-BNS-085,FBALYB Amazon,-20,-20,0,0,0,0
,Teva 4266 Tirra Sandal-BNS-090,Teva 4266 Tirra Sandal-BNS-090,FBALYB Amazon,-27,-27,0,0,0,0
,Teva 4266 Tirra Sandal-BNS-095,Teva 4266 Tirra Sandal-BNS-095,FBALYB Amazon,-7,-7,0,0,0,0
,Teva 4266 Tirra Sandal-BNS-100,Teva 4266 Tirra Sandal-BNS-100,FBALYB Amazon,-11,-11,0,0,0,0
,Teva 4266 Tirra Sandal-BNS-110,Teva 4266 Tirra Sandal-BNS-110,FBALYB Amazon,-5,-5,0,0,0,0
,Teva 4266 Tirra Sandal-BWML-060,Teva 4266 Tirra Sandal-BWML-060,FBALYB Amazon,-1,-1,0,0,0,0
,Teva 4266 Tirra Sandal-BWML-070,Teva 4266 Tirra Sandal-BWML-070,Default Ridgefield,4,4,0,0,0,0
,Teva 4266 Tirra Sandal-BWML-070,Teva 4266 Tirra Sandal-BWML-070,FBALYB Amazon,-3,-3,0,0,0,0
,Teva 4266 Tirra Sandal-BWML-075,Teva 4266 Tirra Sandal-BWML-075,FBALYB Amazon,-2,-2,0,0,0,0
,Teva 4266 Tirra Sandal-BWML-080,Teva 4266 Tirra Sandal-BWML-080,FBALYB Amazon,-4,-4,0,0,0,0
,Teva 4266 Tirra Sandal-BWML-085,Teva 4266 Tirra Sandal-BWML-085,FBALYB Amazon,-3,-3,0,0,0,0
,Teva 4266 Tirra Sandal-BWML-090,Teva 4266 Tirra Sandal-BWML-090,FBALYB Amazon,-4,-4,0,0,0,0
,Teva 4266 Tirra Sandal-BWML-100,Teva 4266 Tirra Sandal-BWML-100,FBALYB Amazon,-5,-5,0,0,0,0
,Teva 4266 Tirra Sandal-BWML-110,Teva 4266 Tirra Sandal-BWML-110,FBALYB Amazon,-3,-3,0,0,0,0
,Teva-6840 Womens Olowahu Sandal-ABRC-060,Teva-6840 Womens Olowahu Sandal-ABRC-060,FBALYB Amazon,-2,-2,0,0,0,0
,Teva-6840 Womens Olowahu Sandal-ABRC-070,Teva-6840 Womens Olowahu Sandal-ABRC-070,FBALYB Amazon,-5,-5,0,0,0,0
,Teva-6840 Womens Olowahu Sandal-ABRC-080,Teva-6840 Womens Olowahu Sandal-ABRC-080,FBALYB Amazon,-7,-7,0,0,0,0
,Teva-6840 Womens Olowahu Sandal-ABRC-090,Teva-6840 Womens Olowahu Sandal-ABRC-090,FBALYB Amazon,-5,-5,0,0,0,0
,Teva-6840 Womens Olowahu Sandal-ABRC-100,Teva-6840 Womens Olowahu Sandal-ABRC-100,Default Ridgefield,1,1,0,0,0,0
,Teva-6840 Womens Olowahu Sandal-ABRC-100,Teva-6840 Womens Olowahu Sandal-ABRC-100,FBALYB Amazon,-7,-7,0,0,0,0
,Teva-6840 Womens Olowahu Sandal-ABRC-110,Teva-6840 Womens Olowahu Sandal-ABRC-110,Default,0,0,0,0,0,5
,Teva-6840 Womens Olowahu Sandal-ABRC-110,Teva-6840 Womens Olowahu Sandal-ABRC-110,FBALYB Amazon,5,5,0,0,0,0
,Teva-6840 Womens Olowahu Sandal FBLCK-050,Teva-6840 Womens Olowahu Sandal FBLCK-051,FBALYB Amazon,-1,-1,0,0,0,0
,Teva-6840 Womens Olowahu Sandal FBLCK-060,Teva-6840 Womens Olowahu Sandal FBLCK-061,FBALYB Amazon,-8,-8,0,0,0,0
,Teva-6840 Womens Olowahu Sandal FBLCK-070,Teva-6840 Womens Olowahu Sandal FBLCK-071,FBALYB Amazon,-11,-11,0,0,0,0
,Teva-6840 Womens Olowahu Sandal FBLCK-080,Teva-6840 Womens Olowahu Sandal FBLCK-081,FBALYB Amazon,-9,-9,0,0,0,0
,Teva-6840 Womens Olowahu Sandal FBLCK-090,Teva-6840 Womens Olowahu Sandal FBLCK-091,FBALYB Amazon,-5,-5,0,0,0,0
,Teva-6840 Womens Olowahu Sandal FBLCK-100,Teva-6840 Womens Olowahu Sandal FBLCK-101,FBALYB Amazon,-2,-2,0,0,0,0
,Teva-6840 Womens Olowahu Sandal SRGM-060,Teva-6840 Womens Olowahu Sandal SRGM-061,FBALYB Amazon,-1,-1,0,0,0,0
,Teva-6840 Womens Olowahu Sandal SRGM-070,Teva-6840 Womens Olowahu Sandal SRGM-071,FBALYB Amazon,-1,-1,0,0,0,0
,Teva-6840 Womens Olowahu Sandal SRGM-080,Teva-6840 Womens Olowahu Sandal SRGM-081,FBALYB Amazon,-1,-1,0,0,0,0
,Teva kids Hurricane Drift Black 1102483C-BLK US Size 1,Teva kids Hurricane Drift Black 1102483C-BLK US Size 1,FBALYB Amazon,45,44,1,0,1,0
,Teva kids Hurricane Drift Black 1102483C-BLK US Size 11,Teva kids Hurricane Drift Black 1102483C-BLK US Size 11,FBALYB Amazon,65,65,0,0,0,0
,Teva kids Hurricane Drift Black 1102483C-BLK US Size 12,Teva kids Hurricane Drift Black 1102483C-BLK US Size 12,FBALYB Amazon,38,38,0,0,0,0
,Teva kids Hurricane Drift Black 1102483C-BLK US Size 13,Teva kids Hurricane Drift Black 1102483C-BLK US Size 13,FBALYB Amazon,105,105,0,0,0,0
,Teva kids Hurricane Drift Black 1102483C-BLK US Size 2,Teva kids Hurricane Drift Black 1102483C-BLK US Size 2,FBALYB Amazon,34,34,0,0,0,0
,Teva kids Hurricane Drift Black 1102483C-BLK US Size 3,Teva kids Hurricane Drift Black 1102483C-BLK US Size 3,Default Ridgefield,1,1,0,0,0,0
,Teva kids Hurricane Drift Black 1102483C-BLK US Size 3,Teva kids Hurricane Drift Black 1102483C-BLK US Size 3,FBALYB Amazon,91,91,0,0,0,0
,Teva Kids Tirra Falls Purple Pennant 1019395C-FPPN Size 1,Teva Kids Tirra Falls Purple Pennant 1019395C-FPPN Size 1,FBALYB Amazon,65,65,0,0,0,0
,Teva Kids Tirra Falls Purple Pennant 1019395C-FPPN Size 12,Teva Kids Tirra Falls Purple Pennant 1019395C-FPPN Size 12,FBALYB Amazon,40,40,0,0,0,0
,Teva Kids Tirra Falls Purple Pennant 1019395C-FPPN Size 13,Teva Kids Tirra Falls Purple Pennant 1019395C-FPPN Size 13,FBALYB Amazon,24,24,0,0,0,0
,Teva Kids Tirra Falls Purple Pennant 1019395C-FPPN Size 2,Teva Kids Tirra Falls Purple Pennant 1019395C-FPPN Size 2,FBALYB Amazon,74,74,0,0,0,0
,Teva Kids Tirra Falls Purple Pennant 1019395C-FPPN Size 3,Teva Kids Tirra Falls Purple Pennant 1019395C-FPPN Size 3,Default Ridgefield,65,65,0,0,0,0
,Teva Men Hurricane Drift Black 1100270-BLK US Size 10,Teva Men Hurricane Drift Black 1100270-BLK US Size 10,FBALYB Amazon,-3,-5,2,53,2,0
,Teva Men Hurricane Drift Black 1100270-BLK US Size 11,Teva Men Hurricane Drift Black 1100270-BLK US Size 11,FBALYB Amazon,58,58,0,0,0,0
,Teva Men Hurricane Drift Black 1100270-BLK US Size 12,Teva Men Hurricane Drift Black 1100270-BLK US Size 12,FBALYB Amazon,6,4,2,0,2,0
,Teva Men Hurricane Drift Black 1100270-BLK US Size 13,Teva Men Hurricane Drift Black 1100270-BLK US Size 13,FBALYB Amazon,6,6,0,0,0,0
,Teva Men Hurricane Drift Black 1100270-BLK US Size 7,Teva Men Hurricane Drift Black 1100270-BLK US Size 7,FBALYB Amazon,31,30,1,0,1,0
,Teva Men Hurricane Drift Black 1100270-BLK US Size 8,Teva Men Hurricane Drift Black 1100270-BLK US Size 8,Default Ridgefield,4,4,0,0,0,0
,Teva Men Hurricane Drift Black 1100270-BLK US Size 8,Teva Men Hurricane Drift Black 1100270-BLK US Size 8,FBALYB Amazon,6,6,0,0,0,0
,Teva Men Hurricane Drift Black 1100270-BLK US Size 9,Teva Men Hurricane Drift Black 1100270-BLK US Size 9,FBALYB Amazon,28,28,0,0,0,0
,Teva Men's Hudson Sandals Dark Gull Grey 1002433-DGGR US Size 10,Teva Men's Hudson Sandals Dark Gull Grey 1002433-DGGR US Size 10,Default Ridgefield,1,1,0,0,0,0
,Teva Men's Hudson Sandals Dark Gull Grey 1002433-DGGR US Size 10,Teva Men's Hudson Sandals Dark Gull Grey 1002433-DGGR US Size 10,FBALYB Amazon,86,83,3,0,3,0
,Teva Men's Hudson Sandals Dark Gull Grey 1002433-DGGR US Size 11,Teva Men's Hudson Sandals Dark Gull Grey 1002433-DGGR US Size 11,Default Ridgefield,12,12,0,0,0,0
,Teva Men's Hudson Sandals Dark Gull Grey 1002433-DGGR US Size 11,Teva Men's Hudson Sandals Dark Gull Grey 1002433-DGGR US Size 11,FBALYB Amazon,193,191,2,0,2,0
,Teva Men's Hudson Sandals Dark Gull Grey 1002433-DGGR US Size 12,Teva Men's Hudson Sandals Dark Gull Grey 1002433-DGGR US Size 12,Default Ridgefield,85,85,0,0,0,0
,Teva Men's Hudson Sandals Dark Gull Grey 1002433-DGGR US Size 12,Teva Men's Hudson Sandals Dark Gull Grey 1002433-DGGR US Size 12,FBALYB Amazon,84,83,1,0,1,0
,Teva Men's Hudson Sandals Dark Gull Grey 1002433-DGGR US Size 13,Teva Men's Hudson Sandals Dark Gull Grey 1002433-DGGR US Size 13,Default Ridgefield,2,2,0,0,0,0
,Teva Men's Hudson Sandals Dark Gull Grey 1002433-DGGR US Size 13,Teva Men's Hudson Sandals Dark Gull Grey 1002433-DGGR US Size 13,FBALYB Amazon,47,47,0,0,0,0
,Teva Men's Hudson Sandals Dark Gull Grey 1002433-DGGR US Size 14,Teva Men's Hudson Sandals Dark Gull Grey 1002433-DGGR US Size 14,Default Ridgefield,25,25,0,0,0,0
,Teva Men's Hudson Sandals Dark Gull Grey 1002433-DGGR US Size 8,Teva Men's Hudson Sandals Dark Gull Grey 1002433-DGGR US Size 8,Default Ridgefield,26,26,0,0,0,0
,Teva Men's Hudson Sandals Dark Gull Grey 1002433-DGGR US Size 9,Teva Men's Hudson Sandals Dark Gull Grey 1002433-DGGR US Size 9,Default Ridgefield,20,20,0,0,0,0
,Teva Men's Hudson Sandals Dark Gull Grey 1002433-DGGR US Size 9,Teva Men's Hudson Sandals Dark Gull Grey 1002433-DGGR US Size 9,FBALYB Amazon,68,66,2,0,2,0
,Teva Men Teva Voya Flip Brick Black 1019050-BKBL US Size 10,Teva Men Teva Voya Flip Brick Black 1019050-BKBL US Size 10,FBALYB Amazon,66,66,0,0,0,0
,Teva Men Teva Voya Flip Brick Black 1019050-BKBL US Size 11,Teva Men Teva Voya Flip Brick Black 1019050-BKBL US Size 11,FBALYB Amazon,63,63,0,0,0,0
,Teva Men Teva Voya Flip Brick Black 1019050-BKBL US Size 12,Teva Men Teva Voya Flip Brick Black 1019050-BKBL US Size 12,FBALYB Amazon,51,51,0,0,0,0
,Teva Men Teva Voya Flip Brick Black 1019050-BKBL US Size 13,Teva Men Teva Voya Flip Brick Black 1019050-BKBL US Size 13,FBALYB Amazon,17,16,1,0,1,0
,Teva Men Teva Voya Flip Brick Black 1019050-BKBL US Size 7,Teva Men Teva Voya Flip Brick Black 1019050-BKBL US Size 7,FBALYB Amazon,20,20,0,0,0,0
,Teva Men Teva Voya Flip Brick Black 1019050-BKBL US Size 8,Teva Men Teva Voya Flip Brick Black 1019050-BKBL US Size 8,Default Ridgefield,42,42,0,0,0,0
,Teva Men Teva Voya Flip Brick Black 1019050-BKBL US Size 9,Teva Men Teva Voya Flip Brick Black 1019050-BKBL US Size 9,FBALYB Amazon,63,63,0,0,0,0
,Teva Omnium for Women Plaza Top Taupe 6154-PLTP US Size 10,Teva Omnium for Women Plaza Top Taupe 6154-PLTP US Size 10,FBALYB Amazon,54,54,0,0,0,0
,Teva Omnium for Women Plaza Top Taupe 6154-PLTP US Size 10.5,Teva Omnium for Women Plaza Top Taupe 6154-PLTP US Size 10.5,Default Ridgefield,4,4,0,0,0,0
,Teva Omnium for Women Plaza Top Taupe 6154-PLTP US Size 10.5,Teva Omnium for Women Plaza Top Taupe 6154-PLTP US Size 10.5,FBALYB Amazon,16,16,0,0,0,0
,Teva Omnium for Women Plaza Top Taupe 6154-PLTP US Size 11,Teva Omnium for Women Plaza Top Taupe 6154-PLTP US Size 11,Default Ridgefield,15,15,0,0,0,0
,Teva Omnium for Women Plaza Top Taupe 6154-PLTP US Size 11,Teva Omnium for Women Plaza Top Taupe 6154-PLTP US Size 11,FBALYB Amazon,90,90,0,0,0,0
,Teva Omnium for Women Plaza Top Taupe 6154-PLTP US Size 5,Teva Omnium for Women Plaza Top Taupe 6154-PLTP US Size 5,FBALYB Amazon,9,9,0,0,0,0
,Teva Omnium for Women Plaza Top Taupe 6154-PLTP US Size 5.5,Teva Omnium for Women Plaza Top Taupe 6154-PLTP US Size 5.5,Default Ridgefield,10,10,0,0,0,0
,Teva Omnium for Women Plaza Top Taupe 6154-PLTP US Size 6,Teva Omnium for Women Plaza Top Taupe 6154-PLTP US Size 6,FBALYB Amazon,30,30,0,0,0,0
,Teva Omnium for Women Plaza Top Taupe 6154-PLTP US Size 6.5,Teva Omnium for Women Plaza Top Taupe 6154-PLTP US Size 6.5,FBALYB Amazon,10,10,0,0,0,0
,Teva Omnium for Women Plaza Top Taupe 6154-PLTP US Size 7,Teva Omnium for Women Plaza Top Taupe 6154-PLTP US Size 7,FBALYB Amazon,78,78,0,0,0,0
,Teva Omnium for Women Plaza Top Taupe 6154-PLTP US Size 7.5,Teva Omnium for Women Plaza Top Taupe 6154-PLTP US Size 7.5,FBALYB Amazon,58,58,0,0,0,0
,Teva Omnium for Women Plaza Top Taupe 6154-PLTP US Size 8,Teva Omnium for Women Plaza Top Taupe 6154-PLTP US Size 8,Default Ridgefield,33,33,0,0,0,0
,Teva Omnium for Women Plaza Top Taupe 6154-PLTP US Size 8,Teva Omnium for Women Plaza Top Taupe 6154-PLTP US Size 8,FBALYB Amazon,70,70,0,0,0,0
,Teva Omnium for Women Plaza Top Taupe 6154-PLTP US Size 8.5,Teva Omnium for Women Plaza Top Taupe 6154-PLTP US Size 8.5,Default Ridgefield,42,42,0,0,0,0
,Teva Omnium for Women Plaza Top Taupe 6154-PLTP US Size 8.5,Teva Omnium for Women Plaza Top Taupe 6154-PLTP US Size 8.5,FBALYB Amazon,69,69,0,0,0,0
,Teva Omnium for Women Plaza Top Taupe 6154-PLTP US Size 9,Teva Omnium for Women Plaza Top Taupe 6154-PLTP US Size 9,Default Ridgefield,75,75,0,0,0,0
,Teva Omnium for Women Plaza Top Taupe 6154-PLTP US Size 9,Teva Omnium for Women Plaza Top Taupe 6154-PLTP US Size 9,FBALYB Amazon,69,69,0,0,0,0
,Teva Omnium for Women Plaza Top Taupe 6154-PLTP US Size 9.5,Teva Omnium for Women Plaza Top Taupe 6154-PLTP US Size 9.5,Default Ridgefield,30,30,0,0,0,0
,Teva Original Universal 90s Multicolor 1004006 SMU-070,Teva Original Universal 90s Multicolor 1004006 SMU-070,Default Ridgefield,1207,1207,0,0,0,0
,Teva Original Universal 90s Multicolor 1004006 SMU-070,Teva Original Universal 90s Multicolor 1004006 SMU-070,FBALYB Amazon,69,69,0,0,0,0
,Teva Original Universal 90s Multicolor 1004006 SMU-080,Teva Original Universal 90s Multicolor 1004006 SMU-080,Default Ridgefield,461,461,0,0,0,0
,Teva Original Universal 90s Multicolor 1004006 SMU-080,Teva Original Universal 90s Multicolor 1004006 SMU-080,FBALYB Amazon,66,66,0,0,0,0
,Teva Original Universal 90s Multicolor 1004006 SMU-090,Teva Original Universal 90s Multicolor 1004006 SMU-090,Default Ridgefield,357,357,0,0,0,0
,Teva Original Universal 90s Multicolor 1004006 SMU-090,Teva Original Universal 90s Multicolor 1004006 SMU-090,FBALYB Amazon,61,61,0,0,0,0
,Teva Original Universal 90s Multicolor 1004006 SMU-100,Teva Original Universal 90s Multicolor 1004006 SMU-100,Default Ridgefield,358,358,0,0,0,0
,Teva Original Universal 90s Multicolor 1004006 SMU-100,Teva Original Universal 90s Multicolor 1004006 SMU-100,FBALYB Amazon,48,48,0,0,0,0
,Teva Original Universal 90s Multicolor 1004006 SMU-110,Teva Original Universal 90s Multicolor 1004006 SMU-110,Default Ridgefield,39,39,0,0,0,0
,Teva Original Universal 90s Multicolor 1004006 SMU-110,Teva Original Universal 90s Multicolor 1004006 SMU-110,FBALYB Amazon,63,62,1,0,1,0
,Teva Voya Womens Black Slides1099269-BLK US Size 10,Teva Voya Womens Black Slides1099269-BLK US Size 10,Default Ridgefield,54,54,0,0,0,0
,Teva Voya Womens Black Slides1099269-BLK US Size 10,Teva Voya Womens Black Slides1099269-BLK US Size 10,FBALYB Amazon,-1,-1,0,0,0,0
,Teva Voya Womens Black Slides1099269-BLK US Size 11,Teva Voya Womens Black Slides1099269-BLK US Size 11,Default Ridgefield,18,18,0,0,0,0
,Teva Voya Womens Black Slides1099269-BLK US Size 6,Teva Voya Womens Black Slides1099269-BLK US Size 6,FBALYB Amazon,18,18,0,0,0,0
,Teva Voya Womens Black Slides1099269-BLK US Size 7,Teva Voya Womens Black Slides1099269-BLK US Size 7,Default Ridgefield,24,24,0,0,0,0
,Teva Voya Womens Black Slides1099269-BLK US Size 8,Teva Voya Womens Black Slides1099269-BLK US Size 8,FBALYB Amazon,22,22,0,0,0,0
,Teva Voya Womens Black Slides1099269-BLK US Size 9,Teva Voya Womens Black Slides1099269-BLK US Size 9,FBALYB Amazon,9,9,0,0,0,0
,Teva Women Hurricane Drift Sage Green1102390-SGRN US Size 10,Teva Women Hurricane Drift Sage Green1102390-SGRN US Size 10,Default Ridgefield,47,47,0,0,0,0
,Teva Women Hurricane Drift Sage Green1102390-SGRN US Size 10,Teva Women Hurricane Drift Sage Green1102390-SGRN US Size 10,FBALYB Amazon,47,47,0,0,0,0
,Teva Women Hurricane Drift Sage Green1102390-SGRN US Size 11,Teva Women Hurricane Drift Sage Green1102390-SGRN US Size 11,FBALYB Amazon,10,10,0,0,0,0
,Teva Women Hurricane Drift Sage Green1102390-SGRN US Size 5,Teva Women Hurricane Drift Sage Green1102390-SGRN US Size 5,Default Ridgefield,10,10,0,0,0,0
,Teva Women Hurricane Drift Sage Green1102390-SGRN US Size 6,Teva Women Hurricane Drift Sage Green1102390-SGRN US Size 6,Default Ridgefield,35,35,0,0,0,0
,Teva Women Hurricane Drift Sage Green1102390-SGRN US Size 7,Teva Women Hurricane Drift Sage Green1102390-SGRN US Size 7,Default Ridgefield,64,64,0,0,0,0
,Teva Women Hurricane Drift Sage Green1102390-SGRN US Size 7,Teva Women Hurricane Drift Sage Green1102390-SGRN US Size 7,FBALYB Amazon,30,29,1,0,1,0
,Teva Women Hurricane Drift Sage Green1102390-SGRN US Size 8,Teva Women Hurricane Drift Sage Green1102390-SGRN US Size 8,Default Ridgefield,103,103,0,0,0,0
,Teva Women Hurricane Drift Sage Green1102390-SGRN US Size 9,Teva Women Hurricane Drift Sage Green1102390-SGRN US Size 9,Default Ridgefield,30,30,0,0,0,0
,Teva Women Hurricane Drift Sage Green1102390-SGRN US Size 9,Teva Women Hurricane Drift Sage Green1102390-SGRN US Size 9,FBALYB Amazon,35,34,1,0,1,0
,Teva Women Olowahu Flip Flops Felicitas Black 6840-FBLCK US Size 10,Teva Women Olowahu Flip Flops Felicitas Black 6840-FBLCK US Size 10,Default Ridgefield,216,216,0,0,0,0
,Teva Women Olowahu Flip Flops Felicitas Black 6840-FBLCK US Size 11,Teva Women Olowahu Flip Flops Felicitas Black 6840-FBLCK US Size 11,Default Ridgefield,123,123,0,0,0,0
,Teva Women Olowahu Flip Flops Felicitas Black 6840-FBLCK US Size 12,Teva Women Olowahu Flip Flops Felicitas Black 6840-FBLCK US Size 12,FBALYB Amazon,3,2,1,0,1,0
,Teva Women Olowahu Flip Flops Felicitas Black 6840-FBLCK US Size 5,Teva Women Olowahu Flip Flops Felicitas Black 6840-FBLCK US Size 5,Default Ridgefield,44,44,0,0,0,0
,Teva Women Olowahu Flip Flops Felicitas Black 6840-FBLCK US Size 6,Teva Women Olowahu Flip Flops Felicitas Black 6840-FBLCK US Size 6,Default Ridgefield,122,122,0,0,0,0
,Teva Women Olowahu Flip Flops Felicitas Black 6840-FBLCK US Size 6,Teva Women Olowahu Flip Flops Felicitas Black 6840-FBLCK US Size 6,FBALYB Amazon,32,31,1,0,1,0
,Teva Women Olowahu Flip Flops Felicitas Black 6840-FBLCK US Size 7,Teva Women Olowahu Flip Flops Felicitas Black 6840-FBLCK US Size 7,Default Ridgefield,273,273,0,0,0,0
,Teva Women Olowahu Flip Flops Felicitas Black 6840-FBLCK US Size 7,Teva Women Olowahu Flip Flops Felicitas Black 6840-FBLCK US Size 7,FBALYB Amazon,39,38,1,0,1,0
,Teva Women Olowahu Flip Flops Felicitas Black 6840-FBLCK US Size 8,Teva Women Olowahu Flip Flops Felicitas Black 6840-FBLCK US Size 8,Default Ridgefield,444,444,0,0,0,0
,Teva Women Olowahu Flip Flops Felicitas Black 6840-FBLCK US Size 8,Teva Women Olowahu Flip Flops Felicitas Black 6840-FBLCK US Size 8,FBALYB Amazon,96,95,1,0,1,0
,Teva Women Olowahu Flip Flops Felicitas Black 6840-FBLCK US Size 9,Teva Women Olowahu Flip Flops Felicitas Black 6840-FBLCK US Size 9,Default Ridgefield,285,285,0,0,0,0
,Teva Women Olowahu Flip Flops Felicitas Black 6840-FBLCK US Size 9,Teva Women Olowahu Flip Flops Felicitas Black 6840-FBLCK US Size 9,FBALYB Amazon,95,92,3,0,3,0
,Teva Women Olowahu Sandals Antiguous Grey 6840-AGGR US Size 10,Teva Women Olowahu Sandals Antiguous Grey 6840-AGGR US Size 10,Default Ridgefield,50,50,0,0,0,0
,Teva Women Olowahu Sandals Antiguous Grey 6840-AGGR US Size 10,Teva Women Olowahu Sandals Antiguous Grey 6840-AGGR US Size 10,FBALYB Amazon,26,25,1,0,1,0
,Teva Women Olowahu Sandals Antiguous Grey 6840-AGGR US Size 11,Teva Women Olowahu Sandals Antiguous Grey 6840-AGGR US Size 11,Default Ridgefield,14,14,0,0,0,0
,Teva Women Olowahu Sandals Antiguous Grey 6840-AGGR US Size 11,Teva Women Olowahu Sandals Antiguous Grey 6840-AGGR US Size 11,FBALYB Amazon,29,28,1,0,1,0
,Teva Women Olowahu Sandals Antiguous Grey 6840-AGGR US Size 12,Teva Women Olowahu Sandals Antiguous Grey 6840-AGGR US Size 12,FBALYB Amazon,6,6,0,0,0,0
,Teva Women Olowahu Sandals Antiguous Grey 6840-AGGR US Size 5,Teva Women Olowahu Sandals Antiguous Grey 6840-AGGR US Size 5,Default Ridgefield,12,12,0,0,0,0
,Teva Women Olowahu Sandals Antiguous Grey 6840-AGGR US Size 5,Teva Women Olowahu Sandals Antiguous Grey 6840-AGGR US Size 5,FBALYB Amazon,-1,-1,0,0,0,0
,Teva Women Olowahu Sandals Antiguous Grey 6840-AGGR US Size 6,Teva Women Olowahu Sandals Antiguous Grey 6840-AGGR US Size 6,Default Ridgefield,54,54,0,0,0,0
,Teva Women Olowahu Sandals Antiguous Grey 6840-AGGR US Size 7,Teva Women Olowahu Sandals Antiguous Grey 6840-AGGR US Size 7,Default Ridgefield,101,101,0,0,0,0
,Teva Women Olowahu Sandals Antiguous Grey 6840-AGGR US Size 7,Teva Women Olowahu Sandals Antiguous Grey 6840-AGGR US Size 7,FBALYB Amazon,8,8,0,0,0,0
,Teva Women Olowahu Sandals Antiguous Grey 6840-AGGR US Size 8,Teva Women Olowahu Sandals Antiguous Grey 6840-AGGR US Size 8,Default Ridgefield,225,225,0,0,0,0
,Teva Women Olowahu Sandals Antiguous Grey 6840-AGGR US Size 9,Teva Women Olowahu Sandals Antiguous Grey 6840-AGGR US Size 9,Default Ridgefield,21,21,0,0,0,0
,Teva Women Olowahu Sandals Antiguous Grey 6840-AGGR US Size 9,Teva Women Olowahu Sandals Antiguous Grey 6840-AGGR US Size 9,FBALYB Amazon,68,68,0,0,0,0
,Teva Women's Mush Mandalyn Wedge Black 1000099-BLK US Size 10,Teva Women's Mush Mandalyn Wedge Black 1000099-BLK US Size 10,Default Ridgefield,265,265,0,0,0,0
,Teva Women's Mush Mandalyn Wedge Black 1000099-BLK US Size 10,Teva Women's Mush Mandalyn Wedge Black 1000099-BLK US Size 10,FBALYB Amazon,8,7,1,0,1,0
,Teva Women's Mush Mandalyn Wedge Black 1000099-BLK US Size 11,Teva Women's Mush Mandalyn Wedge Black 1000099-BLK US Size 11,FBALYB Amazon,2,2,0,0,0,0
,Teva Women's Mush Mandalyn Wedge Black 1000099-BLK US Size 12,Teva Women's Mush Mandalyn Wedge Black 1000099-BLK US Size 12,Default Ridgefield,4,4,0,0,0,0
,Teva Women's Mush Mandalyn Wedge Black 1000099-BLK US Size 12,Teva Women's Mush Mandalyn Wedge Black 1000099-BLK US Size 12,FBALYB Amazon,-2,-2,0,0,0,0
,Teva Women's Mush Mandalyn Wedge Black 1000099-BLK US Size 5,Teva Women's Mush Mandalyn Wedge Black 1000099-BLK US Size 5,Default Ridgefield,15,15,0,0,0,0
,Teva Women's Mush Mandalyn Wedge Black 1000099-BLK US Size 6,Teva Women's Mush Mandalyn Wedge Black 1000099-BLK US Size 6,Default Ridgefield,117,117,0,0,0,0
,Teva Women's Mush Mandalyn Wedge Black 1000099-BLK US Size 6,Teva Women's Mush Mandalyn Wedge Black 1000099-BLK US Size 6,FBALYB Amazon,9,9,0,0,0,0
,Teva Women's Mush Mandalyn Wedge Black 1000099-BLK US Size 7,Teva Women's Mush Mandalyn Wedge Black 1000099-BLK US Size 7,Default Ridgefield,339,339,0,0,0,0
,Teva Women's Mush Mandalyn Wedge Black 1000099-BLK US Size 7,Teva Women's Mush Mandalyn Wedge Black 1000099-BLK US Size 7,FBALYB Amazon,6,6,0,0,0,0
,Teva Women's Mush Mandalyn Wedge Black 1000099-BLK US Size 8,Teva Women's Mush Mandalyn Wedge Black 1000099-BLK US Size 8,Default Ridgefield,398,398,0,0,0,0
,Teva Women's Mush Mandalyn Wedge Black 1000099-BLK US Size 8,Teva Women's Mush Mandalyn Wedge Black 1000099-BLK US Size 8,FBALYB Amazon,56,55,1,43,1,0
,Teva Women's Mush Mandalyn Wedge Black 1000099-BLK US Size 9,Teva Women's Mush Mandalyn Wedge Black 1000099-BLK US Size 9,Default Ridgefield,263,263,0,0,0,0
,Teva Women's Mush Mandalyn Wedge Black 1000099-BLK US Size 9,Teva Women's Mush Mandalyn Wedge Black 1000099-BLK US Size 9,FBALYB Amazon,-1,-1,0,0,0,0
,TEVA Womens Tirra White/Black Sandal 4266-WBCK US Size 10,TEVA Womens Tirra White/Black Sandal 4266-WBCK US Size 10,Default Ridgefield,6,6,0,0,0,0
,TEVA Womens Tirra White/Black Sandal 4266-WBCK US Size 10,TEVA Womens Tirra White/Black Sandal 4266-WBCK US Size 10,FBALYB Amazon,6,6,0,0,0,0
,TEVA Womens Tirra White/Black Sandal 4266-WBCK US Size 11,TEVA Womens Tirra White/Black Sandal 4266-WBCK US Size 11,FBALYB Amazon,9,9,0,0,0,0
,TEVA Womens Tirra White/Black Sandal 4266-WBCK US Size 6,TEVA Womens Tirra White/Black Sandal 4266-WBCK US Size 6,FBALYB Amazon,9,9,0,0,0,0
,TEVA Womens Tirra White/Black Sandal 4266-WBCK US Size 6.5,TEVA Womens Tirra White/Black Sandal 4266-WBCK US Size 6.5,FBALYB Amazon,6,6,0,0,0,0
,TEVA Womens Tirra White/Black Sandal 4266-WBCK US Size 7,TEVA Womens Tirra White/Black Sandal 4266-WBCK US Size 7,Default Ridgefield,43,43,0,0,0,0
,TEVA Womens Tirra White/Black Sandal 4266-WBCK US Size 7.5,TEVA Womens Tirra White/Black Sandal 4266-WBCK US Size 7.5,Default Ridgefield,3,3,0,0,0,0
,TEVA Womens Tirra White/Black Sandal 4266-WBCK US Size 7.5,TEVA Womens Tirra White/Black Sandal 4266-WBCK US Size 7.5,FBALYB Amazon,10,10,0,0,0,0
,TEVA Womens Tirra White/Black Sandal 4266-WBCK US Size 8,TEVA Womens Tirra White/Black Sandal 4266-WBCK US Size 8,Default Ridgefield,31,31,0,0,0,0
,TEVA Womens Tirra White/Black Sandal 4266-WBCK US Size 8,TEVA Womens Tirra White/Black Sandal 4266-WBCK US Size 8,FBALYB Amazon,3,3,0,0,0,0
,TEVA Womens Tirra White/Black Sandal 4266-WBCK US Size 8.5,TEVA Womens Tirra White/Black Sandal 4266-WBCK US Size 8.5,Default Ridgefield,21,21,0,0,0,0
,TEVA Womens Tirra White/Black Sandal 4266-WBCK US Size 8.5,TEVA Womens Tirra White/Black Sandal 4266-WBCK US Size 8.5,FBALYB Amazon,5,5,0,0,0,0
,TEVA Womens Tirra White/Black Sandal 4266-WBCK US Size 9,TEVA Womens Tirra White/Black Sandal 4266-WBCK US Size 9,Default Ridgefield,23,23,0,0,0,0
,TEVA Womens Tirra White/Black Sandal 4266-WBCK US Size 9,TEVA Womens Tirra White/Black Sandal 4266-WBCK US Size 9,FBALYB Amazon,6,5,1,0,1,0
,TEVA Womens Tirra White/Black Sandal 4266-WBCK US Size 9.5,TEVA Womens Tirra White/Black Sandal 4266-WBCK US Size 9.5,Default Ridgefield,8,8,0,0,0,0
,TEVA Womens Tirra White/Black Sandal 4266-WBCK US Size 9.5,TEVA Womens Tirra White/Black Sandal 4266-WBCK US Size 9.5,FBALYB Amazon,8,8,0,0,0,0
,TEVA Womens Voya Strappy Hera Black Sandals 1099271-HBK US Size 10,TEVA Womens Voya Strappy Hera Black Sandals 1099271-HBK US Size 10,Default Ridgefield,126,126,0,0,0,0
,TEVA Womens Voya Strappy Hera Black Sandals 1099271-HBK US Size 11,TEVA Womens Voya Strappy Hera Black Sandals 1099271-HBK US Size 11,Default Ridgefield,31,31,0,0,0,0
,TEVA Womens Voya Strappy Hera Black Sandals 1099271-HBK US Size 5,TEVA Womens Voya Strappy Hera Black Sandals 1099271-HBK US Size 5,Default Ridgefield,25,25,0,0,0,0
,TEVA Womens Voya Strappy Hera Black Sandals 1099271-HBK US Size 6,TEVA Womens Voya Strappy Hera Black Sandals 1099271-HBK US Size 6,Default Ridgefield,89,89,0,0,0,0
,TEVA Womens Voya Strappy Hera Black Sandals 1099271-HBK US Size 7,TEVA Womens Voya Strappy Hera Black Sandals 1099271-HBK US Size 7,Default Ridgefield,141,141,0,0,0,0
,TEVA Womens Voya Strappy Hera Black Sandals 1099271-HBK US Size 8,TEVA Womens Voya Strappy Hera Black Sandals 1099271-HBK US Size 8,Default Ridgefield,319,319,0,0,0,0
,TEVA Womens Voya Strappy Hera Black Sandals 1099271-HBK US Size 9,TEVA Womens Voya Strappy Hera Black Sandals 1099271-HBK US Size 9,Default Ridgefield,91,91,0,0,0,0
,TEVA Womens Voya Strappy Hera Black Sandals 1099271-HBK US Size 9,TEVA Womens Voya Strappy Hera Black Sandals 1099271-HBK US Size 9,FBALYB Amazon,98,98,0,0,0,0
,Teva Women Voya Flip Doria Black 1019040-DBK US Size 10,Teva Women Voya Flip Doria Black 1019040-DBK US Size 10,Default Ridgefield,165,165,0,0,0,0
,Teva Women Voya Flip Doria Black 1019040-DBK US Size 10,Teva Women Voya Flip Doria Black 1019040-DBK US Size 10,FBALYB Amazon,28,28,0,0,0,0
,Teva Women Voya Flip Doria Black 1019040-DBK US Size 11,Teva Women Voya Flip Doria Black 1019040-DBK US Size 11,Default Ridgefield,90,90,0,0,0,0
,Teva Women Voya Flip Doria Black 1019040-DBK US Size 12,Teva Women Voya Flip Doria Black 1019040-DBK US Size 12,FBALYB Amazon,9,9,0,0,0,0
,Teva Women Voya Flip Doria Black 1019040-DBK US Size 5,Teva Women Voya Flip Doria Black 1019040-DBK US Size 5,FBALYB Amazon,24,24,0,0,0,0
,Teva Women Voya Flip Doria Black 1019040-DBK US Size 6,Teva Women Voya Flip Doria Black 1019040-DBK US Size 6,Default Ridgefield,32,32,0,0,0,0
,Teva Women Voya Flip Doria Black 1019040-DBK US Size 7,Teva Women Voya Flip Doria Black 1019040-DBK US Size 7,Default Ridgefield,122,122,0,0,0,0
,Teva Women Voya Flip Doria Black 1019040-DBK US Size 7,Teva Women Voya Flip Doria Black 1019040-DBK US Size 7,FBALYB Amazon,22,22,0,0,0,0
,Teva Women Voya Flip Doria Black 1019040-DBK US Size 8,Teva Women Voya Flip Doria Black 1019040-DBK US Size 8,Default Ridgefield,293,293,0,0,0,0
,Teva Women Voya Flip Doria Black 1019040-DBK US Size 8,Teva Women Voya Flip Doria Black 1019040-DBK US Size 8,FBALYB Amazon,24,24,0,0,0,0
,Teva Women Voya Flip Doria Black 1019040-DBK US Size 9,Teva Women Voya Flip Doria Black 1019040-DBK US Size 9,Default Ridgefield,236,236,0,0,0,0
,Teva Women Voya Flip Doria Black 1019040-DBK US Size 9,Teva Women Voya Flip Doria Black 1019040-DBK US Size 9,FBALYB Amazon,23,23,0,0,0,0
,Teva Women Voya Flip Flop Bar Street Multi Blue 1019040-BSMB US Size 10,Teva Women Voya Flip Flop Bar Street Multi Blue 1019040-BSMB US Size 10,Default Ridgefield,99,99,0,0,0,0
,Teva Women Voya Flip Flop Bar Street Multi Blue 1019040-BSMB US Size 10,Teva Women Voya Flip Flop Bar Street Multi Blue 1019040-BSMB US Size 10,FBALYB Amazon,10,10,0,0,0,0
,Teva Women Voya Flip Flop Bar Street Multi Blue 1019040-BSMB US Size 11,Teva Women Voya Flip Flop Bar Street Multi Blue 1019040-BSMB US Size 11,Default Ridgefield,30,30,0,0,0,0
,Teva Women Voya Flip Flop Bar Street Multi Blue 1019040-BSMB US Size 11,Teva Women Voya Flip Flop Bar Street Multi Blue 1019040-BSMB US Size 11,FBALYB Amazon,22,22,0,0,0,0
,Teva Women Voya Flip Flop Bar Street Multi Blue 1019040-BSMB US Size 5,Teva Women Voya Flip Flop Bar Street Multi Blue 1019040-BSMB US Size 5,Default Ridgefield,15,15,0,0,0,0
,Teva Women Voya Flip Flop Bar Street Multi Blue 1019040-BSMB US Size 6,Teva Women Voya Flip Flop Bar Street Multi Blue 1019040-BSMB US Size 6,Default Ridgefield,20,20,0,0,0,0
,Teva Women Voya Flip Flop Bar Street Multi Blue 1019040-BSMB US Size 7,Teva Women Voya Flip Flop Bar Street Multi Blue 1019040-BSMB US Size 7,Default Ridgefield,67,67,0,0,0,0
,Teva Women Voya Flip Flop Bar Street Multi Blue 1019040-BSMB US Size 7,Teva Women Voya Flip Flop Bar Street Multi Blue 1019040-BSMB US Size 7,FBALYB Amazon,18,18,0,0,0,0
,Teva Women Voya Flip Flop Bar Street Multi Blue 1019040-BSMB US Size 8,Teva Women Voya Flip Flop Bar Street Multi Blue 1019040-BSMB US Size 8,Default Ridgefield,173,173,0,0,0,0
,Teva Women Voya Flip Flop Bar Street Multi Blue 1019040-BSMB US Size 8,Teva Women Voya Flip Flop Bar Street Multi Blue 1019040-BSMB US Size 8,FBALYB Amazon,-1,-1,0,0,0,0
,Teva Women Voya Flip Flop Bar Street Multi Blue 1019040-BSMB US Size 9,Teva Women Voya Flip Flop Bar Street Multi Blue 1019040-BSMB US Size 9,Default Ridgefield,134,134,0,0,0,0
,Teva Women Voya Flip Flop Bar Street Multi Blue 1019040-BSMB US Size 9,Teva Women Voya Flip Flop Bar Street Multi Blue 1019040-BSMB US Size 9,FBALYB Amazon,0,-1,1,0,1,0
,TGSC Epsom Salt Soap 4.25 oz Bar 3 pack,TGSC Epsom Salt Soap 4.25 oz Bar 3 pack,FBALYB Amazon,74,73,1,0,1,0
,TGSC Soap Bar Oatmeal 4.25oz 3 Pack,TGSC Soap Bar Oatmeal 4.25oz 3 Pack,FBALYB Amazon,173,171,2,0,2,0
,THAYER Witch Hazel Alcohol-Free Toner Rose Petal,THAYER Witch Hazel Alcohol-Free Toner Rose Petal,Default Ridgefield,9,9,0,0,0,0
,THAYER Witch Hazel Alcohol-Free Toner Rose Petal 2 PACK,THAYER Witch Hazel Alcohol-Free Toner Rose Petal 2 PACK,FBALYB Amazon,478,408,70,0,70,0
,THAYER Witch Hazel Alcohol-Free Toner Rose Petal 2 PACK,THAYER Witch Hazel Alcohol-Free Toner Rose Petal 2 PACK,FBALYB Canada,20,20,0,0,0,0
,THAYER Witch Hazel Alcohol-Free Toner Rose Petal 3pk,THAYER Witch Hazel Alcohol-Free Toner Rose Petal 3pk,FBALYB Amazon,90,89,1,0,1,0
,THAYER Witch Hazel Cucumber Aloe,THAYER Witch Hazel Cucumber Aloe,Default Ridgefield,2,2,0,0,0,0
,THAYER Witch Hazel Cucumber Aloe 2pk,THAYER Witch Hazel Cucumber Aloe 2pk,FBALYB Amazon,1,0,1,0,1,0
,THAYER Witch Hazel Facial Mist Cucumber,THAYER Witch Hazel Facial Mist Cucumber,FBALYB Amazon,6,2,4,0,4,0
,THAYER Witch Hazel Facial Mist Rose Petal,THAYER Witch Hazel Facial Mist Rose Petal,Default Ridgefield,174,174,0,0,0,0
,THAYER Witch Hazel Facial Mist Rose Petal,THAYER Witch Hazel Facial Mist Rose Petal,FBALYB Amazon,12,-3,15,0,15,0
,THAYER Witch Hazel Facial Mist Rose Petal,THAYER Witch Hazel Facial Mist Rose Petal,FBALYB Canada,-1,-1,0,39,0,0
,THAYER Witch Hazel Facial Toner Mist Lavender,THAYER Witch Hazel Facial Toner Mist Lavender,Default Ridgefield,39,39,0,0,0,0
,THAYER Witch Hazel Facial Toner Mist Lavender,THAYER Witch Hazel Facial Toner Mist Lavender,FBALYB Amazon,7,0,7,1,7,0
,THAYER Witch Hazel Lavender 2pk,THAYER Witch Hazel Lavender 2pk,FBALYB Amazon,2,-1,3,0,3,0
,THAYER Witch Hazel Spray Deodorant Rose Petal,THAYER Witch Hazel Spray Deodorant Rose Petal,Default Ridgefield,5,5,0,0,0,0
,THAYER Witch Hazel Spray Deodorant Rose Petal,THAYER Witch Hazel Spray Deodorant Rose Petal,FBALYB Amazon,56,53,3,0,3,0
,THAYER Witch Hazel Toning Towelettes Rose Petal,THAYER Witch Hazel Toning Towelettes Rose Petal,FBALYB Amazon,3,-15,18,0,18,0
,THAYER Witch Hazel Unscented Aloe,THAYER Witch Hazel Unscented Aloe,Default Ridgefield,44,44,0,0,0,0
,THAYER Witch Hazel Unscented Aloe 2pk,THAYER Witch Hazel Unscented Aloe 2pk,FBALYB Amazon,189,187,2,1,2,0
,THAYER Witch Hazel Unscented Aloe 3pk,THAYER Witch Hazel Unscented Aloe 3pk,FBALYB Amazon,21,10,11,2,11,0
,The Good Bean Chickpeas 2pk,The Good Bean Chickpeas 2pk,FBALYB Amazon,1,1,0,0,0,0
,The Healthy Deodorant Elements - Vanilla + Earth 2oz,The Healthy Deodorant Elements - Vanilla + Earth 2oz,FBALYB Amazon,-1,-1,0,0,0,0
,The Healthy Deodorant Elements - Vanilla + Water 2oz,The Healthy Deodorant Elements - Vanilla + Water 2oz,FBALYB Amazon,-3,-3,0,0,0,0
,The Healthy Deodorant Pure Vanilla 2oz,The Healthy Deodorant Pure Vanilla 2oz,Default,0,-60,60,0,0,0
,The Healthy Deodorant Pure Vanilla 2oz,The Healthy Deodorant Pure Vanilla 2oz,FBALYB Amazon,1,1,0,1,0,0
,The Healthy Deodorant Sport Luxe 2.2oz,The Healthy Deodorant Sport Luxe 2.2oz,FBALYB Amazon,2,2,0,0,0,0
,The Healthy Deodorant Sport Luxe Mini .9oz,The Healthy Deodorant Sport Luxe Mini .9oz,FBALYB Amazon,-1,-1,0,0,0,0
,The Healthy Deodorant Vanilla Coconut 2oz,The Healthy Deodorant Vanilla Coconut 2oz,Default,0,-240,240,0,0,0
,The Healthy Deodorant Vanilla Lavender 2oz,The Healthy Deodorant Vanilla Lavender 2oz,Default,0,-368,368,0,0,0
,The Healthy Fragrance Pure Vanilla 1.7oz,The Healthy Fragrance Pure Vanilla 1.7oz,FBALYB Amazon,-1,-1,0,0,0,0
,The Honest Company Shampoo,The Honest Company Shampoo,FBASKCK Amazon,166,166,0,0,0,0
,The Honest Company Shampoo 2ct,The Honest Company Shampoo 2ct,Default,0,0,0,0,0,17
,The Honest Company Shampoo 2ct,The Honest Company Shampoo 2ct,FBASKCK Amazon,152,152,0,0,0,0
,The Jar Seed Sprouter 1 qt Growin Cap,The Jar Seed Sprouter 1 qt Growin Cap,Default Ridgefield,50,50,0,0,0,0
,The Keg Steak Seasoning 1.1kg,The Keg Steak Seasoning 1.1kg,FBALYB Amazon,1,1,0,0,0,0
,The Lies That Bind - by Emily Giffin,The Lies That Bind - by Emily Giffin,Default Ridgefield,12,12,0,0,0,0
,The North Face ThermoBall Jacket Dark Grey Large T9382CQ2T,The North Face ThermoBall Jacket Dark Grey Large T9382CQ2T,FBALYB Amazon,-6,-6,0,0,0,0
,The North Face ThermoBall Jacket Light Grey Large T9382CXZD,The North Face ThermoBall Jacket Light Grey Large T9382CXZD,FBALYB Amazon,-4,-4,0,0,0,0
,The North Face ThermoBall Jacket Light Grey Medium T9382CXZD,The North Face ThermoBall Jacket Light Grey Medium T9382CXZD,FBALYB Amazon,-5,-5,0,0,0,0
,The North Face ThermoBall Jacket Light Grey XL T9382CXZD,The North Face ThermoBall Jacket Light Grey XL T9382CXZD,FBALYB Amazon,-2,-2,0,0,0,0
,The North Face ThermoBall Jacket Sequoia Red Extra Large,The North Face ThermoBall Jacket Sequoia Red Extra Large,Default Ridgefield,1,1,0,0,0,0
,The North Face ThermoBall Jacket Sequoia Red Large T9382CQ2T,The North Face ThermoBall Jacket Sequoia Red Large T9382CQ2T,Default Ridgefield,11,11,0,0,0,0
,The North Face ThermoBall Jacket Women Amparo Blue T0CUC6NXD  Medium,The North Face ThermoBall Jacket Women Amparo Blue T0CUC6NXD  Medium,Default Ridgefield,11,11,0,0,0,0
,The North Face ThermoBall Jacket Women Amparo Blue T0CUC6NXD Small,The North Face ThermoBall Jacket Women Amparo Blue T0CUC6NXD Small,Default Ridgefield,8,8,0,0,0,0
,The North Face ThermoBall Jacket Women Black T0CUC6JK3 Medium,The North Face ThermoBall Jacket Women Black T0CUC6JK3 Medium,FBALYB Amazon,21,21,0,0,0,0
,The North Face ThermoBall Jacket Women Metallic Silver T0CUC6NU6 Extra Large,The North Face ThermoBall Jacket Women Metallic Silver T0CUC6NU6 Extra Large,Default Ridgefield,3,3,0,0,0,0
,The North Face ThermoBall Jacket Women Metallic Silver T0CUC6NU6 Medium,The North Face ThermoBall Jacket Women Metallic Silver T0CUC6NU6 Medium,Default Ridgefield,40,40,0,0,0,0
,The North Face ThermoBall Jacket Women Metallic Silver T0CUC6NU6 Small,The North Face ThermoBall Jacket Women Metallic Silver T0CUC6NU6 Small,Default Ridgefield,7,7,0,0,0,0
,"ThermaCare HeatWraps, 11 ct.","ThermaCare HeatWraps, 11 ct.",FBALYB Amazon,106,106,0,0,0,0
,Thermoflask 2 pack Blue / Gray,Thermoflask 2 pack Blue / Gray,FBALYB Amazon,-1,-1,0,1,0,0
,ThinAddictives Pistachio Almond,ThinAddictives Pistachio Almond,FBALYB Amazon,2,2,0,0,0,0
,Thomas & Friends: DieselTrackMaster Glow In The Dark Engine-FBY82,Thomas & Friends: DieselTrackMaster Glow In The Dark Engine-FBY82,Default Ridgefield,246,246,0,0,0,0
,Thomas & Friends: Edward TrackMaster Glow In The Dark Engine-FBY82,Thomas & Friends: Edward TrackMaster Glow In The Dark Engine-FBY82,Default Ridgefield,170,170,0,0,0,0
,Thomas & Friends Minis Mystery Engines-FCC92,Thomas & Friends Minis Mystery Engines-FCC92,Default,0,-1800,1800,0,0,0
,Thomas & Friends Minis Mystery Engines-FCC92,Thomas & Friends Minis Mystery Engines-FCC92,Default Oxford,2,2,0,0,0,0
,Thomas & Friends Minis Mystery Engines-FCC92,Thomas & Friends Minis Mystery Engines-FCC92,Default Ridgefield,1798,1798,0,0,0,0
,Thomas & Friends Minis Mystery Engines-FCC92 4PK,Thomas & Friends Minis Mystery Engines-FCC92 4PK,FBALYB Amazon,-5,-5,0,1,0,0
,Thomas & Friends Minis Mystery Engines-FCC92 6PK,Thomas & Friends Minis Mystery Engines-FCC92 6PK,FBALYB Amazon,-3,-3,0,0,0,0
,Thomas & Friends: Thomas TrackMaster Glow In The Dark Engine-FBY82,Thomas & Friends: Thomas TrackMaster Glow In The Dark Engine-FBY82,Default Ridgefield,501,501,0,0,0,0
,Thomas & Friends TrackMaster Glowing Mine Set-FBK52,Thomas & Friends TrackMaster Glowing Mine Set-FBK52,Default,3,3,0,0,0,0
,Thomas & Friends TrackMaster Glowing Mine Set-FBK52,Thomas & Friends TrackMaster Glowing Mine Set-FBK52,Default Ridgefield,2,2,0,0,0,0
,Thomas & Friends TrackMaster Glowing Mine Set-FBK52,Thomas & Friends TrackMaster Glowing Mine Set-FBK52,FBALYB Amazon,-7,-7,0,0,0,0
,Thomas & Friends TrackMaster Glow In The Dark Engine-FBY82,Thomas & Friends TrackMaster Glow In The Dark Engine-FBY82,Default Oxford,110,110,0,0,0,0
,"Thynk Green Palm Leaf 5.5"" Square Bowl 10ct","Thynk Green Palm Leaf 5.5"" Square Bowl 10ct",Default Ridgefield,1707,1707,0,0,0,0
,Ticonderoga 72 Pencils,Ticonderoga Sharpened 72 Pencils ,FBALYB Amazon,1,1,0,0,0,0
,Tide 120ct S. Meadow Pods,Tide 120ct S. Meadow Pods,Default,0,-100,100,0,0,0
,Tide 120ct S. Meadow Pods,Tide 120ct S. Meadow Pods,FBALYB Amazon,9,9,0,0,0,0
,Tide 150,Tide 150,Default,0,-452,452,0,0,0
,Tide 150,Tide 150,Default Ridgefield,112,112,0,0,0,0
,Tide 150,Tide 150,FBAAP Amazon,-96,-96,0,0,0,0
,Tide 150,Tide 150,FBALYB Amazon,-547,-547,0,754,0,0
,Tide Advance Power HE 170oz,Tide Advanced Power High Efficiency 170oz 81 Load (5.31QT),FBALYB Amazon,15,15,0,5,0,0
,Tide Coldwater 170oz,Tide Coldwater Clean 170oz 110 loads,FBALYB Amazon,2,2,0,0,0,0
,Tide Coldwater Clean 150oz,Tide Coldwater Clean 150oz,FBALYB Amazon,-5,-5,0,28,0,0
,Tide Coldwater Clean 165oz,Tide Coldwater Clean 165oz,Default Ridgefield,2167,2167,0,0,0,0
,Tide Coldwater Clean 165oz,Tide Coldwater Clean 165oz,FBALYB Amazon,617,602,15,160,15,0
,Tide Laundry Detergent (Advanced Power HE 170 Oz),Tide Laundry Detergent (Advanced Power HE 170 Oz),FBALYB Amazon,1,1,0,0,0,0
,Tide + Oxi 150oz,Tide + Oxi 150oz,Default,0,-1,1,0,0,0
,Tide + Oxi 150oz,Tide + Oxi 150oz,Default Ridgefield,12,12,0,0,0,0
,Tide + Oxi 150oz,Tide + Oxi 150oz,FBALYB Amazon,-360,-366,6,570,6,0
,Tide + Oxi 165 oz,Tide + Oxi 165 oz,Default Ridgefield,48,48,0,0,0,0
,Tide + Oxi 165 oz,Tide + Oxi 165 oz,FBALYB Amazon,118,114,4,74,4,0
,Tide Pods spring Meadow 120+12 ct,Tide Pods spring Meadow 120+12 ct,FBALYB Amazon,14,14,0,97,0,0
,"Tide Pods Spring Meadow Scent, 152 Loads","Tide Pods Spring Meadow Scent, 152 Loads",FBALYB Amazon,3,3,0,0,0,0
,Tide Pods with Downy 80ct,Tide Pods with Downy 80ct,FBALYB Amazon,0,-4,4,0,4,0
,Tide Turbo Clean 170oz,"Tide Detergent, HE Turbo Clean, Original ‑ 170 fl oz",FBALYB Amazon,38,38,0,0,0,0
,Tide Ultra Concentrated Original Detergent 165oz 131 Loads,Tide Ultra Concentrated Original Detergent 165oz 131 Loads,Default Ridgefield,-3,-3,0,0,0,0
,Tide Ultra Concentrated Original Detergent 165oz 131 Loads,Tide Ultra Concentrated Original Detergent 165oz 131 Loads,FBALYB Amazon,155,111,44,103,44,0
,Tide Ultra Concentrated Original Detergent 165oz 131 Loads,Tide Ultra Concentrated Original Detergent 165oz 131 Loads,FBALYB Canada,5,1,4,0,4,0
,Tigi - After Party 3.4 fl oz,Tigi - After Party 3.4 fl oz,Default Ridgefield,60,60,0,0,0,0
,Tigi - After Party 3.4 fl oz,Tigi - After Party 3.4 fl oz,FBALYB Amazon,1257,1231,26,22,26,0
,Tigi - After Party 3.4 fl oz,Tigi - After Party 3.4 fl oz,FBALYB Canada,0,0,0,165,0,0
,Tigi - After Party 3.4 fl oz,Tigi - After Party 3.4 fl oz,WFS,-296,-296,0,0,0,0
,Tigi - After Party 3.4 fl oz 2PK,Tigi - After Party 3.4 fl oz 2PK,FBALYB Amazon,188,184,4,0,4,0
,Tigi - After Party 3.4 fl oz 2PK,Tigi - After Party 3.4 fl oz 2PK,FBALYB Canada,7,7,0,0,0,0
,Tigi - After Party 3.4 fl oz 3PK,Tigi - After Party 3.4 fl oz 3PK,FBALYB Amazon,15,12,3,0,3,0
,Tigi After Party 3.4oz 2pack,Tigi After Party 3.4oz 2pack,FBALYB Amazon,1638,1587,51,238,51,0
,Tigi After Party 3.4oz 2pack,Tigi After Party 3.4oz 2pack,WFS,-237,-237,0,0,0,0
,Tigi - Beach Freak Detangler  Spray 3.4 fl oz 100 ml,Tigi - Beach Freak Detangler  Spray 3.4 fl oz 100 ml,FBALYB Amazon,3,3,0,0,0,0
,Tigi - Beach Me Wave Defining Gel  Mist 3.4 oz,Tigi - Beach Me Wave Defining Gel  Mist 3.4 oz,FBALYB Amazon,-1,-1,0,1,0,0
,Tigi - Beach Queen Salt Infused Texture Spray 3.4 oz,Tigi - Beach Queen Salt Infused Texture Spray 3.4 oz,Default Ridgefield,2,2,0,0,0,0
,Tigi - Beach Queen Salt Infused Texture Spray 3.4 oz,Tigi - Beach Queen Salt Infused Texture Spray 3.4 oz,FBALYB Amazon,68,67,1,14,1,0
,Tigi Beadhead Colour Goddess Conditioner 750ml,Tigi Beadhead Colour Goddess Conditioner 750ml,Default Ridgefield,241,241,0,0,0,0
,Tigi Beadhead Colour Goddess Conditioner 750ml,Tigi Beadhead Colour Goddess Conditioner 750ml,WFS,430,430,0,0,0,0
,Tigi Beadhead Colour Goddess Shampoo 750ml,Tigi Beadhead Colour Goddess Shampoo 750ml,Default Ridgefield,167,167,0,0,0,0
,Tigi Beadhead Colour Goddess Shampoo 750ml,Tigi Beadhead Colour Goddess Shampoo 750ml,WFS,430,430,0,0,0,0
,Tigi Beadhead Colour Goddess Shampoo & Tigi Beadhead Colour Goddess Conditioner 750ml DUO,Tigi Beadhead Colour Goddess Shampoo & Tigi Beadhead Colour Goddess Conditioner 750ml DUO,FBALYB Amazon,152,108,44,0,44,0
,Tigi Beadhead Colour Goddess Shampoo & Tigi Beadhead Colour Goddess Conditioner 750ml DUO,Tigi Beadhead Colour Goddess Shampoo & Tigi Beadhead Colour Goddess Conditioner 750ml DUO,FBALYB Canada,0,0,0,50,0,0
,Tigi Beadhead Colour Goddess Tween Conditioner,Tigi Beadhead Colour Goddess Tween Conditioner,FBALYB Amazon,-13,-13,0,13,0,0
,Tigi Beadhead Colour Goddess Tween Duo,Tigi Beadhead Colour Goddess Tween Duo,FBALYB Amazon,1413,1413,0,52,0,0
,Tigi Beadhead Colour Goddess Tween Duo,Tigi Beadhead Colour Goddess Tween Duo,WFS,-160,-160,0,0,0,0
,Tigi Beadhead Dumb Blond Conditioner 750ml,Tigi Beadhead Dumb Blond Conditioner 750ml,Default,0,-5994,5994,0,0,0
,Tigi Beadhead Dumb Blond Conditioner 750ml,Tigi Beadhead Dumb Blond Conditioner 750ml,Default Oxford,78,78,0,0,0,0
,Tigi Beadhead Dumb Blond Conditioner 750ml,Tigi Beadhead Dumb Blond Conditioner 750ml,Default Ridgefield,1615,1615,0,0,0,0
,Tigi Beadhead Dumb Blond Conditioner 750ml,Tigi Beadhead Dumb Blond Conditioner 750ml,FBALYB Amazon,54,53,1,0,1,0
,Tigi Beadhead Dumb Blond Shampoo 750ml,Tigi Beadhead Dumb Blond Shampoo 750ml,Default,0,-5994,5994,0,0,104
,Tigi Beadhead Dumb Blond Shampoo 750ml,Tigi Beadhead Dumb Blond Shampoo 750ml,Default Oxford,483,483,0,0,0,0
,Tigi Beadhead Dumb Blond Shampoo & Tigi Beadhead Dumb Blond Conditioner 750ml DUO,Tigi Beadhead Dumb Blond Shampoo & Tigi Beadhead Dumb Blond Conditioner 750ml DUO,FBALYB Amazon,1502,1462,40,20,40,0
,Tigi Beadhead Dumb Blond Shampoo & Tigi Beadhead Dumb Blond Conditioner 750ml DUO,Tigi Beadhead Dumb Blond Shampoo & Tigi Beadhead Dumb Blond Conditioner 750ml DUO,FBALYB Canada,8,7,1,0,1,0
,Tigi Beadhead Dumb Blond Tween Duo,Tigi Beadhead Dumb Blond Tween Duo,FBALYB Amazon,682,682,0,149,0,0
,Tigi Beadhead Loaded Conditioner 750ml,Tigi Beadhead Loaded Conditioner 750ml,Default,0,-672,672,0,0,0
,Tigi Beadhead Loaded Conditioner 750ml,Tigi Beadhead Loaded Conditioner 750ml,Default Ridgefield,11,-578,589,0,0,0
,Tigi Beadhead Loaded Shampoo 750ml,Tigi Beadhead Loaded Shampoo 750ml,Default,0,-672,672,0,0,0
,Tigi Beadhead Loaded Shampoo 750ml,Tigi Beadhead Loaded Shampoo 750ml,Default Ridgefield,18,-571,589,0,0,0
,Tigi Beadhead Loaded Shampoo & Tigi Beadhead Loaded Conditioner 750ml DUO,Tigi Beadhead Loaded Shampoo & Tigi Beadhead Loaded Conditioner 750ml DUO,FBALYB Amazon,128,108,20,6,20,0
,Tigi Beadhead Loaded Tween Duo,Tigi Beadhead Loaded Tween Duo,FBALYB Amazon,89,89,0,1,0,0
,Tigi Beadhead Recharge Conditioner 750ml,Tigi Beadhead Recharge Conditioner 750ml,Default Ridgefield,7,7,0,0,0,0
,Tigi Beadhead Recharge Shampoo & Tigi Beadhead Recharge Conditioner 750ml DUO,Tigi Beadhead Recharge Shampoo & Tigi Beadhead Recharge Conditioner 750ml DUO,FBALYB Amazon,632,630,2,0,2,0
,Tigi Beadhead Recharge Tween Duo,Tigi Beadhead Recharge Tween Duo,FBALYB Amazon,0,0,0,6,0,0
,Tigi Beadhead Recovery Conditioner 750ml,Tigi Beadhead Recovery Conditioner 750ml,Avrami - Ebay,628,628,0,0,0,0
,Tigi Beadhead Recovery Conditioner 750ml,Tigi Beadhead Recovery Conditioner 750ml,Default Ridgefield,213,213,0,0,0,0
,Tigi Beadhead Recovery Conditioner 750ml,Tigi Beadhead Recovery Conditioner 750ml,FBALYB Amazon,149,132,17,0,17,0
,Tigi Beadhead Recovery Conditioner 750ml,Tigi Beadhead Recovery Conditioner 750ml,WFS,807,807,0,0,0,0
,Tigi Beadhead Recovery Conditioner 750ml 2 pack,Tigi Beadhead Recovery Conditioner 750ml 2 pack,FBALYB Amazon,119,117,2,0,2,0
,Tigi Beadhead Recovery Shampoo 750ml,Tigi Beadhead Recovery Shampoo 750ml,Avrami - Ebay,628,628,0,0,0,0
,Tigi Beadhead Recovery Shampoo 750ml,Tigi Beadhead Recovery Shampoo 750ml,Default,0,0,0,0,0,18
,Tigi Beadhead Recovery Shampoo 750ml,Tigi Beadhead Recovery Shampoo 750ml,Default Oxford,5,5,0,0,0,0
,Tigi Beadhead Recovery Shampoo 750ml,Tigi Beadhead Recovery Shampoo 750ml,FBALYB Amazon,27,25,2,0,2,0
,Tigi Beadhead Recovery Shampoo 750ml,Tigi Beadhead Recovery Shampoo 750ml,WFS,807,807,0,0,0,0
,Tigi Beadhead Recovery Shampoo 750ml 2 pack,Tigi Beadhead Recovery Shampoo 750ml 2 pack,FBALYB Amazon,100,95,5,0,5,0
,Tigi Beadhead Recovery Shampoo & Tigi Beadhead Recovery Conditioner 750ml DUO,Tigi Beadhead Recovery Shampoo & Tigi Beadhead Recovery Conditioner 750ml DUO,FBALYB Amazon,-1026,-1105,79,0,79,0
,Tigi Beadhead Recovery Tween Duo,Tigi Beadhead Recovery Tween Duo,Default,0,-24,24,0,0,0
,Tigi Beadhead Recovery Tween Duo,Tigi Beadhead Recovery Tween Duo,Default Ridgefield,10,-936,946,0,0,0
,Tigi Beadhead Recovery Tween Duo,Tigi Beadhead Recovery Tween Duo,FBALYB Amazon,1760,1760,0,61,0,0
,Tigi Beadhead Recovery Tween Duo,Tigi Beadhead Recovery Tween Duo,WFS,-1035,-1035,0,0,0,0
,Tigi Beadhead Recovery Tween Duo with Pump,Tigi Beadhead Recovery Tween Duo with Pump,FBALYB Amazon,86,86,0,3,0,0
,Tigi Beadhead Re-Energize Conditioner 750ml,Tigi Beadhead Re-Energize Conditioner 750ml,Default Ridgefield,103,103,0,0,0,0
,Tigi Beadhead Re-Energize Shampoo 750ml,Tigi Beadhead Re-Energize Shampoo 750ml,Default Ridgefield,122,122,0,0,0,0
,Tigi Beadhead Re-Energize Shampoo 750ml,Tigi Beadhead Re-Energize Shampoo 750ml,FBALYB Amazon,2,1,1,0,1,0
,Tigi Beadhead Re-Energize Shampoo & Tigi Beadhead Re-Energize Conditioner 750ml DUO,Tigi Beadhead Re-Energize Shampoo & Tigi Beadhead Re-Energize Conditioner 750ml DUO,FBALYB Amazon,609,536,73,2,73,0
,Tigi Beadhead Re-Energize Shampoo & Tigi Beadhead Re-Energize Conditioner 750ml DUO,Tigi Beadhead Re-Energize Shampoo & Tigi Beadhead Re-Energize Conditioner 750ml DUO,FBALYB Canada,0,0,0,50,0,0
,Tigi Beadhead Re-Energize Tween Duo,Tigi Beadhead Re-Energize Tween Duo,FBALYB Amazon,264,264,0,200,0,0
,Tigi Beadhead Re-Energize Tween Duo,Tigi Beadhead Re-Energize Tween Duo,WFS,-83,-83,0,0,0,0
,Tigi Beadhead Re-Energize Tween Duo With Pump,Tigi Beadhead Re-Energize Tween Duo With Pump,FBALYB Amazon,304,304,0,1,0,0
,Tigi Beadhead Resurrection Conditioner 750ml,Tigi Beadhead Resurrection Conditioner 750ml,Avrami - Ebay,816,816,0,0,0,0
,Tigi Beadhead Resurrection Conditioner 750ml,Tigi Beadhead Resurrection Conditioner 750ml,Default Ridgefield,2237,2237,0,0,0,0
,Tigi Beadhead Resurrection Conditioner 750ml,Tigi Beadhead Resurrection Conditioner 750ml,FBALYB Canada,0,0,0,50,0,0
,Tigi Beadhead Resurrection Conditioner 750ml 3PK,Tigi Beadhead Resurrection Conditioner 750ml 3PK,FBALYB Amazon,5,5,0,0,0,0
,Tigi Beadhead Resurrection Shampoo 750ml,Tigi Beadhead Resurrection Shampoo 750ml,Avrami - Ebay,816,816,0,0,0,0
,Tigi Beadhead Resurrection Shampoo 750ml,Tigi Beadhead Resurrection Shampoo 750ml,Default Oxford,144,144,0,0,0,0
,Tigi Beadhead Resurrection Shampoo 750ml,Tigi Beadhead Resurrection Shampoo 750ml,Default Ridgefield,2199,2199,0,0,0,0
,Tigi Beadhead Resurrection Shampoo 750ml,Tigi Beadhead Resurrection Shampoo 750ml,FBALYB Amazon,8,8,0,0,0,0
,Tigi Beadhead Resurrection Shampoo & Tigi Beadhead Resurrection Conditioner 750ml DUO,Tigi Beadhead Resurrection Shampoo & Tigi Beadhead Resurrection Conditioner 750ml DUO,FBALYB Amazon,1262,1087,175,459,175,0
,Tigi Beadhead Resurrection Shampoo & Tigi Beadhead Resurrection Conditioner 750ml DUO,Tigi Beadhead Resurrection Shampoo & Tigi Beadhead Resurrection Conditioner 750ml DUO,FBALYB Canada,2,2,0,96,0,0
,Tigi Beadhead Resurrection Tween Duo,Tigi Beadhead Resurrection Tween Duo,Default,0,-54,54,0,0,0
,Tigi Beadhead Resurrection Tween Duo,Tigi Beadhead Resurrection Tween Duo,FBALYB Amazon,633,633,0,613,0,0
,Tigi Beadhead Resurrection Tween Duo,Tigi Beadhead Resurrection Tween Duo,WFS,-106,-106,0,0,0,0
,Tigi Bed Head Clean Up Daily Shampoo 8.45 Oz,Tigi Bed Head Clean Up Daily Shampoo 8.45 Oz,Default Ridgefield,18,18,0,0,0,0
,Tigi Bed Head Clean Up Daily Shampoo 8.45 Oz,Tigi Bed Head Clean Up Daily Shampoo 8.45 Oz,FBALYB Amazon,198,198,0,0,0,0
,TIGI Bed Head Clean Up For Men Shampoo & Conditioner 750ml DUO,TIGI Bed Head Clean Up For Men Shampoo & Conditioner 750ml DUO,FBALYB Amazon,860,841,19,1,19,0
,TIGI Bed Head Clean Up For Men Shampoo & Conditioner 750ml DUO,TIGI Bed Head Clean Up For Men Shampoo & Conditioner 750ml DUO,FBALYB Canada,0,0,0,50,0,0
,TIGI Bed Head Control Freak Serum 2pk,TIGI Bed Head Control Freak Serum 2pk,FBALYB Amazon,136,136,0,102,0,0
,TIGI Bed Head Control Freak Serum 8.45 Ounce,TIGI Bed Head Control Freak Serum 8.45 Ounce ,Default,0,-66,66,0,0,83
,TIGI Bed Head Control Freak Serum 8.45 Ounce,TIGI Bed Head Control Freak Serum 8.45 Ounce ,Default Ridgefield,6,6,0,0,0,0
,TIGI Bed Head Control Freak Serum 8.45 Ounce,TIGI Bed Head Control Freak Serum 8.45 Ounce ,FBALYB Amazon,-3,-8,5,51,5,0
,TIGI BedHead Dumb Blonde Purple Toning Shampoo,TIGI BedHead Dumb Blonde Purple Toning Shampoo,Default,0,-6,6,0,0,0
,TIGI BedHead Dumb Blonde Purple Toning Shampoo,TIGI BedHead Dumb Blonde Purple Toning Shampoo,Default Ridgefield,1737,1737,0,0,0,0
,TIGI BedHead Dumb Blonde Purple Toning Shampoo,TIGI BedHead Dumb Blonde Purple Toning Shampoo,FBALYB Amazon,249,249,0,25,0,0
,TIGI BedHead Dumb Blonde Purple Toning Shampoo,TIGI BedHead Dumb Blonde Purple Toning Shampoo,FBALYB Canada,30,30,0,0,0,0
,Tigi Bed Head Dumb Blonde Smoothing Stuff 50ml/1.69oz,Tigi Bed Head Dumb Blonde Smoothing Stuff 50ml/1.69oz,Default Ridgefield,120,120,0,0,0,0
,Tigi Bed Head Dumb Blonde Smoothing Stuff 50ml/1.69oz,Tigi Bed Head Dumb Blonde Smoothing Stuff 50ml/1.69oz,FBALYB Amazon,56,55,1,0,1,0
,Tigi Bed Head Dumb Blonde Smoothing Stuff 50ml/1.69oz,Tigi Bed Head Dumb Blonde Smoothing Stuff 50ml/1.69oz,WFS,-11,-11,0,0,0,0
,TIGI Bed Head For Men Clean Up Tween Duo,TIGI Bed Head For Men Clean Up Tween Duo,Default,0,-2,2,0,0,0
,TIGI Bed Head For Men Clean Up Tween Duo,TIGI Bed Head For Men Clean Up Tween Duo,FBALYB Amazon,291,291,0,311,0,0
,TIGI Bed Head For Men Clean Up Tween Duo,TIGI Bed Head For Men Clean Up Tween Duo,WFS,-23,-23,0,0,0,0
,Tigi Bed Head For Men Matte Seperation Wax - 3 oz jar,Tigi Bed Head For Men Matte Seperation Wax - 3 oz jar,Avrami - Ebay,60,60,0,0,0,0
,Tigi Bed Head For Men Matte Seperation Wax - 3 oz jar,Tigi Bed Head For Men Matte Seperation Wax - 3 oz jar,Default,0,-2524,2524,0,0,0
,Tigi Bed Head For Men Matte Seperation Wax - 3 oz jar,Tigi Bed Head For Men Matte Seperation Wax - 3 oz jar,Default Ridgefield,129,129,0,0,0,0
,Tigi Bed Head For Men Matte Seperation Wax - 3 oz jar,Tigi Bed Head For Men Matte Seperation Wax - 3 oz jar,FBALYB Amazon,-50,-77,27,185,27,0
,Tigi Bed Head For Men Matte Seperation Wax - 3 oz jar 2 PK,Tigi Bed Head For Men Matte Seperation Wax - 3 oz jar 2 PK,FBALYB Amazon,533,487,46,9,46,0
,TIGI Bed Head for Men Power Play Firm Finish Gel 6.8oz,TIGI Bed Head for Men Power Play Firm Finish Gel 6.8oz,Default Ridgefield,6,6,0,0,0,0
,TIGI Bed Head for Men Power Play Firm Finish Gel 6.8oz,TIGI Bed Head for Men Power Play Firm Finish Gel 6.8oz,FBALYB Amazon,250,190,60,0,60,0
,TIGI Bed Head for Men Power Play Firm Finish Gel 6.8oz 2pk,TIGI Bed Head for Men Power Play Firm Finish Gel 6.8oz 2pk,FBALYB Amazon,247,240,7,0,7,0
,TIGI Bed Head for Men Power Play Gel 2pk,TIGI Bed Head for Men Power Play Gel 2pk,FBALYB Amazon,0,-1,1,2,1,0
,"Tigi Bed Head Hair Stick, 2.7 Ounce 2pk","Tigi Bed Head Hair Stick, 2.7 Ounce 2pk",FBALYB Amazon,457,440,17,3,17,0
,"Tigi Bed Head Hair Stick, 2.7 Ounce 2pk","Tigi Bed Head Hair Stick, 2.7 Ounce 2pk",FBALYB Canada,0,0,0,50,0,0
,Tigi Bedhead Hard Head Hairspray 6Pack,Tigi Bedhead Hard Head Hairspray 6Pack,FBALYB Amazon,62,61,1,10,1,0
,Tigi Bed Head Hard Head Spray 2pk,Tigi Bed Head Hard Head Spray 2pk,FBALYB Amazon,4247,4188,59,204,59,0
,"Tigi Bed Head Hard To Get Paste, 1.5 Ounce","Tigi Bed Head Hard To Get Paste, 1.5 Ounce ",Default Ridgefield,1025,1025,0,0,0,0
,"Tigi Bed Head Hard To Get Paste, 1.5 Ounce","Tigi Bed Head Hard To Get Paste, 1.5 Ounce ",FBALYB Amazon,368,346,22,67,22,0
,TIGI Bed Head Hard to Get Paste 2pk,TIGI Bed Head Hard to Get Paste 2pk,FBALYB Amazon,444,431,13,0,13,0
,"TIGI Bed Head Headrush Spray, 5.3 Ounce","TIGI Bed Head Headrush Spray, 5.3 Ounce",Default Ridgefield,134,134,0,0,0,0
,"TIGI Bed Head Headrush Spray, 5.3 Ounce","TIGI Bed Head Headrush Spray, 5.3 Ounce",FBALYB Amazon,147,122,25,1,25,0
,"TIGI Bed Head Headrush Spray, 5.3 Ounce","TIGI Bed Head Headrush Spray, 5.3 Ounce",FBALYB Canada,6,6,0,0,0,0
,"TIGI Bed Head Headrush Spray, 5.3 Ounce 2PK","TIGI Bed Head Headrush Spray, 5.3 Ounce 2PK",FBALYB Amazon,231,213,18,0,18,0
,"TIGI Bed Head Headrush Spray, 5.3 Ounce 3 PK","TIGI Bed Head Headrush Spray, 5.3 Ounce 3 PK",FBALYB Amazon,-2,-2,0,0,0,0
,Tigi Bed Head Masterpiece 5pack Spray,Tigi Bed Head Masterpiece 5pack Spray,Default Ridgefield,1,0,1,0,0,0
,Tigi Bed Head Masterpiece 5pack Spray,Tigi Bed Head Masterpiece 5pack Spray,FBALYB Amazon,175,162,13,2,13,0
,Tigi Bed Head Masterpiece 9.5oz 2pk,Tigi Bed Head Masterpiece 9.5oz 2pk,FBALYB Amazon,616,472,144,111,144,0
,Tigi Bed Head Masterpiece 9.5oz 6pack,Tigi Bed Head Masterpiece 9.5oz 6pack,FBALYB Amazon,178,168,10,57,10,0
,Tigi Bed Head Motor Mouth 8 Oz,Tigi Bed Head Motor Mouth 8 Oz,Default Ridgefield,3,3,0,0,0,0
,Tigi Bed Head Motor Mouth 8 Oz,Tigi Bed Head Motor Mouth 8 Oz,FBALYB Amazon,106,103,3,1,3,0
,Tigi Bed Head Motor Mouth 8 Oz,Tigi Bed Head Motor Mouth 8 Oz,FBALYB Canada,0,0,0,50,0,0
,TIGI Bed Head Motor Mouth Volumizer 3pk,TIGI Bed Head Motor Mouth Volumizer 3pk,FBALYB Amazon,41,40,1,0,1,0
,Tigi Bed Head Straighten Out Cream 4oz,Tigi Bed Head Straighten Out Cream 4oz,Default Ridgefield,192,192,0,0,0,0
,TIGI Bedhead Superstar Queen 2pk,TIGI Bedhead Superstar Queen 2pk,FBALYB Amazon,0,0,0,10,0,0
,TIGI Bed Head Superstar Queen 311ML,TIGI Bed Head Superstar Queen 311ML,Default,0,-888,888,0,0,0
,TIGI Bed Head Superstar Queen 311ML,TIGI Bed Head Superstar Queen 311ML,Default Ridgefield,614,614,0,0,0,0
,TIGI Bed Head Superstar Queen 311ML,TIGI Bed Head Superstar Queen 311ML,FBALYB Amazon,8,8,0,0,0,0
,Tigi BH4M PRESS UP BODY BUILDING FOAM 4.22 US FL  OZ/125ML,Tigi BH4M PRESS UP BODY BUILDING FOAM 4.22 US FL  OZ/125ML,Default Ridgefield,192,192,0,0,0,0
,TIGI Big Head Volume Boost Foam 4.4oz,TIGI Big Head Volume Boost Foam 4.4oz,FBALYB Amazon,-2,-2,0,0,0,0
,TIGI Catwalk 5.07-ounce Curls Rock Amplifier,TIGI Catwalk 5.07-ounce Curls Rock Amplifier ,Avrami - Ebay,91,91,0,0,0,0
,TIGI Catwalk 5.07-ounce Curls Rock Amplifier,TIGI Catwalk 5.07-ounce Curls Rock Amplifier ,Default,0,-5402,5402,0,0,15
,TIGI Catwalk 5.07-ounce Curls Rock Amplifier,TIGI Catwalk 5.07-ounce Curls Rock Amplifier ,Default Ridgefield,10622,10622,0,0,0,0
,TIGI Catwalk 5.07-ounce Curls Rock Amplifier,TIGI Catwalk 5.07-ounce Curls Rock Amplifier ,FBALYB Amazon,2044,1981,63,60,63,0
,TIGI Catwalk 5.07-ounce Curls Rock Amplifier,TIGI Catwalk 5.07-ounce Curls Rock Amplifier ,FBALYB Canada,0,0,0,50,0,0
,TIGI Catwalk 5.07-ounce Curls Rock Amplifier,TIGI Catwalk 5.07-ounce Curls Rock Amplifier ,WFS,-2,-2,0,0,0,0
,"TIGI Catwalk Blow Out Balm for Smoothness and Shine, 3.04 Ounce","TIGI Catwalk Blow Out Balm for Smoothness and Shine, 3.04 Ounce",Default Ridgefield,720,720,0,0,0,0
,"TIGI Catwalk Blow Out Balm for Smoothness and Shine, 3.04 Ounce","TIGI Catwalk Blow Out Balm for Smoothness and Shine, 3.04 Ounce",FBALYB Amazon,1,1,0,0,0,0
,TIGI Catwalk Curls Rock Amplifier 3pack,TIGI Catwalk Curls Rock Amplifier 3pack,FBALYB Amazon,793,776,17,5,17,0
,TIGI Catwalk Curls Rock Amplifier 3pack,TIGI Catwalk Curls Rock Amplifier 3pack,FBALYB Dubai,-23,-23,0,0,0,0
,Tigi -Catwalk  Firm Hold Hairspray US 9 oz,Tigi -Catwalk  Firm Hold Hairspray US 9 oz,Default Ridgefield,2,2,0,0,0,0
,Tigi -Catwalk  Firm Hold Hairspray US 9 oz,Tigi -Catwalk  Firm Hold Hairspray US 9 oz,FBALYB Amazon,41,16,25,10,25,0
,Tigi -Catwalk Firm Hold Hairspray US 9 oz 3pk,Tigi -Catwalk Firm Hold Hairspray US 9 oz 3pk,FBALYB Amazon,5,4,1,0,1,0
,Tigi Catwalk Root Boost 8.1 Oz Spray,Tigi Catwalk Root Boost 8.1 Oz Spray,Default,0,0,0,0,0,21
,Tigi Catwalk Root Boost 8.1 Oz Spray,Tigi Catwalk Root Boost 8.1 Oz Spray,Default Ridgefield,1961,1961,0,0,0,0
,Tigi Catwalk Root Boost 8.1 Oz Spray,Tigi Catwalk Root Boost 8.1 Oz Spray,FBALYB Amazon,4,1,3,1,3,0
,Tigi Catwalk Root Boost 8.1 Oz Spray 4PK,Tigi Catwalk Root Boost 8.1 Oz Spray 4PK,FBALYB Amazon,1,0,1,0,1,0
,TIGI Catwalk Root Boost 8.5oz 3pk,TIGI Catwalk Root Boost 8.5oz 3pk,FBALYB Amazon,16,7,9,1,9,0
,Tigi CatwalkRootBoost Spray8.1oz 2pk,Tigi CatwalkRootBoost Spray8.1oz 2pk,FBALYB Amazon,697,593,104,17,104,0
,TIGI Catwalk Session Series Salt Spray 9.13 fl Oz,Tigi - Texturising Salt Spray US 9.13 FL. OZ. 270ML,Default Ridgefield,192,192,0,0,0,0
,TIGI Catwalk Session Series Salt Spray 9.13 fl Oz,Tigi - Texturising Salt Spray US 9.13 FL. OZ. 270ML,FBALYB Amazon,39,36,3,18,3,0
,Tigi Catwalk Strong Hold Mousse 6.7 oz,Tigi Catwalk Strong Hold Mousse 6.7 oz,Default Ridgefield,9,9,0,0,0,0
,Tigi Catwalk Strong Hold Mousse 6.7 oz,Tigi Catwalk Strong Hold Mousse 6.7 oz,FBALYB Amazon,905,869,36,69,36,0
,Tigi Catwalk Strong Hold Mousse 6.7 oz,Tigi Catwalk Strong Hold Mousse 6.7 oz,FBALYB Canada,4,3,1,0,1,0
,Tigi Color Goddess Conditioner,Tigi Color Goddess Conditioner 750ml,Default,0,-4230,4230,0,0,0
,Tigi Color Goddess Conditioner,Tigi Color Goddess Conditioner 750ml,FBALYB Amazon,5,5,0,0,0,0
,Tigi Color Goddess Duo,Tigi Color Goddess Duo,FBALYB Amazon,11,11,0,0,0,0
,Tigi Color Goddess Shampoo,Tigi Color Goddess Shampoo 750ml,Default,0,-4230,4230,0,0,0
,Tigi Color Goddess Shampoo,Tigi Color Goddess Shampoo 750ml,FBALYB Amazon,20,20,0,0,0,0
,TIGI Colour Goddess Duo,TIGI Colour Goddess Duo,FBALYB Amazon,18,18,0,0,0,0
,Tigi - Colour Goddess Miracle Treatment Mask 7.05 oz,Tigi - Colour Goddess Miracle Treatment Mask 7.05 oz,Default,0,0,0,0,0,120
,Tigi - Colour Goddess Miracle Treatment Mask 7.05 oz,Tigi - Colour Goddess Miracle Treatment Mask 7.05 oz,Default Ridgefield,192,192,0,0,0,0
,Tigi - Colour Goddess Miracle Treatment Mask 7.05 oz,Tigi - Colour Goddess Miracle Treatment Mask 7.05 oz,FBALYB Amazon,-122,-122,0,0,0,0
,Tigi - Creamy Molding Wax 1.76 oz,Tigi - Creamy Molding Wax 1.76 oz,Default,0,-198,198,0,0,0
,Tigi - Creamy Molding Wax 1.76 oz,Tigi - Creamy Molding Wax 1.76 oz,Default Ridgefield,5,5,0,0,0,0
,Tigi - Creamy Molding Wax 1.76 oz,Tigi - Creamy Molding Wax 1.76 oz,FBALYB Amazon,-1,-1,0,0,0,0
,Tigi DIAMOND DREAMS TWEEN DUO,Tigi DIAMOND DREAMS TWEEN DUO,FBALYB Amazon,94,90,4,1,4,0
,TIGI Dirty Secret Dry Shampoo 6.3oz 2pk,TIGI Dirty Secret Dry Shampoo 6.3oz 2pk,FBALYB Amazon,1282,1232,50,3,50,0
,TIGI Dumb Blonde Purple Toning 2pk,TIGI Dumb Blonde Purple Toning 2pk,FBALYB Amazon,134,130,4,58,4,0
,Tigi - Ego Boost 8 fl oz,Tigi - Ego Boost 8 fl oz,FBALYB Amazon,-19,-20,1,90,1,0
,Tigi Elasticate Conditioner 750ml,Tigi Elasticate Conditioner 750ml,Default Ridgefield,1,1,0,0,0,0
,Tigi Elasticate Conditioner 750ml,Tigi Elasticate Conditioner 750ml,FBALYB Amazon,0,0,0,6,0,0
,Tigi Elasticate Shampoo 750ml,Tigi Elasticate Shampoo 750ml,Default Ridgefield,1,1,0,0,0,0
,Tigi Elasticate Shampoo & Tigi Elasticate Conditioner 750ml DUO,Tigi Elasticate Shampoo & Tigi Elasticate Conditioner 750ml DUO,FBALYB Amazon,-222,-223,1,0,1,0
,Tigi Elasticate Tween Duo,Tigi Elasticate Tween Duo,FBALYB Amazon,348,348,0,0,0,0
,TIGI Fashionasta Violet Conditoner 750ml,TIGI Fashionasta Violet Conditoner 750ml,Default,0,-1990,1990,0,0,0
,TIGI Fashionasta Violet Conditoner 750ml,TIGI Fashionasta Violet Conditoner 750ml,Default Ridgefield,71,71,0,0,0,0
,TIGI Fashionasta Violet Shampoo 750ml,TIGI Fashionasta Violet Shampoo 750ml,Default,0,-1990,1990,0,0,0
,TIGI Fashionasta Violet Shampoo 750ml,TIGI Fashionasta Violet Shampoo 750ml,Default Ridgefield,71,71,0,0,0,0
,TIGI Fashionasta Violet Shampoo 750ml,TIGI Fashionasta Violet Shampoo 750ml,FBALYB Amazon,158,157,1,0,1,0
,TIGI Fashionasta Violet Shampoo & TIGI Fashionasta Violet Conditoner 750ml DUO,TIGI Fashionasta Violet Shampoo & TIGI Fashionasta Violet Conditoner 750ml DUO,FBALYB Amazon,14,12,2,0,2,0
,TIGI Fashionasta Violet Tween,TIGI Fashionasta Violet Tween,FBALYB Amazon,50,50,0,43,0,0
,Tigi Fashionista Blonde Duo,Tigi Fashionista Blonde Duo,FBALYB Amazon,-2,-2,0,6,0,0
,Tigi Foxy Curls Contour Cream 6.76oz 2pk,Tigi Foxy Curls Contour Cream 6.76oz 2pk,FBALYB Amazon,3,1,2,0,2,0
,Tigi - Foxy Curls Contour Crème 6.76  fl oz,Tigi - Foxy Curls Contour Crème 6.76  fl oz,FBALYB Amazon,-99,-109,10,8,10,0
,Tigi FOXY CURLS EXTREME CURL MOUSSE ROW RETAIL 8.45 US FL. OZ./ 250ml,Tigi FOXY CURLS EXTREME CURL MOUSSE ROW RETAIL 8.45 US FL. O,Default Ridgefield,59,59,0,0,0,0
,Tigi FOXY CURLS EXTREME CURL MOUSSE ROW RETAIL 8.45 US FL. OZ./ 250ml,Tigi FOXY CURLS EXTREME CURL MOUSSE ROW RETAIL 8.45 US FL. O,FBALYB Amazon,334,327,7,0,7,0
,Tigi FOXY CURLS EXTREME CURL MOUSSE ROW RETAIL 8.45 US FL. OZ./ 250ml,Tigi FOXY CURLS EXTREME CURL MOUSSE ROW RETAIL 8.45 US FL. O,WFS,-12,-12,0,0,0,0
,Tigi FOXY CURLS EXTREME CURL MOUSSE ROW RETAIL 8.45 US FL. OZ./ 250ml 2 Pack,Tigi FOXY CURLS EXTREME CURL MOUSSE ROW RETAIL 8.45 US FL. OZ./ 250ml 2 Pack,FBALYB Amazon,3,0,3,0,3,0
,Tigi - Hair Stick 2.7 oz,Tigi - Hair Stick 2.7 oz,Default,0,-560,560,0,0,45
,Tigi - Hair Stick 2.7 oz,Tigi - Hair Stick 2.7 oz,Default Ridgefield,2234,234,2000,0,0,0
,Tigi - Hair Stick 2.7 oz,Tigi - Hair Stick 2.7 oz,FBALYB Amazon,598,471,127,55,127,0
,Tigi - Hair Stick 2.7 oz,Tigi - Hair Stick 2.7 oz,FBALYB Canada,-1,-1,0,87,0,0
,Tigi - Hair Stick 2.7 oz 3PK,Tigi - Hair Stick 2.7 oz 3PK,FBALYB Amazon,250,236,14,0,14,0
,Tigi - Hair Stick 2.7 oz 3PK,Tigi - Hair Stick 2.7 oz 3PK,FBALYB Canada,0,0,0,19,0,0
,TIGI Hard Head HairSpray,TIGI Hard Head HairSpray,Default,0,-13980,13980,0,0,0
,Tigi HARD HEAD HAIRSPRAY 10.6 OZ / 300gr / 350ML,Tigi HARD HEAD HAIRSPRAY 10.6 OZ / 300gr / 350ML,Default Ridgefield,147,127,20,0,0,0
,Tigi HARD HEAD HAIRSPRAY 10.6 OZ / 300gr / 350ML,Tigi HARD HEAD HAIRSPRAY 10.6 OZ / 300gr / 350ML,FBALYB Amazon,26,17,9,3,9,0
,Tigi HARD HEAD HAIRSPRAY 10.6 OZ / 300gr / 350ML,Tigi HARD HEAD HAIRSPRAY 10.6 OZ / 300gr / 350ML,FBALYB Canada,1,1,0,0,0,0
,TIGI Hard Head HairSpray 3PK,TIGI Hard Head HairSpray 3PK,FBALYB Amazon,31,30,1,18,1,0
,Tigi Hard Head Mini 3 oz 3PK,Tigi Hard Head Mini 3 oz 3PK,FBALYB Amazon,3,3,0,1,0,0
,Tigi - Haute Iron Spray 6 fl oz,Tigi - Haute Iron Spray 6 fl oz,FBALYB Amazon,19,19,0,1,0,0
,TIGI Head Foxy Curls Contour Cream 3pk,TIGI Head Foxy Curls Contour Cream 3pk,FBALYB Amazon,-1,-1,0,0,0,0
,Tigi - Lion Tamer Beard and Hair  Balm,Tigi - Lion Tamer Beard and Hair  Balm,Default Ridgefield,451,252,199,0,0,0
,Tigi - Lion Tamer Beard and Hair  Balm,Tigi - Lion Tamer Beard and Hair  Balm,FBALYB Amazon,81,71,10,0,10,0
,Tigi - Lion Tamer Beard and Hair  Balm,Tigi - Lion Tamer Beard and Hair  Balm,FBALYB Saudi,0,0,0,10,0,0
,TIGI Masterpiece HairSpray 340ML,TIGI Masterpiece HairSpray 340ML,Default,0,-1,1,0,0,0
,TIGI Masterpiece HairSpray 340ML,TIGI Masterpiece HairSpray 340ML,FBALYB Amazon,1,1,0,0,0,0
,Tigi Masterpiece Hairspray 9.5OZ/ 270gr /315ML,Tigi Masterpiece Hairspray 9.5OZ/ 270gr /315ML,FBALYB Amazon,-917,-935,18,1002,18,0
,Tigi Masterpiece Hairspray 9.5OZ/ 270gr /315ML,Tigi Masterpiece Hairspray 9.5OZ/ 270gr /315ML,FBALYB Canada,39,38,1,0,1,0
,Tigi Masterpiece Mini 2.4 oz 2PK,Tigi Masterpiece Mini 2.4 oz 2PK,FBALYB Amazon,-1,-1,0,1,0,0
,Tigi - Maxxed-Out 8 fl oz,Tigi - Maxxed-Out 8 fl oz,Default Ridgefield,80,63,17,0,0,0
,Tigi - Maxxed-Out 8 fl oz,Tigi - Maxxed-Out 8 fl oz,FBALYB Amazon,159,60,99,2,99,0
,Tigi - Maxxed-Out 8 fl oz,Tigi - Maxxed-Out 8 fl oz,FBALYB Dubai,127,127,0,2,0,0
,Tigi Men Clean up Conditioner 25.36 oz,Tigi Men Clean up Conditioner 25.36 oz,Default Oxford,21,21,0,0,0,0
,Tigi Men Clean up Conditioner 25.36 oz,Tigi Men Clean up Conditioner 25.36 oz,Default Ridgefield,1026,499,527,0,0,0
,Tigi Men Clean up Conditioner 25.36 oz,Tigi Men Clean up Conditioner 25.36 oz,WFS,407,407,0,0,0,0
,Tigi Men Clean Up Shampoo 25.36 fl oz,Tigi Men Clean Up Shampoo 25.36 fl oz,Default,0,0,0,0,0,12
,Tigi Men Clean Up Shampoo 25.36 fl oz,Tigi Men Clean Up Shampoo 25.36 fl oz,Default Ridgefield,2733,2206,527,0,0,0
,Tigi Men Clean Up Shampoo 25.36 fl oz,Tigi Men Clean Up Shampoo 25.36 fl oz,FBALYB Amazon,343,326,17,2,17,0
,Tigi Men Clean Up Shampoo 25.36 fl oz,Tigi Men Clean Up Shampoo 25.36 fl oz,WFS,407,407,0,0,0,0
,Tigi Mens Workable Wax 3pk,Tigi Mens Workable Wax 3pk,FBALYB Amazon,160,152,8,1,8,0
,Tigi OATMEAL & HONEY Conditioner 750ml,Tigi OATMEAL & HONEY Conditioner 750ml,Default Ridgefield,42,42,0,0,0,0
,Tigi OATMEAL & HONEY Conditioner 750ml,Tigi OATMEAL & HONEY Conditioner 750ml,FBALYB Amazon,3,1,2,100,2,0
,Tigi - Oatmeal & Honey Mask 7.05 fl  oz,Tigi - Oatmeal & Honey Mask 7.05 fl  oz,FBALYB Amazon,97,96,1,0,1,0
,Tigi - Oatmeal & Honey Mask 7.05 fl  oz,Tigi - Oatmeal & Honey Mask 7.05 fl  oz,FBALYB Canada,19,19,0,0,0,0
,Tigi - Oatmeal & Honey Mask 7.05 fl oz 2pk,Tigi - Oatmeal & Honey Mask 7.05 fl oz 2pk,FBALYB Amazon,28,27,1,0,1,0
,Tigi OATMEAL & HONEY Shampoo 750ml,Tigi OATMEAL & HONEY Shampoo 750ml,Default Ridgefield,46,46,0,0,0,0
,Tigi OATMEAL & HONEY Shampoo & Tigi OATMEAL & HONEY Conditioner 750ml DUO,Tigi OATMEAL & HONEY Shampoo & Tigi OATMEAL & HONEY Conditioner 750ml DUO,FBALYB Amazon,-351,-365,14,40,14,0
,Tigi OATMEAL & HONEY Shampoo & Tigi OATMEAL & HONEY Conditioner 750ml DUO,Tigi OATMEAL & HONEY Shampoo & Tigi OATMEAL & HONEY Conditioner 750ml DUO,FBALYB Canada,1,1,0,0,0,0
,Tigi OATMEAL & HONEY TWEEN DUO,Tigi OATMEAL & HONEY TWEEN DUO,FBALYB Amazon,439,439,0,53,0,0
,Tigi Oh Bee Hive 5oz Matte Dry Shampoo,Tigi Oh Bee Hive 5oz Matte Dry Shampoo 238ml,Default Ridgefield,22,22,0,0,0,0
,Tigi Oh Bee Hive 5oz Matte Dry Shampoo 2PK,Tigi Oh Bee Hive 5oz Matte Dry Shampoo 2PK,FBALYB Amazon,552,550,2,2,2,0
,Tigi On the Rebound 4.22oz,Tigi On the Rebound 4.22oz,FBALYB Amazon,89,89,0,0,0,0
,Tigi - Pure Texture Molding Paste  3.38 fl oz,Tigi - Pure Texture Molding Paste  3.38 fl oz,Default,0,-94,94,0,0,0
,Tigi - Pure Texture Molding Paste  3.38 fl oz,Tigi - Pure Texture Molding Paste  3.38 fl oz,FBALYB Amazon,0,0,0,136,0,0
,Tigi Pure TextureMoldingPaste 3.38oz 2pk,Tigi Pure TextureMoldingPaste 3.38oz 2pk,FBALYB Amazon,541,524,17,0,17,0
,Tigi Recovery Conditioner Single,Tigi Recovery Conditioner Single,FBALYB Amazon,-2,-2,0,0,0,0
,Tigi Recovery Shampoo single,Tigi Recovery Shampoo single,FBALYB Amazon,-2,-2,0,2,0,0
,Tigi Reenergize Conditioner,Tigi Reenergize Conditioner,Default Ridgefield,193,193,0,0,0,0
,Tigi Reenergize Conditioner,Tigi Reenergize Conditioner,FBALYB Amazon,-5,-5,0,0,0,0
,Tigi Reenergize Shampoo,Tigi Reenergize Shampoo,Default Ridgefield,121,121,0,0,0,0
,Tigi Reenergize Shampoo,Tigi Reenergize Shampoo,FBALYB Amazon,-11,-11,0,0,0,0
,Tigi Rockaholic Dirty Secret Dry Shampoo  6.3OZ / 179g / 300ml,Tigi Rockaholic Dirty Secret Dry Shampoo  6.3OZ / 179g / 300ml,Default Ridgefield,1352,1352,0,0,0,0
,Tigi Rockaholic Dirty Secret Dry Shampoo  6.3OZ / 179g / 300ml,Tigi Rockaholic Dirty Secret Dry Shampoo  6.3OZ / 179g / 300ml,FBALYB Amazon,1069,1025,44,31,44,0
,Tigi Serious Conditioner 150ML,Tigi Serious Conditioner 150ML,Avrami - Ebay,6,6,0,0,0,0
,Tigi Serious Conditioner 150ML,Tigi Serious Conditioner 150ML,Default Ridgefield,12,12,0,0,0,0
,Tigi Serious Conditioner 150ML,Tigi Serious Conditioner 150ML,FBALYB Amazon,-1,-1,0,0,0,0
,Tigi - Session Series Work-It  Hairspray 9.2oz,Tigi - Session Series Work-It  Hairspray 9.2oz,Default Ridgefield,379,379,0,0,0,0
,Tigi - Session Series Work-It  Hairspray 9.2oz,Tigi - Session Series Work-It  Hairspray 9.2oz,FBALYB Amazon,79,63,16,1,16,0
,Tigi SFactor CreamyMolding Wax 50g 2pk,Tigi SFactor CreamyMolding Wax 50g 2pk,FBALYB Amazon,-1,-1,0,0,0,0
,Tigi S Factor Flat Iron Shine Spray 125ml,Tigi S Factor Flat Iron Shine Spray 125ml,FBALYB Amazon,5,4,1,3,1,0
,Tigi S Factor Smoothing Lusterizer (Defrizzer & Tamer) 200ml/6.76oz,Tigi S Factor Smoothing Lusterizer (Defrizzer & Tamer) 200ml/6.76oz,FBALYB Amazon,-18,-24,6,12,6,0
,Tigi S Factor True Lasting Tween Duo,Tigi S Factor True Lasting Tween Duo,FBALYB Amazon,4,4,0,0,0,0
,Tigi - Slick Trick Pomade 2.65 oz,Tigi - Slick Trick Pomade 2.65 oz,Default,0,0,0,0,0,27
,Tigi - Slick Trick Pomade 2.65 oz,Tigi - Slick Trick Pomade 2.65 oz,Default Ridgefield,332,332,0,0,0,0
,Tigi - Slick Trick Pomade 2.65 oz,Tigi - Slick Trick Pomade 2.65 oz,FBALYB Amazon,299,299,0,0,0,0
,Tigi - Slick Trick Pomade 2.65 oz,Tigi - Slick Trick Pomade 2.65 oz,FBALYB Canada,-1,-1,0,50,0,0
,Tigi Small Talk 125 ML,Tigi Small Talk 125 ML,Default,17,17,0,0,0,0
,Tigi Small Talk 125 ML,Tigi Small Talk 125 ML,Default Ridgefield,75,75,0,0,0,0
,Tigi Small Talk 125 ML,Tigi Small Talk 125 ML,FBALYB Amazon,-181,-186,5,0,5,0
,Tigi - Small Talk 8 fl oz,Tigi - Small Talk 8 fl oz,Default Ridgefield,48,33,15,0,0,0
,Tigi - Small Talk 8 fl oz,Tigi - Small Talk 8 fl oz,FBALYB Amazon,-229,-231,2,4,2,0
,TIGI Small Talk Thickifier 8 oz 2pk,TIGI Small Talk Thickifier 8 oz 2pk,FBALYB Amazon,97,97,0,1,0,0
,Tigi Stunning Volume Duo,Tigi Stunning Volume Duo ,FBALYB Amazon,1,1,0,0,0,0
,Tigi Stunning Volume Shampoo 750ml,Tigi Stunning Volume Shampoo 750ml,Default Ridgefield,239,239,0,0,0,0
,TIGI Style Manipulator 57ML,TIGI Style Manipulator 57ML,Default,0,-3234,3234,0,0,93
,TIGI Style Manipulator 57ML,TIGI Style Manipulator 57ML,Default Ridgefield,7190,6430,760,0,0,0
,TIGI Style Manipulator 57ML,TIGI Style Manipulator 57ML,FBALYB Amazon,1093,1093,0,14,0,0
,TIGI Style Manipulator 57ML 2PK,TIGI Style Manipulator 57ML 2PK,FBALYB Amazon,13,11,2,0,2,0
,TIGI Style Manipulator 57ML 4PK,TIGI Style Manipulator 57ML 4PK,FBALYB Amazon,617,611,6,0,6,0
,TIGI Style Manipulator 57ML 7PK,TIGI Style Manipulator 57ML 7PK,FBALYB Amazon,9,9,0,0,0,0
,TIGI Style Manipulator 57ML 7PK,TIGI Style Manipulator 57ML 7PK,FBALYB Canada,0,0,0,25,0,0
,TIGI Style Small Talk 200ML,TIGI Style Small Talk 200ML,Default,0,-1900,1900,0,0,0
,TIGI Style Small Talk 200ML,TIGI Style Small Talk 200ML,Default Ridgefield,25,25,0,0,0,0
,TIGI Style Small Talk 200ML,TIGI Style Small Talk 200ML,FBALYB Amazon,436,436,0,17,0,0
,Tigi - Superfuel On the Rebound  Curl Cream,Tigi - Superfuel On the Rebound  Curl Cream,Default Ridgefield,31,31,0,0,0,0
,Tigi - Superfuel On the Rebound  Curl Cream,Tigi - Superfuel On the Rebound  Curl Cream,FBALYB Amazon,209,177,32,1,32,0
,Tigi - Superfuel On the Rebound Curl Cream 4.22oz 2pk,Tigi - Superfuel On the Rebound Curl Cream 4.22oz 2pk,FBALYB Amazon,-3,-3,0,0,0,0
,Tigi - Superstar Blowdry Lotion 8.5 fl  oz,Tigi - Superstar Blowdry Lotion 8.5 fl  oz,Default Ridgefield,625,625,0,0,0,0
,Tigi - Superstar Blowdry Lotion 8.5 fl  oz,Tigi - Superstar Blowdry Lotion 8.5 fl  oz,FBALYB Amazon,6,3,3,0,3,0
,Tigi - Superstar Blowdry Lotion 8.5 fl  oz,Tigi - Superstar Blowdry Lotion 8.5 fl  oz,FBALYB Canada,0,0,0,50,0,0
,Tigi - Texturising Salt Spray US 9.13  FL. OZ. 270ML,Tigi - Texturising Salt Spray US 9.13  FL. OZ. 270ML,FBALYB Amazon,8,8,0,0,0,0
,Tigi - Transforming Dry Shampoo 5.2  OZ,Tigi - Transforming Dry Shampoo 5.2  OZ,Default Ridgefield,372,372,0,0,0,0
,Tigi - Transforming Dry Shampoo 5.2  OZ,Tigi - Transforming Dry Shampoo 5.2  OZ,FBALYB Amazon,-2,-2,0,0,0,0
,Tigi - UA Reboot Scalp Shampoo 8.45 US FL OZ 250 ML,Tigi - UA Reboot Scalp Shampoo 8.45 US FL OZ 250 ML,Default,0,0,0,0,0,177
,Tigi - UA Reboot Scalp Shampoo 8.45 US FL OZ 250 ML,Tigi - UA Reboot Scalp Shampoo 8.45 US FL OZ 250 ML,Default Ridgefield,250,250,0,0,0,0
,Tigi - UA Reboot Scalp Shampoo 8.45 US FL OZ 250 ML,Tigi - UA Reboot Scalp Shampoo 8.45 US FL OZ 250 ML,FBALYB Amazon,32,24,8,0,8,0
,Tigi - UA Recovery Treatment Mask  7.05oz 200g,Tigi - UA Recovery Treatment Mask  7.05oz 200g,FBALYB Amazon,172,171,1,2,1,0
,Tigi - UA Resurrection Treatment  Mask 7.05oz 200g,Tigi - UA Resurrection Treatment  Mask 7.05oz 200g,FBALYB Amazon,0,-1,1,0,1,0
,Tigi - UA Resurrection Treatment  Mask 7.05oz 200g,Tigi - UA Resurrection Treatment  Mask 7.05oz 200g,FBALYB Canada,-2,-2,0,0,0,0
,Tigi Your Highness Conditioner 750ml,Tigi Your Highness Conditioner 750ml,Default,0,-1728,1728,0,0,0
,Tigi Your Highness Conditioner 750ml,Tigi Your Highness Conditioner 750ml,Default Ridgefield,33,33,0,0,0,0
,Tigi Your Highness Conditioner 750ml,Tigi Your Highness Conditioner 750ml,FBALYB Amazon,0,0,0,3,0,0
,Tigi Your Highness Shampoo 750ml,Tigi Your Highness Shampoo 750ml,Default,0,-1728,1728,0,0,0
,Tigi Your Highness Shampoo 750ml,Tigi Your Highness Shampoo 750ml,Default Ridgefield,33,33,0,0,0,0
,Tigi Your Highness Shampoo & Conditioner Duo,Tigi Your Highness Shampoo & Conditioner Duo,FBALYB Amazon,609,609,0,25,0,0
,Tigi Your Highness Shampoo & Conditioner Duo,Tigi Your Highness Shampoo & Conditioner Duo,FBALYB Canada,50,50,0,0,0,0
,Tigi Your Highness Shampoo & Tigi Your Highness Conditioner 750ml DUO,Tigi Your Highness Shampoo & Tigi Your Highness Conditioner 750ml DUO,FBALYB Amazon,-496,-506,10,0,10,0
,Tigi Your Highness Shampoo & Tigi Your Highness Conditioner 750ml DUO,Tigi Your Highness Shampoo & Tigi Your Highness Conditioner 750ml DUO,FBALYB Canada,-50,-50,0,0,0,0
,"Tilex Mold & Mildew Remover, 96oz","Tilex Mold & Mildew Remover, 96oz",Default,0,-192,192,0,0,0
,"Tilex Mold & Mildew Remover, 96oz","Tilex Mold & Mildew Remover, 96oz",FBALYB Amazon,339,331,8,25,8,0
,Timberland Men's 6 inch Double Collar Ankle Boot Wheat Nubuck Size 10,Timberland Men's 6 inch Double Collar Ankle Boot Wheat Nubuck Size 10,FBALYB Amazon,31,30,1,2,1,0
,Timberland Men's 6 inch Double Collar Ankle Boot Wheat Nubuck Size 10.5,Timberland Men's 6 inch Double Collar Ankle Boot Wheat Nubuck Size 10.5,Default Oxford,1,1,0,0,0,0
,Timberland Men's 6 inch Double Collar Ankle Boot Wheat Nubuck Size 10.5,Timberland Men's 6 inch Double Collar Ankle Boot Wheat Nubuck Size 10.5,FBALYB Amazon,158,158,0,0,0,0
,Timberland Men's 6 inch Double Collar Ankle Boot Wheat Nubuck Size 11,Timberland Men's 6 inch Double Collar Ankle Boot Wheat Nubuck Size 11,Default Oxford,9,9,0,0,0,0
,Timberland Men's 6 inch Double Collar Ankle Boot Wheat Nubuck Size 11,Timberland Men's 6 inch Double Collar Ankle Boot Wheat Nubuck Size 11,FBALYB Amazon,173,172,1,1,1,0
,Timberland Men's 6 inch Double Collar Ankle Boot Wheat Nubuck Size 11.5,Timberland Men's 6 inch Double Collar Ankle Boot Wheat Nubuck Size 11.5,FBALYB Amazon,-9,-9,0,0,0,0
,Timberland Men's 6 inch Double Collar Ankle Boot Wheat Nubuck Size 12,Timberland Men's 6 inch Double Collar Ankle Boot Wheat Nubuck Size 12,FBALYB Amazon,144,144,0,0,0,0
,Timberland Men's 6 inch Double Collar Ankle Boot Wheat Nubuck Size 7.5,Timberland Men's 6 inch Double Collar Ankle Boot Wheat Nubuck Size 7.5,FBALYB Amazon,33,32,1,0,1,0
,Timberland Men's 6 inch Double Collar Ankle Boot Wheat Nubuck Size 8.5W,Timberland Men's 6 inch Double Collar Ankle Boot Wheat Nubuck Size 8.5W,FBALYB Amazon,24,23,1,0,1,0
,Timberland Men's 6 inch Double Collar Ankle Boot Wheat Nubuck Size 9,Timberland Men's 6 inch Double Collar Ankle Boot Wheat Nubuck Size 9,FBALYB Amazon,-7,-7,0,1,0,0
,Timberland Men's 6 inch Double Collar Ankle Boot Wheat Nubuck Size 9.5,Timberland Men's 6 inch Double Collar Ankle Boot Wheat Nubuck Size 9.5,FBALYB Amazon,-1,-1,0,0,0,0
,Timberland Men's 6 inch Double Collar Ankle Boot Wheat Nubuck Size 9W,Timberland Men's 6 inch Double Collar Ankle Boot Wheat Nubuck Size 9W,FBALYB Amazon,-2,-2,0,0,0,0
,Timeless-20% Vitamin C + E Ferulic  Acid Serum,Timeless-20% Vitamin C + E Ferulic  Acid Serum,FBALYB Amazon,337,337,0,6,0,0
,Timeless-20% Vitamin C + E Ferulic  Acid Serum,Timeless-20% Vitamin C + E Ferulic  Acid Serum,WFS,-25,-25,0,0,0,0
,Timeless-20% Vitamin C + E Ferulic Acid Serum 2pk,Timeless-20% Vitamin C + E Ferulic Acid Serum 2pk,FBALYB Amazon,-4,-4,0,0,0,0
,Timeless-20% Vitamin C + E Ferulic Acid Serum 2pk,Timeless-20% Vitamin C + E Ferulic Acid Serum 2pk,WFS,-23,-23,0,0,0,0
,Timeless - 20% Vitamin C + E Ferulic Acid  Serum Refill 4oz,Timeless - 20% Vitamin C + E Ferulic Acid  Serum Refill 4oz,FBALYB Amazon,1,1,0,0,0,0
,Timeless-Coenzyme Q10 Serum 1oz,Timeless-Coenzyme Q10 Serum 1oz,FBALYB Amazon,-15,-15,0,2,0,0
,Timeless-Hyaluronic Acid 100% Pure  Serum 2oz,Timeless-Hyaluronic Acid 100% Pure  Serum 2oz,FBALYB Amazon,3,3,0,0,0,0
,Timeless-Hyaluronic Acid 100% Pure Serum 2oz 2pk,Timeless-Hyaluronic Acid 100% Pure Serum 2oz 2pk,FBALYB Amazon,-1,-1,0,0,0,0
,Timeless-Hyaluronic Acid 100% Pure  Serum 8oz,Timeless-Hyaluronic Acid 100% Pure  Serum 8oz,FBALYB Amazon,11,11,0,1,0,0
,Timeless - Hyaluronic Acid Vitamin C Serum  1oz,Timeless - Hyaluronic Acid Vitamin C Serum  1oz,FBALYB Amazon,1,1,0,0,0,0
,Timeless-Matrixyl Synthe’6 Serum  1oz,Timeless-Matrixyl Synthe’6 Serum  1oz,Default,0,-75,75,0,0,0
,Timeless-Matrixyl Synthe’6 Serum  1oz,Timeless-Matrixyl Synthe’6 Serum  1oz,FBALYB Amazon,119,119,0,0,0,0
,Timeless-Matrixyl Synthe’6 Serum  1oz,Timeless-Matrixyl Synthe’6 Serum  1oz,WFS,-32,-32,0,0,0,0
,Timeless-Squalane Oil 100% Pure  2oz,Timeless-Squalane Oil 100% Pure  2oz,FBALYB Amazon,4,3,1,2,1,0
,Timeless-Squalane Oil 100% Pure  8oz,Timeless-Squalane Oil 100% Pure  8oz,FBALYB Amazon,-2,-2,0,0,0,0
,Timeless - Vitamin B5 Serum 1 oz,Timeless - Vitamin B5 Serum 1 oz,Default Ridgefield,75,75,0,0,0,0
,TIM HORTON K CUP DECAF 24 CT 2pk,TIM HORTON K CUP DECAF 24 CT 2pk,FBALYB Amazon,2,2,0,0,0,0
,TIM HORTON K CUP DECAF 24 CT 3pk,TIM HORTON K CUP DECAF 24 CT 3pk,FBALYB Amazon,-1,-1,0,0,0,0
,Tim Hortons 72ct k cups,Tim Hortons 72ct k cups,FBALYB Amazon,-73,-73,0,91,0,0
,Tim Hortons Dark Roast K Cup 24 Count 4pk,Tim Hortons Dark Roast K Cup 24 Count 4pk,FBALYB Amazon,-2,-2,0,2,0,0
,Tim Hortons French vanilla K Cup 24 Count 2pk,Tim Hortons French vanilla K Cup 24 Count 2pk,FBALYB Amazon,-2,-2,0,5,0,0
,Tim Hortons French vanilla K Cup 24 Count 3pk,Tim Hortons French vanilla K Cup 24 Count 3pk,FBALYB Amazon,2,0,2,0,2,0
,Tim Hortons Ground Coffee 1.36kg Original,Tim Hortons Ground Coffee 1.36kg Original,Default Ridgefield,20,20,0,0,0,0
,Tim Hortons Ground Coffee 1.36kg Original,Tim Hortons Ground Coffee 1.36kg Original,FBALYB Amazon,-8,-8,0,90,0,0
,Tim Hortons Original Blend K Cups 24 Count 3PK,Tim Hortons Original Blend K Cups 24 Count 3PK,FBALYB Amazon,2,2,0,0,0,0
,Tim Hortons Original Blend K Cups 24 Count 4pk,Tim Hortons Original Blend K Cups 24 Count 4pk,FBALYB Amazon,1,1,0,0,0,0
,"TIMOTHY'S  Breakfast Blend, 24 CT","TIMOTHY'S  Breakfast Blend, 24 CT",Default,0,-362,362,0,0,0
,"TIMOTHY'S  Breakfast Blend, 24 CT 2pk","TIMOTHY'S  Breakfast Blend, 24 CT 2pk",FBALYB Amazon,8,8,0,0,0,0
,"TIMOTHY'S Breakfast Blend, 24 CT 4pk","TIMOTHY'S Breakfast Blend, 24 CT 4pk",FBALYB Amazon,1,1,0,0,0,0
,Timothy’s Chai Tea 24 k cups,Timothy’s Chai Tea 24 k cups,FBALYB Amazon,27,27,0,0,0,0
,Timothy’s Chamomile Tea K Cups 24,Timothy’s Chamomile Tea K Cups 24,Default,0,0,0,0,0,20
,Timothy’s Chinese Green Tea 24ct k cups,Timothy’s Chinese Green Tea 24ct k cups,Default,0,0,0,0,0,20
,Timothy's Cinnamon Pastry 24 K-cups,Timothy's Cinnamon Pastry 24 K-cups,FBALYB Amazon,1,-1,2,3,2,0
,Timothy's Cinnamon Pastry 24 K-cups 2pk,Timothy's Cinnamon Pastry 24 K-cups 2pk,FBALYB Amazon,9,8,1,2,1,0
,Timothy’s Cranberry Twist Tea 24ct k cups,Timothy’s Cranberry Twist Tea 24ct k cups,FBALYB Amazon,41,41,0,3,0,0
,Timothy's Decaf Colombian 24 Kcups,Timothy's Decaf Colombian 24 Kcups,FBALYB Amazon,15,11,4,0,4,0
,Timothy's Decaf Colombian 24 Kcups 2pk,Timothy's Decaf Colombian 24 Kcups 2pk,Default,0,-100,100,0,0,0
,Timothy's Decaf Colombian 24 Kcups 2pk,Timothy's Decaf Colombian 24 Kcups 2pk,FBALYB Amazon,0,0,0,3,0,0
,Timothy's Decaf Colombian 24 Kcups 4pk,Timothy's Decaf Colombian 24 Kcups 4pk,FBALYB Amazon,-5,-5,0,34,0,0
,Timothy's Decaf Colombian 50ct,Timothy's Decaf Colombian 50ct,FBALYB Amazon,2,1,1,0,1,0
,Timothy's Decaf English Breakfast 24ct K Cups,Timothy's Decaf English Breakfast 24ct K Cups,FBALYB Amazon,2,2,0,0,0,0
,Timothy's Donut Blend 24 kcups 2pk,Timothy's Donut Blend 24 kcups 2pk,FBALYB Amazon,1,1,0,0,0,0
,Timothy's Earl Gray Tea 24 K Cups 4 PK,Timothy's Earl Gray Tea 24 K Cups 4 PK,FBALYB Amazon,13,13,0,0,0,0
,Timothy's Earl Gray Tea 24 K Cups Count 2pk,Timothy's Earl Gray Tea 24 K Cups Count 2pk,FBALYB Amazon,2,2,0,0,0,0
,Timothy's French Roast 24ct K Cups,Timothy's French Roast 24ct K Cups,Default,0,-50,50,0,0,0
,Timothy's French Roast K Cup 2pk (48),Timothy's French Roast K Cup 2pk (48),FBALYB Amazon,38,38,0,0,0,0
,TIMOTHY'S  French Vanilla,TIMOTHY'S  French Vanilla,Default,0,-64,64,0,0,60
,TIMOTHY'S French Vanilla 2pk,TIMOTHY'S French Vanilla 2pk,FBALYB Amazon,-1,-1,0,1,0,0
,Timothy's German Chocolate Cake 24 kcups,Timothy's German Chocolate Cake 24 kcups,FBALYB Amazon,-6,-7,1,45,1,0
,Timothy's German Chocolate Cake 24 kcups 2pk,Timothy's German Chocolate Cake 24 kcups 2pk,FBALYB Amazon,118,111,7,38,7,0
,Timothy's German Chocolate Cake 24 kcups 4pk,Timothy's German Chocolate Cake 24 kcups 4pk,FBALYB Amazon,19,19,0,10,0,0
,Timothy's Hazelnut 24ct K Cups,Timothy's Hazelnut 24ct K Cups,Default,0,0,0,0,0,4
,Timothy's Hazelnut K Cups 48ct,Timothy's Hazelnut K Cups 48ct,FBALYB Amazon,32,32,0,0,0,0
,Timothy's Irish Cream 24 kcups,Timothy's Irish Cream 24 kcups,Default,0,-120,120,0,0,0
,Timothy's Irish Cream 24 kcups,Timothy's Irish Cream 24 kcups,FBALYB Amazon,24,23,1,0,1,0
,Timothy's Irish Cream 24 kcups 2pk,Timothy's Irish Cream 24 kcups 2pk,FBALYB Amazon,2,2,0,0,0,0
,Timothy's Italian Blend 24 kcups,Timothy's Italian Blend 24 kcups,Default,0,-136,136,0,0,80
,Timothy's Italian Blend 24 kcups,Timothy's Italian Blend 24 kcups,FBALYB Amazon,1,1,0,0,0,0
,Timothy's Italian Blend 24 kcups 2pk,Timothy's Italian Blend 24 kcups 2pk,FBALYB Amazon,-10,-14,4,13,4,0
,Timothy's Kahlua 24 kcups,Timothy's Kahlua 24 kcups,Default,0,-65,65,0,0,0
,Timothy's Kahlua 24 kcups,Timothy's Kahlua 24 kcups,FBALYB Amazon,-39,-40,1,72,1,0
,Timothy's Kahlua 24 kcups 4pk,Timothy's Kahlua 24 kcups 4pk,FBALYB Amazon,-2,-2,0,3,0,0
,Timothy's Kahlua 24 kcups 5pk,Timothy's Kahlua 24 kcups 5pk,FBALYB Amazon,92,92,0,3,0,0
,Timothy's Lemon Blueberry Passion Tea 24ct,Timothy's Lemon Blueberry Passion Tea 24ct,FBALYB Amazon,4,4,0,0,0,0
,Timothy's Lemon Blueberry Passion Tea 48ct 2PK,Timothy's Lemon Blueberry Passion Tea 48ct 2PK,FBALYB Amazon,7,7,0,0,0,0
,Timothy's Midnight Magic 24 kcups,Timothy's Midnight Magic 24 kcups,Default,0,-120,120,0,0,128
,Timothy's Midnight Magic 24 kcups 2pk,Timothy's Midnight Magic 24 kcups 2pk,FBALYB Amazon,0,-2,2,1,2,0
,Timothy's Mocha Java 24 kcups 2pk,Timothy's Mocha Java 24 kcups 2pk,FBALYB Amazon,16,16,0,18,0,0
,Timothy's Morning Blend 24ct K Cups,Timothy's Morning Blend 24ct K Cups,Default,0,0,0,0,0,40
,Timothy's Nicaraguan FT Org Ex Bold 48ct K Cups,Timothy's Nicaraguan FT Org Ex Bold 48ct K Cups,FBALYB Amazon,7,7,0,0,0,0
,"TIMOTHY'S  Parisian Nights Extra Bold, 24 CT","TIMOTHY'S  Parisian Nights Extra Bold, 24 CT",Default,0,0,0,0,0,56
,"TIMOTHY'S  Parisian Nights Extra Bold, 24 CT","TIMOTHY'S  Parisian Nights Extra Bold, 24 CT",Joes Playground (Testing),6,6,0,0,0,0
,"TIMOTHY'S Parisian Nights Extra Bold, 24 CT 4pk","TIMOTHY'S Parisian Nights Extra Bold, 24 CT 4pk",FBALYB Amazon,-31,-31,0,0,0,0
,"TIMOTHY'S Parisian Nights Extra Bold, 48 CT 2 PK","TIMOTHY'S Parisian Nights Extra Bold, 48 CT 2 PK",Joes Playground (Testing),2,2,0,0,0,0
,Timothy's Rainforest Espresso 24 kcups 2pk,Timothy's Rainforest Espresso 24 kcups 2pk,Default,0,0,0,0,0,176
,Timothy's Rainforest Espresso 24 kcups 2pk,Timothy's Rainforest Espresso 24 kcups 2pk,FBALYB Amazon,6,6,0,1,0,0
,Timothy's Rainforest Espresso Extra Bold 24 kcups,Timothy's Rainforest Espresso Extra Bold 24 kcups,FBALYB Amazon,1,1,0,3,0,0
,Timothy's Rainforest Espresso Extra Bold 24 kcups 4PK,Timothy's Rainforest Espresso Extra Bold 24 kcups 4PK,FBALYB Amazon,2,2,0,2,0,0
,TIMOTHY'S  San Lorenzo Dark,TIMOTHY'S  San Lorenzo Dark,Default,0,0,0,0,0,71
,Timothy's Sugar Bush Maple K Cups 24ct Seasonal,Timothy's Sugar Bush Maple K Cups 24ct Seasonal,Default,0,0,0,0,0,184
,Tiny N Tuff Buildables,Mega Bloks Cat Dump Truck Tiny N Tuff Buildables,FBALYB Amazon,3,3,0,0,0,0
,TMC PURE SEDUCTION MIST 250ML +  VS TMC PURE SEDUCTION BODY LOTION 237ML,TMC PURE SEDUCTION MIST 250ML +  VS TMC PURE SEDUCTION BODY LOTION 237ML,FBALYB Amazon,-3,-3,0,2,0,0
,Toblerone 600g,Toblerone Milk 35G 24ct,Default,0,0,0,0,0,8
,Toblerone 600g,Toblerone Milk 35G 24ct,FBALYB Amazon,63,63,0,0,0,0
,Toblerone Chocolate  Nougat 750g,Toblerone Chocolate  Nougat 750g,Default,0,0,0,0,0,3
,Toblerone Chocolate  Nougat 750g,Toblerone Chocolate  Nougat 750g,FBALYB Amazon,-97,-97,0,96,0,0
,Tojiro Bread Slicer 235 mm,Tojiro Bread Slicer 235 mm,Avrami - Ebay,39,39,0,0,0,0
,Tojiro Bread Slicer 235 mm,Tojiro Bread Slicer 235 mm,Default Ridgefield,477,477,0,0,0,0
,Tojiro Bread Slicer 235 mm,Tojiro Bread Slicer 235 mm,FBALYB Amazon,429,429,0,19,0,0
,Tojiro Bread Slicer 235 mm,Tojiro Bread Slicer 235 mm,WFS,-14,-14,0,0,0,0
,Tojiro Bread Slicer 270 mm,Tojiro Bread Slicer 270 mm,Avrami - Ebay,41,41,0,0,0,0
,Tojiro Bread Slicer 270 mm,Tojiro Bread Slicer 270 mm,FBALYB Amazon,90,90,0,0,0,0
,Tojiro Bread Slicer 270 mm,Tojiro Bread Slicer 270 mm,WFS,-7,-7,0,0,0,0
,Tojiro Canvas Knife Pocket,Tojiro Canvas Knife Pocket,FBALYB Amazon,30,30,0,1,0,0
,Tojiro Double-Edged Shirogami Santoku 165 mm,Tojiro Double-Edged Shirogami Santoku 165 mm,FBALYB Amazon,2,2,0,0,0,0
,Tojiro DP 3 Layered Steel by VG10 Chef 180 mm,Tojiro DP 3 Layered Steel by VG10 Chef 180 mm,FBALYB Amazon,4,4,0,0,0,0
,Tojiro DP 3 Layered Steel by VG10 Chef 210 mm,Tojiro DP 3 Layered Steel by VG10 Chef 210 mm,FBALYB Amazon,3,3,0,0,0,0
,Tojiro DP 3 Layered Steel by VG10 Santoku 170mm,Tojiro DP 3 Layered Steel by VG10 Santoku 170mm,FBALYB Amazon,1,1,0,0,0,0
,Tojiro DP 3 Steel by VG10 Chicken Boning 150 mm,Tojiro DP 3 Steel by VG10 Chicken Boning 150 mm,FBALYB Amazon,29,29,0,1,0,0
,Tojiro DP 3 Steel by VG10 Chicken Boning 150 mm,Tojiro DP 3 Steel by VG10 Chicken Boning 150 mm,WFS,-7,-7,0,0,0,0
,Tojiro Separable Kitchen Shears,Tojiro Separable Kitchen Shears ,FBALYB Amazon,10,10,0,0,0,0
,Tojiro Separable Kitchen Shears,Tojiro Separable Kitchen Shears ,WFS,-5,-5,0,0,0,0
,Tomlyn Laxatone Natural 4.25oz,Tomlyn Laxatone Natural 4.25oz,Default,0,0,0,0,0,69
,Tomlyn Laxatone Natural 4.25oz,Tomlyn Laxatone Natural 4.25oz,FBALYB Amazon,1,1,0,1,0,0
,Tomlyn Laxatone Natural 4.25oz 2pk,Tomlyn Laxatone Natural 4.25oz 2pk,FBALYB Amazon,60,60,0,0,0,0
,Tomlyn Laxatone Original 4.25oz,Tomlyn Laxatone Original 4.25oz,FBALYB Amazon,20,20,0,0,0,0
,Tomlyn Laxatone Original 4.25oz 2pk,Tomlyn Laxatone Original 4.25oz 2pk,FBALYB Amazon,-61,-61,0,0,0,0
,Tommy Bahama PJ Set Large Black,Tommy Bahama PJ Set Large Black,FBASKCK Amazon,17,17,0,0,0,0
,Tommy Bahama PJ Set Large Navy,Tommy Bahama PJ Set Large Navy,FBASKCK Amazon,9,9,0,0,0,0
,Tommy Bahama PJ Set Medium Black,Tommy Bahama PJ Set Medium Black,FBASKCK Amazon,28,28,0,0,0,0
,Tommy Bahama PJ Set Medium Navy,Tommy Bahama PJ Set Medium Navy,FBASKCK Amazon,69,69,0,0,0,0
,TOMS Men's Alpargata Black Denim Classics Size 10 10014478,TOMS Men's Alpargata Black Denim Classics Size 10 10014478,Default Ridgefield,52,52,0,0,0,0
,TOMS Men's Alpargata Black Denim Classics Size 10 10014478,TOMS Men's Alpargata Black Denim Classics Size 10 10014478,FBALYB Amazon,50,50,0,0,0,0
,TOMS Men's Alpargata Black Denim Classics Size 10.5 10014478,TOMS Men's Alpargata Black Denim Classics Size 10.5 10014478,Default Ridgefield,64,64,0,0,0,0
,TOMS Men's Alpargata Black Denim Classics Size 10.5 10014478,TOMS Men's Alpargata Black Denim Classics Size 10.5 10014478,FBALYB Amazon,31,30,1,0,1,0
,TOMS Men's Alpargata Black Denim Classics Size 11 10014478,TOMS Men's Alpargata Black Denim Classics Size 11 10014478,Default Ridgefield,12,12,0,0,0,0
,TOMS Men's Alpargata Black Denim Classics Size 11 10014478,TOMS Men's Alpargata Black Denim Classics Size 11 10014478,FBALYB Amazon,51,51,0,0,0,0
,TOMS Men's Alpargata Black Denim Classics Size 11.5 10014478,TOMS Men's Alpargata Black Denim Classics Size 11.5 10014478,Default Ridgefield,13,13,0,0,0,0
,TOMS Men's Alpargata Black Denim Classics Size 12 10014478,TOMS Men's Alpargata Black Denim Classics Size 12 10014478,Default Ridgefield,17,17,0,0,0,0
,TOMS Men's Alpargata Black Denim Classics Size 12 10014478,TOMS Men's Alpargata Black Denim Classics Size 12 10014478,FBALYB Amazon,33,33,0,0,0,0
,TOMS Men's Alpargata Black Denim Classics Size 13 10014478,TOMS Men's Alpargata Black Denim Classics Size 13 10014478,FBALYB Amazon,14,14,0,0,0,0
,TOMS Men's Alpargata Black Denim Classics Size 8 10014478,TOMS Men's Alpargata Black Denim Classics Size 8 10014478,Default Ridgefield,25,25,0,0,0,0
,TOMS Men's Alpargata Black Denim Classics Size 8 10014478,TOMS Men's Alpargata Black Denim Classics Size 8 10014478,FBALYB Amazon,23,23,0,0,0,0
,TOMS Men's Alpargata Black Denim Classics Size 8.5 10014478,TOMS Men's Alpargata Black Denim Classics Size 8.5 10014478,Default Ridgefield,35,35,0,0,0,0
,TOMS Men's Alpargata Black Denim Classics Size 8.5 10014478,TOMS Men's Alpargata Black Denim Classics Size 8.5 10014478,FBALYB Amazon,28,28,0,0,0,0
,TOMS Men's Alpargata Black Denim Classics Size 9 10014478,TOMS Men's Alpargata Black Denim Classics Size 9 10014478,Default Ridgefield,34,34,0,0,0,0
,TOMS Men's Alpargata Black Denim Classics Size 9 10014478,TOMS Men's Alpargata Black Denim Classics Size 9 10014478,FBALYB Amazon,34,34,0,0,0,0
,TOMS Men's Alpargata Black Denim Classics Size 9.5 10014478,TOMS Men's Alpargata Black Denim Classics Size 9.5 10014478,Default Ridgefield,28,28,0,0,0,0
,TOMS Men's Alpargata Black Denim Classics Size 9.5 10014478,TOMS Men's Alpargata Black Denim Classics Size 9.5 10014478,FBALYB Amazon,46,46,0,0,0,0
,TOMS Men's Black Canvas Classics Size 10 001001A07,TOMS Men's Black Canvas Classics Size 10 001001A07,FBALYB Amazon,-6,-6,0,0,0,0
,TOMS Men's Black Canvas Classics Size 10.5 001001A07,TOMS Men's Black Canvas Classics Size 10.5 001001A07,FBALYB Amazon,-3,-3,0,0,0,0
,TOMS Men's Black Canvas Classics Size 11 001001A07,TOMS Men's Black Canvas Classics Size 11 001001A07,Default Ridgefield,8,8,0,0,0,0
,TOMS Men's Black Canvas Classics Size 11 001001A07,TOMS Men's Black Canvas Classics Size 11 001001A07,FBALYB Amazon,-3,-3,0,0,0,0
,TOMS Men's Black Canvas Classics Size 13 001001A07,TOMS Men's Black Canvas Classics Size 13 001001A07,FBALYB Amazon,-2,-2,0,0,0,0
,TOMS Men's Black Canvas Classics Size 7 001001A07,TOMS Men's Black Canvas Classics Size 7 001001A07,Default Ridgefield,12,12,0,0,0,0
,TOMS Men's Black Canvas Classics Size 8 001001A07,TOMS Men's Black Canvas Classics Size 8 001001A07,FBALYB Amazon,-3,-3,0,0,0,0
,TOMS Men's Black Canvas Classics Size 8.5 001001A07,TOMS Men's Black Canvas Classics Size 8.5 001001A07,FBALYB Amazon,-3,-3,0,0,0,0
,TOMS Men's Black Canvas Classics Size 9 001001A07,TOMS Men's Black Canvas Classics Size 9 001001A07,FBALYB Amazon,-7,-7,0,0,0,0
,TOMS Men's Black Canvas Classics Size 9.5 001001A07,TOMS Men's Black Canvas Classics Size 9.5 001001A07,FBALYB Amazon,-4,-4,0,0,0,0
,TOMS Men's Black on Black Canvas Classics Size 10 10002931,TOMS Men's Black on Black Canvas Classics Size 10 10002931,Default Oxford,1,1,0,0,0,0
,TOMS Men's Black on Black Canvas Classics Size 10 10002931,TOMS Men's Black on Black Canvas Classics Size 10 10002931,Default Ridgefield,298,298,0,0,0,0
,TOMS Men's Black on Black Canvas Classics Size 10 10002931,TOMS Men's Black on Black Canvas Classics Size 10 10002931,FBALYB Amazon,16,15,1,0,1,0
,TOMS Men's Black on Black Canvas Classics Size 10.5 10002931,TOMS Men's Black on Black Canvas Classics Size 10.5 10002931,Default Ridgefield,86,86,0,0,0,0
,TOMS Men's Black on Black Canvas Classics Size 10.5 10002931,TOMS Men's Black on Black Canvas Classics Size 10.5 10002931,FBALYB Amazon,-43,-44,1,0,1,0
,TOMS Men's Black on Black Canvas Classics Size 11 10002931,TOMS Men's Black on Black Canvas Classics Size 11 10002931,Default Ridgefield,440,440,0,0,0,0
,TOMS Men's Black on Black Canvas Classics Size 11 10002931,TOMS Men's Black on Black Canvas Classics Size 11 10002931,FBALYB Amazon,27,21,6,3,6,0
,TOMS Men's Black on Black Canvas Classics Size 11.5 10002931,TOMS Men's Black on Black Canvas Classics Size 11.5 10002931,Default Ridgefield,26,26,0,0,0,0
,TOMS Men's Black on Black Canvas Classics Size 11.5 10002931,TOMS Men's Black on Black Canvas Classics Size 11.5 10002931,FBALYB Amazon,-11,-11,0,5,0,0
,TOMS Men's Black on Black Canvas Classics Size 12 10002931,TOMS Men's Black on Black Canvas Classics Size 12 10002931,Default Ridgefield,3,3,0,0,0,0
,TOMS Men's Black on Black Canvas Classics Size 12 10002931,TOMS Men's Black on Black Canvas Classics Size 12 10002931,FBALYB Amazon,-1,-3,2,71,2,0
,TOMS Men's Black on Black Canvas Classics Size 13 10002931,TOMS Men's Black on Black Canvas Classics Size 13 10002931,FBALYB Amazon,-34,-34,0,0,0,0
,TOMS Men's Black on Black Canvas Classics Size 14 10002931,TOMS Men's Black on Black Canvas Classics Size 14 10002931,FBALYB Amazon,-4,-4,0,0,0,0
,TOMS Men's Black on Black Canvas Classics Size 7 10002931,TOMS Men's Black on Black Canvas Classics Size 7 10002931,FBALYB Amazon,-46,-46,0,0,0,0
,TOMS Men's Black on Black Canvas Classics Size 8 10002931,TOMS Men's Black on Black Canvas Classics Size 8 10002931,FBALYB Amazon,1,1,0,0,0,0
,TOMS Men's Black on Black Canvas Classics Size 8.5 10002931,TOMS Men's Black on Black Canvas Classics Size 8.5 10002931,Default Ridgefield,73,73,0,0,0,0
,TOMS Men's Black on Black Canvas Classics Size 8.5 10002931,TOMS Men's Black on Black Canvas Classics Size 8.5 10002931,FBALYB Amazon,-55,-55,0,0,0,0
,TOMS Men's Black on Black Canvas Classics Size 9 10002931,TOMS Men's Black on Black Canvas Classics Size 9 10002931,Default Oxford,1,1,0,0,0,0
,TOMS Men's Black on Black Canvas Classics Size 9 10002931,TOMS Men's Black on Black Canvas Classics Size 9 10002931,Default Ridgefield,141,141,0,0,0,0
,TOMS Men's Black on Black Canvas Classics Size 9 10002931,TOMS Men's Black on Black Canvas Classics Size 9 10002931,FBALYB Amazon,1,-1,2,0,2,0
,TOMS Men's Black on Black Canvas Classics Size 9.5 10002931,TOMS Men's Black on Black Canvas Classics Size 9.5 10002931,Default Oxford,5,5,0,0,0,0
,TOMS Men's Black on Black Canvas Classics Size 9.5 10002931,TOMS Men's Black on Black Canvas Classics Size 9.5 10002931,Default Ridgefield,289,289,0,0,0,0
,TOMS Men's Black on Black Canvas Classics Size 9.5 10002931,TOMS Men's Black on Black Canvas Classics Size 9.5 10002931,FBALYB Amazon,-54,-56,2,2,2,0
,TOMS Men's Navy Canvas Classics Size 10 001001A07,TOMS Men's Navy Canvas Classics Size 10 001001A07,FBALYB Amazon,37,36,1,0,1,0
,TOMS Men's Navy Canvas Classics Size 10.5 001001A07,TOMS Men's Navy Canvas Classics Size 10.5 001001A07,Default Ridgefield,35,35,0,0,0,0
,TOMS Men's Navy Canvas Classics Size 10.5 001001A07,TOMS Men's Navy Canvas Classics Size 10.5 001001A07,FBALYB Amazon,10,9,1,0,1,0
,TOMS Men's Navy Canvas Classics Size 11 001001A07,TOMS Men's Navy Canvas Classics Size 11 001001A07,Default Ridgefield,12,12,0,0,0,0
,TOMS Men's Navy Canvas Classics Size 11 001001A07,TOMS Men's Navy Canvas Classics Size 11 001001A07,FBALYB Amazon,7,6,1,0,1,0
,TOMS Men's Navy Canvas Classics Size 11.5 001001A07,TOMS Men's Navy Canvas Classics Size 11.5 001001A07,FBALYB Amazon,21,21,0,0,0,0
,TOMS Men's Navy Canvas Classics Size 12 001001A07,TOMS Men's Navy Canvas Classics Size 12 001001A07,FBALYB Amazon,30,30,0,0,0,0
,TOMS Men's Navy Canvas Classics Size 13 001001A07,TOMS Men's Navy Canvas Classics Size 13 001001A07,FBALYB Amazon,-2,-2,0,0,0,0
,TOMS Men's Navy Canvas Classics Size 8 001001A07,TOMS Men's Navy Canvas Classics Size 8 001001A07,FBALYB Amazon,9,8,1,0,1,0
,TOMS Men's Navy Canvas Classics Size 8.5 001001A07,TOMS Men's Navy Canvas Classics Size 8.5 001001A07,Default Ridgefield,6,6,0,0,0,0
,TOMS Men's Navy Canvas Classics Size 8.5 001001A07,TOMS Men's Navy Canvas Classics Size 8.5 001001A07,FBALYB Amazon,17,16,1,0,1,0
,TOMS Men's Navy Canvas Classics Size 9 001001A07,TOMS Men's Navy Canvas Classics Size 9 001001A07,Default Ridgefield,41,41,0,0,0,0
,TOMS Men's Navy Canvas Classics Size 9 001001A07,TOMS Men's Navy Canvas Classics Size 9 001001A07,FBALYB Amazon,15,15,0,13,0,0
,TOMS Men's Navy Canvas Classics Size 9.5 001001A07,TOMS Men's Navy Canvas Classics Size 9.5 001001A07,Default Ridgefield,58,58,0,0,0,0
,TOMS Men's Navy Canvas Classics Size 9.5 001001A07,TOMS Men's Navy Canvas Classics Size 9.5 001001A07,FBALYB Amazon,42,41,1,0,1,0
,TOMS Men's Red Canvas Classics Size 10 001001A07,TOMS Men's Red Canvas Classics Size 10 001001A07,FBALYB Amazon,2,2,0,0,0,0
,TOMS Men's Red Canvas Classics Size 10.5 001001A07,TOMS Men's Red Canvas Classics Size 10.5 001001A07,FBALYB Amazon,35,33,2,0,2,0
,TOMS Men's Red Canvas Classics Size 11 001001A07,TOMS Men's Red Canvas Classics Size 11 001001A07,FBALYB Amazon,3,1,2,0,2,0
,TOMS Men's Red Canvas Classics Size 11.5 001001A07,TOMS Men's Red Canvas Classics Size 11.5 001001A07,FBALYB Amazon,16,16,0,0,0,0
,TOMS Men's Red Canvas Classics Size 12 001001A07,TOMS Men's Red Canvas Classics Size 12 001001A07,FBALYB Amazon,-16,-16,0,0,0,0
,TOMS Men's Red Canvas Classics Size 13 001001A07,TOMS Men's Red Canvas Classics Size 13 001001A07,FBALYB Amazon,-8,-8,0,0,0,0
,TOMS Men's Red Canvas Classics Size 8 001001A07,TOMS Men's Red Canvas Classics Size 8 001001A07,FBALYB Amazon,3,0,3,0,3,0
,TOMS Men's Red Canvas Classics Size 8.5 001001A07,TOMS Men's Red Canvas Classics Size 8.5 001001A07,Default Ridgefield,25,25,0,0,0,0
,TOMS Men's Red Canvas Classics Size 8.5 001001A07,TOMS Men's Red Canvas Classics Size 8.5 001001A07,FBALYB Amazon,-12,-12,0,0,0,0
,TOMS Men's Red Canvas Classics Size 9 001001A07,TOMS Men's Red Canvas Classics Size 9 001001A07,Default Ridgefield,41,41,0,0,0,0
,TOMS Men's Red Canvas Classics Size 9 001001A07,TOMS Men's Red Canvas Classics Size 9 001001A07,FBALYB Amazon,5,5,0,0,0,0
,TOMS Men's Red Canvas Classics Size 9.5 001001A07,TOMS Men's Red Canvas Classics Size 9.5 001001A07,FBALYB Amazon,-6,-8,2,0,2,0
,Tom's of Maine Spearmint,Tom's of Maine Whole Care Toothpaste With Flouride Spearmint Flavor 4.7 Ounce Tube (pack of 3),FBALYB Amazon,17,17,0,0,0,0
,Tom's of Maine Toothpaste,Tom's of Maine Whole Care Toothpaste With Flouride Peppermint Flavor 4.7 Ounce Tube (pack of 3),FBALYB Amazon,3,3,0,0,0,0
,TOMS Women's Black Canvas Avalon Size 10 10006322,TOMS Women's Black Canvas Avalon Size 10 10006322,Default Ridgefield,36,36,0,0,0,0
,TOMS Women's Black Canvas Avalon Size 10 10006322,TOMS Women's Black Canvas Avalon Size 10 10006322,FBALYB Amazon,16,16,0,0,0,0
,TOMS Women's Black Canvas Avalon Size 11 10006322,TOMS Women's Black Canvas Avalon Size 11 10006322,FBALYB Amazon,26,23,3,0,3,0
,TOMS Women's Black Canvas Avalon Size 6 10006322,TOMS Women's Black Canvas Avalon Size 6 10006322,FBALYB Amazon,2,2,0,0,0,0
,TOMS Women's Black Canvas Avalon Size 6.5 10006322,TOMS Women's Black Canvas Avalon Size 6.5 10006322,FBALYB Amazon,45,45,0,0,0,0
,TOMS Women's Black Canvas Avalon Size 7 10006322,TOMS Women's Black Canvas Avalon Size 7 10006322,Default Ridgefield,66,66,0,0,0,0
,TOMS Women's Black Canvas Avalon Size 7 10006322,TOMS Women's Black Canvas Avalon Size 7 10006322,FBALYB Amazon,35,35,0,0,0,0
,TOMS Women's Black Canvas Avalon Size 7.5 10006322,TOMS Women's Black Canvas Avalon Size 7.5 10006322,Default Ridgefield,130,130,0,0,0,0
,TOMS Women's Black Canvas Avalon Size 7.5 10006322,TOMS Women's Black Canvas Avalon Size 7.5 10006322,FBALYB Amazon,-2,-2,0,0,0,0
,TOMS Women's Black Canvas Avalon Size 8 10006322,TOMS Women's Black Canvas Avalon Size 8 10006322,Default Ridgefield,81,81,0,0,0,0
,TOMS Women's Black Canvas Avalon Size 8 10006322,TOMS Women's Black Canvas Avalon Size 8 10006322,FBALYB Amazon,47,47,0,0,0,0
,TOMS Women's Black Canvas Avalon Size 8.5 10006322,TOMS Women's Black Canvas Avalon Size 8.5 10006322,Default Ridgefield,136,136,0,0,0,0
,TOMS Women's Black Canvas Avalon Size 8.5 10006322,TOMS Women's Black Canvas Avalon Size 8.5 10006322,FBALYB Amazon,-5,-5,0,0,0,0
,TOMS Women's Black Canvas Avalon Size 9 10006322,TOMS Women's Black Canvas Avalon Size 9 10006322,Default Ridgefield,46,46,0,0,0,0
,TOMS Women's Black Canvas Avalon Size 9 10006322,TOMS Women's Black Canvas Avalon Size 9 10006322,FBALYB Amazon,27,23,4,0,4,0
,TOMS Women's Black Canvas Avalon Size 9.5 10006322,TOMS Women's Black Canvas Avalon Size 9.5 10006322,FBALYB Amazon,4,3,1,0,1,0
,TOMS Women's Black Canvas Classics Size 10 001001B07,TOMS Women's Black Canvas Classics Size 10 001001B07,Default Ridgefield,366,366,0,0,0,0
,TOMS Women's Black Canvas Classics Size 10 001001B07,TOMS Women's Black Canvas Classics Size 10 001001B07,FBALYB Amazon,48,47,1,0,1,0
,TOMS Women's Black Canvas Classics Size 11 001001B07,TOMS Women's Black Canvas Classics Size 11 001001B07,FBALYB Amazon,199,192,7,0,7,0
,TOMS Women's Black Canvas Classics Size 12 001001B07,TOMS Women's Black Canvas Classics Size 12 001001B07,FBALYB Amazon,-17,-17,0,0,0,0
,TOMS Women's Black Canvas Classics Size 5 001001B07,TOMS Women's Black Canvas Classics Size 5 001001B07,Default Oxford,4,4,0,0,0,0
,TOMS Women's Black Canvas Classics Size 5 001001B07,TOMS Women's Black Canvas Classics Size 5 001001B07,Default Ridgefield,192,192,0,0,0,0
,TOMS Women's Black Canvas Classics Size 5 001001B07,TOMS Women's Black Canvas Classics Size 5 001001B07,FBALYB Amazon,-25,-25,0,0,0,0
,TOMS Women's Black Canvas Classics Size 5.5 001001B07,TOMS Women's Black Canvas Classics Size 5.5 001001B07,FBALYB Amazon,-21,-22,1,1,1,0
,TOMS Women's Black Canvas Classics Size 6 001001B07,TOMS Women's Black Canvas Classics Size 6 001001B07,Default,0,0,0,0,0,2
,TOMS Women's Black Canvas Classics Size 6 001001B07,TOMS Women's Black Canvas Classics Size 6 001001B07,Default Ridgefield,154,154,0,0,0,0
,TOMS Women's Black Canvas Classics Size 6 001001B07,TOMS Women's Black Canvas Classics Size 6 001001B07,FBALYB Amazon,121,118,3,0,3,0
,TOMS Women's Black Canvas Classics Size 6.5 001001B07,TOMS Women's Black Canvas Classics Size 6.5 001001B07,Default Oxford,77,77,0,0,0,0
,TOMS Women's Black Canvas Classics Size 6.5 001001B07,TOMS Women's Black Canvas Classics Size 6.5 001001B07,Default Ridgefield,98,98,0,0,0,0
,TOMS Women's Black Canvas Classics Size 6.5 001001B07,TOMS Women's Black Canvas Classics Size 6.5 001001B07,FBALYB Amazon,73,71,2,0,2,0
,TOMS Women's Black Canvas Classics Size 7 001001B07,TOMS Women's Black Canvas Classics Size 7 001001B07,Default,0,0,0,0,0,48
,TOMS Women's Black Canvas Classics Size 7 001001B07,TOMS Women's Black Canvas Classics Size 7 001001B07,Default Ridgefield,515,515,0,0,0,0
,TOMS Women's Black Canvas Classics Size 7 001001B07,TOMS Women's Black Canvas Classics Size 7 001001B07,FBALYB Amazon,114,107,7,1,7,0
,TOMS Women's Black Canvas Classics Size 7.5 001001B07,TOMS Women's Black Canvas Classics Size 7.5 001001B07,Default Ridgefield,426,426,0,0,0,0
,TOMS Women's Black Canvas Classics Size 7.5 001001B07,TOMS Women's Black Canvas Classics Size 7.5 001001B07,FBALYB Amazon,34,30,4,0,4,0
,TOMS Women's Black Canvas Classics Size 8 001001B07,TOMS Women's Black Canvas Classics Size 8 001001B07,Default,0,0,0,0,0,1
,TOMS Women's Black Canvas Classics Size 8 001001B07,TOMS Women's Black Canvas Classics Size 8 001001B07,Default Ridgefield,740,740,0,0,0,0
,TOMS Women's Black Canvas Classics Size 8 001001B07,TOMS Women's Black Canvas Classics Size 8 001001B07,FBALYB Amazon,390,388,2,32,2,0
,TOMS Women's Black Canvas Classics Size 8.5 001001B07,TOMS Women's Black Canvas Classics Size 8.5 001001B07,Default,0,0,0,0,0,3
,TOMS Women's Black Canvas Classics Size 8.5 001001B07,TOMS Women's Black Canvas Classics Size 8.5 001001B07,Default Ridgefield,830,830,0,0,0,0
,TOMS Women's Black Canvas Classics Size 8.5 001001B07,TOMS Women's Black Canvas Classics Size 8.5 001001B07,FBALYB Amazon,383,377,6,9,6,0
,TOMS Women's Black Canvas Classics Size 9 001001B07,TOMS Women's Black Canvas Classics Size 9 001001B07,Default Ridgefield,565,565,0,0,0,0
,TOMS Women's Black Canvas Classics Size 9 001001B07,TOMS Women's Black Canvas Classics Size 9 001001B07,FBALYB Amazon,20,20,0,1,0,0
,TOMS Women's Black Canvas Classics Size 9.5 001001B07,TOMS Women's Black Canvas Classics Size 9.5 001001B07,Default Ridgefield,2,2,0,0,0,0
,TOMS Women's Black Canvas Classics Size 9.5 001001B07,TOMS Women's Black Canvas Classics Size 9.5 001001B07,FBALYB Amazon,242,239,3,0,3,0
,TOMS Women's Black Jutti Ballet Flat Size 10 10012994,TOMS Women's Black Jutti Ballet Flat Size 10 10012994,FBALYB Amazon,-5,-5,0,0,0,0
,TOMS Women's Black Jutti Ballet Flat Size 11 10012994,TOMS Women's Black Jutti Ballet Flat Size 11 10012994,FBALYB Amazon,-8,-8,0,0,0,0
,TOMS Women's Black Jutti Ballet Flat Size 5 10012994,TOMS Women's Black Jutti Ballet Flat Size 5 10012994,FBALYB Amazon,-1,-1,0,0,0,0
,TOMS Women's Black Jutti Ballet Flat Size 6 10012994,TOMS Women's Black Jutti Ballet Flat Size 6 10012994,FBALYB Amazon,-3,-3,0,0,0,0
,TOMS Women's Black Jutti Ballet Flat Size 7 10012994,TOMS Women's Black Jutti Ballet Flat Size 7 10012994,FBALYB Amazon,-6,-6,0,0,0,0
,TOMS Women's Black Jutti Ballet Flat Size 7.5 10012994,TOMS Women's Black Jutti Ballet Flat Size 7.5 10012994,FBALYB Amazon,-9,-9,0,0,0,0
,TOMS Women's Black Jutti Ballet Flat Size 8 10012994,TOMS Women's Black Jutti Ballet Flat Size 8 10012994,FBALYB Amazon,-15,-15,0,0,0,0
,TOMS Women's Black Jutti Ballet Flat Size 8.5 10012994,TOMS Women's Black Jutti Ballet Flat Size 8.5 10012994,FBALYB Amazon,-9,-9,0,0,0,0
,TOMS Women's Black Jutti Ballet Flat Size 9 10012994,TOMS Women's Black Jutti Ballet Flat Size 9 10012994,FBALYB Amazon,-2,-2,0,0,0,0
,TOMS Women's Black Jutti Ballet Flat Size 9.5 10012994,TOMS Women's Black Jutti Ballet Flat Size 9.5 10012994,FBALYB Amazon,-7,-7,0,0,0,0
,TOMS Women's Black on Black Canvas Classics Size 10 10002472,TOMS Women's Black on Black Canvas Classics Size 10 10002472,Default Ridgefield,37,37,0,0,0,0
,TOMS Women's Black on Black Canvas Classics Size 10 10002472,TOMS Women's Black on Black Canvas Classics Size 10 10002472,FBALYB Amazon,259,246,13,0,13,0
,TOMS Women's Black on Black Canvas Classics Size 11 10002472,TOMS Women's Black on Black Canvas Classics Size 11 10002472,FBALYB Amazon,20,13,7,0,7,0
,TOMS Women's Black on Black Canvas Classics Size 12 10002472,TOMS Women's Black on Black Canvas Classics Size 12 10002472,FBALYB Amazon,-6,-6,0,0,0,0
,TOMS Women's Black on Black Canvas Classics Size 5 10002472,TOMS Women's Black on Black Canvas Classics Size 5 10002472,Default Oxford,72,72,0,0,0,0
,TOMS Women's Black on Black Canvas Classics Size 5 10002472,TOMS Women's Black on Black Canvas Classics Size 5 10002472,FBALYB Amazon,30,25,5,0,5,0
,TOMS Women's Black on Black Canvas Classics Size 5.5 10002472,TOMS Women's Black on Black Canvas Classics Size 5.5 10002472,FBALYB Amazon,-19,-19,0,1,0,0
,TOMS Women's Black on Black Canvas Classics Size 6 10002472,TOMS Women's Black on Black Canvas Classics Size 6 10002472,Default Ridgefield,1,1,0,0,0,0
,TOMS Women's Black on Black Canvas Classics Size 6 10002472,TOMS Women's Black on Black Canvas Classics Size 6 10002472,FBALYB Amazon,-26,-28,2,0,2,0
,TOMS Women's Black on Black Canvas Classics Size 6.5 10002472,TOMS Women's Black on Black Canvas Classics Size 6.5 10002472,Default Ridgefield,13,13,0,0,0,0
,TOMS Women's Black on Black Canvas Classics Size 6.5 10002472,TOMS Women's Black on Black Canvas Classics Size 6.5 10002472,FBALYB Amazon,-49,-55,6,0,6,0
,TOMS Women's Black on Black Canvas Classics Size 7 10002472,TOMS Women's Black on Black Canvas Classics Size 7 10002472,Default Oxford,12,12,0,0,0,0
,TOMS Women's Black on Black Canvas Classics Size 7 10002472,TOMS Women's Black on Black Canvas Classics Size 7 10002472,Default Ridgefield,1,1,0,0,0,0
,TOMS Women's Black on Black Canvas Classics Size 7 10002472,TOMS Women's Black on Black Canvas Classics Size 7 10002472,FBALYB Amazon,45,27,18,0,18,0
,TOMS Women's Black on Black Canvas Classics Size 7.5 10002472,TOMS Women's Black on Black Canvas Classics Size 7.5 10002472,Default Oxford,4,4,0,0,0,0
,TOMS Women's Black on Black Canvas Classics Size 7.5 10002472,TOMS Women's Black on Black Canvas Classics Size 7.5 10002472,FBALYB Amazon,-120,-134,14,0,14,0
,TOMS Women's Black on Black Canvas Classics Size 8 10002472,TOMS Women's Black on Black Canvas Classics Size 8 10002472,Default Ridgefield,44,44,0,0,0,0
,TOMS Women's Black on Black Canvas Classics Size 8 10002472,TOMS Women's Black on Black Canvas Classics Size 8 10002472,FBALYB Amazon,-76,-101,25,0,25,0
,TOMS Women's Black on Black Canvas Classics Size 8.5 10002472,TOMS Women's Black on Black Canvas Classics Size 8.5 10002472,Default Ridgefield,156,156,0,0,0,0
,TOMS Women's Black on Black Canvas Classics Size 8.5 10002472,TOMS Women's Black on Black Canvas Classics Size 8.5 10002472,FBALYB Amazon,459,437,22,1,22,0
,TOMS Women's Black on Black Canvas Classics Size 9 10002472,TOMS Women's Black on Black Canvas Classics Size 9 10002472,Default Ridgefield,2,2,0,0,0,0
,TOMS Women's Black on Black Canvas Classics Size 9 10002472,TOMS Women's Black on Black Canvas Classics Size 9 10002472,FBALYB Amazon,-492,-494,2,387,2,0
,TOMS Women's Black on Black Canvas Classics Size 9.5 10002472,TOMS Women's Black on Black Canvas Classics Size 9.5 10002472,Default Ridgefield,7,7,0,0,0,0
,TOMS Women's Black on Black Canvas Classics Size 9.5 10002472,TOMS Women's Black on Black Canvas Classics Size 9.5 10002472,FBALYB Amazon,59,46,13,28,13,0
,TOMS Women's Grey Canvas Classics Size 10 001001B07,TOMS Women's Grey Canvas Classics Size 10 001001B07,Default Ridgefield,109,109,0,0,0,0
,TOMS Women's Grey Canvas Classics Size 10 001001B07,TOMS Women's Grey Canvas Classics Size 10 001001B07,FBALYB Amazon,-2,-2,0,0,0,0
,TOMS Women's Grey Canvas Classics Size 11 001001B07,TOMS Women's Grey Canvas Classics Size 11 001001B07,Default Ridgefield,14,14,0,0,0,0
,TOMS Women's Grey Canvas Classics Size 11 001001B07,TOMS Women's Grey Canvas Classics Size 11 001001B07,FBALYB Amazon,70,69,1,0,1,0
,TOMS Women's Grey Canvas Classics Size 5 001001B07,TOMS Women's Grey Canvas Classics Size 5 001001B07,Default Ridgefield,2,2,0,0,0,0
,TOMS Women's Grey Canvas Classics Size 5 001001B07,TOMS Women's Grey Canvas Classics Size 5 001001B07,FBALYB Amazon,41,40,1,0,1,0
,TOMS Women's Grey Canvas Classics Size 6 001001B07,TOMS Women's Grey Canvas Classics Size 6 001001B07,Default Ridgefield,89,89,0,0,0,0
,TOMS Women's Grey Canvas Classics Size 6 001001B07,TOMS Women's Grey Canvas Classics Size 6 001001B07,FBALYB Amazon,-8,-8,0,0,0,0
,TOMS Women's Grey Canvas Classics Size 6.5 001001B07,TOMS Women's Grey Canvas Classics Size 6.5 001001B07,Default,0,0,0,0,0,1
,TOMS Women's Grey Canvas Classics Size 6.5 001001B07,TOMS Women's Grey Canvas Classics Size 6.5 001001B07,Default Oxford,23,23,0,0,0,0
,TOMS Women's Grey Canvas Classics Size 6.5 001001B07,TOMS Women's Grey Canvas Classics Size 6.5 001001B07,Default Ridgefield,124,121,3,0,0,0
,TOMS Women's Grey Canvas Classics Size 6.5 001001B07,TOMS Women's Grey Canvas Classics Size 6.5 001001B07,FBALYB Amazon,9,9,0,0,0,0
,TOMS Women's Grey Canvas Classics Size 7 001001B07,TOMS Women's Grey Canvas Classics Size 7 001001B07,Default Ridgefield,225,225,0,0,0,0
,TOMS Women's Grey Canvas Classics Size 7 001001B07,TOMS Women's Grey Canvas Classics Size 7 001001B07,FBALYB Amazon,-8,-8,0,0,0,0
,TOMS Women's Grey Canvas Classics Size 7.5 001001B07,TOMS Women's Grey Canvas Classics Size 7.5 001001B07,Default Ridgefield,112,112,0,0,0,0
,TOMS Women's Grey Canvas Classics Size 7.5 001001B07,TOMS Women's Grey Canvas Classics Size 7.5 001001B07,FBALYB Amazon,77,72,5,1,5,0
,TOMS Women's Grey Canvas Classics Size 8 001001B07,TOMS Women's Grey Canvas Classics Size 8 001001B07,Default Ridgefield,339,339,0,0,0,0
,TOMS Women's Grey Canvas Classics Size 8 001001B07,TOMS Women's Grey Canvas Classics Size 8 001001B07,FBALYB Amazon,-14,-14,0,0,0,0
,TOMS Women's Grey Canvas Classics Size 8.5 001001B07,TOMS Women's Grey Canvas Classics Size 8.5 001001B07,Default Ridgefield,95,95,0,0,0,0
,TOMS Women's Grey Canvas Classics Size 8.5 001001B07,TOMS Women's Grey Canvas Classics Size 8.5 001001B07,FBALYB Amazon,75,70,5,0,5,0
,TOMS Women's Grey Canvas Classics Size 9 001001B07,TOMS Women's Grey Canvas Classics Size 9 001001B07,Default Ridgefield,38,38,0,0,0,0
,TOMS Women's Grey Canvas Classics Size 9 001001B07,TOMS Women's Grey Canvas Classics Size 9 001001B07,FBALYB Amazon,170,164,6,0,6,0
,TOMS Women's Grey Canvas Classics Size 9.5 001001B07,TOMS Women's Grey Canvas Classics Size 9.5 001001B07,Default Ridgefield,159,159,0,0,0,0
,TOMS Women's Grey Canvas Classics Size 9.5 001001B07,TOMS Women's Grey Canvas Classics Size 9.5 001001B07,FBALYB Amazon,-7,-7,0,0,0,0
,TOMS Women's MORNING DOVE HERITAG WM ALPCP SLIPON SIZE 10 10013492,TOMS Women's MORNING DOVE HERITAG WM ALPCP SLIPON SIZE 10 10013492,FBALYB Amazon,12,12,0,0,0,0
,TOMS Women's MORNING DOVE HERITAG WM ALPCP SLIPON SIZE 7 10013492,TOMS Women's MORNING DOVE HERITAG WM ALPCP SLIPON SIZE 7 10013492,FBALYB Amazon,27,27,0,0,0,0
,TOMS Women's MORNING DOVE HERITAG WM ALPCP SLIPON SIZE 7.5 10013492,TOMS Women's MORNING DOVE HERITAG WM ALPCP SLIPON SIZE 7.5 10013492,FBALYB Amazon,14,12,2,0,2,0
,TOMS Women's MORNING DOVE HERITAG WM ALPCP SLIPON SIZE 8 10013492,TOMS Women's MORNING DOVE HERITAG WM ALPCP SLIPON SIZE 8 10013492,FBALYB Amazon,26,25,1,0,1,0
,TOMS Women's MORNING DOVE HERITAG WM ALPCP SLIPON SIZE 8.5 10013492,TOMS Women's MORNING DOVE HERITAG WM ALPCP SLIPON SIZE 8.5 10013492,FBALYB Amazon,37,37,0,0,0,0
,TOMS Women's MORNING DOVE HERITAG WM ALPCP SLIPON SIZE 9 10013492,TOMS Women's MORNING DOVE HERITAG WM ALPCP SLIPON SIZE 9 10013492,FBALYB Amazon,10,10,0,0,0,0
,TOMS Women's MORNING DOVE HERITAG WM ALPCP SLIPON SIZE 9.5 10013492,TOMS Women's MORNING DOVE HERITAG WM ALPCP SLIPON SIZE 9.5 10013492,FBALYB Amazon,11,11,0,0,0,0
,TOMS Women's NATURAL METALLIC WOV WM ALPR ESP SIZE 10 10014487,TOMS Women's NATURAL METALLIC WOV WM ALPR ESP SIZE 10 10014487,FBALYB Amazon,17,17,0,0,0,0
,TOMS Women's NATURAL METALLIC WOV WM ALPR ESP SIZE 11 10014487,TOMS Women's NATURAL METALLIC WOV WM ALPR ESP SIZE 11 10014487,FBALYB Amazon,30,30,0,0,0,0
,TOMS Women's NATURAL METALLIC WOV WM ALPR ESP SIZE 6 10014487,TOMS Women's NATURAL METALLIC WOV WM ALPR ESP SIZE 6 10014487,FBALYB Amazon,26,26,0,0,0,0
,TOMS Women's NATURAL METALLIC WOV WM ALPR ESP SIZE 6.5 10014487,TOMS Women's NATURAL METALLIC WOV WM ALPR ESP SIZE 6.5 10014487,FBALYB Amazon,38,38,0,0,0,0
,TOMS Women's NATURAL METALLIC WOV WM ALPR ESP SIZE 7 10014487,TOMS Women's NATURAL METALLIC WOV WM ALPR ESP SIZE 7 10014487,Default Ridgefield,53,53,0,0,0,0
,TOMS Women's NATURAL METALLIC WOV WM ALPR ESP SIZE 7 10014487,TOMS Women's NATURAL METALLIC WOV WM ALPR ESP SIZE 7 10014487,FBALYB Amazon,21,21,0,0,0,0
,TOMS Women's NATURAL METALLIC WOV WM ALPR ESP SIZE 7.5 10014487,TOMS Women's NATURAL METALLIC WOV WM ALPR ESP SIZE 7.5 10014487,Default Ridgefield,33,33,0,0,0,0
,TOMS Women's NATURAL METALLIC WOV WM ALPR ESP SIZE 7.5 10014487,TOMS Women's NATURAL METALLIC WOV WM ALPR ESP SIZE 7.5 10014487,FBALYB Amazon,14,14,0,0,0,0
,TOMS Women's NATURAL METALLIC WOV WM ALPR ESP SIZE 8 10014487,TOMS Women's NATURAL METALLIC WOV WM ALPR ESP SIZE 8 10014487,Default Ridgefield,52,52,0,0,0,0
,TOMS Women's NATURAL METALLIC WOV WM ALPR ESP SIZE 8 10014487,TOMS Women's NATURAL METALLIC WOV WM ALPR ESP SIZE 8 10014487,FBALYB Amazon,35,35,0,0,0,0
,TOMS Women's NATURAL METALLIC WOV WM ALPR ESP SIZE 8.5 10014487,TOMS Women's NATURAL METALLIC WOV WM ALPR ESP SIZE 8.5 10014487,Default Ridgefield,34,34,0,0,0,0
,TOMS Women's NATURAL METALLIC WOV WM ALPR ESP SIZE 8.5 10014487,TOMS Women's NATURAL METALLIC WOV WM ALPR ESP SIZE 8.5 10014487,FBALYB Amazon,21,20,1,0,1,0
,TOMS Women's NATURAL METALLIC WOV WM ALPR ESP SIZE 9 10014487,TOMS Women's NATURAL METALLIC WOV WM ALPR ESP SIZE 9 10014487,Default Ridgefield,59,59,0,0,0,0
,TOMS Women's NATURAL METALLIC WOV WM ALPR ESP SIZE 9 10014487,TOMS Women's NATURAL METALLIC WOV WM ALPR ESP SIZE 9 10014487,FBALYB Amazon,21,21,0,0,0,0
,TOMS Women's NATURAL METALLIC WOV WM ALPR ESP SIZE 9.5 10014487,TOMS Women's NATURAL METALLIC WOV WM ALPR ESP SIZE 9.5 10014487,FBALYB Amazon,31,31,0,0,0,0
,TOMS Women's Natural Yarn Dye Majorca Cutout Size 10 10009814,TOMS Women's Natural Yarn Dye Majorca Cutout Size 10 10009814,FBALYB Amazon,-19,-19,0,0,0,0
,TOMS Women's Natural Yarn Dye Majorca Cutout Size 11 10009814,TOMS Women's Natural Yarn Dye Majorca Cutout Size 11 10009814,FBALYB Amazon,-10,-10,0,0,0,0
,TOMS Women's Natural Yarn Dye Majorca Cutout Size 5 10009814,TOMS Women's Natural Yarn Dye Majorca Cutout Size 5 10009814,FBALYB Amazon,-8,-8,0,0,0,0
,TOMS Women's Natural Yarn Dye Majorca Cutout Size 5.5 10009814,TOMS Women's Natural Yarn Dye Majorca Cutout Size 5.5 10009814,FBALYB Amazon,-8,-8,0,0,0,0
,TOMS Women's Natural Yarn Dye Majorca Cutout Size 6 10009814,TOMS Women's Natural Yarn Dye Majorca Cutout Size 6 10009814,FBALYB Amazon,-6,-6,0,0,0,0
,TOMS Women's Natural Yarn Dye Majorca Cutout Size 6.5 10009814,TOMS Women's Natural Yarn Dye Majorca Cutout Size 6.5 10009814,FBALYB Amazon,-25,-25,0,0,0,0
,TOMS Women's Natural Yarn Dye Majorca Cutout Size 7 10009814,TOMS Women's Natural Yarn Dye Majorca Cutout Size 7 10009814,FBALYB Amazon,-17,-17,0,0,0,0
,TOMS Women's Natural Yarn Dye Majorca Cutout Size 7.5 10009814,TOMS Women's Natural Yarn Dye Majorca Cutout Size 7.5 10009814,FBALYB Amazon,-22,-22,0,0,0,0
,TOMS Women's Natural Yarn Dye Majorca Cutout Size 8 10009814,TOMS Women's Natural Yarn Dye Majorca Cutout Size 8 10009814,FBALYB Amazon,-17,-17,0,0,0,0
,TOMS Women's Natural Yarn Dye Majorca Cutout Size 8.5 10009814,TOMS Women's Natural Yarn Dye Majorca Cutout Size 8.5 10009814,FBALYB Amazon,-18,-18,0,0,0,0
,TOMS Women's Natural Yarn Dye Majorca Cutout Size 9 10009814,TOMS Women's Natural Yarn Dye Majorca Cutout Size 9 10009814,FBALYB Amazon,-9,-9,0,0,0,0
,TOMS Women's Natural Yarn Dye Majorca Cutout Size 9.5 10009814,TOMS Women's Natural Yarn Dye Majorca Cutout Size 9.5 10009814,FBALYB Amazon,-17,-17,0,0,0,0
,TOMS Women's Navy Canvas Classics Size 10 001001B07,TOMS Women's Navy Canvas Classics Size 10 001001B07,Default Ridgefield,222,222,0,0,0,0
,TOMS Women's Navy Canvas Classics Size 10 001001B07,TOMS Women's Navy Canvas Classics Size 10 001001B07,FBALYB Amazon,197,197,0,0,0,0
,TOMS Women's Navy Canvas Classics Size 6 001001B07,TOMS Women's Navy Canvas Classics Size 6 001001B07,Default Ridgefield,76,76,0,0,0,0
,TOMS Women's Navy Canvas Classics Size 6 001001B07,TOMS Women's Navy Canvas Classics Size 6 001001B07,FBALYB Amazon,-9,-9,0,0,0,0
,TOMS Women's Navy Canvas Classics Size 6.5 001001B07,TOMS Women's Navy Canvas Classics Size 6.5 001001B07,Default Ridgefield,83,83,0,0,0,0
,TOMS Women's Navy Canvas Classics Size 6.5 001001B07,TOMS Women's Navy Canvas Classics Size 6.5 001001B07,FBALYB Amazon,-10,-10,0,0,0,0
,TOMS Women's Navy Canvas Classics Size 7 001001B07,TOMS Women's Navy Canvas Classics Size 7 001001B07,Default Ridgefield,207,207,0,0,0,0
,TOMS Women's Navy Canvas Classics Size 7 001001B07,TOMS Women's Navy Canvas Classics Size 7 001001B07,FBALYB Amazon,-13,-13,0,0,0,0
,TOMS Women's Navy Canvas Classics Size 7.5 001001B07,TOMS Women's Navy Canvas Classics Size 7.5 001001B07,Default Ridgefield,251,251,0,0,0,0
,TOMS Women's Navy Canvas Classics Size 7.5 001001B07,TOMS Women's Navy Canvas Classics Size 7.5 001001B07,FBALYB Amazon,-22,-22,0,0,0,0
,TOMS Women's Navy Canvas Classics Size 8 001001B07,TOMS Women's Navy Canvas Classics Size 8 001001B07,Default Oxford,12,12,0,0,0,0
,TOMS Women's Navy Canvas Classics Size 8 001001B07,TOMS Women's Navy Canvas Classics Size 8 001001B07,Default Ridgefield,182,182,0,0,0,0
,TOMS Women's Navy Canvas Classics Size 8 001001B07,TOMS Women's Navy Canvas Classics Size 8 001001B07,FBALYB Amazon,178,174,4,28,4,0
,TOMS Women's Navy Canvas Classics Size 8.5 001001B07,TOMS Women's Navy Canvas Classics Size 8.5 001001B07,Default Ridgefield,219,219,0,0,0,0
,TOMS Women's Navy Canvas Classics Size 8.5 001001B07,TOMS Women's Navy Canvas Classics Size 8.5 001001B07,FBALYB Amazon,98,97,1,0,1,0
,TOMS Women's Navy Canvas Classics Size 9 001001B07,TOMS Women's Navy Canvas Classics Size 9 001001B07,Default Ridgefield,46,46,0,0,0,0
,TOMS Women's Navy Canvas Classics Size 9 001001B07,TOMS Women's Navy Canvas Classics Size 9 001001B07,FBALYB Amazon,179,175,4,0,4,0
,TOMS Women's Navy Canvas Classics Size 9.5 001001B07,TOMS Women's Navy Canvas Classics Size 9.5 001001B07,Default Ridgefield,107,107,0,0,0,0
,TOMS Women's Navy Canvas Classics Size 9.5 001001B07,TOMS Women's Navy Canvas Classics Size 9.5 001001B07,FBALYB Amazon,85,80,5,0,5,0
,TOMS Women's Navy Classic Espadrille Wedge Size 10 10014030,TOMS Women's Navy Classic Espadrille Wedge Size 10 10014030,FBALYB Amazon,-10,-10,0,0,0,0
,TOMS Women's Navy Classic Espadrille Wedge Size 5 10014030,TOMS Women's Navy Classic Espadrille Wedge Size 5 10014030,FBALYB Amazon,5,5,0,0,0,0
,TOMS Women's Navy Classic Espadrille Wedge Size 5.5 10014030,TOMS Women's Navy Classic Espadrille Wedge Size 5.5 10014030,FBALYB Amazon,-1,-1,0,0,0,0
,TOMS Women's Navy Classic Espadrille Wedge Size 6.5 10014030,TOMS Women's Navy Classic Espadrille Wedge Size 6.5 10014030,FBALYB Amazon,-2,-2,0,0,0,0
,TOMS Women's Navy Classic Espadrille Wedge Size 7 10014030,TOMS Women's Navy Classic Espadrille Wedge Size 7 10014030,FBALYB Amazon,-3,-3,0,0,0,0
,TOMS Women's Navy Classic Espadrille Wedge Size 7.5 10014030,TOMS Women's Navy Classic Espadrille Wedge Size 7.5 10014030,FBALYB Amazon,-5,-5,0,0,0,0
,TOMS Women's Navy Classic Espadrille Wedge Size 8 10014030,TOMS Women's Navy Classic Espadrille Wedge Size 8 10014030,FBALYB Amazon,-14,-14,0,0,0,0
,TOMS Women's Navy Classic Espadrille Wedge Size 8.5 10014030,TOMS Women's Navy Classic Espadrille Wedge Size 8.5 10014030,FBALYB Amazon,-1,-1,0,0,0,0
,TOMS Women's Navy Classic Espadrille Wedge Size 9 10014030,TOMS Women's Navy Classic Espadrille Wedge Size 9 10014030,FBALYB Amazon,-5,-5,0,0,0,0
,TOMS Women's Navy Classic Espadrille Wedge Size 9.5 10014030,TOMS Women's Navy Classic Espadrille Wedge Size 9.5 10014030,FBALYB Amazon,-2,-2,0,0,0,0
,TOMS Women's Red Canvas Classics Size 10 001001B07,TOMS Women's Red Canvas Classics Size 10 001001B07,Default Ridgefield,26,26,0,0,0,0
,TOMS Women's Red Canvas Classics Size 10 001001B07,TOMS Women's Red Canvas Classics Size 10 001001B07,FBALYB Amazon,11,6,5,0,5,0
,TOMS Women's Red Canvas Classics Size 11 001001B07,TOMS Women's Red Canvas Classics Size 11 001001B07,FBALYB Amazon,-13,-13,0,0,0,0
,TOMS Women's Red Canvas Classics Size 6 001001B07,TOMS Women's Red Canvas Classics Size 6 001001B07,Default Ridgefield,1,1,0,0,0,0
,TOMS Women's Red Canvas Classics Size 6 001001B07,TOMS Women's Red Canvas Classics Size 6 001001B07,FBALYB Amazon,0,-1,1,3,1,0
,TOMS Women's Red Canvas Classics Size 6.5 001001B07,TOMS Women's Red Canvas Classics Size 6.5 001001B07,FBALYB Amazon,35,35,0,0,0,0
,TOMS Women's Red Canvas Classics Size 7 001001B07,TOMS Women's Red Canvas Classics Size 7 001001B07,Default,0,0,0,0,0,11
,TOMS Women's Red Canvas Classics Size 7 001001B07,TOMS Women's Red Canvas Classics Size 7 001001B07,Default Ridgefield,1,1,0,0,0,0
,TOMS Women's Red Canvas Classics Size 7 001001B07,TOMS Women's Red Canvas Classics Size 7 001001B07,FBALYB Amazon,50,46,4,0,4,0
,TOMS Women's Red Canvas Classics Size 7.5 001001B07,TOMS Women's Red Canvas Classics Size 7.5 001001B07,FBALYB Amazon,0,-15,15,0,15,0
,TOMS Women's Red Canvas Classics Size 8 001001B07,TOMS Women's Red Canvas Classics Size 8 001001B07,Default,0,0,0,0,0,2
,TOMS Women's Red Canvas Classics Size 8 001001B07,TOMS Women's Red Canvas Classics Size 8 001001B07,Default Ridgefield,4,4,0,0,0,0
,TOMS Women's Red Canvas Classics Size 8 001001B07,TOMS Women's Red Canvas Classics Size 8 001001B07,FBALYB Amazon,158,148,10,0,10,0
,TOMS Women's Red Canvas Classics Size 8.5 001001B07,TOMS Women's Red Canvas Classics Size 8.5 001001B07,Default Ridgefield,56,56,0,0,0,0
,TOMS Women's Red Canvas Classics Size 8.5 001001B07,TOMS Women's Red Canvas Classics Size 8.5 001001B07,FBALYB Amazon,38,34,4,33,4,0
,TOMS Women's Red Canvas Classics Size 9 001001B07,TOMS Women's Red Canvas Classics Size 9 001001B07,Default Ridgefield,147,147,0,0,0,0
,TOMS Women's Red Canvas Classics Size 9 001001B07,TOMS Women's Red Canvas Classics Size 9 001001B07,FBALYB Amazon,-63,-70,7,1,7,0
,TOMS Women's Red Canvas Classics Size 9.5 001001B07,TOMS Women's Red Canvas Classics Size 9.5 001001B07,FBALYB Amazon,29,26,3,0,3,0
,TOMS Women's Red Crosshatch Classic Wedge Size 10 10013671,TOMS Women's Red Crosshatch Classic Wedge Size 10 10013671,FBALYB Amazon,-3,-3,0,0,0,0
,TOMS Women's Red Crosshatch Classic Wedge Size 5 10013671,TOMS Women's Red Crosshatch Classic Wedge Size 5 10013671,FBALYB Amazon,52,52,0,0,0,0
,TOMS Women's Red Crosshatch Classic Wedge Size 5.5 10013671,TOMS Women's Red Crosshatch Classic Wedge Size 5.5 10013671,FBALYB Amazon,-9,-9,0,0,0,0
,TOMS Women's Red Crosshatch Classic Wedge Size 6 10013671,TOMS Women's Red Crosshatch Classic Wedge Size 6 10013671,FBALYB Amazon,-5,-5,0,0,0,0
,TOMS Women's Red Crosshatch Classic Wedge Size 6.5 10013671,TOMS Women's Red Crosshatch Classic Wedge Size 6.5 10013671,FBALYB Amazon,-2,-2,0,0,0,0
,TOMS Women's Red Crosshatch Classic Wedge Size 7 10013671,TOMS Women's Red Crosshatch Classic Wedge Size 7 10013671,FBALYB Amazon,-2,-2,0,0,0,0
,TOMS Women's Red Crosshatch Classic Wedge Size 7.5 10013671,TOMS Women's Red Crosshatch Classic Wedge Size 7.5 10013671,FBALYB Amazon,-5,-5,0,0,0,0
,TOMS Women's Red Crosshatch Classic Wedge Size 8 10013671,TOMS Women's Red Crosshatch Classic Wedge Size 8 10013671,FBALYB Amazon,-13,-13,0,0,0,0
,TOMS Women's Red Crosshatch Classic Wedge Size 8.5 10013671,TOMS Women's Red Crosshatch Classic Wedge Size 8.5 10013671,FBALYB Amazon,-2,-2,0,0,0,0
,TOMS Women's Red Crosshatch Classic Wedge Size 9 10013671,TOMS Women's Red Crosshatch Classic Wedge Size 9 10013671,FBALYB Amazon,-3,-3,0,0,0,0
,TOMS Women's ROSE GOLD MET WOVEN WM AVA SLIPON SIZE 10 10012400,TOMS Women's ROSE GOLD MET WOVEN WM AVA SLIPON SIZE 10 10012400,Default Ridgefield,2,2,0,0,0,0
,TOMS Women's ROSE GOLD MET WOVEN WM AVA SLIPON SIZE 10 10012400,TOMS Women's ROSE GOLD MET WOVEN WM AVA SLIPON SIZE 10 10012400,FBALYB Amazon,12,12,0,0,0,0
,TOMS Women's ROSE GOLD MET WOVEN WM AVA SLIPON SIZE 11 10012400,TOMS Women's ROSE GOLD MET WOVEN WM AVA SLIPON SIZE 11 10012400,Default Ridgefield,28,28,0,0,0,0
,TOMS Women's ROSE GOLD MET WOVEN WM AVA SLIPON SIZE 6 10012400,TOMS Women's ROSE GOLD MET WOVEN WM AVA SLIPON SIZE 6 10012400,FBALYB Amazon,5,4,1,0,1,0
,TOMS Women's ROSE GOLD MET WOVEN WM AVA SLIPON SIZE 6.5 10012400,TOMS Women's ROSE GOLD MET WOVEN WM AVA SLIPON SIZE 6.5 10012400,FBALYB Amazon,2,2,0,0,0,0
,TOMS Women's ROSE GOLD MET WOVEN WM AVA SLIPON SIZE 7 10012400,TOMS Women's ROSE GOLD MET WOVEN WM AVA SLIPON SIZE 7 10012400,FBALYB Amazon,25,24,1,36,1,0
,TOMS Women's ROSE GOLD MET WOVEN WM AVA SLIPON SIZE 7.5 10012400,TOMS Women's ROSE GOLD MET WOVEN WM AVA SLIPON SIZE 7.5 10012400,Default Ridgefield,89,89,0,0,0,0
,TOMS Women's ROSE GOLD MET WOVEN WM AVA SLIPON SIZE 8 10012400,TOMS Women's ROSE GOLD MET WOVEN WM AVA SLIPON SIZE 8 10012400,FBALYB Amazon,59,55,4,0,4,0
,TOMS Women's ROSE GOLD MET WOVEN WM AVA SLIPON SIZE 8.5 10012400,TOMS Women's ROSE GOLD MET WOVEN WM AVA SLIPON SIZE 8.5 10012400,FBALYB Amazon,23,18,5,45,5,0
,TOMS Women's ROSE GOLD MET WOVEN WM AVA SLIPON SIZE 9 10012400,TOMS Women's ROSE GOLD MET WOVEN WM AVA SLIPON SIZE 9 10012400,FBALYB Amazon,4,3,1,54,1,0
,TOMS Women's ROSE GOLD MET WOVEN WM AVA SLIPON SIZE 9.5 10012400,TOMS Women's ROSE GOLD MET WOVEN WM AVA SLIPON SIZE 9.5 10012400,Default Ridgefield,1,1,0,0,0,0
,TOMS Women's ROSE GOLD MET WOVEN WM AVA SLIPON SIZE 9.5 10012400,TOMS Women's ROSE GOLD MET WOVEN WM AVA SLIPON SIZE 9.5 10012400,FBALYB Amazon,5,5,0,0,0,0
,TOMS Women's White Canvas Classics Size 10 10013874,TOMS Women's White Canvas Classics Size 10 10013874,Default Ridgefield,3,3,0,0,0,0
,TOMS Women's White Canvas Classics Size 10 10013874,TOMS Women's White Canvas Classics Size 10 10013874,FBALYB Amazon,24,21,3,0,3,0
,TOMS Women's White Canvas Classics Size 11 10013874,TOMS Women's White Canvas Classics Size 11 10013874,FBALYB Amazon,105,105,0,0,0,0
,TOMS Women's White Canvas Classics Size 5 10013874,TOMS Women's White Canvas Classics Size 5 10013874,FBALYB Amazon,89,89,0,0,0,0
,TOMS Women's White Canvas Classics Size 5.5 10013874,TOMS Women's White Canvas Classics Size 5.5 10013874,FBALYB Amazon,91,91,0,0,0,0
,TOMS Women's White Canvas Classics Size 6 10013874,TOMS Women's White Canvas Classics Size 6 10013874,FBALYB Amazon,32,32,0,0,0,0
,TOMS Women's White Canvas Classics Size 6.5 10013874,TOMS Women's White Canvas Classics Size 6.5 10013874,FBALYB Amazon,-15,-15,0,0,0,0
,TOMS Women's White Canvas Classics Size 7 10013874,TOMS Women's White Canvas Classics Size 7 10013874,FBALYB Amazon,-7,-7,0,0,0,0
,TOMS Women's White Canvas Classics Size 7.5 10013874,TOMS Women's White Canvas Classics Size 7.5 10013874,Default,0,0,0,0,0,1
,TOMS Women's White Canvas Classics Size 7.5 10013874,TOMS Women's White Canvas Classics Size 7.5 10013874,FBALYB Amazon,-19,-20,1,0,1,0
,TOMS Women's White Canvas Classics Size 8 10013874,TOMS Women's White Canvas Classics Size 8 10013874,FBALYB Amazon,-21,-22,1,0,1,0
,TOMS Women's White Canvas Classics Size 8.5 10013874,TOMS Women's White Canvas Classics Size 8.5 10013874,FBALYB Amazon,-19,-19,0,0,0,0
,TOMS Women's White Canvas Classics Size 9 10013874,TOMS Women's White Canvas Classics Size 9 10013874,FBALYB Amazon,-25,-25,0,0,0,0
,TOMS Women's White Canvas Classics Size 9.5 10013874,TOMS Women's White Canvas Classics Size 9.5 10013874,FBALYB Amazon,-23,-24,1,1,1,0
,TOMS Wome's BLUE SLUB CHAMBR WM ALPR ESP SIZE 10 10014410,TOMS Wome's BLUE SLUB CHAMBR WM ALPR ESP SIZE 10 10014410,Default Ridgefield,62,62,0,0,0,0
,TOMS Wome's BLUE SLUB CHAMBR WM ALPR ESP SIZE 10 10014410,TOMS Wome's BLUE SLUB CHAMBR WM ALPR ESP SIZE 10 10014410,FBALYB Amazon,49,49,0,0,0,0
,TOMS Wome's BLUE SLUB CHAMBR WM ALPR ESP SIZE 6 10014410,TOMS Wome's BLUE SLUB CHAMBR WM ALPR ESP SIZE 6 10014410,Default Ridgefield,400,400,0,0,0,0
,TOMS Wome's BLUE SLUB CHAMBR WM ALPR ESP SIZE 6 10014410,TOMS Wome's BLUE SLUB CHAMBR WM ALPR ESP SIZE 6 10014410,FBALYB Amazon,50,50,0,0,0,0
,TOMS Wome's BLUE SLUB CHAMBR WM ALPR ESP SIZE 6.5 10014410,TOMS Wome's BLUE SLUB CHAMBR WM ALPR ESP SIZE 6.5 10014410,Default Ridgefield,62,62,0,0,0,0
,TOMS Wome's BLUE SLUB CHAMBR WM ALPR ESP SIZE 6.5 10014410,TOMS Wome's BLUE SLUB CHAMBR WM ALPR ESP SIZE 6.5 10014410,FBALYB Amazon,49,49,0,0,0,0
,TOMS Wome's BLUE SLUB CHAMBR WM ALPR ESP SIZE 7 10014410,TOMS Wome's BLUE SLUB CHAMBR WM ALPR ESP SIZE 7 10014410,Default Ridgefield,172,172,0,0,0,0
,TOMS Wome's BLUE SLUB CHAMBR WM ALPR ESP SIZE 7 10014410,TOMS Wome's BLUE SLUB CHAMBR WM ALPR ESP SIZE 7 10014410,FBALYB Amazon,50,50,0,0,0,0
,TOMS Wome's BLUE SLUB CHAMBR WM ALPR ESP SIZE 7.5 10014410,TOMS Wome's BLUE SLUB CHAMBR WM ALPR ESP SIZE 7.5 10014410,Default Ridgefield,172,172,0,0,0,0
,TOMS Wome's BLUE SLUB CHAMBR WM ALPR ESP SIZE 7.5 10014410,TOMS Wome's BLUE SLUB CHAMBR WM ALPR ESP SIZE 7.5 10014410,FBALYB Amazon,45,45,0,0,0,0
,TOMS Wome's BLUE SLUB CHAMBR WM ALPR ESP SIZE 8 10014410,TOMS Wome's BLUE SLUB CHAMBR WM ALPR ESP SIZE 8 10014410,Default Ridgefield,172,172,0,0,0,0
,TOMS Wome's BLUE SLUB CHAMBR WM ALPR ESP SIZE 8 10014410,TOMS Wome's BLUE SLUB CHAMBR WM ALPR ESP SIZE 8 10014410,FBALYB Amazon,49,49,0,0,0,0
,TOMS Wome's BLUE SLUB CHAMBR WM ALPR ESP SIZE 8.5 10014410,TOMS Wome's BLUE SLUB CHAMBR WM ALPR ESP SIZE 8.5 10014410,Default Ridgefield,172,172,0,0,0,0
,TOMS Wome's BLUE SLUB CHAMBR WM ALPR ESP SIZE 8.5 10014410,TOMS Wome's BLUE SLUB CHAMBR WM ALPR ESP SIZE 8.5 10014410,FBALYB Amazon,49,49,0,0,0,0
,TOMS Wome's BLUE SLUB CHAMBR WM ALPR ESP SIZE 9 10014410,TOMS Wome's BLUE SLUB CHAMBR WM ALPR ESP SIZE 9 10014410,Default Ridgefield,62,62,0,0,0,0
,TOMS Wome's BLUE SLUB CHAMBR WM ALPR ESP SIZE 9 10014410,TOMS Wome's BLUE SLUB CHAMBR WM ALPR ESP SIZE 9 10014410,FBALYB Amazon,44,43,1,0,1,0
,TOMS Wome's BLUE SLUB CHAMBR WM ALPR ESP SIZE 9.5 10014410,TOMS Wome's BLUE SLUB CHAMBR WM ALPR ESP SIZE 9.5 10014410,Default Ridgefield,29,29,0,0,0,0
,TOMS Wome's BLUE SLUB CHAMBR WM ALPR ESP SIZE 9.5 10014410,TOMS Wome's BLUE SLUB CHAMBR WM ALPR ESP SIZE 9.5 10014410,FBALYB Amazon,24,24,0,0,0,0
,Tootsie 4lb Fruit Roll Mega Mix,Tootsie 4lb Fruit Roll Mega Mix,FBALYB Amazon,12,12,0,0,0,0
,Top Chews Dog Treats,Top Chews Chicken & Apple Recipe 100% Natural Dog Treats,FBALYB Amazon,10,9,1,0,1,0
,Top class,Top class ,Default,0,0,0,0,0,1
,Tops 50 sheet writing pads 24ct,Tops 50 sheet writing pads 24ct,FBALYB Amazon,1,1,0,0,0,0
,Tortilla Warmer Red,Tortilla Warmer Red,Default,0,-200,200,0,0,0
,Toy State Tough Bulldozer,Cat Construction Vehicle Toy Bulldozer,FBALYB Amazon,6,6,0,0,0,0
,Toy State Tough Dump Truck,Cat Construction Crew Dump Truck Vehicle Playset,FBALYB Amazon,-1,-1,0,0,0,0
,Toy State Tough Excavator,Toy State Caterpillar CAT Tough Tracks Construction Crew Excavator Vehicle,FBALYB Amazon,-2,-2,0,0,0,0
,Toy Story 4 Blast Off Buzz Lightyear Figure,Toy Story 4 Blast Off Buzz Lightyear Figure,FBALYB Amazon,-28,-29,1,0,1,0
,Toy Story 4 Furry & Feathers Interactive 2 Pack,,Default Ridgefield,170,170,0,0,0,0
,Toy Story 4 Furry & Feathers Interactive 2 Pack,,FBALYB Amazon,85,85,0,1,0,0
,Toy Story 4 Little People 7 Friends Pack,,Default,0,-14,14,0,0,0
,Toy Story 4 Little People 7 Friends Pack,,FBALYB Amazon,67,61,6,348,6,0
,Toy Story 4 Little People 7 Friends Pack,,FBALYB Canada,19,19,0,0,0,0
,Toy Story 4 True Talkers Assorted,,Default,0,-1376,1376,0,0,0
,Toy Story 4 True Talkers Assorted,,Default Oxford,-132,-132,0,0,0,0
,Toy Story 4 True Talkers Assorted,,Default Ridgefield,132,132,0,0,0,0
,Toy Story Signature Bo Peep With Sheep 13.5 In-64444TS4,Toy Story Signature Bo Peep With Sheep 13.5 In-64444TS4,FBALYB Amazon,-3,-3,0,0,0,0
,Toy Story Signature Bucket O Soldier-64017TS4,Toy Story Signature Bucket O Soldier-64017TS4,Default,0,-24,24,0,0,0
,Toy Story Signature Bucket O Soldier-64017TS4,Toy Story Signature Bucket O Soldier-64017TS4,Default Oxford,6,6,0,0,0,0
,Toy Story Signature Bucket O Soldier-64017TS4,Toy Story Signature Bucket O Soldier-64017TS4,Default Ridgefield,24,24,0,0,0,0
,Toy Story Signature Bucket O Soldier-64017TS4,Toy Story Signature Bucket O Soldier-64017TS4,FBALYB Amazon,-3,-3,0,0,0,0
,Toy Story Signature Space Aliens 3 Pk 5 Inch-64018TS4,Toy Story Signature Space Aliens 3 Pk 5 Inch-64018TS4,Default Ridgefield,100,100,0,0,0,0
,Toy Story Signature Space Aliens 3 Pk 5 Inch-64018TS4,Toy Story Signature Space Aliens 3 Pk 5 Inch-64018TS4,FBALYB Amazon,96,96,0,0,0,0
,Toy Story True Talkers Jesse,Toy Story True Talkers Jesse,Default Ridgefield,0,-300,300,0,0,0
,Toy Story True Talkers Jesse,Toy Story True Talkers Jesse,FBALYB Amazon,-2,-2,0,0,0,0
,Trace Minerals Concentrace Mineral Drops TMD01 8 fl oz,Trace Minerals Concentrace Mineral Drops TMD01 8 fl oz,FBALYB Amazon,24,24,0,0,0,0
,Trace Minerals Greens Pak PGG02 30 packets,Trace Minerals Greens Pak PGG02 30 packets,Default Ridgefield,45,45,0,0,0,0
,Trace Minerals Greens Pak PGG02 30 packets,Trace Minerals Greens Pak PGG02 30 packets,FBALYB Amazon,11,11,0,0,0,0
,Trace Minerals Research Endure Performance Electrolyte ELT02 4oz,Trace Minerals Research Endure Performance Electrolyte ELT02 4oz       ,Default Ridgefield,1,1,0,0,0,0
,Trace Minerals Research Endure Performance Electrolyte ELT02 4oz,Trace Minerals Research Endure Performance Electrolyte ELT02 4oz       ,FBALYB Amazon,15,15,0,0,0,0
,Trace Minerals Watermelon Electrolyte Stamina Power Pak ESPP26 30 Packets,Trace Minerals Watermelon Electrolyte Stamina Power Pak ESPP26 30 Packets,FBALYB Amazon,41,41,0,0,0,0
,Train Puzzle & Rhymes Card Pack,Mindware Matching Train ‑ Train Puzzle & Rhymes Card Pack,FBALYB Amazon,8,8,0,0,0,0
,Tranquility By Colorado Clothing Ladies Reversible Skirt Cobalt Paint Small,Tranquility By Colorado Clothing Ladies Reversible Skirt Cobalt Paint Small,Default Ridgefield,4,4,0,0,0,0
,Tranquility By Colorado Clothing Reversible Skirt Black Blooms Large,Tranquility By Colorado Clothing Reversible Skirt Black Blooms Large,Default Ridgefield,1,1,0,0,0,0
,Tranquility By Colorado Clothing Reversible Skirt Cobalt Paint Medium,Tranquility By Colorado Clothing Reversible Skirt Cobalt Paint Medium,Default Ridgefield,15,15,0,0,0,0
,Tranquility By Colorado Clothing Reversible Skirt Henna Flower Large,Tranquility By Colorado Clothing Reversible Skirt Henna Flower Large,Default Ridgefield,22,22,0,0,0,0
,Tranquility By Colorado Clothing Reversible Skirt Henna Flower Medium,Tranquility By Colorado Clothing Reversible Skirt Henna Flower Medium,Default Ridgefield,32,32,0,0,0,0
,Tranquility By Colorado Clothing Reversible Skirt Henna Flower XL,Tranquility By Colorado Clothing Reversible Skirt Henna Flower XL,Default Ridgefield,3,3,0,0,0,0
,Tranquility By Colorado Clothing Women Pull On Reversible Skirt Cobalt Paint XL,Tranquility By Colorado Clothing Women Pull On Reversible Skirt Cobalt Paint XL,Default Ridgefield,11,11,0,0,0,0
,Tranquility By Colorado Clothing Women Reversible Skirt Cobalt Paint Large,Tranquility By Colorado Clothing Women Reversible Skirt Cobalt Paint Large,Default Ridgefield,19,19,0,0,0,0
,Tranquility By Colorado Clothing Women Reversible Skirt Henna Flower 2XL,Tranquility By Colorado Clothing Women Reversible Skirt Henna Flower 2XL,Default Ridgefield,4,4,0,0,0,0
,Tranquility By Colorado Clothing Women Skirt Reversible Blue Size L Large,Tranquility By Colorado Clothing Women Skirt Reversible Blue Size L Large,Default Ridgefield,5,5,0,0,0,0
,Tranquility By Colorado Company Women Reversible Skirt Black Blooms Medium,Tranquility By Colorado Company Women Reversible Skirt Black Blooms Medium,Default Ridgefield,24,24,0,0,0,0
,Tranquility By Colorado Company Women Reversible Skirt Black Blooms Small,Tranquility By Colorado Company Women Reversible Skirt Black Blooms Small,Default Ridgefield,8,8,0,0,0,0
,Tranquility By Colorado Ladies Reversible Skirt Cobalt Paint 2XL,Tranquility By Colorado Ladies Reversible Skirt Cobalt Paint 2XL,Default Ridgefield,1,1,0,0,0,0
,Tranquility By Colorado Women Reversible Skirt Navy Ikat Medium,Tranquility By Colorado Women Reversible Skirt Navy Ikat Medium,Default Ridgefield,30,30,0,0,0,0
,Tranquility By Colorado Women Reversible Skirt Navy Ikat Small,Tranquility By Colorado Women Reversible Skirt Navy Ikat Small,Default Ridgefield,10,10,0,0,0,0
,Transformers Bot Bots Grand Opening Surprise,Transformers Bot Bots Grand Opening Surprise,Default Ridgefield,269,269,0,0,0,0
,Transformers Bot Bots Grand Opening Surprise,Transformers Bot Bots Grand Opening Surprise,FBALYB Amazon,572,556,16,0,16,0
,Transformers Bot Bots Grand Opening Surprise,Transformers Bot Bots Grand Opening Surprise,FBALYB Canada,15,15,0,0,0,0
,Transformers Combiner Wars,Transformers Generations Combiner Wars Victorion Collection Pack,FBALYB Amazon,-3,-3,0,0,0,0
,Transformers Cyberverse Warrior Bumble Bee Sting Shot,Transformers Cyberverse Warrior Bumble Bee Sting Shot,Default Ridgefield,276,276,0,0,0,0
,Transformers Cyberverse Warrior Bumble Bee Sting Shot,Transformers Cyberverse Warrior Bumble Bee Sting Shot,FBALYB Amazon,63,63,0,0,0,0
,Transformers Cyberverse Warrior Slipstream Sonic Swirl,Transformers Cyberverse Warrior Slipstream Sonic Swirl,Default Ridgefield,524,524,0,0,0,0
,Transformers Cyberverse Warrior Slipstream Sonic Swirl,Transformers Cyberverse Warrior Slipstream Sonic Swirl,FBALYB Amazon,22,18,4,0,4,0
,Transformers Grimlock & Bumble,Transformers Platinum RID Grimlock and Bumblebee,FBALYB Amazon,36,36,0,0,0,0
,Transformers Wars Bruticus,Transformers Generations Combiner Wars Series PK Bruticus,FBALYB Amazon,-1,-1,0,0,0,0
,Transformers Wars Computron,Transformers Generations Combiner Wars Computron Collection Pack,FBALYB Amazon,0,0,0,3,0,0
,Transquility By Colorado Clothing Reversible Skirt Henna Flower Small,Transquility By Colorado Clothing Reversible Skirt Henna Flower Small,Default Ridgefield,10,10,0,0,0,0
,Tredeau Salt and Pepper Shaker,Tredeau Salt and Pepper Shaker,FBALYB Amazon,7,7,0,0,0,0
,TRESemme Keratin Shine Serum 3.3oz,TRESemme Keratin Smooth Shine Serum 3.3 oz,FBALYB Amazon,-1,-1,0,0,0,0
,TRESemme Keratin Smooth Shine Serum 2pk,TRESemme Keratin Smooth Shine Serum 2pk,FBALYB Amazon,1,1,0,0,0,0
,Tresemme Shampoo & Conditioner,TRESemme Moisture Rich Shampoo & Conditioner ‑ 2 pack.,FBALYB Amazon,59,59,0,9,0,0
,Triangle 40 Lance Toast PB Crackers,"Lance Toast Chee Peanut Butter Crackers, 40 Count",FBALYB Amazon,-1,-1,0,0,0,0
,Triangle 42mm Gold Aluminum + Cocoa Band,Triangle 42mm Gold Aluminum + Cocoa Band,Default,0,0,0,0,0,1
,Triangle 42mm Gold Aluminum + Cocoa Band,Triangle 42mm Gold Aluminum + Cocoa Band,FBALYB Amazon,3,3,0,0,0,0
,Triangle Apple Watch Series 2 38mm Gray,Apple Watch Gen 2 Series 2 38mm Space Gray Aluminum - Black Sport Band,FBALYB Amazon,4,4,0,0,0,0
,Triangle Apple Watch Series 2 Gold/Cocoa,Apple watch series 2 42mm ALUMINUM Case SPORT (Gold Aluminum case with cocoa ...,FBALYB Amazon,-1,-1,0,0,0,0
,Triangle BELLA 6 Quart Pressure Cooker,BELLA 6 Quart Pressure Cooker with 10 pre-set functions and Searing Technolog...,FBALYB Amazon,-1,-1,0,0,0,0
,Triangle Bissell 1785A CrossWave,Bissell 1785A CrossWave All-in-One Multi-Surface Cleaner - Corded,FBALYB Amazon,-2,-2,0,1,0,0
,Triangle Calphalon 1937308 2 Pc Pan Set,"Calphalon 2 Piece Classic Ceramic Nonstick Omelet Chef Pan Set, Grey/White",FBALYB Amazon,0,0,0,4,0,0
,Triangle CooperStreet AllNatural Cookies,Cooper Street All Natural Orange Cranberry Cookies 18 oz.,FBALYB Amazon,1,1,0,0,0,0
,triangle cuisinart gr-11 grill/panini,Cuisinart GR-11 Griddler 3-in-1 Grill and Panini Press,FBALYB Amazon,0,-17,17,0,17,0
,Triangle Cuisinart WAF-200 Waffle Maker2,Cuisinart WAF-200 4-Slice Belgian Waffle Maker,FBALYB Amazon,-1,-1,0,0,0,0
,Triangle Donut Shop Decaf Coffee 48 Pack,"Keurig K-Cup Coffee People Donut Shop Decaf Coffee, 48 Pack (Packaging May Vary)",FBALYB Amazon,3,3,0,0,0,0
,Triangle Dunkin Medium Original 40oz Bag,Dunkin' Donuts Original Blend Medium Roast Ground Coffee 100 % Premium Arabic...,FBALYB Amazon,-2,-2,0,0,0,0
,Triangle Folgers 18 k-cup 2 pack,Triangle Folgers medium roast decaf 18 k-cup 2 pack,FBALYB Amazon,17,17,0,0,0,0
,Triangle Gevalia Kaffe 84 Count,"GEVALIA Signature Blend Coffee, Mild, K-CUP Pods, 84 Count",FBALYB Amazon,6,6,0,12,0,0
,Triangle HighDesert Roasters Medium KCup,High Desert Roasters Organic Rainforest Medium Roast Coffee 80k-cup Pods,FBALYB Amazon,-1,-1,0,0,0,0
,"Triangle HP 902XL Color Combo Ink Cartridges, 3 pk","HP 902XL Color Combo Ink Cartridges, 3 pk",FBALYB Amazon,12,12,0,0,0,0
,Triangle iPad Pro 9.7-inch 256GB Wi-Fi,"iPad Pro 9.7-inch  (256GB, Wi-Fi,  Space Gray) 2016 Model",FBALYB Amazon,-1,-1,0,0,0,0
,Triangle JBL CLIP 2 BLUE,JBL Clip 2 Waterproof Portable Bluetooth Speaker (Blue),FBALYB Amazon,-2,-2,0,0,0,0
,Triangle K250 Strawberry,Triangle K250 Strawberry,FBALYB Amazon,1,1,0,2,0,0
,Triangle K250 Violet,Triangle K250 Violet,FBALYB Amazon,-1,-1,0,0,0,0
,Triangle K250 Violet,Triangle K250 Violet,Oregon,1,1,0,0,0,0
,Triangle K450 Coffee Brewing System (Grey),K450 Coffee Brewing System (Grey),Default,0,0,0,0,0,1
,Triangle Keurig 2.0 K575 Platinum,Keurig 2.0 K575 Coffee Brewing System in Platinum,FBALYB Amazon,-1,-1,0,5,0,0
,Triangle Keurig Maintenance Kit,Triangle Keurig Maintenance Kit,Default,0,0,0,0,0,4
,Triangle Lenovo Yoga 11e 20GE0002US,"Lenovo ThinkPad Yoga 11e - 20GE0002US - 11.6"" HD Multi-Touch Chromebook, Inte...",FBALYB Amazon,-2,-2,0,0,0,0
,Triangle LG Electronics G Watch - Black,LG Electronics G Watch - Black,FBALYB Amazon,-2,-2,0,0,0,0
,Triangle LINDOR Asst Chocolate Truffles,"Lindt LINDOR Assorted Chocolate Truffles, 19oz",FBALYB Amazon,2,2,0,0,0,0
,Triangle Logitech MK345,Logitech MK345 Wireless Desktop Combo 920-006972,FBALYB Amazon,24,24,0,0,0,0
,Triangle Mélange Grey Surface TypeCover,Triangle Mélange Grey Surface TypeCover,FBALYB Amazon,-15,-16,1,20,1,0
,Triangle Nabisco HoneyMaid GrahamCracker,"Nabisco Honey Maid Graham Crackers, Honey  4-14.4oz",Default,0,0,0,0,0,310
,Triangle Newman's 100 K Cups Coffee,"Newman's Own Special Extra Bold Blend Coffee K-Cups, Medium Roast, 100 Count",FBALYB Amazon,-35,-35,0,57,0,0
,Triangle Nutri Ninja BL680A Auto-IQ 1500,NEW Nutri Ninja BL680A Auto-IQ 1500 Watts Duo Nutrient Extraction Blender System,Default,0,0,0,0,0,2
,Triangle Nutri Ninja BL680A Auto-IQ 1500,NEW Nutri Ninja BL680A Auto-IQ 1500 Watts Duo Nutrient Extraction Blender System,FBALYB Amazon,-1,-1,0,0,0,0
,Triangle NV501 Shark Rotator Lift-away Vacuum,NV501 Shark Rotator Lift-away Vacuum,FBALYB Amazon,1,1,0,0,0,0
,Triangle Rubbermaid Premier 22-Pc. Storage Set - Aqua,Rubbermaid Premier 22-Pc. Storage Set - Aqua,FBALYB Amazon,1,1,0,0,0,0
,Triangle Samsung Galaxy Express 3 AT+T,Samsung Galaxy Express 3 AT&T Prepaid (U.S. Warranty),FBALYB Amazon,-1,-1,0,0,0,0
,Triangle Scotch Masking Tape 6 pack,Scotch Masking Tape 6 rolls/ 1 pk,FBALYB Amazon,1,1,0,0,0,0
,Triangle Series 1 38mm Gold/Concrete,"Apple Watch Series 1 38mm Smartwatch (Gold Aluminum Case, Concrete Sport Band)",FBALYB Amazon,-6,-6,0,0,0,0
,Triangle Series 1 42mm Silver /White,"Apple Watch Series 1 42mm Smartwatch (Silver Aluminum Case, White Sport Band)",FBALYB Amazon,1,1,0,0,0,0
,Triangle Starbucks Cocoa Holiday Bundle,Starbucks Hot Cocoa Chocolate - 48 K-Cups - 32 Classic and 16 Salted Carmel,FBALYB Amazon,1,1,0,0,0,0
,Triangle Straight Talk Grey iPhone 16gb2,"Straight Talk Apple iPhone 5S 16GB 4G LTE Prepaid Smartphone, 250 hours Hours...",Default,1,1,0,0,0,0
,Triangle Straight Talk Grey iPhone 16gb2,"Straight Talk Apple iPhone 5S 16GB 4G LTE Prepaid Smartphone, 250 hours Hours...",FBALYB Amazon,-1,-1,0,0,0,0
,Triangle Sultra the Bombshell,Sultra The Bombshell Rod Curling Iron,FBALYB Amazon,-4,-4,0,0,0,0
,Triangle  VIZIO SB4551-D5 Smartcast,VIZIO SB4551-D5 Smartcast 45 5.1 Slim Sound Bar System,FBALYB Amazon,-4,-4,0,0,0,0
,Triangle Watch Series 1 38mm Gray/Black,"Apple Watch Series 1 38mm Smartwatch (Space Gray Aluminum Case, Black Sport B...",FBALYB Amazon,6,6,0,0,0,0
,Triangle Watch Series 1 38mm Silv/White,"Apple Watch Series 1 38mm Smartwatch (Silver Aluminum Case, White Sport Band)",FBALYB Amazon,-6,-6,0,0,0,0
,Triangle Watch Series 1 42mm Gold/Cocoa,"Apple Watch Series 1 42mm Smartwatch (Gold Aluminum Case, Cocoa Sport Band)",FBALYB Amazon,-2,-2,0,0,0,0
,Triangle Xbox One S Battlefield SE Grey,"Xbox One S Battlefield 1 Special Edition Bundle, Storm Grey (500GB)",FBALYB Amazon,1,1,0,0,0,0
,Tricky Trainers 5oz 2pk bundle,Tricky Trainers 5oz 2pk bundle,FBALYB Amazon,22,22,0,0,0,0
,Tricky Trainers 8oz 3pk bundle,Tricky Trainers 8oz 3pk bundle,Default,0,-1,1,0,0,0
,"Trident Gum, Sugar Free, Bubblegum","Trident Gum, Sugar Free, Bubblegum ",FBALYB Amazon,6,6,0,0,0,0
,"Trident Gum, Sugar Free, Cinnamon","Trident Gum, Sugar Free, Cinnamon",FBALYB Amazon,1,1,0,0,0,0
,"Trident Gum, Sugar Free, Original Flavor","Trident Gum, Sugar Free, Original Flavor",FBALYB Amazon,74,74,0,0,0,0
,"Trident Gum, Sugar Free, Tropical Twist","Trident Gum, Sugar Free, Tropical Twist",FBALYB Amazon,3,3,0,0,0,0
,"Trident Gum, Sugar Free, Watermelon","Trident Gum, Sugar Free, Watermelon ",FBALYB Amazon,4,4,0,0,0,0
,Trident Layers Strawberry/Citrus Gum 14 ct,Trident Layers Strawberry/Citrus Gum 14 ct,FBALYB Amazon,2,2,0,0,0,0
,Trident Spearmint,Trident Spearmint,FBALYB Amazon,3,3,0,0,0,0
,TRIM NAIL CLIPPER  6pk,TRIM NAIL CLIPPER  6pk,FBALYB Amazon,-16,-16,0,0,0,0
,Triple Eight Dual Certified Helmet ALL Black L/XL,Triple Eight Dual Certified Helmet ALL Black L/XL,Default Ridgefield,88,88,0,0,0,0
,Triple Eight Dual Certified Helmet ALL Black L/XL,Triple Eight Dual Certified Helmet ALL Black L/XL,FBALYB Amazon,2,0,2,0,2,0
,Triple Eight Dual Certified Helmet ALL Black S/M,Triple Eight Dual Certified Helmet ALL Black S/M,FBALYB Amazon,-6,-6,0,0,0,0
,Triple Eight Dual Certified Helmet ALL Black XS/S,Triple Eight Dual Certified Helmet ALL Black XS/S,FBALYB Amazon,53,52,1,0,1,0
,Triple Eight Dual Certified Helmet Black/Zest L/XL,Triple Eight Dual Certified Helmet Black/Zest L/XL,FBALYB Amazon,151,151,0,0,0,0
,Triple Eight Dual Certified Helmet Black/Zest S/M,Triple Eight Dual Certified Helmet Black/Zest S/M,FBALYB Amazon,-1,-1,0,0,0,0
,Triple Eight Dual Certified Helmet Black/Zest XS/S,Triple Eight Dual Certified Helmet Black/Zest XS/S,FBALYB Amazon,0,0,0,1,0,0
,Triple Eight Dual Certified Helmet Blue Matte L/XL,Triple Eight Dual Certified Helmet Blue Matte L/XL,Default Ridgefield,0,-77,77,0,0,0
,Triple Eight Dual Certified Helmet Blue Matte S/M,Triple Eight Dual Certified Helmet Blue Matte S/M,Default Ridgefield,0,-94,94,0,0,0
,Triple Eight Dual Certified Helmet Blue Matte S/M,Triple Eight Dual Certified Helmet Blue Matte S/M,FBALYB Amazon,-1,-1,0,1,0,0
,Triple Eight Dual Certified Helmet Gun Matte L/XL,Triple Eight Dual Certified Helmet Gun Matte L/XL,Default Ridgefield,376,376,0,0,0,0
,Triple Eight Dual Certified Helmet Gun Matte L/XL,Triple Eight Dual Certified Helmet Gun Matte L/XL,FBALYB Amazon,211,210,1,0,1,0
,Triple Eight Dual Certified Helmet Gun Matte S/M,Triple Eight Dual Certified Helmet Gun Matte S/M,FBALYB Amazon,84,82,2,0,2,0
,Triple Eight Dual Certified Helmet Gun Matte XS/S,Triple Eight Dual Certified Helmet Gun Matte XS/S,FBALYB Amazon,109,109,0,0,0,0
,Triple Eight Dual Certified Helmet Kelly Green L/XL,Triple Eight Dual Certified Helmet Kelly Green L/XL,Default Ridgefield,6,6,0,0,0,0
,Triple Eight Dual Certified Helmet Kelly Green L/XL,Triple Eight Dual Certified Helmet Kelly Green L/XL,FBALYB Amazon,140,140,0,0,0,0
,Triple Eight Dual Certified Helmet Kelly Green XS/S,Triple Eight Dual Certified Helmet Kelly Green XS/S,Default Ridgefield,6,6,0,0,0,0
,Triple Eight Dual Certified Helmet Kelly Green XS/S,Triple Eight Dual Certified Helmet Kelly Green XS/S,FBALYB Amazon,-2,-2,0,0,0,0
,Triple Eight Dual Certified Helmet White Matte L/XL,Triple Eight Dual Certified Helmet White Matte L/XL,Default Ridgefield,226,226,0,0,0,0
,Triple Eight Dual Certified Helmet White Matte L/XL,Triple Eight Dual Certified Helmet White Matte L/XL,FBALYB Amazon,151,150,1,0,1,0
,Triple Eight Dual Certified Helmet White Matte S/M,Triple Eight Dual Certified Helmet White Matte S/M,FBALYB Amazon,-2,-2,0,0,0,0
,Triple Eight Dual Certified Helmet White Matte XS/S,Triple Eight Dual Certified Helmet White Matte XS/S,FBALYB Amazon,2,1,1,0,1,0
,Triple Eight EP 55 JR. BLACK,Triple Eight EP 55 JR. BLACK,Default Ridgefield,120,120,0,0,0,0
,Triple Eight EP 55 JR. BLACK,Triple Eight EP 55 JR. BLACK,FBALYB Amazon,88,87,1,0,1,0
,Triple Eight EP 55 L BLACK,Triple Eight EP 55 L BLACK,Default Ridgefield,312,312,0,0,0,0
,Triple Eight EP 55 L BLACK,Triple Eight EP 55 L BLACK,FBALYB Amazon,70,70,0,0,0,0
,Triple Eight EP 55 M BLACK,Triple Eight EP 55 M BLACK,Default Ridgefield,312,312,0,0,0,0
,Triple Eight EP 55 M BLACK,Triple Eight EP 55 M BLACK,FBALYB Amazon,180,179,1,1,1,0
,Triple Eight EP 55 S BLACK,Triple Eight EP 55 S BLACK,Default Ridgefield,216,216,0,0,0,0
,Triple Eight EP 55 S BLACK,Triple Eight EP 55 S BLACK,FBALYB Amazon,152,152,0,0,0,0
,Triple Eight EP 55 XL BLACK,Triple Eight EP 55 XL BLACK,Default Ridgefield,313,313,0,0,0,0
,Triple Eight EP 55 XL BLACK,Triple Eight EP 55 XL BLACK,FBALYB Amazon,185,185,0,0,0,0
,Triple Eight Gotham Helmet Baja Matte - L/XL,Triple Eight Gotham Helmet Baja Matte - L/XL,FBALYB Amazon,120,120,0,0,0,0
,Triple Eight Gotham Helmet Baja Matte - S/M,Triple Eight Gotham Helmet Baja Matte - S/M,Default Ridgefield,76,76,0,0,0,0
,Triple Eight Gotham Helmet Baja Matte - S/M,Triple Eight Gotham Helmet Baja Matte - S/M,FBALYB Amazon,166,166,0,0,0,0
,Triple Eight Gotham Helmet Baja Matte - XS/S,Triple Eight Gotham Helmet Baja Matte - XS/S,FBALYB Amazon,49,49,0,0,0,0
,Triple Eight Gotham Helmet Black Matte - L/XL,Triple Eight Gotham Helmet Black Matte - L/XL,FBALYB Amazon,43,43,0,0,0,0
,Triple Eight Gotham Helmet Black Matte - S/M,Triple Eight Gotham Helmet Black Matte - S/M,Default Ridgefield,76,76,0,0,0,0
,Triple Eight Gotham Helmet Black Matte - S/M,Triple Eight Gotham Helmet Black Matte - S/M,FBALYB Amazon,150,150,0,0,0,0
,Triple Eight Gotham Helmet Black Matte - XS/S,Triple Eight Gotham Helmet Black Matte - XS/S,Default,0,-1,1,0,0,0
,Triple Eight Gotham Helmet Black Matte - XS/S,Triple Eight Gotham Helmet Black Matte - XS/S,FBALYB Amazon,49,49,0,0,0,0
,Triple Eight Gotham Helmet Blu Matte - L/XL,Triple Eight Gotham Helmet Blu Matte - L/XL,FBALYB Amazon,33,33,0,0,0,0
,Triple Eight Gotham Helmet Blu Matte - S/M,Triple Eight Gotham Helmet Blu Matte - S/M,FBALYB Amazon,79,79,0,0,0,0
,Triple Eight Gotham Helmet Blu Matte - XS/S,Triple Eight Gotham Helmet Blu Matte - XS/S,FBALYB Amazon,23,23,0,0,0,0
,Triple Eight SAVER 3-PACK- 604352 60012 JR - 808,Triple Eight SAVER 3-PACK- 604352 60012 JR - 808,Default Ridgefield,156,156,0,0,0,0
,Triple Eight SAVER 3-PACK- 604352 60012 JR - 808,Triple Eight SAVER 3-PACK- 604352 60012 JR - 808,FBALYB Amazon,23,22,1,0,1,0
,Triple Eight SAVER 3-PACK- 604352 60013 S - 8-10,Triple Eight SAVER 3-PACK- 604352 60013 S - 8-10,Default Ridgefield,702,702,0,0,0,0
,Triple Eight SAVER 3-PACK- 604352 60013 S - 8-10,Triple Eight SAVER 3-PACK- 604352 60013 S - 8-10,FBALYB Amazon,94,91,3,0,3,0
,Triple Eight SAVER 3-PACK- 604352 60014 M - 8-13,Triple Eight SAVER 3-PACK- 604352 60014 M - 8-13,Default Ridgefield,552,552,0,0,0,0
,Triple Eight SAVER 3-PACK- 604352 60014 M - 8-13,Triple Eight SAVER 3-PACK- 604352 60014 M - 8-13,FBALYB Amazon,210,209,1,0,1,0
,Triple Eight SAVER 3-PACK- 604352 60015 LG- 8-16,Triple Eight SAVER 3-PACK- 604352 60015 LG- 8-16,Default CT,202,202,0,0,0,0
,Triple Eight SAVER 3-PACK- 604352 60015 LG- 8-16,Triple Eight SAVER 3-PACK- 604352 60015 LG- 8-16,Default Ridgefield,2,2,0,0,0,0
,Triple Eight SAVER 3-PACK- 604352 60015 LG- 8-16,Triple Eight SAVER 3-PACK- 604352 60015 LG- 8-16,FBALYB Amazon,366,365,1,0,1,0
,Triple Eight Sweatsaver Helmet ALL Blk Rub 1350 XS,Triple Eight Sweatsaver Helmet ALL Blk Rub 1350 XS,FBALYB Amazon,4,4,0,0,0,0
,Triple Eight Sweatsaver Helmet ALL Blk Rub 1351 S,Triple Eight Sweatsaver Helmet ALL Blk Rub 1351 S,Default Ridgefield,96,96,0,0,0,0
,Triple Eight Sweatsaver Helmet ALL Blk Rub 1351 S,Triple Eight Sweatsaver Helmet ALL Blk Rub 1351 S,FBALYB Amazon,66,65,1,0,1,0
,Triple Eight Sweatsaver Helmet ALL Blk Rub 1352 M,Triple Eight Sweatsaver Helmet ALL Blk Rub 1352 M,FBALYB Amazon,87,87,0,0,0,0
,Triple Eight Sweatsaver Helmet ALL Blk Rub 1353 L,Triple Eight Sweatsaver Helmet ALL Blk Rub 1353 L,Default Ridgefield,156,156,0,0,0,0
,Triple Eight Sweatsaver Helmet ALL Blk Rub 1353 L,Triple Eight Sweatsaver Helmet ALL Blk Rub 1353 L,FBALYB Amazon,15,14,1,0,1,0
,Triple Eight Sweatsaver Helmet ALL Blk Rub 1354 XL,Triple Eight Sweatsaver Helmet ALL Blk Rub 1354 XL,Default Ridgefield,1,1,0,0,0,0
,Triple Eight Sweatsaver Helmet ALL Blk Rub 1354 XL,Triple Eight Sweatsaver Helmet ALL Blk Rub 1354 XL,FBALYB Amazon,47,47,0,0,0,0
,Triple Eight Sweatsaver Helmet Baja Teal Rub 1316 S,Triple Eight Sweatsaver Helmet Baja Teal Rub 1316 S,Default Ridgefield,108,108,0,0,0,0
,Triple Eight Sweatsaver Helmet Baja Teal Rub 1316 S,Triple Eight Sweatsaver Helmet Baja Teal Rub 1316 S,FBALYB Amazon,74,74,0,0,0,0
,Triple Eight Sweatsaver Helmet Baja Teal Rub 1317 M,Triple Eight Sweatsaver Helmet Baja Teal Rub 1317 M,Default Ridgefield,96,96,0,0,0,0
,Triple Eight Sweatsaver Helmet Baja Teal Rub 1317 M,Triple Eight Sweatsaver Helmet Baja Teal Rub 1317 M,FBALYB Amazon,50,49,1,0,1,0
,Triple Eight Sweatsaver Helmet Baja Teal Rub 1318 L,Triple Eight Sweatsaver Helmet Baja Teal Rub 1318 L,Default Ridgefield,156,156,0,0,0,0
,Triple Eight Sweatsaver Helmet Baja Teal Rub 1318 L,Triple Eight Sweatsaver Helmet Baja Teal Rub 1318 L,FBALYB Amazon,107,107,0,0,0,0
,Triple Eight Sweatsaver Helmet Blk Rub w/ Red 1310 XS,Triple Eight Sweatsaver Helmet Blk Rub w/ Red 1310 XS,FBALYB Amazon,43,43,0,0,0,0
,Triple Eight Sweatsaver Helmet Blk Rub w/ Red 1311 S,Triple Eight Sweatsaver Helmet Blk Rub w/ Red 1311 S,Default CT,400,400,0,0,0,0
,Triple Eight Sweatsaver Helmet Blk Rub w/ Red 1311 S,Triple Eight Sweatsaver Helmet Blk Rub w/ Red 1311 S,Default Ridgefield,612,612,0,0,0,0
,Triple Eight Sweatsaver Helmet Blk Rub w/ Red 1311 S,Triple Eight Sweatsaver Helmet Blk Rub w/ Red 1311 S,FBALYB Amazon,148,148,0,0,0,0
,Triple Eight Sweatsaver Helmet Blk Rub w/ Red 1312 M,Triple Eight Sweatsaver Helmet Blk Rub w/ Red 1312 M,Default CT,540,540,0,0,0,0
,Triple Eight Sweatsaver Helmet Blk Rub w/ Red 1312 M,Triple Eight Sweatsaver Helmet Blk Rub w/ Red 1312 M,Default Ridgefield,421,421,0,0,0,0
,Triple Eight Sweatsaver Helmet Blk Rub w/ Red 1312 M,Triple Eight Sweatsaver Helmet Blk Rub w/ Red 1312 M,FBALYB Amazon,153,153,0,0,0,0
,Triple Eight Sweatsaver Helmet Blk Rub w/ Red 1313 L,Triple Eight Sweatsaver Helmet Blk Rub w/ Red 1313 L,Default CT,808,808,0,0,0,0
,Triple Eight Sweatsaver Helmet Blk Rub w/ Red 1313 L,Triple Eight Sweatsaver Helmet Blk Rub w/ Red 1313 L,Default Ridgefield,958,958,0,0,0,0
,Triple Eight Sweatsaver Helmet Blk Rub w/ Red 1313 L,Triple Eight Sweatsaver Helmet Blk Rub w/ Red 1313 L,FBALYB Amazon,51,50,1,0,1,0
,Triple Eight Sweatsaver Helmet Blk Rub w/ Red 1314 XL,Triple Eight Sweatsaver Helmet Blk Rub w/ Red 1314 XL,Default CT,208,208,0,0,0,0
,Triple Eight Sweatsaver Helmet Blk Rub w/ Red 1314 XL,Triple Eight Sweatsaver Helmet Blk Rub w/ Red 1314 XL,Default Ridgefield,408,408,0,0,0,0
,Triple Eight Sweatsaver Helmet Blk Rub w/ Red 1314 XL,Triple Eight Sweatsaver Helmet Blk Rub w/ Red 1314 XL,FBALYB Amazon,-6,-7,1,0,1,0
,Triple Eight Sweatsaver Helmet Carbon Rubber 1076 S,Triple Eight Sweatsaver Helmet Carbon Rubber 1076 S,Default Ridgefield,120,120,0,0,0,0
,Triple Eight Sweatsaver Helmet Carbon Rubber 1076 S,Triple Eight Sweatsaver Helmet Carbon Rubber 1076 S,FBALYB Amazon,88,88,0,0,0,0
,Triple Eight Sweatsaver Helmet Carbon Rubber 1077 M,Triple Eight Sweatsaver Helmet Carbon Rubber 1077 M,Default Ridgefield,108,108,0,0,0,0
,Triple Eight Sweatsaver Helmet Carbon Rubber 1077 M,Triple Eight Sweatsaver Helmet Carbon Rubber 1077 M,FBALYB Amazon,132,132,0,0,0,0
,Triple Eight Sweatsaver Helmet Carbon Rubber 1078 L,Triple Eight Sweatsaver Helmet Carbon Rubber 1078 L,Default CT,4,4,0,0,0,0
,Triple Eight Sweatsaver Helmet Carbon Rubber 1078 L,Triple Eight Sweatsaver Helmet Carbon Rubber 1078 L,Default Ridgefield,204,204,0,0,0,0
,Triple Eight Sweatsaver Helmet Carbon Rubber 1078 L,Triple Eight Sweatsaver Helmet Carbon Rubber 1078 L,FBALYB Amazon,135,134,1,0,1,0
,Triple Eight Sweatsaver Helmet Carbon Rubber 1079 XL,Triple Eight Sweatsaver Helmet Carbon Rubber 1079 XL,Default Ridgefield,84,84,0,0,0,0
,Triple Eight Sweatsaver Helmet Carbon Rubber 1079 XL,Triple Eight Sweatsaver Helmet Carbon Rubber 1079 XL,FBALYB Amazon,35,34,1,0,1,0
,Triple Eight Sweatsaver Helmet Royal Rubber 1245 S,Triple Eight Sweatsaver Helmet Royal Rubber 1245 S,Default Ridgefield,60,60,0,0,0,0
,Triple Eight Sweatsaver Helmet Royal Rubber 1245 S,Triple Eight Sweatsaver Helmet Royal Rubber 1245 S,FBALYB Amazon,50,49,1,0,1,0
,Triple Eight Sweatsaver Helmet Royal Rubber 1246 M,Triple Eight Sweatsaver Helmet Royal Rubber 1246 M,Default Ridgefield,60,60,0,0,0,0
,Triple Eight Sweatsaver Helmet Royal Rubber 1246 M,Triple Eight Sweatsaver Helmet Royal Rubber 1246 M,FBALYB Amazon,27,27,0,0,0,0
,Triple Eight Sweatsaver Helmet Royal Rubber 1247 L,Triple Eight Sweatsaver Helmet Royal Rubber 1247 L,Default Ridgefield,108,108,0,0,0,0
,Triple Eight Sweatsaver Helmet Royal Rubber 1247 L,Triple Eight Sweatsaver Helmet Royal Rubber 1247 L,FBALYB Amazon,64,64,0,0,0,0
,Triple Eight Sweatsaver Helmet Royal Rubber 1248 XL,Triple Eight Sweatsaver Helmet Royal Rubber 1248 XL,Default Ridgefield,48,48,0,0,0,0
,Triple Eight Sweatsaver Helmet Royal Rubber 1248 XL,Triple Eight Sweatsaver Helmet Royal Rubber 1248 XL,FBALYB Amazon,20,20,0,0,0,0
,Triple Eight Sweatsaver Helmet United Red Rub 1321 S,Triple Eight Sweatsaver Helmet United Red Rub 1321 S,Default Ridgefield,36,36,0,0,0,0
,Triple Eight Sweatsaver Helmet United Red Rub 1321 S,Triple Eight Sweatsaver Helmet United Red Rub 1321 S,FBALYB Amazon,12,12,0,0,0,0
,Triple Eight Sweatsaver Helmet United Red Rub 1322 M,Triple Eight Sweatsaver Helmet United Red Rub 1322 M,Default Ridgefield,36,36,0,0,0,0
,Triple Eight Sweatsaver Helmet United Red Rub 1322 M,Triple Eight Sweatsaver Helmet United Red Rub 1322 M,FBALYB Amazon,19,18,1,0,1,0
,Triple Eight Sweatsaver Helmet United Red Rub 1323 L,Triple Eight Sweatsaver Helmet United Red Rub 1323 L,Default Ridgefield,60,60,0,0,0,0
,Triple Eight Sweatsaver Helmet United Red Rub 1323 L,Triple Eight Sweatsaver Helmet United Red Rub 1323 L,FBALYB Amazon,46,46,0,0,0,0
,Triple Eight Sweatsaver Helmet United Red Rub 1324 XL,Triple Eight Sweatsaver Helmet United Red Rub 1324 XL,Default Ridgefield,24,24,0,0,0,0
,Triple Eight Sweatsaver Helmet United Red Rub 1324 XL,Triple Eight Sweatsaver Helmet United Red Rub 1324 XL,FBALYB Amazon,7,7,0,0,0,0
,Triple Eight Sweatsaver Helmet White Rubber 1211 S,Triple Eight Sweatsaver Helmet White Rubber 1211 S,Default Ridgefield,96,96,0,0,0,0
,Triple Eight Sweatsaver Helmet White Rubber 1211 S,Triple Eight Sweatsaver Helmet White Rubber 1211 S,FBALYB Amazon,119,119,0,0,0,0
,Triple Eight Sweatsaver Helmet White Rubber 1212 M,Triple Eight Sweatsaver Helmet White Rubber 1212 M,FBALYB Amazon,70,69,1,0,1,0
,Triple Eight Sweatsaver Helmet White Rubber 1213 L,Triple Eight Sweatsaver Helmet White Rubber 1213 L,Default Ridgefield,156,156,0,0,0,0
,Triple Eight Sweatsaver Helmet White Rubber 1213 L,Triple Eight Sweatsaver Helmet White Rubber 1213 L,FBALYB Amazon,11,11,0,0,0,0
,Triple Eight Swtsvr W/R 1214 XL,Triple Eight Sweatsaver Helmet White Rubber 1214 XL,Default Ridgefield,60,60,0,0,0,0
,Triple Eight T8 Bumsaver BLACK L BLACK,Triple Eight T8 Bumsaver BLACK L BLACK,Default Ridgefield,40,40,0,0,0,0
,Triple Eight T8 Bumsaver BLACK L BLACK,Triple Eight T8 Bumsaver BLACK L BLACK,FBALYB Amazon,28,26,2,0,2,0
,Triple Eight T8 Bumsaver BLACK M BLACK,Triple Eight T8 Bumsaver BLACK M BLACK,Default Ridgefield,60,60,0,0,0,0
,Triple Eight T8 Bumsaver BLACK M BLACK,Triple Eight T8 Bumsaver BLACK M BLACK,FBALYB Amazon,35,35,0,0,0,0
,Triple Eight T8 Bumsaver BLACK S BLACK,Triple Eight T8 Bumsaver BLACK S BLACK,Default Ridgefield,40,40,0,0,0,0
,Triple Eight T8 Bumsaver BLACK S BLACK,Triple Eight T8 Bumsaver BLACK S BLACK,FBALYB Amazon,4,0,4,0,4,0
,Triple Eight T8 Bumsaver BLACK XL BLACK,Triple Eight T8 Bumsaver BLACK XL BLACK,Default Ridgefield,160,160,0,0,0,0
,Triple Eight T8 Bumsaver BLACK XL BLACK,Triple Eight T8 Bumsaver BLACK XL BLACK,FBALYB Amazon,33,33,0,0,0,0
,"Triple Eight THE Certified Sweatsaver Helmet, Black Rubber 3600 XS/S","Triple Eight THE Certified Sweatsaver Helmet, Black Rubber 3600 XS/S",Default Ridgefield,60,60,0,0,0,0
,"Triple Eight THE Certified Sweatsaver Helmet, Black Rubber 3600 XS/S","Triple Eight THE Certified Sweatsaver Helmet, Black Rubber 3600 XS/S",FBALYB Amazon,10,10,0,0,0,0
,"Triple Eight THE Certified Sweatsaver Helmet, Carbon Rubber 3603 XS/S","Triple Eight THE Certified Sweatsaver Helmet, Carbon Rubber 3603 XS/S",Default Ridgefield,30,30,0,0,0,0
,"Triple Eight THE Certified Sweatsaver Helmet, Carbon Rubber 3603 XS/S","Triple Eight THE Certified Sweatsaver Helmet, Carbon Rubber 3603 XS/S",FBALYB Amazon,13,13,0,0,0,0
,Triple Eight WRISTSAVER- 604352 60006 S - 9-20,Triple Eight WRISTSAVER- 604352 60006 S - 9-20,FBALYB Amazon,124,122,2,0,2,0
,Triple Eight WRISTSAVER- 604352 60007 M - 9-21,Triple Eight WRISTSAVER- 604352 60007 M - 9-21,Default Ridgefield,456,456,0,0,0,0
,Triple Eight WRISTSAVER- 604352 60007 M - 9-21,Triple Eight WRISTSAVER- 604352 60007 M - 9-21,FBALYB Amazon,161,159,2,0,2,0
,Triple Eight WRISTSAVER- 604352 60008 L - 9-22,Triple Eight WRISTSAVER- 604352 60008 L - 9-22,Default CT,400,400,0,0,0,0
,Triple Eight WRISTSAVER- 604352 60008 L - 9-22,Triple Eight WRISTSAVER- 604352 60008 L - 9-22,Default Ridgefield,300,300,0,0,0,0
,Triple Eight WRISTSAVER- 604352 60008 L - 9-22,Triple Eight WRISTSAVER- 604352 60008 L - 9-22,FBALYB Amazon,260,259,1,0,1,0
,Triple Eight Wristsaver SLIDE ON L BLACK,Triple Eight Wristsaver SLIDE ON L BLACK,Default Ridgefield,580,580,0,0,0,0
,Triple Eight Wristsaver SLIDE ON L BLACK,Triple Eight Wristsaver SLIDE ON L BLACK,FBALYB Amazon,305,302,3,0,3,0
,Triple Eight Wristsaver SLIDE ON L BLACK,Triple Eight Wristsaver SLIDE ON L BLACK,FBALYB Canada,0,0,0,20,0,0
,Triple Eight Wristsaver SLIDE ON M BLACK,Triple Eight Wristsaver SLIDE ON M BLACK,Default Ridgefield,436,436,0,0,0,0
,Triple Eight Wristsaver SLIDE ON M BLACK,Triple Eight Wristsaver SLIDE ON M BLACK,FBALYB Amazon,174,174,0,0,0,0
,Triple Eight Wristsaver SLIDE ON M BLACK,Triple Eight Wristsaver SLIDE ON M BLACK,FBALYB Canada,0,0,0,20,0,0
,Triple Eight Wristsaver SLIDE ON S BLACK,Triple Eight Wristsaver SLIDE ON S BLACK,Default Ridgefield,17,17,0,0,0,0
,Triple Eight Wristsaver SLIDE ON S BLACK,Triple Eight Wristsaver SLIDE ON S BLACK,FBALYB Amazon,100,100,0,0,0,0
,Triumph Cat Food Chicken n Liver 12ct,Triumph Cat Food Chicken n Liver 12ct,FBALYB Amazon,18,18,0,0,0,0
,Triumph Jerky Variety 24oz 2pk,Triumph Jerky Variety 24oz 2pk,FBALYB Amazon,-1,-1,0,0,0,0
,Triumph Turkey/Pea/Berry Jerkey 24oz 2pk,Triumph Turkey/Pea/Berry Jerkey 24oz 2pk,FBALYB Amazon,1,1,0,0,0,0
,Trolli Apple Gummy Candy 12pk,Trolli Apple Gummy Candy 12pk,FBALYB Amazon,11,11,0,0,0,0
,Trolls World Tour Rock City Bobble,Trolls World Tour Rock City Bobble,Default Ridgefield,650,650,0,0,0,0
,Trolls World Tour Techno Reef Bobble,Trolls World Tour Techno Reef Bobble,Default Ridgefield,30,30,0,0,0,0
,Trolls World Tour Techno Reef Bobble,Trolls World Tour Techno Reef Bobble,FBALYB Amazon,104,102,2,26,2,0
,Tropical Carnival Fruit & Nut Cockatiel 8oz,"Brown's Tropical Carnival Fruit & Nut Cockatiel Bird Treats, 8-oz bag",FBALYB Amazon,2,2,0,0,0,0
,Tropical Carnival Gourmet Macaw Big Bites,Tropical Carnival Gourmet Macaw Big Bites,FBALYB Amazon,10,10,0,0,0,0
,TropiClean Ear Cleaning Pet Wipes 50ct,TropiClean Ear Cleaning Pet Wipes 50ct,FBALYB Amazon,18,18,0,1,0,0
,Tropiclean Fresh Breath Water 33oz 2pk,Tropiclean Fresh Breath Water 33oz 2pk,Default,-6,-6,0,0,0,0
,True Nature 3oz 12pk Bundle,True Nature 3oz 12pk Bundle,FBALYB Amazon,6,6,0,3,0,0
,Trunate Coenzyme Q10,Trunature Coenzyme Q10 100MG 220 CT,FBALYB Amazon,-1,-1,0,0,0,0
,Trunature Cinsulin 500mg 170CT,Trunature Cinsulin 500mg 170CT,Default,0,0,0,0,0,121
,Trunature Cinsulin 500mg 170CT 2pk,Trunature Cinsulin 500mg 170CT 2pk,FBALYB Amazon,-2,-2,0,0,0,0
,Trunature Cranberry,Trunature Cranberry 300MG 250 Softgels,FBALYB Amazon,-2,-4,2,0,2,0
,Trunature Ginkgo Biloba,Trunature Ginkgo Biloba 120MG 300 Softgels,Default,0,0,0,0,0,33
,Trunature Ginkgo Biloba,Trunature Ginkgo Biloba 120MG 300 Softgels,FBALYB Amazon,-3,-3,0,1,0,0
,Trunature Ginkgo Biloba 3pk,Trunature Ginkgo Biloba 3pk,FBALYB Amazon,-5,-5,0,0,0,0
,"TruNature Lutein & Zeaxanthin, Softgels ‑ 140 count","TruNature Lutein & Zeaxanthin, Softgels ‑ 140 count",Default,0,-1,1,0,0,1
,"TruNature Lutein & Zeaxanthin, Softgels ‑ 140 count","TruNature Lutein & Zeaxanthin, Softgels ‑ 140 count",FBALYB Amazon,-4,-4,0,0,0,0
,"TruNature Lutein & Zeaxanthin, Softgels ‑ 140 count 2pk","TruNature Lutein & Zeaxanthin, Softgels ‑ 140 count 2pk",FBALYB Amazon,4,0,4,0,4,0
,Trunature Probiotic 180 gummies,Trunature Probiotic 180 gummies,Default,0,0,0,0,0,3
,Trunature Prostate Health 250 (2 pack),Trunature Prostate Health 250 (2 pack),FBALYB Amazon,-5,-5,0,0,0,0
,Truss  Amino Miracle Heat Protectant Hair Spray  225ml/7.61.oz,Truss  Amino Miracle Heat Protectant Hair Spray  225ml/7.61.oz,Default Ridgefield,149,149,0,0,0,0
,Truss  Amino Miracle Heat Protectant Hair Spray  225ml/7.61.oz,Truss  Amino Miracle Heat Protectant Hair Spray  225ml/7.61.oz,FBALYB Amazon,13,13,0,0,0,0
,Truss - Blond Shampoo 300ml/10.14.oz,Truss - Blond Shampoo 300ml/10.14.oz,Default Ridgefield,12,12,0,0,0,0
,Truss - Blond Shampoo 300ml/10.14.oz,Truss - Blond Shampoo 300ml/10.14.oz,FBALYB Amazon,1,1,0,0,0,0
,Truss - Deluxe Prime Hair Reconstructor  260ml/8.79oz,Truss - Deluxe Prime Hair Reconstructor  260ml/8.79oz,FBALYB Amazon,248,247,1,1,1,0
,Truss - Infusion Conditioner 300ml/10.14.oz,Truss - Infusion Conditioner 300ml/10.14.oz,FBALYB Amazon,-2,-2,0,0,0,0
,Truss - Infusion Shampoo 300ml/10.14.oz,Truss - Infusion Shampoo 300ml/10.14.oz,FBALYB Amazon,4,4,0,0,0,0
,Truss - Miracle Conditioner 300ml/10.14oz,Truss - Miracle Conditioner 300ml/10.14oz,Default Ridgefield,104,104,0,0,0,0
,Truss - Miracle Conditioner 300ml/10.14oz,Truss - Miracle Conditioner 300ml/10.14oz,FBALYB Amazon,-16,-16,0,0,0,0
,Truss - Miracle Mask 180g/6.35oz,Truss - Miracle Mask 180g/6.35oz,FBALYB Amazon,2,2,0,0,0,0
,Truss - Miracle Shampoo 300ml/10.14oz,Truss - Miracle Shampoo 300ml/10.14oz,Default Ridgefield,1,1,0,0,0,0
,Truss - Miracle Shampoo 300ml/10.14oz,Truss - Miracle Shampoo 300ml/10.14oz,FBALYB Amazon,9,9,0,2,0,0
,Truss - Night SPA Serum 250ml/8.45.oz,Truss - Night SPA Serum 250ml/8.45.oz,Default,3,3,0,0,0,0
,Truss - Night SPA Serum 250ml/8.45.oz,Truss - Night SPA Serum 250ml/8.45.oz,FBALYB Amazon,-14,-14,0,0,0,0
,Truss - Shock Repair Hair Treatment (4 units of 17ml/0.57.oz),Truss - Shock Repair Hair Treatment (4 units of 17ml/0.57.oz),FBALYB Amazon,-4,-4,0,0,0,0
,Truss - Ultra Hydration Conditioner 300ml/10.14.oz,Truss - Ultra Hydration Conditioner 300ml/10.14.oz,FBALYB Amazon,-77,-78,1,0,1,0
,Tru Three Crock Buffet,Tru Three Crock Buffet Slow Cooker,FBALYB Amazon,3,3,0,0,0,0
,TRU Triple Buffet Server,TRU Triple Buffet Server with 3 2-1/2-Quart Oval Removable Inserts,FBAAP Amazon,10,10,0,0,0,0
,TTetra Bio-Bag Cartridge Large 12ct Refill,TTetra Bio-Bag Cartridge Large 12ct Refill,Default Ridgefield,39,39,0,0,0,0
,TTetra Bio-Bag Cartridge Large 12ct Refill,TTetra Bio-Bag Cartridge Large 12ct Refill,FBALYB Amazon,276,276,0,11,0,0
,TTetra Bio-Bag Cartridge Large 12ct Refill,TTetra Bio-Bag Cartridge Large 12ct Refill,FBALYB Canada,167,167,0,1,0,0
,TTetra Bio-Bag Cartridge Large 12ct Refill 2PK,TTetra Bio-Bag Cartridge Large 12ct Refill 2PK,FBALYB Amazon,12,12,0,0,0,0
,TTetra Bio-Bag Cartridge Large 8ct Refill,TTetra Bio-Bag Cartridge Large 8ct Refill,Default,0,-1,1,0,0,0
,TTetra Bio-Bag Cartridge Large 8ct Refill,TTetra Bio-Bag Cartridge Large 8ct Refill,Default Ridgefield,324,324,0,0,0,0
,TTetra Bio-Bag Cartridge Large 8ct Refill,TTetra Bio-Bag Cartridge Large 8ct Refill,FBALYB Amazon,5,5,0,2,0,0
,TTetra Bio-Bag Cartridge Large 8ct Refill,TTetra Bio-Bag Cartridge Large 8ct Refill,FBALYB Canada,0,0,0,50,0,0
,Tucks 100ct 2PK,Tucks 100ct 2PK,FBALYB Amazon,459,459,0,7,0,0
,Tucks 100ct 3pk,Tucks 100ct 3pk,FBALYB Amazon,-3,-3,0,5,0,0
,Tucks 100ct 5pk,Tucks 100ct 5pk,FBALYB Amazon,1,1,0,0,0,0
,Tucks Cooling Pads 200ct,Tucks Medicated Cooling Pads 200 Pads,FBALYB Amazon,253,253,0,0,0,0
,Tucks Cooling Pads 200ct 2pk,Tucks Cooling Pads 200ct 2pk,FBALYB Amazon,3,3,0,0,0,0
,Tucks Cooling Pads 200ct 3PK,Tucks Cooling Pads 200ct 3PK,FBALYB Amazon,-1,-1,0,0,0,0
,Tully's French & Italian Roast,Tully's French & Italian Roast,FBALYB Amazon,2,1,1,0,1,0
,Tully's French Roast 24 kcups,Tully's French Roast 24 kcups,Default,0,0,0,0,0,80
,Tully's French Roast 24 kcups 3pk,Tully's French Roast 24 kcups 3pk,FBALYB Amazon,1,1,0,0,0,0
,Tully's French Roast 24 kcups 4pk,Tully's French Roast 24 kcups 4pk,FBALYB Amazon,-1,-1,0,0,0,0
,Tully's French Roast Decaf 24 kcups,Tully's French Roast Decaf 24 kcups,Default,0,-40,40,0,0,0
,Tully's French Roast Decaf 24 kcups,Tully's French Roast Decaf 24 kcups,FBALYB Amazon,127,127,0,0,0,0
,Tullys Italian roast 96ct,Tullys Italian roast 96ct,FBALYB Amazon,1,0,1,1,1,0
,Tums Ultra Berry 265 CT,Tums Ultra Berry 265 CT,FBALYB Amazon,-14,-14,0,6,0,0
,Tunature Prostate Health 250ct,Tunature Prostate Health 250ct,Default,0,0,0,0,0,122
,TUO Fiery 8 piece set TC0714,TUO Fiery 8 piece set TC0714,Default,0,0,0,0,0,432
,TUO Fiery 8 piece set TC0714,TUO Fiery 8 piece set TC0714,Default Ridgefield,374,374,0,0,0,0
,TUO Fiery 8 piece set TC0714,TUO Fiery 8 piece set TC0714,FBAFBA LYB AUSTRALIA,0,0,0,10,0,0
,TUO Fiery 8 piece set TC0714,TUO Fiery 8 piece set TC0714,FBALYB Amazon,385,384,1,0,1,0
,TUO Fiery 8 piece set TC0714,TUO Fiery 8 piece set TC0714,FBALYB Canada,15,15,0,0,0,0
,TUO Fiery Boning Knife German 7 inch TC0711,TUO Fiery Boning Knife German 7 inch TC0711,Default,0,0,0,0,0,20
,TUO Fiery Boning Knife German 7 inch TC0711,TUO Fiery Boning Knife German 7 inch TC0711,FBALYB Amazon,78,78,0,0,0,0
,TUO Fiery Bread Knife German 9 inch TC0712,TUO Fiery Bread Knife German 9 inch TC0712,FBALYB Amazon,88,88,0,0,0,0
,TUO Fiery Chopper 6 inch TC0701,TUO Fiery Chopper 6 inch TC0701,Default Ridgefield,60,60,0,0,0,0
,TUO Fiery Chopper 6 inch TC0701,TUO Fiery Chopper 6 inch TC0701,FBAFBA LYB AUSTRALIA,0,0,0,20,0,0
,TUO Fiery Chopper 6 inch TC0701,TUO Fiery Chopper 6 inch TC0701,FBALYB Amazon,174,174,0,0,0,0
,TUO Fiery Cleaver German 7 inch TC0702,TUO Fiery Cleaver German 7 inch TC0702,Default,0,0,0,0,0,170
,TUO Fiery Cleaver German 7 inch TC0702,TUO Fiery Cleaver German 7 inch TC0702,Default Ridgefield,1440,1440,0,0,0,0
,TUO Fiery Cleaver German 7 inch TC0702,TUO Fiery Cleaver German 7 inch TC0702,FBALYB Amazon,148,148,0,0,0,0
,TUO Fiery Cleaver Japanese 7 inch TC0702D,TUO Fiery Cleaver Japanese 7 inch TC0702D,Default Ridgefield,5,5,0,0,0,0
,TUO Fiery Cleaver Japanese 7 inch TC0702D,TUO Fiery Cleaver Japanese 7 inch TC0702D,FBALYB Amazon,82,82,0,0,0,0
,TUO Fiery Cleaver Japanese 8 inch TC0703D,TUO Fiery Cleaver Japanese 8 inch TC0703D,FBALYB Amazon,136,136,0,0,0,0
,TUO Fiery Cutlery 10 inch German TC0716,TUO Fiery Cutlery 10 inch German TC0716,Default,0,0,0,0,0,30
,TUO Fiery Cutlery 10 inch German TC0716,TUO Fiery Cutlery 10 inch German TC0716,FBALYB Amazon,180,180,0,0,0,0
,TUO Fiery Cutlery 8 inch German TC0715,TUO Fiery Cutlery 8 inch German TC0715,FBALYB Amazon,185,185,0,0,0,0
,TUO Fiery Cutlery 8 inch German TC0719,TUO Fiery Cutlery 8 inch German TC0719,FBALYB Amazon,27,27,0,0,0,0
,TUO Fiery Hollowed Santoku 7 inch TC0704,TUO Fiery Hollowed Santoku 7 inch TC0704,Default Ridgefield,24,24,0,0,0,0
,TUO Fiery Hollowed Santoku 7 inch TC0704,TUO Fiery Hollowed Santoku 7 inch TC0704,FBALYB Amazon,201,201,0,0,0,0
,TUO Fiery Honing Steel TC0708,TUO Fiery Honing Steel TC0708,Default Ridgefield,1,1,0,0,0,0
,TUO Fiery Honing Steel TC0708,TUO Fiery Honing Steel TC0708,FBALYB Amazon,-2,-2,0,0,0,0
,TUO Fiery Kitchen Veg Meat Knives 6 inch German TC0722,TUO Fiery Kitchen Veg Meat Knives 6 inch German TC0722,FBALYB Amazon,60,60,0,0,0,0
,TUO Fiery Kitchen Veg Meat Knives 7 inch German TC0721,TUO Fiery Kitchen Veg Meat Knives 7 inch German TC0721,Default,0,0,0,0,0,20
,TUO Fiery Kitchen Veg Meat Knives 7 inch German TC0721,TUO Fiery Kitchen Veg Meat Knives 7 inch German TC0721,Default Ridgefield,40,40,0,0,0,0
,TUO Fiery Kitchen Veg Meat Knives 7 inch German TC0721,TUO Fiery Kitchen Veg Meat Knives 7 inch German TC0721,FBALYB Amazon,146,146,0,0,0,0
,TUO Fiery Kritsuke 8.5 inch German TC0718,TUO Fiery Kritsuke 8.5 inch German TC0718,Default Ridgefield,140,140,0,0,0,0
,TUO Fiery Kritsuke 8.5 inch German TC0718,TUO Fiery Kritsuke 8.5 inch German TC0718,FBALYB Amazon,363,363,0,0,0,0
,TUO Fiery Meat and Veg Cleaver 7 inch TC0702H,TUO Fiery Meat and Veg Cleaver 7 inch TC0702H,FBALYB Amazon,84,84,0,0,0,0
,TUO Fiery Nakiri 6.5 inch Veg Cleavers TC0717,TUO Fiery Nakiri 6.5 inch Veg Cleavers TC0717,FBALYB Amazon,-5,-9,4,0,4,0
,TUO Fiery Pairing German 4 inch TC0706,TUO Fiery Pairing German 4 inch TC0706,Default,0,0,0,0,0,50
,TUO Fiery Pairing German 4 inch TC0706,TUO Fiery Pairing German 4 inch TC0706,FBALYB Amazon,88,87,1,0,1,0
,TUO Fiery Slicing Knife German 12 inch TC0713,TUO Fiery Slicing Knife German 12 inch TC0713,Default,0,0,0,0,0,30
,TUO Fiery Slicing Knife German 12 inch TC0713,TUO Fiery Slicing Knife German 12 inch TC0713,Default Ridgefield,10,10,0,0,0,0
,TUO Fiery Slicing Knife German 12 inch TC0713,TUO Fiery Slicing Knife German 12 inch TC0713,FBALYB Amazon,192,192,0,0,0,0
,TUO Fiery Utility German 5 inch TC0705,TUO Fiery Utility German 5 inch TC0705,FBALYB Amazon,400,400,0,0,0,0
,TUO Fiery Utility German 5 inch TC0705,TUO Fiery Utility German 5 inch TC0705,FBALYB Canada,18,18,0,0,0,0
,Tuo Knives Set,Tuo Knives Set,FBALYB Amazon,63,63,0,0,0,0
,Turbocharger,Turbocharger,FBALYB Amazon,4,4,0,0,0,0
,"TURRET, AXIS, LUG 980SBK","TURRET, AXIS, LUG 980SBK",FBALYB Amazon,11,-1,12,0,12,0
,"TURRET, AXS, LUG",,FBALYB Amazon,-2,-2,0,0,0,0
,"Twizzlers Strawberry Twists, 180 ct.","Twizzlers Strawberry Twists, 180 ct.",FBALYB Amazon,8,8,0,3,0,0
,"Two Little Fishies ATLMSPD4 Marine Snow, 16.9oz","Two Little Fishies ATLMSPD4 Marine Snow, 16.9oz",FBALYB Amazon,2,2,0,0,0,0
,Two Little Fishies GFO Phosban Reactor 150,Two Little Fishies GFO Phosban Reactor 150,FBALYB Amazon,-3,-3,0,0,0,0
,Tylenol Cold and Flu 3 pk,Tylenol Cold and Flu Severe Day and Night - 3 pack (Total 72 Caplets),Default,0,-1,1,0,0,0
,Tylenol Cold and Flu 3 pk,Tylenol Cold and Flu Severe Day and Night - 3 pack (Total 72 Caplets),Default Ridgefield,0,-64,64,0,0,0
,Tylenol Cold and Flu 3 pk,Tylenol Cold and Flu Severe Day and Night - 3 pack (Total 72 Caplets),FBALYB Amazon,-1,-1,0,0,0,0
,Tylenol Extra Strength,Tylenol Extra Strength 500mg 325 ct,FBALYB Amazon,-4,-4,0,0,0,0
,Tylenol Severe Sinus 72 ct.,Tylenol Severe Sinus 72 ct.,FBALYB Amazon,22,22,0,0,0,0
,Typhoo 240s,Typhoo 240s,Default,0,-872,872,0,0,0
,Typhoo 240s,Typhoo 240s,Default Ridgefield,69,69,0,0,0,0
,Typhoo 240s,Typhoo 240s,FBALYB Amazon,244,207,37,426,37,0
,Typhoo 240s,Typhoo 240s,FBALYB Canada,0,0,0,50,0,0
,TYphoo Decaf 80 ct 2pk,TYphoo Decaf 80 ct 2pk,FBALYB Amazon,-16,-21,5,129,5,0
,TYphoo Decaf 80 ct 2pk,TYphoo Decaf 80 ct 2pk,FBALYB Canada,8,8,0,0,0,0
,Typhoo Decaf 80ct 3pk,Typhoo Decaf 80ct 3pk,Default,0,-1,1,0,0,0
,Typhoo Decaf 80ct 3pk,Typhoo Decaf 80ct 3pk,FBALYB Amazon,261,255,6,14,6,0
,Typhoo Decaf 80ct 3pk,Typhoo Decaf 80ct 3pk,FBALYB Canada,20,20,0,0,0,0
,Typhoo Decaf Tea Teabag 8ct 6pk,Typhoo Decaf Tea Teabag 8ct 6pk,FBALYB Amazon,485,479,6,51,6,0
,Typhoo Tea 80's DECAF,Typhoo Tea 80's DECAF,Avrami - Ebay,1,1,0,0,0,0
,Typhoo Tea 80's DECAF,Typhoo Tea 80's DECAF,Default,0,-3744,3744,0,0,0
,Typhoo Tea 80's DECAF,Typhoo Tea 80's DECAF,Default Ridgefield,14846,14846,0,0,0,0
,Typhoo Tea 80's DECAF,Typhoo Tea 80's DECAF,FBALYB Amazon,325,314,11,3,11,0
,Typhoo tea bags 2pk 480,Typhoo tea bags 2pk 480,FBALYB Amazon,-115,-122,7,239,7,0
,Typhoo tea bags 2pk 480,Typhoo tea bags 2pk 480,FBALYB Canada,19,19,0,0,0,0
,UB Boys Pants Charcoal M 10/12,UB Boys Pants Charcoal M 10/12,FBALYB Amazon,-1,-1,0,0,0,0
,UB Boys Pants Charcoal S 7/8,UB Boys Pants Charcoal S 7/8,FBALYB Amazon,-12,-12,0,0,0,0
,UB Boys Pants Charcoal XS 5/6,UB Boys Pants Charcoal XS 5/6,FBALYB Amazon,12,12,0,0,0,0
,UB Boys Pants Dk Reptile M 10/12,UB Boys Pants Dk Reptile M 10/12,FBALYB Amazon,-5,-5,0,0,0,0
,UB Boys Pants DK Reptile S 8/7,UB Boys Pants DK Reptile S 8/7,FBALYB Amazon,-7,-7,0,0,0,0
,UB Boys Pants DK Reptile XS 5/6,UB Boys Pants DK Reptile XS 5/6,FBALYB Amazon,-8,-8,0,0,0,0
,UB Boys Pants Navy Blue S 7/8,UB Boys Pants Navy Blue S 7/8,FBALYB Amazon,-6,-6,0,0,0,0
,UB Boys Pants Navy Blue XS 5/6,UB Boys Pants Navy Blue XS 5/6,FBALYB Amazon,-3,-3,0,0,0,0
,UB Men's Shorts Flint 34,UB Men's Shorts Flint 34,FBALYB Amazon,-1,-1,0,0,0,0
,UB Men's Shorts Grain 42,UB Men's Shorts Grain 42,Default,0,0,0,0,0,1
,UB Men's Shorts Grain 42,UB Men's Shorts Grain 42,FBALYB Amazon,-1,-1,0,0,0,0
,UB Tech Men's Black 32 x 30,UB Tech Men's Black 32 x 30,Default Ridgefield,9,9,0,0,0,0
,UB Tech Men's Black 32 x 34,UB Tech Men's Black 32 x 34,Default Ridgefield,3,3,0,0,0,0
,UB Tech Men's Black 32 x 34,UB Tech Men's Black 32 x 34,FBALYB Amazon,-2,-2,0,0,0,0
,UB Tech Men's Black 34 x 30,UB Tech Men's Black 34 x 30,Default Ridgefield,11,11,0,0,0,0
,UB Tech Men's Black 34 x 30,UB Tech Men's Black 34 x 30,FBALYB Amazon,-2,-2,0,0,0,0
,UB Tech Men's Black 34 x 32,UB Tech Men's Black 34 x 32,Default Ridgefield,12,12,0,0,0,0
,UB Tech Men's Black 34 x 34,UB Tech Men's Black 34 x 34,FBALYB Amazon,-1,-1,0,0,0,0
,UB Tech Men's Black 36 x 30,UB Tech Men's Black 36 x 30,Default Ridgefield,3,3,0,0,0,0
,UB Tech Men's Black 36 x 32,UB Tech Men's Black 36 x 32,FBALYB Amazon,-1,-1,0,0,0,0
,UB Tech Men's Black 38 x 30,UB Tech Men's Black 38 x 30,Default Ridgefield,5,5,0,0,0,0
,UB Tech Men's Black 38 x 34,UB Tech Men's Black 38 x 34,Default Ridgefield,1,1,0,0,0,0
,UB Tech Men's Desert 32 x 32,UB Tech Men's Desert 32 x 32,FBALYB Amazon,-1,-1,0,0,0,0
,UB Tech Men's Desert 34 x 32,UB Tech Men's Desert 34 x 32,Default Ridgefield,3,3,0,0,0,0
,UB Tech Men's Desert 34 x 32,UB Tech Men's Desert 34 x 32,FBALYB Amazon,-2,-2,0,0,0,0
,UB Tech Men's Grey 34 x 30,UB Tech Men's Grey 34 x 30,Default Ridgefield,11,11,0,0,0,0
,UB Tech Men's Grey 34 x 30,UB Tech Men's Grey 34 x 30,FBALYB Amazon,-2,-2,0,0,0,0
,UB Tech Men's Grey 34 x 32,UB Tech Men's Grey 34 x 32,Default Ridgefield,5,5,0,0,0,0
,UB Tech Men's Grey 34 x 32,UB Tech Men's Grey 34 x 32,FBALYB Amazon,-1,-1,0,0,0,0
,UB Tech Men's Grey 38 x 34,UB Tech Men's Grey 38 x 34,Default Ridgefield,4,4,0,0,0,0
,UE Boom 2 Blue,UE Boom 2 Blue Waterproof Bluetooth Speaker,FBALYB Amazon,0,0,0,3,0,0
,UE Boom 2 White,UE Boom 2 White Waterproof Speaker,FBALYB Amazon,1,0,1,1,1,0
,UE Megaboom Panther,UE Megaboom Panther,Default,2,2,0,0,0,0
,UE Megaboom Panther,UE Megaboom Panther,FBALYB Amazon,-2,-2,0,0,0,0
,UE WONDERBOOM Black,UE WONDERBOOM Portable Speaker ‑ Wireless ‑ Black,FBALYB Amazon,0,0,0,4,0,0
,UE WONDERBOOM Blue,UE WONDERBOOM Portable Speaker - Blue,FBALYB Amazon,1,1,0,0,0,0
,UE WONDERBOOM Red,UE WONDERBOOM Portable Speaker ‑ Wireless ‑ Red,FBALYB Amazon,-1,-1,0,0,0,0
,UK-X9SW-DRXH,"MCCAFE Premium Roast Coffee, K-CUP PODS, 84 Count",FBALYB Amazon,-4,-4,0,0,0,0
,Under Armour 16oz Protege Brz Blue,Under Armour 16oz Protege Breeze Blue UA70510-60006,FBALYB Amazon,86,85,1,0,1,0
,Under Armour 16oz Protege Hyper Dye,Under Armour 16oz Protege Hyper Dye UA70510-90006,Default Ridgefield,1,1,0,0,0,0
,Under Armour 16oz Protege Hyper Dye,Under Armour 16oz Protege Hyper Dye UA70510-90006,FBALYB Amazon,40,39,1,0,1,0
,Under Armour 16oz Protege Omge Orng,Under Armour 16oz Protege Omege Orange UA70510-60066,FBALYB Amazon,25,23,2,0,2,0
,Under Armour 16oz Protege Royal,Under Armour 16oz Protege Royal UA70510-60044,FBALYB Amazon,79,79,0,0,0,0
,Under Armour 16oz Protege Satin Black,Under Armour 16oz Protege Satin Black UA70510-00004,Default Ridgefield,2,2,0,0,0,0
,Under Armour 16oz Protege Satin Black,Under Armour 16oz Protege Satin Black UA70510-00004,FBALYB Amazon,107,106,1,0,1,0
,Under Armour 16oz Protege Wave Camo,Under Armour 16oz Protege Wave Camo UA70510-20043,FBALYB Amazon,41,40,1,0,1,0
,Under Armour 16oz Protege Wte Wdlnd,Under Armour 16oz Protege White Woodland UA70510-90034,FBALYB Amazon,39,38,1,0,1,0
,Under Armour 18oz Beynd Stainless,Under Armour 18oz Beyond Stainless UA70270-80005,FBALYB Amazon,33,33,0,0,0,0
,Under Armour 18oz Beyond Rose Gold,Under Armour 18oz Beyond Rose Gold UA70270-20040,FBALYB Amazon,18,18,0,0,0,0
,Under Armour 18oz Beyond Satin Blk,Under Armour 18oz Beyond Satin Black UA70270-00004,FBALYB Amazon,94,94,0,0,0,0
,Under Armour 18oz Bynd GBrz/Crme,Under Armour 18oz Beyond Gradient Breeze/Chrome UA70290-60040,FBALYB Amazon,14,14,0,0,0,0
,Under Armour 24oz Dom Brz Blue,Under Armour 24oz Dominate Breeze Blue UA70170-60006,FBALYB Amazon,75,75,0,0,0,0
,Under Armour 24oz Dominate Royal,Under Armour 24oz Dominate Royal UA70170-60044,FBALYB Amazon,41,41,0,0,0,0
,Under Armour 24oz Dominate Smoke,Under Armour 24oz Dominate Smoke UA70170-80009,FBALYB Amazon,15,14,1,0,1,0
,Under Armour 24oz Dominate Stnls,Under Armour 24oz Dominate Stainless UA70170-80005,FBALYB Amazon,28,28,0,0,0,0
,Under Armour 24oz Dom Plnt Prpl,Under Armour 24oz Dominate Planet Purple UA70170-70005,FBALYB Amazon,98,98,0,0,0,0
,Under Armour 24oz Draft Breeze Blue,Under Armour 24oz Draft Breeze Blue UA70370-60006,FBALYB Amazon,71,70,1,0,1,0
,Under Armour 24oz Draft Charcoal,Under Armour 24oz Draft Charcoal UA70370-80003,Default Ridgefield,75,75,0,0,0,0
,Under Armour 24oz Draft Clear,Under Armour 24oz Draft Clear UA70370-80001,FBALYB Amazon,70,70,0,0,0,0
,Under Armour 24oz Draft Grip Clear,Under Armour 24oz Draft Grip Clear UA70240-80001,Default Ridgefield,2,2,0,0,0,0
,Under Armour 24oz Draft Grip Clear,Under Armour 24oz Draft Grip Clear UA70240-80001,FBALYB Amazon,84,84,0,0,0,0
,Under Armour 24oz Draft Grip Red,Under Armour 24oz Draft Grip Red UA70240-20002,FBALYB Amazon,86,86,0,0,0,0
,Under Armour 24oz Draft Grip Royal,Under Armour 24oz Draft Grip Royal UA70240-60044,FBALYB Amazon,75,74,1,0,1,0
,Under Armour 24oz Draft Red,Under Armour 24oz Draft Red UA70370-20002,FBALYB Amazon,70,70,0,0,0,0
,Under Armour 24oz Draft Royal,Under Armour 24oz Draft Royal UA70370-60044,FBALYB Amazon,75,75,0,0,0,0
,Under Armour 24oz Drft Grip Chrcol,Under Armour 24oz Draft Grip Charcoal UA70240-80003,Default Ridgefield,16,16,0,0,0,0
,Under Armour 24oz Drft Grip Chrcol,Under Armour 24oz Draft Grip Charcoal UA70240-80003,FBALYB Amazon,32,32,0,0,0,0
,Under Armour 64oz Plymkr Jg Acdmy,Under Armour 64oz Playmaker Jug Academy UA70020-60052,FBALYB Amazon,10,9,1,0,1,0
,Under Armour Black 64oz Playmaker Jug UA70020-00001,Under Armour Black 64oz Playmaker Jug UA70020-00001,FBALYB Amazon,339,308,31,0,31,0
,Under Armour Black 64oz Playmaker Jug UA70020-00001,Under Armour Black 64oz Playmaker Jug UA70020-00001,FBALYB Canada,-2,-2,0,0,0,0
,Under Armour Breeze Blue 64oz Playmaker Jug UA70020-60006,Under Armour Breeze Blue 64oz Playmaker Jug UA70020-60006,Default Ridgefield,50,50,0,0,0,0
,Under Armour Breeze Blue 64oz Playmaker Jug UA70020-60006,Under Armour Breeze Blue 64oz Playmaker Jug UA70020-60006,FBALYB Amazon,5,2,3,0,3,0
,Under Armour Cerise 64oz Playmaker Jug UA70020-20035,Under Armour Cerise 64oz Playmaker Jug UA70020-20035,FBALYB Amazon,15,13,2,0,2,0
,Under Armour Dark Orange/Pitch 64oz Playmaker Jug UA70020-30003,Under Armour Dark Orange/Pitch 64oz Playmaker Jug UA70020-30003,FBALYB Amazon,36,25,11,0,11,0
,Under Armour Dark Orange/Pitch 64oz Playmaker Jug UA70020-30003,Under Armour Dark Orange/Pitch 64oz Playmaker Jug UA70020-30003,FBALYB Canada,-10,-10,0,0,0,0
,Under Armour Hi-Vis Yellow 64oz Playmaker Jug UA70020-40011,Under Armour Hi-Vis Yellow 64oz Playmaker Jug UA70020-40011,Default Ridgefield,1,1,0,0,0,0
,Under Armour Hi-Vis Yellow 64oz Playmaker Jug UA70020-40011,Under Armour Hi-Vis Yellow 64oz Playmaker Jug UA70020-40011,FBALYB Amazon,13,12,1,0,1,0
,Under Armour Hi-Vis Yellow 64oz Playmaker Jug UA70020-40011,Under Armour Hi-Vis Yellow 64oz Playmaker Jug UA70020-40011,FBALYB Canada,-8,-8,0,0,0,0
,Under Armour Mod Grey 64oz Playmaker Jug UA70020-80004,Under Armour Mod Grey 64oz Playmaker Jug UA70020-80004,FBALYB Amazon,50,46,4,0,4,0
,Under Armour Mod Grey 64oz Playmaker Jug UA70020-80004,Under Armour Mod Grey 64oz Playmaker Jug UA70020-80004,FBALYB Canada,6,6,0,0,0,0
,Under Armour Red 64oz Playmaker Jug UA70020-20002,Under Armour Red 64oz Playmaker Jug UA70020-20002,Default Ridgefield,1,1,0,0,0,0
,Under Armour Red 64oz Playmaker Jug UA70020-20002,Under Armour Red 64oz Playmaker Jug UA70020-20002,FBALYB Amazon,316,270,46,0,46,0
,Under Armour Red 64oz Playmaker Jug UA70020-20002,Under Armour Red 64oz Playmaker Jug UA70020-20002,FBALYB Canada,-2,-2,0,0,0,0
,Under Armour Royal 64oz Playmaker Jug UA70020-60044,Under Armour Royal 64oz Playmaker Jug UA70020-60044,Default Ridgefield,276,276,0,0,0,0
,Under Armour Royal 64oz Playmaker Jug UA70020-60044,Under Armour Royal 64oz Playmaker Jug UA70020-60044,FBALYB Amazon,18,18,0,0,0,0
,Under Armour White 64oz Playmaker Jug UA70020-90002,Under Armour White 64oz Playmaker Jug UA70020-90002,Default Ridgefield,500,500,0,0,0,0
,Under Armour White 64oz Playmaker Jug UA70020-90002,Under Armour White 64oz Playmaker Jug UA70020-90002,FBALYB Amazon,88,46,42,0,42,0
,Under Armour White 64oz Playmaker Jug UA70020-90002,Under Armour White 64oz Playmaker Jug UA70020-90002,FBALYB Canada,20,20,0,0,0,0
,Uni Ball Vision Elite Roller Pens 10ct,Uni Ball Vision Elite Roller Pens 10ct,FBALYB Amazon,-1,-1,0,0,0,0
,Uni-verse Core Unicorn Collectible Assorted-6054904,Uni-verse Core Unicorn Collectible Assorted-6054904,Default,0,-64,64,0,0,0
,Uni-verse Core Unicorn Collectible Assorted-6054904,Uni-verse Core Unicorn Collectible Assorted-6054904,FBALYB Amazon,139,139,0,0,0,0
,Uni-verse Core Unicorn Collectible Assorted-6054904 2pk,Uni-verse Core Unicorn Collectible Assorted-6054904 2pk,FBALYB Amazon,-168,-171,3,28,3,0
,Uppercut Deluxe Pomade,Uppercut Deluxe Pomade,Default,0,-1800,1800,0,0,0
,Uppercut Deluxe Pomade,Uppercut Deluxe Pomade,FBALYB Amazon,78,77,1,0,1,0
,Uppercut Deluxe Pomade 2pk,Uppercut Deluxe Pomade 2pk,FBALYB Amazon,-119,-125,6,110,6,0
,Uppercut Deluxe Pomade and Uppercut Deluxe Matt Pomade,Uppercut Deluxe Pomade and Uppercut Deluxe Matt Pomade ,FBALYB Amazon,-3,-3,0,0,0,0
,Uppercut Easy hold,Uppercut Easy hold,FBALYB Amazon,-5,-12,7,0,7,0
,Uppercut Easy hold,Uppercut Easy hold,WFS,-20,-20,0,0,0,0
,Uppercut Easy Hold Pomade and Uppercut Monster Hold Pomade,Uppercut Easy Hold Pomade and Uppercut Monster Hold Pomade,FBALYB Amazon,-1,-1,0,0,0,0
,Uppercut Featherweight,Uppercut Featherweight,Default,0,-400,400,0,0,0
,Uppercut Featherweight,Uppercut Featherweight,FBALYB Amazon,-2,-14,12,0,12,0
,Uppercut Matte Pomade,Uppercut Matte Pomade,Default,0,-500,500,0,0,0
,Uppercut Matte Pomade,Uppercut Matte Pomade,FBALYB Amazon,29,29,0,0,0,0
,Uppercut Matte Pomade 2pk,Uppercut Matte Pomade 2pk,FBALYB Amazon,-2,-2,0,0,0,0
,Uppercut Monster Hold,Uppercut Monster Hold,Avrami - Ebay,45,45,0,0,0,0
,Uppercut Monster Hold,Uppercut Monster Hold,FBALYB Amazon,-2,-8,6,0,6,0
,Uppercut Monster Hold,Uppercut Monster Hold,WFS,-15,-15,0,0,0,0
,Uppercut Quiff Roller,Uppercut Quiff Roller,Default Ridgefield,3304,3304,0,0,0,0
,Uppercut Quiff Roller 2pk,Uppercut Quiff Roller 2pk,FBALYB Amazon,186,183,3,1,3,0
,Urban Decay Naked3 Pallet,Urban Decay Naked3 Pallet,FBALYB Amazon,-43,-43,0,43,0,0
,Urban Star Blue 34 x 30,Urban Star Blue 34 x 30,Default Ridgefield,23,23,0,0,0,0
,Urban Star Men's (32x34) Relaxed Fit Straight Leg Jeans Midnight Blue,Urban Star Men's (32x34) Relaxed Fit Straight Leg Jeans Midnight Blue,Default Ridgefield,9,9,0,0,0,0
,Urban Star Men's Blue/Black Size 34 x 34,Urban Star Men's Blue/Black Size 34 x 34,FBALYB Amazon,9,9,0,0,0,0
,Urban Star Men's Dark Rinse Size 32 x 32,Urban Star Men's Dark Rinse Size 32 x 32,Default Ridgefield,9,9,0,0,0,0
,Urban Star Men's Dark Wash Jeans Relaxed Fit Straight Leg Sz 32x30,Urban Star Men's Dark Wash Jeans Relaxed Fit Straight Leg Sz 32x30,Default Ridgefield,1,1,0,0,0,0
,Urban Star Men's Dark Wash Rinse Size 32 x 32,Urban Star Men's Dark Wash Rinse Size 32 x 32,Default Ridgefield,1,1,0,0,0,0
,"Urban Star Men's Jean Dark Rinse, Size 34 x 34","Urban Star Men's Jean Dark Rinse, Size 34 x 34",Default Ridgefield,1,1,0,0,0,0
,"Urban Star Men's Jean Denim Relaxed Fit Straight, Size 30x34","Urban Star Men's Jean Denim Relaxed Fit Straight, Size 30x34",Default Ridgefield,3,3,0,0,0,0
,"Urban Star Men's Jean Relaxed Fit Dark Midnight Blue, Size 32x32","Urban Star Men's Jean Relaxed Fit Dark Midnight Blue, Size 32x32",Default Ridgefield,1,1,0,0,0,0
,"Urban Star Men's Jean Relaxed Fit  Dark Rinse, Size 32x30","Urban Star Men's Jean Relaxed Fit  Dark Rinse, Size 32x30",Default Ridgefield,12,12,0,0,0,0
,"Urban Star Men's Jean Relaxed Fit  Dark Rinse, Size 32x30","Urban Star Men's Jean Relaxed Fit  Dark Rinse, Size 32x30",FBALYB Amazon,49,48,1,0,1,0
,"Urban Star Men's Jean Relaxed Fit Dark Rinse, Size 36x30","Urban Star Men's Jean Relaxed Fit Dark Rinse, Size 36x30",Default Ridgefield,3,3,0,0,0,0
,Urban Star Men's Jean Relaxed Fit Denims Straight Leg Black 34x32,Urban Star Men's Jean Relaxed Fit Denims Straight Leg Black 34x32,Default Ridgefield,3,3,0,0,0,0
,"Urban Star Men's Jean Relaxed Fit Denims Straight Leg Grey, Size 34x30","Urban Star Men's Jean Relaxed Fit Denims Straight Leg Grey, Size 34x30",Default Ridgefield,14,14,0,0,0,0
,"Urban Star Men's Jean Relaxed Fit Denims Straight Leg Grey, Size 34x30","Urban Star Men's Jean Relaxed Fit Denims Straight Leg Grey, Size 34x30",FBALYB Amazon,9,9,0,0,0,0
,"Urban Star Men's Jean Relaxed Fit Midnight Blue, Size 32 X 30","Urban Star Men's Jean Relaxed Fit Midnight Blue, Size 32 X 30",Default Ridgefield,2,2,0,0,0,0
,"Urban Star Men's Jean Relaxed Fit Straight Leg Black, Size 32x34","Urban Star Men's Jean Relaxed Fit Straight Leg Black, Size 32x34",Default Ridgefield,10,10,0,0,0,0
,"Urban Star Men's Jean Relaxed Fit Straight Leg Black, Size 40W x 29L","Urban Star Men's Jean Relaxed Fit Straight Leg Black, Size 40W x 29L",Default Ridgefield,1,1,0,0,0,0
,"Urban Star Men's Jean Relaxed Fit Straight Leg Dark Wash, Size 34x30","Urban Star Men's Jean Relaxed Fit Straight Leg Dark Wash, Size 34x30",Default Ridgefield,6,6,0,0,0,0
,"Urban Star Men's Jean Relaxed Fit Straight Leg Grey, Size 30x34","Urban Star Men's Jean Relaxed Fit Straight Leg Grey, Size 30x34",Default Ridgefield,5,5,0,0,0,0
,"Urban Star Men's Jean Relaxed Fit Straight Leg Stretch Black, Size 34x34","Urban Star Men's Jean Relaxed Fit Straight Leg Stretch Black, Size 34x34",Default Ridgefield,3,3,0,0,0,0
,"Urban Star Men's Jean Relaxed Fit Straight Leg Stretch Dark Rinse, Size 32x34","Urban Star Men's Jean Relaxed Fit Straight Leg Stretch Dark Rinse, Size 32x34",Default Ridgefield,13,13,0,0,0,0
,"Urban Star Men's Jean Relaxed Fit Straight Leg Stretch Denim Dark midnight, Size 32x34","Urban Star Men's Jean Relaxed Fit Straight Leg Stretch Denim Dark midnight, Size 32x34",Default Ridgefield,6,6,0,0,0,0
,"Urban Star Men's Jean Relaxed Fit Straight Leg Stretch Jean Grey, Size 34 X 32","Urban Star Men's Jean Relaxed Fit Straight Leg Stretch Jean Grey, Size 34 X 32",Default Ridgefield,35,35,0,0,0,0
,"Urban Star Men's Jean Relaxed Fit Straight Leg Stretch, Size: 36 X 34","Urban Star Men's Jean Relaxed Fit Straight Leg Stretch, Size: 36 X 34",Default Ridgefield,1,1,0,0,0,0
,"Urban Star Men's Jean Relaxed Fit Straight Stretch Leg Black, Size 38x34","Urban Star Men's Jean Relaxed Fit Straight Stretch Leg Black, Size 38x34",Default Ridgefield,1,1,0,0,0,0
,"Urban Star Men's Jean Relaxed Fit Straight Stretch Leg Blue, Size 30 X 30","Urban Star Men's Jean Relaxed Fit Straight Stretch Leg Blue, Size 30 X 30",Default Ridgefield,4,4,0,0,0,0
,"Urban Star Men's Jean Relaxed Fit Stretch Blue, Size 34x34","Urban Star Men's Jean Relaxed Fit Stretch Blue, Size 34x34",Default Ridgefield,27,27,0,0,0,0
,"Urban Star Men's Jean, Relaxed Fit Stretch Straight Leg Light Gray, Size 36x30","Urban Star Men's Jean, Relaxed Fit Stretch Straight Leg Light Gray, Size 36x30",Default Ridgefield,5,5,0,0,0,0
,"Urban Star Men's Jean Relaxed Stretch Straight Leg Indigo Blue Jeans, Size 40 X 32","Urban Star Men's Jean Relaxed Stretch Straight Leg Indigo Blue Jeans, Size 40 X 32",Default Ridgefield,2,2,0,0,0,0
,Urban Star Mens Jeans 32 X 30 Dark Relaxed Fit Straight Leg,Urban Star Mens Jeans 32 X 30 Dark Relaxed Fit Straight Leg,Default Ridgefield,1,1,0,0,0,0
,Urban Star Mens Jeans 34 X 32 Dark Relaxed Fit Straight Leg 610584,Urban Star Mens Jeans 34 X 32 Dark Relaxed Fit Straight Leg 610584,Default Ridgefield,3,3,0,0,0,0
,Urban Star Mens Jeans 38x30 Dark Relaxed Fit Straight Leg Stretch,Urban Star Mens Jeans 38x30 Dark Relaxed Fit Straight Leg Stretch,Default Ridgefield,14,14,0,0,0,0
,Urban Star Mens Jeans 42 X 32 Relaxed Fit 1085970 Dark Blue Straight Stretch,Urban Star Mens Jeans 42 X 32 Relaxed Fit 1085970 Dark Blue Straight Stretch,Default Ridgefield,1,1,0,0,0,0
,Urban Star Mens Jeans Dark Rinse Size 32x30,Urban Star Mens Jeans Dark Rinse Size 32x30,FBALYB Amazon,3,3,0,0,0,0
,Urban Star men's jeans - relaxed fit - straight - 30x34 - black -610584,Urban Star men's jeans - relaxed fit - straight - 30x34 - black -610584,Default Ridgefield,1,1,0,0,0,0
,Urban Star men's jeans - relaxed fit - straight - 36 x 36 - blue 610584,Urban Star men's jeans - relaxed fit - straight - 36 x 36 - blue 610584,Default Ridgefield,3,3,0,0,0,0
,Urban Star men's jeans - relaxed fit - straight - 44 x 30 - black -610584,Urban Star men's jeans - relaxed fit - straight - 44 x 30 - black -610584,Default Ridgefield,1,1,0,0,0,0
,Urban Star Men's Jeans Straight Leg Stretch Relaxed Fit Dark Wash Size 32x34,Urban Star Men's Jeans Straight Leg Stretch Relaxed Fit Dark Wash Size 32x34,Default Ridgefield,1,1,0,0,0,0
,Urban Star Men's Jean Straight Leg Relaxed Fit Size 32*32,Urban Star Men's Jean Straight Leg Relaxed Fit Size 32*32,Default Ridgefield,1,1,0,0,0,0
,"Urban Star Men's Jean Stretch Denim Straight Leg Dark Wash Blue, Size 34x30","Urban Star Men's Jean Stretch Denim Straight Leg Dark Wash Blue, Size 34x30",Default Ridgefield,4,4,0,0,0,0
,"Urban Star Men's Jean Stretch Relaxed Fit Straight Leg Blue, Size 36x32","Urban Star Men's Jean Stretch Relaxed Fit Straight Leg Blue, Size 36x32",Default Ridgefield,45,45,0,0,0,0
,"Urban Star Men's Jean Stretch Relaxed Fit Straight Leg Dark Blue, Size 38x34","Urban Star Men's Jean Stretch Relaxed Fit Straight Leg Dark Blue, Size 38x34",Default Ridgefield,14,14,0,0,0,0
,"Urban Star Men's Jean Stretch Relaxed Fit Straight Leg Midnight Blue, Size 32x30","Urban Star Men's Jean Stretch Relaxed Fit Straight Leg Midnight Blue, Size 32x30",FBALYB Amazon,32,29,3,0,3,0
,"Urban Star Men's Jean Stretch Relaxed Straight Leg dark Blue, Size 34x32","Urban Star Men's Jean Stretch Relaxed Straight Leg dark Blue, Size 34x32",Default Ridgefield,1,1,0,0,0,0
,"Urban Star Men's Light Blue, Size 32 x 34","Urban Star Men's Light Blue, Size 32 x 34",Default Ridgefield,1,1,0,0,0,0
,Urban Star Men's Midnight Blue Size 32 x 32,Urban Star Men's Midnight Blue Size 32 x 32,Default Ridgefield,1,1,0,0,0,0
,Urban Star Men's Relaxed Fit JeansBlue Us Size 34x32,Urban Star Men's Relaxed Fit JeansBlue Us Size 34x32,Default Ridgefield,3,3,0,0,0,0
,Urban Star Men's Relaxed Fit Jean sBlue Us Size 34x34,Urban Star Men's Relaxed Fit Jean sBlue Us Size 34x34,Default Ridgefield,1,1,0,0,0,0
,Urban Star Men's Relaxed Fit JeansBlue Us Size 42x32,Urban Star Men's Relaxed Fit JeansBlue Us Size 42x32,Default Ridgefield,1,1,0,0,0,0
,Urban Star Men's Relaxed Fit Jeans Dark Rinse Us Size 34x30,Urban Star Men's Relaxed Fit Jeans Dark Rinse Us Size 34x30,Default Ridgefield,6,6,0,0,0,0
,Urban Star Men's Relaxed Fit Jeans Dark Rinse Us Size 34x34 610584,Urban Star Men's Relaxed Fit Jeans Dark Rinse Us Size 34x34 610584,Default Ridgefield,4,4,0,0,0,0
,Urban Star Men's Relaxed Fit Jeans Dark Rinse Us Size 36x32,Urban Star Men's Relaxed Fit Jeans Dark Rinse Us Size 36x32,Default Ridgefield,1,1,0,0,0,0
,Urban Star Men's Relaxed Fit Jeans Denims Straight Leg 30*30,Urban Star Men's Relaxed Fit Jeans Denims Straight Leg 30*30,Default Ridgefield,1,1,0,0,0,0
,"Urban Star Men's Relaxed Fit Jeans Denims Straight Leg Gray, Size 36x34","Urban Star Men's Relaxed Fit Jeans Denims Straight Leg Gray, Size 36x34",Default Ridgefield,13,13,0,0,0,0
,"Urban Star Men's Relaxed Fit Jean Straight Leg dark Blue, Size 36w X 34l","Urban Star Men's Relaxed Fit Jean Straight Leg dark Blue, Size 36w X 34l",FBALYB Amazon,17,17,0,0,0,0
,"Urban Star Men's Relaxed Fit Jean Stretch Straight Leg Blue, Size 30 X 31","Urban Star Men's Relaxed Fit Jean Stretch Straight Leg Blue, Size 30 X 31",Default Ridgefield,13,13,0,0,0,0
,"Urban Star Men's Relaxed Fit Jean Stretch Straight Leg Blue, Size 30 X 33","Urban Star Men's Relaxed Fit Jean Stretch Straight Leg Blue, Size 30 X 33",Default Ridgefield,12,12,0,0,0,0
,"Urban Star Men's Relaxed Fit Jean Stretch Straight Leg Blue, Size 32 X 31","Urban Star Men's Relaxed Fit Jean Stretch Straight Leg Blue, Size 32 X 31",Default Ridgefield,13,13,0,0,0,0
,"Urban Star Men's Relaxed Fit Jean Stretch Straight Leg Blue, Size 32 X 33","Urban Star Men's Relaxed Fit Jean Stretch Straight Leg Blue, Size 32 X 33",Default Ridgefield,12,12,0,0,0,0
,"Urban Star Men's Relaxed Fit Jean Stretch Straight Leg Blue, Size 36 X 31","Urban Star Men's Relaxed Fit Jean Stretch Straight Leg Blue, Size 36 X 31",Default Ridgefield,13,13,0,0,0,0
,"Urban Star Men's Relaxed Fit Jean Stretch Straight Leg Blue, Size 36 X 33","Urban Star Men's Relaxed Fit Jean Stretch Straight Leg Blue, Size 36 X 33",Default Ridgefield,12,12,0,0,0,0
,"Urban Star Men's Relaxed Fit Jean Stretch Straight Leg Blue, Size 38 X 31","Urban Star Men's Relaxed Fit Jean Stretch Straight Leg Blue, Size 38 X 31",Default Ridgefield,13,13,0,0,0,0
,"Urban Star Men's Relaxed Fit Jean Stretch Straight Leg Blue, Size 38 X 33","Urban Star Men's Relaxed Fit Jean Stretch Straight Leg Blue, Size 38 X 33",Default Ridgefield,12,12,0,0,0,0
,"Urban Star Men's Relaxed Fit Jean Stretch Straight Leg Blue, Size 40 X 31","Urban Star Men's Relaxed Fit Jean Stretch Straight Leg Blue, Size 40 X 31",Default Ridgefield,13,13,0,0,0,0
,"Urban Star Men's Relaxed Fit Jean Stretch Straight Leg Blue, Size 40 X 33","Urban Star Men's Relaxed Fit Jean Stretch Straight Leg Blue, Size 40 X 33",Default Ridgefield,11,11,0,0,0,0
,"Urban Star Men's Relaxed Fit Jean Stretch Straight Leg Blue, Size 42 X 30","Urban Star Men's Relaxed Fit Jean Stretch Straight Leg Blue, Size 42 X 30",Default Ridgefield,1,1,0,0,0,0
,"Urban Star Men's Relaxed Fit Jean Stretch Straight Leg Blue, Size 42 X 31","Urban Star Men's Relaxed Fit Jean Stretch Straight Leg Blue, Size 42 X 31",Default Ridgefield,12,12,0,0,0,0
,"Urban Star Men's Relaxed Fit Jean Stretch Straight Leg Blue, Size 42 X 33","Urban Star Men's Relaxed Fit Jean Stretch Straight Leg Blue, Size 42 X 33",Default Ridgefield,13,13,0,0,0,0
,"Urban Star Men's Relaxed Fit Jean Stretch Straight Leg Blue, Size 44 X 31","Urban Star Men's Relaxed Fit Jean Stretch Straight Leg Blue, Size 44 X 31",Default Ridgefield,13,13,0,0,0,0
,"Urban Star Men's Relaxed Fit Jean Stretch Straight Leg Blue, Size 44 X 33","Urban Star Men's Relaxed Fit Jean Stretch Straight Leg Blue, Size 44 X 33",Default Ridgefield,12,12,0,0,0,0
,"Urban Star Men's Relaxed Fit Straight Leg Classic Blue, Size 36x30","Urban Star Men's Relaxed Fit Straight Leg Classic Blue, Size 36x30",Default Ridgefield,1,1,0,0,0,0
,Urban Star Mens Relaxed Fit Straight Leg Jeans /32x30/ Black,Urban Star Mens Relaxed Fit Straight Leg Jeans /32x30/ Black,FBALYB Amazon,14,14,0,0,0,0
,"Urban Star Men's Relaxed Fit Straight Leg Jeans Black, Size 32x32","Urban Star Men's Relaxed Fit Straight Leg Jeans Black, Size 32x32",Default Ridgefield,15,15,0,0,0,0
,"Urban Star Men's Relaxed Fit Straight Leg Jeans Blue, Size 32x32","Urban Star Men's Relaxed Fit Straight Leg Jeans Blue, Size 32x32",Default Ridgefield,33,33,0,0,0,0
,"Urban Star Men's Relaxed Fit Straight Leg Jeans Blue, Size 42x32","Urban Star Men's Relaxed Fit Straight Leg Jeans Blue, Size 42x32",Default Ridgefield,5,5,0,0,0,0
,"Urban Star Men's Relaxed Fit Straight Leg Jeans classic Blue, Size 34x32","Urban Star Men's Relaxed Fit Straight Leg Jeans classic Blue, Size 34x32",Default Ridgefield,49,49,0,0,0,0
,"Urban Star Men's Relaxed Fit Straight Leg Jeans Gray, Size 32x30 #610584","Urban Star Men's Relaxed Fit Straight Leg Jeans Gray, Size 32x30 #610584",Default Ridgefield,26,26,0,0,0,0
,"Urban Star Men's Relaxed Fit Straight Leg Jeans Gray, Size 32x32 #610584","Urban Star Men's Relaxed Fit Straight Leg Jeans Gray, Size 32x32 #610584",Default Ridgefield,16,16,0,0,0,0
,"Urban Star Men's Relaxed Fit Straight Leg Jeans, Grey, Size 30x30","Urban Star Men's Relaxed Fit Straight Leg Jeans, Grey, Size 30x30",Default Ridgefield,5,5,0,0,0,0
,Urban Star Men's Relaxed Fit Straight Leg Stretch Jeans- Dark Wash 36 X 34,Urban Star Men's Relaxed Fit Straight Leg Stretch Jeans- Dark Wash 36 X 34,Default Ridgefield,2,2,0,0,0,0
,"Urban Star Men's Relaxed Jean Fit Denims Straight Leg Dark Gray, Size 36x32","Urban Star Men's Relaxed Jean Fit Denims Straight Leg Dark Gray, Size 36x32",Default Ridgefield,12,12,0,0,0,0
,"Urban Star Men's Relaxed Jean Fit Denims Straight Leg Grey, Size 38x30","Urban Star Men's Relaxed Jean Fit Denims Straight Leg Grey, Size 38x30",Default Ridgefield,1,1,0,0,0,0
,"Urban Star Men's Relaxed Jeans Fit Straight Leg Grey, Size 32x32","Urban Star Men's Relaxed Jeans Fit Straight Leg Grey, Size 32x32",Default Ridgefield,4,4,0,0,0,0
,Urban Star Men's Straight Leg Jeans Dark Gray Size 34x32 #610584,Urban Star Men's Straight Leg Jeans Dark Gray Size 34x32 #610584,Default Ridgefield,23,23,0,0,0,0
,Urban Star Men's Straight Leg Relaxed Fit Jeans Size 34x30,Urban Star Men's Straight Leg Relaxed Fit Jeans Size 34x30,Default Ridgefield,3,3,0,0,0,0
,Urban Star Men's Stretch Relaxed Fit Straight Jeans Faded Black 38x34,Urban Star Men's Stretch Relaxed Fit Straight Jeans Faded Black 38x34,Default Ridgefield,13,13,0,0,0,0
,"Urban Star Men's Stretch Relaxed Jean Fit Midnight Blue, Size: 38x32","Urban Star Men's Stretch Relaxed Jean Fit Midnight Blue, Size: 38x32",Default Ridgefield,1,1,0,0,0,0
,"Urban Star Men's Stretch Relaxed Jean Fit Straight Leg Grey, Size 34x34","Urban Star Men's Stretch Relaxed Jean Fit Straight Leg Grey, Size 34x34",Default Ridgefield,9,9,0,0,0,0
,"Urban Star Men's Stretch Relaxed Jean Fit Straight Leg Grey, Size 36x32","Urban Star Men's Stretch Relaxed Jean Fit Straight Leg Grey, Size 36x32",Default Ridgefield,3,3,0,0,0,0
,"Urban Star Men's Stretch Relaxed Jean Fit Straight Leg Grey, Size 38x32","Urban Star Men's Stretch Relaxed Jean Fit Straight Leg Grey, Size 38x32",Default Ridgefield,2,2,0,0,0,0
,"Urban Star Men's Stretch Relaxed Jean Fit Straight Leg Grey, Size 42x32","Urban Star Men's Stretch Relaxed Jean Fit Straight Leg Grey, Size 42x32",Default Ridgefield,2,2,0,0,0,0
,"Urban Star Mens Stretch Relaxed Straight Leg Authenic Jeans, Grey, 32x34","Urban Star Mens Stretch Relaxed Straight Leg Authenic Jeans, Grey, 32x34",Default Ridgefield,1,1,0,0,0,0
,Urban Star Midnight Blue 32 x 32,Urban Star Midnight Blue 32 x 32,FBALYB Amazon,1,1,0,0,0,0
,Urban Star Relaxed Fit Straight Leg Dk Denim Blue Sz 36 X 30,Urban Star Relaxed Fit Straight Leg Dk Denim Blue Sz 36 X 30,Default Ridgefield,1,1,0,0,0,0
,Urban Star Straight Leg Stretch Dark Wash Relaxed Jeans 38 X 34,Urban Star Straight Leg Stretch Dark Wash Relaxed Jeans 38 X 34,Default Ridgefield,1,1,0,0,0,0
,Urine Off Dog & Puppy Formula 32 Oz,Urine Off Dog & Puppy Formula With Carpet Injector Cap 32 Oz,FBALYB Amazon,23,23,0,0,0,0
,Utility Shovel,Utility Shovel,FBALYB Amazon,-23,-27,4,24,4,0
,UTZ 43oz Party Mix Barrel,UTZ 43oz Party Mix Barrel,Default,0,0,0,0,0,69
,UX-YC01-JWX5,"NutriBullet Pro 900 Hi-Speed Blender/Mixer, 9-piece Set",Default,0,0,0,0,0,12
,V8-LR15-A7Y8,"Kellogg's Nutri-Grain Cereal Bars, 36 Count",FBALYB Amazon,-1,-1,0,0,0,0
,Valley Chewy Trail Mix Fruit and Nut Bar,Nature Valley Chewy Trail Mix Fruit and Nut Bars Forty-Eight 1.2 Ounce bars,Default,0,0,0,0,0,4
,Valley Chewy Trail Mix Fruit and Nut Bar,Nature Valley Chewy Trail Mix Fruit and Nut Bars Forty-Eight 1.2 Ounce bars,FBALYB Amazon,39,39,0,0,0,0
,Van Houtte Breakfast Blend 24ct k cups,Van Houtte Breakfast Blend 24ct k cups,FBALYB Amazon,42,42,0,0,0,0
,Van Houtte Chocolate Rasp 72ct,Van Houtte Chocolate Rasp 72ct,FBALYB Amazon,6,3,3,0,3,0
,Van Houtte Chocolate Raspberry Truffle 24ct k cups,Van Houtte Chocolate Raspberry Truffle 24ct k cups,FBALYB Amazon,13,1,12,491,12,0
,Van Houtte Chocolate Raspberry Truffle 24ct k cups 4PK,Van Houtte Chocolate Raspberry Truffle 24ct k cups 4PK,FBALYB Amazon,5,4,1,1,1,0
,Van Houtte Choc Raspberry Truffle 48ct,Van Houtte Choc Raspberry Truffle 48ct,FBALYB Amazon,91,86,5,38,5,0
,Van Houtte Colombian 48ct K Cups,Van Houtte Colombian 48ct K Cups,FBALYB Amazon,1,1,0,0,0,0
,Van Houtte Creme Brulee 24ct K Cups,Van Houtte Creme Brulee 24ct K Cups,Default,0,-48,48,0,0,0
,Van Houtte Creme Brulee 24ct K Cups,Van Houtte Creme Brulee 24ct K Cups,FBALYB Amazon,185,185,0,0,0,0
,VanHoutte FrenchVanilla Coffee 120ct 5pk,VanHoutte FrenchVanilla Coffee 120ct 5pk,FBALYB Amazon,1,0,1,2,1,0
,Van Houtte French Vanilla K Cups 72ct,Van Houtte French Vanilla K Cups 72ct,FBALYB Amazon,309,303,6,0,6,0
,Van Houtte House Blend 24ct k cups,Van Houtte House Blend 24ct k cups,FBALYB Amazon,7,7,0,0,0,0
,Van Houtte Midnight Express 24ct k cups,Van Houtte Midnight Express 24ct k cups,FBALYB Amazon,29,29,0,0,0,0
,Van Houtte Sumatra 24ct K Cups FT / Ex Bold,Van Houtte Sumatra 24ct K Cups FT / Ex Bold,FBALYB Amazon,19,19,0,0,0,0
,Van Houtte Swiss Water Decaf 24ct,Van Houtte Swiss Water Decaf Fair Trade Organic 24ct,FBALYB Amazon,71,67,4,48,4,0
,Van Houtte Swiss Water Decaf 24ct 2pk,Van Houtte Swiss Water Decaf 24ct 2pk,FBALYB Amazon,42,42,0,4,0,0
,Vanity Fair Plates(54 ct.),"Vanity Fair 10.25"" Plates, Family Pack (54 ct.)",FBALYB Amazon,2,2,0,1,0,0
,Vanness AF3 3‑Pound Auto Feeder,Vanness AF3 3‑Pound Auto Feeder,FBALYB Amazon,95,95,0,0,0,0
,Van Ness Cat Pan - Medium,Van Ness Cat Pan - Medium,FBALYB Amazon,71,71,0,0,0,0
,Van Ness Cat Pan - Medium 2pk,Van Ness Cat Pan - Medium 2pk,FBALYB Amazon,-7,-7,0,0,0,0
,Van Ness Stainless Steel Dish Small,Van Ness Stainless Steel Dish Small,Default,0,0,0,0,0,2
,Van Ness Stainless Steel Dish Small,Van Ness Stainless Steel Dish Small,FBALYB Amazon,127,127,0,0,0,0
,"Van Ness X-Small Auto Feeder, 1.5lb","Van Ness X-Small Auto Feeder, 1.5lb",FBALYB Amazon,-1,-1,0,0,0,0
,Van's Men's C&D Authentic Casual Sneakers VJU Size 4,,Default Oxford,15,15,0,0,0,0
,Van's Men's C&D Authentic Casual Sneakers VJU Size 4.5,,Default Oxford,9,9,0,0,0,0
,Van's Men's C&D Authentic Casual Sneakers VJU Size 5,,Default Oxford,8,8,0,0,0,0
,Van's Men's C&D Authentic Casual Sneakers VJU Size 5.5,,Default Oxford,16,16,0,0,0,0
,Van's Men's C&D Authentic Casual Sneakers VJU Size 6,,Default Oxford,23,23,0,0,0,0
,Van's Men's C&D Authentic Casual Sneakers VJU Size 6.5,,Default Ridgefield,6,6,0,0,0,0
,Van's Men's C&D Authentic Casual Sneakers VJU Size 7,,Default Oxford,1,1,0,0,0,0
,Van's Men's C&D Authentic Casual Sneakers VJU Size 7,,Default Ridgefield,16,16,0,0,0,0
,Van's Men's C&D Authentic Casual Sneakers VJU Size 7.5,,Default Oxford,10,10,0,0,0,0
,Van's Men's C&D Authentic Casual Sneakers VJU Size 8.5,,Default Oxford,16,16,0,0,0,0
,Van's Men's VN000ZDF Old Skool Skate 1WX Shoe Size 10,,Default Oxford,10,10,0,0,0,0
,Van's Men's VN000ZDF Old Skool Skate 1WX Shoe Size 10.5,,Default Oxford,8,8,0,0,0,0
,Van's Men's VN000ZDF Old Skool Skate 1WX Shoe Size 11,,Default Oxford,8,8,0,0,0,0
,Van's Men's VN000ZDF Old Skool Skate 1WX Shoe Size 11.5,,Default Oxford,2,2,0,0,0,0
,Van's Men's VN000ZDF Old Skool Skate 1WX Shoe Size 11.5,,Default Ridgefield,1,1,0,0,0,0
,Van's Men's VN000ZDF Old Skool Skate 1WX Shoe Size 11.5,,FBALYB Amazon,5,5,0,0,0,0
,Van's Men's VN000ZDF Old Skool Skate 1WX Shoe Size 12,,Default Ridgefield,7,7,0,0,0,0
,Van's Men's VN000ZDF Old Skool Skate 1WX Shoe Size 9.5,,Default Ridgefield,2,2,0,0,0,0
,Van's Men's VN000ZDF Old Skool Skate 1WX Shoe Size 9.5,,FBALYB Amazon,5,5,0,0,0,0
,Van's Men's VN000ZDF Old Skool Skate Shoe Size 4,,Default Oxford,1,1,0,0,0,0
,Van's Men's VN000ZDF Old Skool Skate Shoe Size 4.5,,Default Oxford,1,1,0,0,0,0
,Van's Men's VN000ZDF Old Skool Skate Shoe Size 7.5,,Default Oxford,9,9,0,0,0,0
,Van's Men's VN000ZDF Old Skool Skate Shoe Size 8,,Default Oxford,13,13,0,0,0,0
,Van's Men's VN000ZDF Old Skool Skate Shoe Size 8.5,,Default Oxford,13,13,0,0,0,0
,Van's Men's VN000ZDF Old Skool Skate Shoe Size 9,,Default Oxford,9,9,0,0,0,0
,Van's Men's VN0A38FR Era Canvas VOV Sneaker Size 4,,Default Oxford,17,17,0,0,0,0
,Van's Men's VN0A38FR Era Canvas VOV Sneaker Size 4.5,,Default Oxford,14,14,0,0,0,0
,Van's Men's VN0A38FR Era Canvas VOV Sneaker Size 5,,Default Oxford,17,17,0,0,0,0
,Van's Men's VN0A38FR Era Canvas VOV Sneaker Size 5.5,,Default Oxford,45,45,0,0,0,0
,Van's Men's VN0A38FR Era Canvas VOV Sneaker Size 6,,Default Oxford,42,42,0,0,0,0
,Van's Men's VN0A38FR Era Canvas VOV Sneaker Size 6.5,,Default Oxford,15,15,0,0,0,0
,Van's Men's VN0A38FR Era Canvas VOV Sneaker Size 7,,Default Oxford,46,46,0,0,0,0
,Van's Men's VN0A38FR Era Canvas VOV Sneaker Size 7.5,,Default Oxford,17,17,0,0,0,0
,Van's Men's VN0A38FR Era Canvas VOV Sneaker Size 8.5,,Default Oxford,15,15,0,0,0,0
,Van's Men's VN0A3AV8 Authentic Platform 2.0 Shoe S1T Size 4,,Default Oxford,9,9,0,0,0,0
,Van's Men's VN0A3AV8 Authentic Platform 2.0 Shoe S1T Size 4.5,,Default Oxford,9,9,0,0,0,0
,Van's Men's VN0A3AV8 Authentic Platform 2.0 Shoe S1T Size 5,,Default Oxford,10,10,0,0,0,0
,Van's Men's VN0A3AV8 Authentic Platform 2.0 Shoe S1T Size 5.5,,Default Oxford,16,16,0,0,0,0
,Van's Men's VN0A3AV8 Authentic Platform 2.0 Shoe S1T Size 6,,Default Oxford,17,17,0,0,0,0
,Van's Men's VN0A3AV8 Authentic Platform 2.0 Shoe S1T Size 6.5,,Default Oxford,10,10,0,0,0,0
,Van's Men's VN0A3AV8 Authentic Platform 2.0 Shoe S1T Size 7,,Default Oxford,17,17,0,0,0,0
,Van's Men's VN0A3AV8 Authentic Platform 2.0 Shoe S1T Size 8.5,,Default Oxford,12,12,0,0,0,0
,Van's Men's VN0A3AV8 Authentic Platform 2.0 Shoe S1X Size 4,,Default Oxford,18,18,0,0,0,0
,Van's Men's VN0A3AV8 Authentic Platform 2.0 Shoe S1X Size 4.5,,Default Oxford,6,6,0,0,0,0
,Van's Men's VN0A3AV8 Authentic Platform 2.0 Shoe S1X Size 5,,Default Oxford,10,10,0,0,0,0
,Van's Men's VN0A3AV8 Authentic Platform 2.0 Shoe S1X Size 5.5,,Default Oxford,23,23,0,0,0,0
,Van's Men's VN0A3AV8 Authentic Platform 2.0 Shoe S1X Size 6,,Default Oxford,15,15,0,0,0,0
,Van's Men's VN0A3AV8 Authentic Platform 2.0 Shoe S1X Size 6.5,,Default Oxford,4,4,0,0,0,0
,Van's Men's VN0A3AV8 Authentic Platform 2.0 Shoe S1X Size 7,,Default Oxford,25,25,0,0,0,0
,Van's Men's VN0A3AV8 Authentic Platform 2.0 Shoe S1X Size 7.5,,Default Oxford,1,1,0,0,0,0
,Van's Men's VN0A3AV8 Authentic Platform 2.0 Shoe S1X Size 8.5,,Default Oxford,16,16,0,0,0,0
,Van's Men's VN-0EYE  Classic Slip-On BWW Size 10,,Default Oxford,10,10,0,0,0,0
,Van's Men's VN-0EYE  Classic Slip-On BWW Size 10.5,,Default Oxford,7,7,0,0,0,0
,Van's Men's VN-0EYE  Classic Slip-On BWW Size 11,,Default Oxford,8,8,0,0,0,0
,Van's Men's VN-0EYE  Classic Slip-On BWW Size 11.5,,Default Oxford,8,8,0,0,0,0
,Van's Men's VN-0EYE  Classic Slip-On BWW Size 12,,Default Oxford,8,8,0,0,0,0
,Van's Men's VN-0EYE  Classic Slip-On BWW Size 4,,Default Oxford,5,5,0,0,0,0
,Van's Men's VN-0EYE  Classic Slip-On BWW Size 5,,Default Oxford,4,4,0,0,0,0
,Van's Men's VN-0EYE  Classic Slip-On BWW Size 5.5,,Default Oxford,3,3,0,0,0,0
,Van's Men's VN-0EYE  Classic Slip-On BWW Size 6,,Default Oxford,4,4,0,0,0,0
,Van's Men's VN-0EYE  Classic Slip-On BWW Size 6.5,,Default Oxford,4,4,0,0,0,0
,Van's Men's VN-0EYE  Classic Slip-On BWW Size 7,,Default Oxford,4,4,0,0,0,0
,Van's Men's VN-0EYE  Classic Slip-On BWW Size 7.5,,Default Oxford,9,9,0,0,0,0
,Van's Men's VN-0EYE  Classic Slip-On BWW Size 7.5,,FBALYB Amazon,2,0,2,0,2,0
,Van's Men's VN-0EYE  Classic Slip-On BWW Size 8,,Default Oxford,16,16,0,0,0,0
,Van's Men's VN-0EYE  Classic Slip-On BWW Size 8.5,,Default Oxford,1,1,0,0,0,0
,Van's Men's VN-0EYE  Classic Slip-On BWW Size 8.5,,Default Ridgefield,15,15,0,0,0,0
,Van's Men's VN-0EYE  Classic Slip-On BWW Size 9,,Default Oxford,10,10,0,0,0,0
,Van's Men's VN-0EYE  Classic Slip-On BWW Size 9.5,,Default Oxford,12,12,0,0,0,0
,Vans Unisex Big Check Slip-On Shoes WRT Size 10,,Default Oxford,3,3,0,0,0,0
,Vans Unisex Big Check Slip-On Shoes WRT Size 10.5,,Default Oxford,1,1,0,0,0,0
,Vans Unisex Big Check Slip-On Shoes WRT Size 11,,Default Oxford,3,3,0,0,0,0
,Vans Unisex Big Check Slip-On Shoes WRT Size 11.5,,Default Oxford,1,1,0,0,0,0
,Vans Unisex Big Check Slip-On Shoes WRT Size 12,,Default Oxford,1,1,0,0,0,0
,Vans Unisex Big Check Slip-On Shoes WRT Size 4,,Default Oxford,4,4,0,0,0,0
,Vans Unisex Big Check Slip-On Shoes WRT Size 4,,Default Ridgefield,1,1,0,0,0,0
,Vans Unisex Big Check Slip-On Shoes WRT Size 4.5,,Default Oxford,3,3,0,0,0,0
,Vans Unisex Big Check Slip-On Shoes WRT Size 4.5,,Default Ridgefield,2,2,0,0,0,0
,Vans Unisex Big Check Slip-On Shoes WRT Size 5,,Default Oxford,3,3,0,0,0,0
,Vans Unisex Big Check Slip-On Shoes WRT Size 5,,FBALYB Amazon,2,2,0,0,0,0
,Vans Unisex Big Check Slip-On Shoes WRT Size 5.5,,Default Oxford,6,6,0,0,0,0
,Vans Unisex Big Check Slip-On Shoes WRT Size 6,,Default Oxford,3,3,0,0,0,0
,Vans Unisex Big Check Slip-On Shoes WRT Size 6,,Default Ridgefield,6,6,0,0,0,0
,Vans Unisex Big Check Slip-On Shoes WRT Size 6.5,,Default Oxford,10,10,0,0,0,0
,Vans Unisex Big Check Slip-On Shoes WRT Size 6.5,,FBALYB Amazon,7,7,0,0,0,0
,Vans Unisex Big Check Slip-On Shoes WRT Size 7,,Default Oxford,18,18,0,0,0,0
,Vans Unisex Big Check Slip-On Shoes WRT Size 7.5,,Default Oxford,1,1,0,0,0,0
,Vans Unisex Big Check Slip-On Shoes WRT Size 8,,Default Oxford,1,1,0,0,0,0
,Vans Unisex Big Check Slip-On Shoes WRT Size 8.5,,Default Oxford,1,1,0,0,0,0
,Vans Unisex Big Check Slip-On Shoes WRT Size 9,,Default Oxford,1,1,0,0,0,0
,Vans Unisex Big Check Slip-On Shoes WRT Size 9.5,,Default Oxford,1,1,0,0,0,0
,Vans Unisex ComfyCush Old Skool Sneakers VNC Size 10,,Default Ridgefield,26,26,0,0,0,0
,Vans Unisex ComfyCush Old Skool Sneakers VNC Size 10.5,,Default Oxford,1,1,0,0,0,0
,Vans Unisex ComfyCush Old Skool Sneakers VNC Size 10.5,,Default Ridgefield,9,9,0,0,0,0
,Vans Unisex ComfyCush Old Skool Sneakers VNC Size 11,,Default Ridgefield,10,10,0,0,0,0
,Vans Unisex ComfyCush Old Skool Sneakers VNC Size 11.5,,Default Ridgefield,12,12,0,0,0,0
,Vans Unisex ComfyCush Old Skool Sneakers VNC Size 12,,Default Ridgefield,8,8,0,0,0,0
,Vans Unisex ComfyCush Old Skool Sneakers VNC Size 8.5,,Default Ridgefield,23,23,0,0,0,0
,Vans Unisex ComfyCush Old Skool Sneakers VNC Size 9,,Default Ridgefield,26,26,0,0,0,0
,Vans Unisex ComfyCush Old Skool Sneakers VNC Size 9.5,,Default Ridgefield,11,11,0,0,0,0
,Vapor grey green,"Zulu Vapor BPA-Free Plastic Water Bottle with Flip Straw, Grey/Green, 24 oz",FBALYB Amazon,-2,-2,0,0,0,0
,Variety Bundle dove men care body wash,Variety Bundle dove men care body wash,Default,0,-720,720,0,0,0
,Variety Bundle dove men care body wash,Variety Bundle dove men care body wash,Default Ridgefield,396,0,396,0,0,0
,Variety Bundle dove men care body wash,Variety Bundle dove men care body wash,FBALYB Amazon,-403,-403,0,693,0,0
,Vaseline Extremely Dry Skin Rescue 400ml,Vaseline Extremely Dry Skin Rescue 400ml,Default Ridgefield,6,6,0,0,0,0
,Vaseline Extremely Dry Skin Rescue 400ml,Vaseline Extremely Dry Skin Rescue 400ml,FBALYB Amazon,22,21,1,0,1,0
,Vaseline Extremely Dry Skin Rescue 400ml 2pk,Vaseline Extremely Dry Skin Rescue 400ml 2pk,Default Ridgefield,1,1,0,0,0,0
,Vaseline Extremely Dry Skin Rescue 400ml 2pk,Vaseline Extremely Dry Skin Rescue 400ml 2pk,FBALYB Amazon,305,305,0,4,0,0
,Vaseline lip therapy 20g original 6 pk,Vaseline lip therapy 20g original 6 pk,FBALYB Amazon,-2,-2,0,0,0,0
,VE-1JPB-7TQE,Microsoft Type Cover for Surface Pro 4 - Black (QC7-00001),FBALYB Amazon,1,1,0,0,0,0
,Vega Organic Protein Powder Vanilla 35.3oz,Vega Organic Protein Powder Vanilla 35.3oz,FBALYB Amazon,-2,-2,0,0,0,0
,Vera Chicken Treats 22oz,Vera Chicken Treats 22oz,Default,0,0,0,0,0,2
,Verizon Galaxy J7 16GB Black,Verizon Prepaid - Samsung Galaxy J7 4G LTE with 16GB Memory Prepaid Cell Phone - Black,Default,1,1,0,0,0,0
,Verizon Galaxy J7 16GB Black,Verizon Prepaid - Samsung Galaxy J7 4G LTE with 16GB Memory Prepaid Cell Phone - Black,FBALYB Amazon,-2,-2,0,0,0,0
,Vermints Mints Cinnamon Tin (6pack),Vermints Mints Cinnamon Tin (6pack),FBALYB Amazon,117,117,0,0,0,0
,Vermints Mints Gingermint Tin (6pack),Vermints Mints Gingermint Tin (6pack),FBALYB Amazon,234,234,0,0,0,0
,Vermints Mints Peppermint Tin (6pack),Vermints Mints Peppermint Tin (6pack),FBALYB Amazon,231,231,0,0,0,0
,Vertical Wood Gate With Door,Vertical Wood Gate With Door,FBALYB Amazon,1,1,0,0,0,0
,Veterinary Clinical Care Shampoo 2pk,Veterinary Clinical Care Shampoo 2pk,FBALYB Amazon,17,17,0,0,0,0
,Veterinary Flea and Tick Shampoo 16oz,Veterinary Formula Clinical Care Flea and Tick Shampoo 16 oz bottle,FBALYB Amazon,16,16,0,0,0,0
,Vet's Best Anti-Flea Spray Shampoo 16oz,Vet's Best Anti-Flea Spray Shampoo 16oz,FBALYB Amazon,183,183,0,0,0,0
,VG-ZQ1Y-2NX0,"Daily Chef Organic Dark Roast, Single Serve (80 ct.)",FBALYB Amazon,1,1,0,0,0,0
,Viactiv 180 2pack,Viactiv 180 2pack,FBALYB Amazon,1,1,0,0,0,0
,"Viactiv Chews, 180 Count","Viactiv Calcium Plus D Vitamin Chews, 180 Count",FBALYB Amazon,6,6,0,12,0,0
,Victoria Marinara 2- 40oz,Victoria White Linen Marinara Sauce Twin pack 2- 40oz bottles,Default,0,0,0,0,0,16
,Victoria Marinara 2- 40oz,Victoria White Linen Marinara Sauce Twin pack 2- 40oz bottles,FBALYB Amazon,36,36,0,0,0,0
,VICTORIA SECRET BOMBSHELL MIST SPR 250ML,VICTORIA SECRET BOMBSHELL MIST SPR 250ML,FBALYB Amazon,6,6,0,0,0,0
,VICTORIA SECRET PINK FRESH AND CLEAN MIST 250ML,VICTORIA SECRET PINK FRESH AND CLEAN MIST 250ML,Default Ridgefield,8,8,0,0,0,0
,VICTORIA SECRET PINK FRESH AND CLEAN MIST 250ML,VICTORIA SECRET PINK FRESH AND CLEAN MIST 250ML,FBALYB Amazon,193,192,1,0,1,0
,VICTORIA SECRET PINK WARM AND COZY MIST 250ML,VICTORIA SECRET PINK WARM AND COZY MIST 250ML,FBALYB Amazon,-2,-2,0,0,0,0
,VICTORIA SECRET TMC AMBER ROMANCE BODY LOTION 237ML, VICTORIA SECRET TMC AMBER ROMANCE BODY LOTION 237ML,Default Ridgefield,4,4,0,0,0,0
,VICTORIA SECRET TMC AMBER ROMANCE BODY LOTION 237ML, VICTORIA SECRET TMC AMBER ROMANCE BODY LOTION 237ML,FBALYB Amazon,29,19,10,0,10,0
,VICTORIA SECRET TMC AMBER ROMANCE MIST 250ML,VICTORIA SECRET TMC AMBER ROMANCE MIST 250ML,Default Ridgefield,4,4,0,0,0,0
,VICTORIA SECRET TMC AMBER ROMANCE MIST 250ML,VICTORIA SECRET TMC AMBER ROMANCE MIST 250ML,FBALYB Amazon,230,230,0,0,0,0
,VICTORIA SECRET TMC AMBER ROMANCE MIST 250ML + VICTORIA SECRET TMC AMBER ROMANCE BODY LOTION 237ML,VICTORIA SECRET TMC AMBER ROMANCE MIST 250ML + VICTORIA SECRET TMC AMBER ROMANCE BODY LOTION 237ML,Default Ridgefield,0,-1,1,0,0,0
,VICTORIA SECRET TMC AMBER ROMANCE MIST 250ML + VICTORIA SECRET TMC AMBER ROMANCE BODY LOTION 237ML,VICTORIA SECRET TMC AMBER ROMANCE MIST 250ML + VICTORIA SECRET TMC AMBER ROMANCE BODY LOTION 237ML,FBALYB Amazon,119,108,11,0,11,0
,VICTORIA SECRET TMC AQUA KISS BODY LOTION 236ML,VICTORIA SECRET TMC AQUA KISS BODY LOTION 236ML,FBALYB Amazon,27,22,5,0,5,0
,VICTORIA SECRET TMC AQUA KISS MIST 250ML,VICTORIA SECRET TMC AQUA KISS MIST 250ML,Default Ridgefield,2,2,0,0,0,0
,VICTORIA SECRET TMC AQUA KISS MIST 250ML,VICTORIA SECRET TMC AQUA KISS MIST 250ML,FBALYB Amazon,2,2,0,0,0,0
,VICTORIA SECRET TMC COCONUT PASSION BODY LOTION 236ML,VICTORIA SECRET TMC COCONUT PASSION BODY LOTION 236ML,FBALYB Amazon,-1,-1,0,0,0,0
,VICTORIA SECRET TMC COCONUT PASSION MIST 250ML,VICTORIA SECRET TMC COCONUT PASSION MIST 250ML,FBALYB Amazon,1,1,0,0,0,0
,VICTORIA SECRET TMC LOVE ADDICT MIST 250ML,VICTORIA SECRET TMC LOVE ADDICT MIST 250ML,FBALYB Amazon,-1,-1,0,0,0,0
,VICTORIA SECRET TMC LOVE SPELL BODY LOTION 236ML,VICTORIA SECRET TMC LOVE SPELL BODY LOTION 236ML,Default Ridgefield,17,17,0,0,0,0
,VICTORIA SECRET TMC LOVE SPELL BODY LOTION 236ML,VICTORIA SECRET TMC LOVE SPELL BODY LOTION 236ML,FBALYB Amazon,69,69,0,0,0,0
,VICTORIA SECRET TMC LOVE SPELL MIST 250ML,VICTORIA SECRET TMC LOVE SPELL MIST 250ML,Default Ridgefield,4,4,0,0,0,0
,VICTORIA SECRET TMC LOVE SPELL MIST 250ML,VICTORIA SECRET TMC LOVE SPELL MIST 250ML,FBALYB Amazon,-26,-29,3,0,3,0
,VICTORIA SECRET TMC PURE SEDUCTION BODY LOTION 237ML,VICTORIA SECRET TMC PURE SEDUCTION BODY LOTION 237ML,Default,0,-300,300,0,0,0
,VICTORIA SECRET TMC PURE SEDUCTION BODY LOTION 237ML,VICTORIA SECRET TMC PURE SEDUCTION BODY LOTION 237ML,Default Ridgefield,2,2,0,0,0,0
,VICTORIA SECRET TMC PURE SEDUCTION BODY LOTION 237ML,VICTORIA SECRET TMC PURE SEDUCTION BODY LOTION 237ML,FBALYB Amazon,11,11,0,0,0,0
,VICTORIA SECRET TMC PURE SEDUCTION MIST 250ML,VICTORIA SECRET TMC PURE SEDUCTION MIST 250ML,Default,0,-300,300,0,0,0
,VICTORIA SECRET TMC PURE SEDUCTION MIST 250ML,VICTORIA SECRET TMC PURE SEDUCTION MIST 250ML,Default Ridgefield,2,-1492,1494,0,0,0
,VICTORIA SECRET TMC PURE SEDUCTION MIST 250ML,VICTORIA SECRET TMC PURE SEDUCTION MIST 250ML,FBALYB Amazon,7,-6,13,0,13,0
,VICTORIA SECRET TMC PURE SEDUCTION MIST 250ML + VICTORIA SECRET TMC PURE SEDUCTION BODY LOTION 237ML Bundle,VICTORIA SECRET TMC PURE SEDUCTION MIST 250ML + VICTORIA SECRET TMC PURE SEDUCTION BODY LOTION 237ML Bundle,FBALYB Amazon,13,13,0,0,0,0
,VICTORIA SECRET TMC ROMANTIC BODY LOTION 236ML,VICTORIA SECRET TMC ROMANTIC BODY LOTION 236ML,FBALYB Amazon,-40,-40,0,40,0,0
,VICTORIA SECRET TMC RUSH MIST 250ML,VICTORIA SECRET TMC RUSH MIST 250ML,Default Ridgefield,2,2,0,0,0,0
,VICTORIA SECRET TMC RUSH MIST 250ML,VICTORIA SECRET TMC RUSH MIST 250ML,FBALYB Amazon,130,122,8,0,8,0
,VICTORIA SECRET TMC TEMPTATION BODY LOTION 236ML,VICTORIA SECRET TMC TEMPTATION BODY LOTION 236ML,FBALYB Amazon,-1,-1,0,0,0,0
,VICTORIA SECRET TMC TEMPTATION MIST 250ML,VICTORIA SECRET TMC TEMPTATION MIST 250ML,FBALYB Amazon,2,2,0,0,0,0
,Victoria Secret VS TMC RUSH BODY LOTION 237ML,Victoria Secret VS TMC RUSH BODY LOTION 237ML,Default Ridgefield,2,2,0,0,0,0
,Victoria Secret VS TMC RUSH BODY LOTION 237ML,Victoria Secret VS TMC RUSH BODY LOTION 237ML,FBALYB Amazon,259,257,2,0,2,0
,Victoria Secret VS TMC RUSH BODY LOTION 237ML + VICTORIA SECRET TMC RUSH MIST 250ML,Victoria Secret VS TMC RUSH BODY LOTION 237ML + VICTORIA SECRET TMC RUSH MIST 250ML,FBALYB Amazon,602,601,1,0,1,0
,Victorinox 6.7831 Red Swiss Classic Tomato and sausage Knife,Victorinox 6.7831 Red Swiss Classic Tomato and sausage Knife,Default Ridgefield,350,350,0,0,0,0
,Victorinox 6.7832 Blue Swiss Classic Tomato and sausage Knife,Victorinox 6.7832 Blue Swiss Classic Tomato and sausage Knife,Default Ridgefield,415,415,0,0,0,0
,Victorinox 6.7836.L114 Light Green Swiss Classic Tomato and sausage Knife,Victorinox 6.7836.L114 Light Green Swiss Classic Tomato and sausage Knife,Default Ridgefield,3216,3216,0,0,0,0
,Victorinox 6.7836.L115 Pink Swiss Classic Tomato and sausage Knife,Victorinox 6.7836.L115 Pink Swiss Classic Tomato and sausage Knife,Default Ridgefield,1962,1962,0,0,0,0
,Victorinox 6.7836.L118 Yellow Swiss Classic Tomato and sausage Knife,Victorinox 6.7836.L118 Yellow Swiss Classic Tomato and sausage Knife,Default Ridgefield,2747,2747,0,0,0,0
,Victorinox 6.7836.L119 Orange Swiss Classic Tomato and sausage Knife,Victorinox 6.7836.L119 Orange Swiss Classic Tomato and sausage Knife,Default Ridgefield,2727,2727,0,0,0,0
,Victorinox Black Fibrox Carving Knife 5.2003.19,Victorinox Black Fibrox Carving Knife 5.2003.19,Default Ridgefield,170,170,0,0,0,0
,Victorinox Black Fibrox Carving Knife 5.2003.19,Victorinox Black Fibrox Carving Knife 5.2003.19,FBALYB Amazon,248,247,1,0,1,0
,Victorinox Black Fibrox Pro Boning Knife 5.6413.15,Victorinox Black Fibrox Pro Boning Knife 5.6413.15,Default Ridgefield,34,34,0,0,0,0
,Victorinox Black Fibrox Pro Boning Knife 5.6413.15,Victorinox Black Fibrox Pro Boning Knife 5.6413.15,FBALYB Amazon,1129,1099,30,2,30,0
,Victorinox Black Fibrox Pro Boning Knife 5.6413.15,Victorinox Black Fibrox Pro Boning Knife 5.6413.15,FBALYB Canada,8,7,1,1,1,0
,Victorinox Black Fibrox Pro Bread Knife 5.2533.21,Victorinox Black Fibrox Pro Bread Knife 5.2533.21,Default Ridgefield,4299,4299,0,0,0,0
,Victorinox Black Fibrox Pro Bread Knife 5.2533.21,Victorinox Black Fibrox Pro Bread Knife 5.2533.21,FBAFBA LYB AUSTRALIA,0,0,0,10,0,0
,Victorinox Black Fibrox Pro Bread Knife 5.2533.21,Victorinox Black Fibrox Pro Bread Knife 5.2533.21,FBALYB Amazon,81,81,0,0,0,0
,Victorinox Black Fibrox Pro Bread Knife 5.2533.21,Victorinox Black Fibrox Pro Bread Knife 5.2533.21,WFS,-13,-13,0,0,0,0
,Victorinox Black Fibrox Pro Carving Knife 5.2003.25,Victorinox Black Fibrox Pro Carving Knife 5.2003.25,FBALYB Amazon,19,14,5,0,5,0
,Victorinox Black Fibrox Pro Carving Knife 5.2003.25,Victorinox Black Fibrox Pro Carving Knife 5.2003.25,FBALYB Canada,-1,-1,0,35,0,0
,Victorinox Black Fibrox Pro Kitchen Knife 5.2003.15,Victorinox Black Fibrox Pro Kitchen Knife 5.2003.15,Default,0,0,0,0,0,2
,Victorinox Black Fibrox Pro Kitchen Knife 5.2003.15,Victorinox Black Fibrox Pro Kitchen Knife 5.2003.15,Default Ridgefield,220,220,0,0,0,0
,Victorinox Black Fibrox Pro Kitchen Knife 5.2003.15,Victorinox Black Fibrox Pro Kitchen Knife 5.2003.15,FBAFBA LYB AUSTRALIA,0,0,0,50,0,0
,Victorinox Black Fibrox Pro Kitchen Knife 5.2003.15,Victorinox Black Fibrox Pro Kitchen Knife 5.2003.15,FBALYB Amazon,620,580,40,9,40,0
,Victorinox Black Fibrox Pro Kitchen Knife 5.2003.15,Victorinox Black Fibrox Pro Kitchen Knife 5.2003.15,FBALYB Canada,0,0,0,75,0,0
,VICTORINOX  Black FIBROX SANTOKU 6.8523.17G,VICTORINOX  Black FIBROX SANTOKU 6.8523.17G,Default Ridgefield,234,234,0,0,0,0
,Victorinox Black Fibrox Slicing Knife 5.4723.30,Victorinox Black Fibrox Slicing Knife 5.4723.30,Default Ridgefield,1796,1796,0,0,0,0
,Victorinox Black Fibrox Slicing Knife 5.4723.30,Victorinox Black Fibrox Slicing Knife 5.4723.30,FBALYB Amazon,660,630,30,0,30,0
,"Victorinox Black Paring Knife Set, 3 Pieces 5.1113.3","Victorinox Black Paring Knife Set, 3 Pieces 5.1113.3",Default Ridgefield,65,65,0,0,0,0
,"Victorinox Black Paring Knife Set, 3 Pieces 5.1113.3","Victorinox Black Paring Knife Set, 3 Pieces 5.1113.3",FBAFBA LYB AUSTRALIA,0,0,0,35,0,0
,"Victorinox Black Paring Knife Set, 3 Pieces 5.1113.3","Victorinox Black Paring Knife Set, 3 Pieces 5.1113.3",FBALYB Amazon,570,556,14,1,14,0
,"Victorinox Black Paring Knife Set, 3 Pieces 5.1113.3","Victorinox Black Paring Knife Set, 3 Pieces 5.1113.3",FBALYB Canada,13,13,0,0,0,0
,Victorinox Black Swiss Classic Paring Knife 6.7603,Victorinox Black Swiss Classic Paring Knife 6.7603,Default Ridgefield,3,3,0,0,0,0
,Victorinox Black Swiss Classic Paring Knife 6.7603,Victorinox Black Swiss Classic Paring Knife 6.7603,FBALYB Amazon,36,6,30,10,30,0
,"Victorinox Black Swiss Classic Steak Knife Set, 6 Pieces 6.7233.6","Victorinox Black Swiss Classic Steak Knife Set, 6 Pieces 6.7233.6",Default Ridgefield,235,235,0,0,0,0
,"Victorinox Black Swiss Classic Steak Knife Set, 6 Pieces 6.7233.6","Victorinox Black Swiss Classic Steak Knife Set, 6 Pieces 6.7233.6",FBAFBA LYB AUSTRALIA,0,0,0,10,0,0
,"Victorinox Black Swiss Classic Steak Knife Set, 6 Pieces 6.7233.6","Victorinox Black Swiss Classic Steak Knife Set, 6 Pieces 6.7233.6",FBALYB Amazon,616,599,17,0,17,0
,"Victorinox Black Swiss Classic Tomato and Table Knife Set, 6 pieces 6.7833.6","Victorinox Black Swiss Classic Tomato and Table Knife Set, 6 pieces 6.7833.6",FBAFBA LYB AUSTRALIA,-10,-10,0,35,0,0
,"Victorinox Black Swiss Classic Tomato and Table Knife Set, 6 pieces 6.7833.6","Victorinox Black Swiss Classic Tomato and Table Knife Set, 6 pieces 6.7833.6",FBALYB Amazon,101,97,4,4,4,0
,"Victorinox Black Swiss Classic Tomato and Table Knife Set, 6 pieces 6.7833.6","Victorinox Black Swiss Classic Tomato and Table Knife Set, 6 pieces 6.7833.6",FBALYB Canada,-3,-3,0,0,0,0
,Victorinox Blue Swiss Classic Steak Knife 6.7232.20,Victorinox Blue Swiss Classic Steak Knife 6.7232.20,Default Ridgefield,240,240,0,0,0,0
,Victorinox Blue Swiss Classic Steak Knife 6.7232.20,Victorinox Blue Swiss Classic Steak Knife 6.7232.20,FBALYB Amazon,9,7,2,0,2,0
,Victorinox Blue Swiss Classic Steak Knife 6.7232.20 6pk,Victorinox Blue Swiss Classic Steak Knife 6.7232.20 6pk,FBALYB Amazon,48,47,1,0,1,0
,Victorinox Orange Swiss Classic Tomato and sausage Knife 6.7836.L119,Victorinox Orange Swiss Classic Tomato and sausage Knife 6.7836.L119,Default,0,0,0,0,0,20
,Victorinox Orange Swiss Classic Tomato and sausage Knife 6.7836.L119,Victorinox Orange Swiss Classic Tomato and sausage Knife 6.7836.L119,Default Ridgefield,385,385,0,0,0,0
,Victorinox Pink Swiss Classic Tomato and sausage Knife 6.7836.L115,Victorinox Pink Swiss Classic Tomato and sausage Knife 6.7836.L115,Default,0,0,0,0,0,20
,Victorinox Pink Swiss Classic Tomato and sausage Knife 6.7836.L115,Victorinox Pink Swiss Classic Tomato and sausage Knife 6.7836.L115,Default Ridgefield,1196,1196,0,0,0,0
,Victorinox Red Swiss Classic Paring Knife 6.7601,Victorinox Red Swiss Classic Paring Knife 6.7601,Default Ridgefield,894,894,0,0,0,0
,Victorinox Red Swiss Classic Paring Knife 6.7601,Victorinox Red Swiss Classic Paring Knife 6.7601,FBALYB Amazon,728,708,20,0,20,0
,Victorinox Red Swiss Classic Paring Knife 6.7601,Victorinox Red Swiss Classic Paring Knife 6.7601,FBALYB Canada,0,0,0,44,0,0
,Victorinox Red Swiss Classic Paring Knife 6.7701,Victorinox Red Swiss Classic Paring Knife 6.7701,Default,0,-116,116,0,0,0
,Victorinox Red Swiss Classic Paring Knife 6.7701,Victorinox Red Swiss Classic Paring Knife 6.7701,Default Ridgefield,705,705,0,0,0,0
,Victorinox Red Swiss Classic Paring Knife 6.7701,Victorinox Red Swiss Classic Paring Knife 6.7701,FBALYB Amazon,104,97,7,0,7,0
,Victorinox Red Swiss Classic Paring Knife 6.7701,Victorinox Red Swiss Classic Paring Knife 6.7701,FBALYB Canada,0,0,0,50,0,0
,Victorinox Red Swiss Classic Tomato and sausage Knife 6.7831,Victorinox Red Swiss Classic Tomato and sausage Knife 6.7831,Default Ridgefield,65,65,0,0,0,0
,Victorinox Red Swiss Classic Tomato and sausage Knife 6.7831,Victorinox Red Swiss Classic Tomato and sausage Knife 6.7831,FBALYB Amazon,6,6,0,0,0,0
,Victorinox Rosewood Pastry knife 5.2930.26,Victorinox Rosewood Pastry knife 5.2930.26,Default Ridgefield,480,480,0,0,0,0
,"Victorinox Tomato and Sausage Knife Green, Orange, Pink, Yellow, Red, Blue 6pc Set","Victorinox Tomato and Sausage Knife Green, Orange, Pink, Yellow, Red, Blue 6pc Set",FBALYB Amazon,15,4,11,0,11,0
,"Victorinox Tomato and Sausage Knife Green, Pink, Yellow, Orange 4pc Set","Victorinox Tomato and Sausage Knife Green, Pink, Yellow, Orange 4pc Set",FBAFBA LYB AUSTRALIA,-1,-1,0,20,0,0
,"Victorinox Tomato and Sausage Knife Green, Pink, Yellow, Orange 4pc Set","Victorinox Tomato and Sausage Knife Green, Pink, Yellow, Orange 4pc Set",FBALYB Amazon,1536,1536,0,50,0,0
,"Victorinox Tomato and Sausage Knife Green, Pink, Yellow, Orange 4pcs Set","Victorinox Tomato and Sausage Knife Green, Pink, Yellow, Orange 4pcs Set",FBALYB Amazon,976,902,74,0,74,0
,"Victorinox Tomato and Sausage Knife Green, Pink, Yellow, Orange 4pcs Set","Victorinox Tomato and Sausage Knife Green, Pink, Yellow, Orange 4pcs Set",FBALYB Canada,0,0,0,87,0,0
,Victorinox Yellow Swiss Classic Tomato and sausage Knife 6.7836.L118,Victorinox Yellow Swiss Classic Tomato and sausage Knife 6.7836.L118,Default,0,0,0,0,0,1
,Victorinox Yellow Swiss Classic Tomato and sausage Knife 6.7836.L118,Victorinox Yellow Swiss Classic Tomato and sausage Knife 6.7836.L118,Default Ridgefield,386,386,0,0,0,0
,"Vim Cream with Bleach 750 ml, 3ct","Vim Cream with Bleach 750 ml, 3ct",Default Ridgefield,1210,1210,0,0,0,0
,"Vim Cream with Bleach 750 ml, 3ct","Vim Cream with Bleach 750 ml, 3ct",FBALYB Amazon,208,193,15,0,15,0
,"Vim Cream with Bleach 750 ml, 3ct","Vim Cream with Bleach 750 ml, 3ct",FBALYB Canada,0,0,0,60,0,0
,VINUM BORDEAUX GRAND CRU,VINUM BORDEAUX GRAND CRU,Default Ridgefield,355,355,0,0,0,0
,VINUM BORDEAUX GRAND CRU,VINUM BORDEAUX GRAND CRU,FBALYB Amazon,108,103,5,2,5,0
,VINUM MARTINI XL,VINUM MARTINI XL,Default Ridgefield,16,16,0,0,0,0
,VINUM MARTINI XL,VINUM MARTINI XL,FBALYB Amazon,23,23,0,0,0,0
,VINUM PAY 6 GET 8 CABERNET SAUVIGNON/MERLOT,VINUM PAY 6 GET 8 CABERNET SAUVIGNON/MERLOT,Default Ridgefield,248,247,1,0,0,0
,VINUM PAY 6 GET 8 CABERNET SAUVIGNON/MERLOT,VINUM PAY 6 GET 8 CABERNET SAUVIGNON/MERLOT,FBALYB Amazon,246,234,12,0,12,0
,VINUM PAY 6 GET 8 VIOGNIER/CHARDONNAY,VINUM PAY 6 GET 8 VIOGNIER/CHARDONNAY,Default Ridgefield,263,263,0,0,0,0
,VINUM PAY 6 GET 8 VIOGNIER/CHARDONNAY,VINUM PAY 6 GET 8 VIOGNIER/CHARDONNAY,FBALYB Amazon,281,279,2,0,2,0
,Vionic Mens Preston Loafer Black 10000703 Size 10.5M,Vionic Mens Preston Loafer Black 10000703 Size 10.5M,Default Ridgefield,20,20,0,0,0,0
,Vionic Mens Preston Loafer Black 10000703 Size 10M,Vionic Mens Preston Loafer Black 10000703 Size 10M,Default Ridgefield,20,20,0,0,0,0
,Vionic Mens Preston Loafer Black 10000703 Size 11.5M,Vionic Mens Preston Loafer Black 10000703 Size 11.5M,Default Ridgefield,20,20,0,0,0,0
,Vionic Mens Preston Loafer Black 10000703 Size 11M,Vionic Mens Preston Loafer Black 10000703 Size 11M,Default,0,0,0,0,0,2
,Vionic Mens Preston Loafer Black 10000703 Size 11M,Vionic Mens Preston Loafer Black 10000703 Size 11M,Default Ridgefield,18,18,0,0,0,0
,Vionic Mens Preston Loafer Black 10000703 Size 9.5M,Vionic Mens Preston Loafer Black 10000703 Size 9.5M,Default Ridgefield,20,20,0,0,0,0
,Vionic Mens Preston Loafer Tan 10000703 Size 10.5M,Vionic Mens Preston Loafer Tan 10000703 Size 10.5M,Default Ridgefield,20,20,0,0,0,0
,Vionic Mens Preston Loafer Tan 10000703 Size 10M,Vionic Mens Preston Loafer Tan 10000703 Size 10M,Default Ridgefield,20,20,0,0,0,0
,Vionic Mens Preston Loafer Tan 10000703 Size 11.5M,Vionic Mens Preston Loafer Tan 10000703 Size 11.5M,Default Ridgefield,20,20,0,0,0,0
,Vionic Mens Preston Loafer Tan 10000703 Size 11M,Vionic Mens Preston Loafer Tan 10000703 Size 11M,Default Ridgefield,20,20,0,0,0,0
,Vionic Mens Preston Loafer Tan 10000703 Size 9.5M,Vionic Mens Preston Loafer Tan 10000703 Size 9.5M,Default Ridgefield,20,20,0,0,0,0
,Vionic Mens Shane Lace Up Black 10010037 Size 10.5M,Vionic Mens Shane Lace Up Black 10010037 Size 10.5M,Default Ridgefield,37,37,0,0,0,0
,Vionic Mens Shane Lace Up Black 10010037 Size 10.5M,Vionic Mens Shane Lace Up Black 10010037 Size 10.5M,FBALYB Amazon,0,0,0,23,0,0
,Vionic Mens Shane Lace Up Black 10010037 Size 10M,Vionic Mens Shane Lace Up Black 10010037 Size 10M,Default,0,0,0,0,0,10
,Vionic Mens Shane Lace Up Black 10010037 Size 10M,Vionic Mens Shane Lace Up Black 10010037 Size 10M,Default Ridgefield,26,26,0,0,0,0
,Vionic Mens Shane Lace Up Black 10010037 Size 11M,Vionic Mens Shane Lace Up Black 10010037 Size 11M,Default Ridgefield,24,24,0,0,0,0
,Vionic Mens Shane Lace Up Black 10010037 Size 12M,Vionic Mens Shane Lace Up Black 10010037 Size 12M,Default Ridgefield,24,24,0,0,0,0
,Vionic Mens Shane Lace Up Black 10010037 Size 13M,Vionic Mens Shane Lace Up Black 10010037 Size 13M,Default Ridgefield,24,24,0,0,0,0
,Vionic Mens Shane Lace Up Black 10010037 Size 9.5M,Vionic Mens Shane Lace Up Black 10010037 Size 9.5M,Default Ridgefield,18,18,0,0,0,0
,Vionic Mens Shane Lace Up Black 10010037 Size 9.5M,Vionic Mens Shane Lace Up Black 10010037 Size 9.5M,FBALYB Amazon,0,0,0,42,0,0
,Vionic Mens Tide Toe Post Sandal Black 10000541 Size 10M,Vionic Mens Tide Toe Post Sandal Black 10000541 Size 10M,FBALYB Amazon,-14,-14,0,0,0,0
,Vionic Mens Tide Toe Post Sandal Black 10000541 Size 8M,Vionic Mens Tide Toe Post Sandal Black 10000541 Size 8M,FBALYB Amazon,-2,-2,0,0,0,0
,Vionic Mens Tide Toe Post Sandal Black 10000541 Size 9M,Vionic Mens Tide Toe Post Sandal Black 10000541 Size 9M,FBALYB Amazon,-26,-26,0,1,0,0
,Vionic Mens Tide Toe Post Sandal Brown 10000541 Size 10M,Vionic Mens Tide Toe Post Sandal Brown 10000541 Size 10M,FBALYB Amazon,-18,-18,0,0,0,0
,Vionic Mens Tide Toe Post Sandal Brown 10000541 Size 11M,Vionic Mens Tide Toe Post Sandal Brown 10000541 Size 11M,FBALYB Amazon,-7,-7,0,0,0,0
,Vionic Mens Tide Toe Post Sandal Brown 10000541 Size 7M,Vionic Mens Tide Toe Post Sandal Brown 10000541 Size 7M,FBALYB Amazon,-4,-4,0,0,0,0
,Vionic Mens Tide Toe Post Sandal Brown 10000541 Size 8M,Vionic Mens Tide Toe Post Sandal Brown 10000541 Size 8M,FBALYB Amazon,-6,-6,0,0,0,0
,Vionic Mens Tide Toe Post Sandal Brown 10000541 Size 9M,Vionic Mens Tide Toe Post Sandal Brown 10000541 Size 9M,FBALYB Amazon,-32,-32,0,0,0,0
,VIONIC Womens Amber Backstrap Sandal Black Croc 10000430 Size 10,VIONIC Womens Amber Backstrap Sandal Black Croc 10000430 Size 10,Default Ridgefield,10,10,0,0,0,0
,VIONIC Womens Amber Backstrap Sandal Black Croc 10000430 Size 10,VIONIC Womens Amber Backstrap Sandal Black Croc 10000430 Size 10,FBALYB Amazon,-3,-3,0,0,0,0
,VIONIC Womens Amber Backstrap Sandal Black Croc 10000430 Size 11,VIONIC Womens Amber Backstrap Sandal Black Croc 10000430 Size 11,Default Oxford,10,10,0,0,0,0
,VIONIC Womens Amber Backstrap Sandal Black Croc 10000430 Size 11,VIONIC Womens Amber Backstrap Sandal Black Croc 10000430 Size 11,FBALYB Amazon,-1,-1,0,0,0,0
,VIONIC Womens Amber Backstrap Sandal Black Croc 10000430 Size 6,VIONIC Womens Amber Backstrap Sandal Black Croc 10000430 Size 6,FBALYB Amazon,-3,-3,0,0,0,0
,VIONIC Womens Amber Backstrap Sandal Black Croc 10000430 Size 8,VIONIC Womens Amber Backstrap Sandal Black Croc 10000430 Size 8,FBALYB Amazon,-15,-15,0,0,0,0
,VIONIC Womens Amber Backstrap Sandal Black Croc 10000430 Size 8W,VIONIC Womens Amber Backstrap Sandal Black Croc 10000430 Size 8W,FBALYB Amazon,-11,-11,0,0,0,0
,VIONIC Womens Amber Backstrap Sandal Black Croc 10000430 Size 9,VIONIC Womens Amber Backstrap Sandal Black Croc 10000430 Size 9,FBALYB Amazon,-3,-3,0,0,0,0
,VIONIC Womens Amber Backstrap Sandal Black Croc 10000430 Size 9W,VIONIC Womens Amber Backstrap Sandal Black Croc 10000430 Size 9W,FBALYB Amazon,-5,-5,0,0,0,0
,VIONIC Womens Amber Backstrap Sandal Gold Cork 10000430 Size 10,VIONIC Womens Amber Backstrap Sandal Gold Cork 10000430 Size 10,FBALYB Amazon,-12,-12,0,0,0,0
,VIONIC Womens Amber Backstrap Sandal Gold Cork 10000430 Size 11,VIONIC Womens Amber Backstrap Sandal Gold Cork 10000430 Size 11,FBALYB Amazon,2,2,0,0,0,0
,VIONIC Womens Amber Backstrap Sandal Gold Cork 10000430 Size 6,VIONIC Womens Amber Backstrap Sandal Gold Cork 10000430 Size 6,FBALYB Amazon,-10,-10,0,0,0,0
,VIONIC Womens Amber Backstrap Sandal Gold Cork 10000430 Size 8,VIONIC Womens Amber Backstrap Sandal Gold Cork 10000430 Size 8,FBALYB Amazon,-42,-42,0,0,0,0
,VIONIC Womens Amber Backstrap Sandal Gold Cork 10000430 Size 8W,VIONIC Womens Amber Backstrap Sandal Gold Cork 10000430 Size 8W,FBALYB Amazon,-15,-15,0,0,0,0
,VIONIC Womens Amber Backstrap Sandal Gold Cork 10000430 Size 9,VIONIC Womens Amber Backstrap Sandal Gold Cork 10000430 Size 9,FBALYB Amazon,-10,-10,0,0,0,0
,VIONIC Womens Amber Backstrap Sandal Gold Cork 10000430 Size 9W,VIONIC Womens Amber Backstrap Sandal Gold Cork 10000430 Size 9W,FBALYB Amazon,-14,-14,0,0,0,0
,Vionic Womens Brisk Aimmy Walking Shoes Black 10010737 Size 10M,Vionic Womens Brisk Aimmy Walking Shoes Black 10010737 Size 10M,FBALYB Amazon,-4,-4,0,0,0,0
,Vionic Womens Brisk Aimmy Walking Shoes Black 10010737 Size 6.5M,Vionic Womens Brisk Aimmy Walking Shoes Black 10010737 Size 6.5M,FBALYB Amazon,-10,-10,0,0,0,0
,Vionic Womens Brisk Aimmy Walking Shoes Black 10010737 Size 6M,Vionic Womens Brisk Aimmy Walking Shoes Black 10010737 Size 6M,FBALYB Amazon,-7,-7,0,0,0,0
,Vionic Womens Brisk Aimmy Walking Shoes Black 10010737 Size 7.5M,Vionic Womens Brisk Aimmy Walking Shoes Black 10010737 Size 7.5M,FBALYB Amazon,-7,-7,0,0,0,0
,Vionic Womens Brisk Aimmy Walking Shoes Black 10010737 Size 7M,Vionic Womens Brisk Aimmy Walking Shoes Black 10010737 Size 7M,FBALYB Amazon,-15,-15,0,0,0,0
,Vionic Womens Brisk Aimmy Walking Shoes Black 10010737 Size 8.5M,Vionic Womens Brisk Aimmy Walking Shoes Black 10010737 Size 8.5M,FBALYB Amazon,-10,-10,0,0,0,0
,Vionic Womens Brisk Aimmy Walking Shoes Black 10010737 Size 8.5W,Vionic Womens Brisk Aimmy Walking Shoes Black 10010737 Size 8.5W,FBALYB Amazon,-19,-19,0,0,0,0
,Vionic Womens Brisk Aimmy Walking Shoes Black 10010737 Size 8M,Vionic Womens Brisk Aimmy Walking Shoes Black 10010737 Size 8M,Default Ridgefield,40,40,0,0,0,0
,Vionic Womens Brisk Aimmy Walking Shoes Black 10010737 Size 8M,Vionic Womens Brisk Aimmy Walking Shoes Black 10010737 Size 8M,FBALYB Amazon,-22,-22,0,0,0,0
,Vionic Womens Brisk Aimmy Walking Shoes Black 10010737 Size 8W,Vionic Womens Brisk Aimmy Walking Shoes Black 10010737 Size 8W,FBALYB Amazon,-4,-4,0,0,0,0
,Vionic Womens Brisk Aimmy Walking Shoes Black 10010737 Size 9.5W,Vionic Womens Brisk Aimmy Walking Shoes Black 10010737 Size 9.5W,FBALYB Amazon,-3,-3,0,0,0,0
,Vionic Womens Brisk Aimmy Walking Shoes Black 10010737 Size 9M,Vionic Womens Brisk Aimmy Walking Shoes Black 10010737 Size 9M,FBALYB Amazon,-20,-20,0,0,0,0
,Vionic Womens Brisk Miles Lace Up Black 10000672 Size 10,Vionic Womens Brisk Miles Lace Up Black 10000672 Size 10,Default,1,1,0,0,0,0
,Vionic Womens Brisk Miles Lace Up Black 10000672 Size 10,Vionic Womens Brisk Miles Lace Up Black 10000672 Size 10,FBALYB Amazon,-8,-8,0,0,0,0
,Vionic Womens Brisk Miles Lace Up Black 10000672 Size 11,Vionic Womens Brisk Miles Lace Up Black 10000672 Size 11,FBALYB Amazon,-8,-8,0,0,0,0
,Vionic Womens Brisk Miles Lace Up Black 10000672 Size 7.5,Vionic Womens Brisk Miles Lace Up Black 10000672 Size 7.5,FBALYB Amazon,-3,-3,0,0,0,0
,Vionic Womens Brisk Miles Lace Up Black 10000672 Size 7.5W,Vionic Womens Brisk Miles Lace Up Black 10000672 Size 7.5W,FBALYB Amazon,-18,-18,0,0,0,0
,Vionic Womens Brisk Miles Lace Up Black 10000672 Size 8,Vionic Womens Brisk Miles Lace Up Black 10000672 Size 8,FBALYB Amazon,-6,-6,0,0,0,0
,Vionic Womens Brisk Miles Lace Up Black 10000672 Size 8.5,Vionic Womens Brisk Miles Lace Up Black 10000672 Size 8.5,FBALYB Amazon,-7,-7,0,0,0,0
,Vionic Womens Brisk Miles Lace Up Black 10000672 Size 8.5W,Vionic Womens Brisk Miles Lace Up Black 10000672 Size 8.5W,FBALYB Amazon,-15,-15,0,0,0,0
,Vionic Womens Brisk Miles Lace Up Black 10000672 Size 8W,Vionic Womens Brisk Miles Lace Up Black 10000672 Size 8W,FBALYB Amazon,-15,-15,0,0,0,0
,Vionic Womens Brisk Miles Lace Up Black 10000672 Size 9,Vionic Womens Brisk Miles Lace Up Black 10000672 Size 9,FBALYB Amazon,-10,-10,0,0,0,0
,Vionic Womens Brisk Miles Lace Up Black 10000672 Size 9.5,Vionic Womens Brisk Miles Lace Up Black 10000672 Size 9.5,FBALYB Amazon,-18,-18,0,0,0,0
,Vionic Womens Brisk Miles Lace Up Black 10000672 Size 9.5W,Vionic Womens Brisk Miles Lace Up Black 10000672 Size 9.5W,FBALYB Amazon,-14,-14,0,0,0,0
,Vionic Womens Brisk Miles Lace Up Black 10000672 Size 9W,Vionic Womens Brisk Miles Lace Up Black 10000672 Size 9W,FBALYB Amazon,-15,-15,0,0,0,0
,Vionic Womens Brisk Miles Lace Up Grey 10000672 Size 10,Vionic Womens Brisk Miles Lace Up Grey 10000672 Size 10,FBALYB Amazon,-7,-7,0,0,0,0
,Vionic Womens Brisk Miles Lace Up Grey 10000672 Size 11,Vionic Womens Brisk Miles Lace Up Grey 10000672 Size 11,FBALYB Amazon,-2,-2,0,0,0,0
,Vionic Womens Brisk Miles Lace Up Grey 10000672 Size 6,Vionic Womens Brisk Miles Lace Up Grey 10000672 Size 6,FBALYB Amazon,-3,-4,1,0,1,0
,Vionic Womens Brisk Miles Lace Up Grey 10000672 Size 6.5,Vionic Womens Brisk Miles Lace Up Grey 10000672 Size 6.5,FBALYB Amazon,-2,-2,0,0,0,0
,Vionic Womens Brisk Miles Lace Up Grey 10000672 Size 7,Vionic Womens Brisk Miles Lace Up Grey 10000672 Size 7,FBALYB Amazon,-2,-2,0,0,0,0
,Vionic Womens Brisk Miles Lace Up Grey 10000672 Size 7.5,Vionic Womens Brisk Miles Lace Up Grey 10000672 Size 7.5,FBALYB Amazon,-3,-3,0,0,0,0
,Vionic Womens Brisk Miles Lace Up Grey 10000672 Size 7.5W,Vionic Womens Brisk Miles Lace Up Grey 10000672 Size 7.5W,FBALYB Amazon,-2,-2,0,0,0,0
,Vionic Womens Brisk Miles Lace Up Grey 10000672 Size 8,Vionic Womens Brisk Miles Lace Up Grey 10000672 Size 8,FBALYB Amazon,-3,-3,0,0,0,0
,Vionic Womens Brisk Miles Lace Up Grey 10000672 Size 8.5,Vionic Womens Brisk Miles Lace Up Grey 10000672 Size 8.5,FBALYB Amazon,-8,-8,0,0,0,0
,Vionic Womens Brisk Miles Lace Up Grey 10000672 Size 8.5W,Vionic Womens Brisk Miles Lace Up Grey 10000672 Size 8.5W,FBALYB Amazon,-7,-7,0,0,0,0
,Vionic Womens Brisk Miles Lace Up Grey 10000672 Size 8W,Vionic Womens Brisk Miles Lace Up Grey 10000672 Size 8W,FBALYB Amazon,-9,-9,0,0,0,0
,Vionic Womens Brisk Miles Lace Up Grey 10000672 Size 9,Vionic Womens Brisk Miles Lace Up Grey 10000672 Size 9,FBALYB Amazon,-12,-12,0,0,0,0
,Vionic Womens Brisk Miles Lace Up Grey 10000672 Size 9.5,Vionic Womens Brisk Miles Lace Up Grey 10000672 Size 9.5,FBALYB Amazon,-10,-10,0,1,0,0
,Vionic Womens Brisk Miles Lace Up Grey 10000672 Size 9.5W,Vionic Womens Brisk Miles Lace Up Grey 10000672 Size 9.5W,Default Ridgefield,20,20,0,0,0,0
,Vionic Womens Brisk Miles Lace Up Grey 10000672 Size 9.5W,Vionic Womens Brisk Miles Lace Up Grey 10000672 Size 9.5W,FBALYB Amazon,-6,-6,0,0,0,0
,Vionic Womens Brisk Miles Lace Up Grey 10000672 Size 9W,Vionic Womens Brisk Miles Lace Up Grey 10000672 Size 9W,FBALYB Amazon,-13,-13,0,0,0,0
,Vionic Womens Demetra Slip On Black 10010858 Size 10M,Vionic Womens Demetra Slip On Black 10010858 Size 10M,FBALYB Amazon,-3,-3,0,0,0,0
,Vionic Womens Demetra Slip On Black 10010858 Size 11M,Vionic Womens Demetra Slip On Black 10010858 Size 11M,FBALYB Amazon,-3,-3,0,0,0,0
,Vionic Womens Demetra Slip On Black 10010858 Size 6M,Vionic Womens Demetra Slip On Black 10010858 Size 6M,FBALYB Amazon,12,12,0,0,0,0
,Vionic Womens Demetra Slip On Black 10010858 Size 7.5M,Vionic Womens Demetra Slip On Black 10010858 Size 7.5M,FBALYB Amazon,-17,-17,0,0,0,0
,Vionic Womens Demetra Slip On Black 10010858 Size 8M,Vionic Womens Demetra Slip On Black 10010858 Size 8M,FBALYB Amazon,-18,-18,0,0,0,0
,Vionic Womens Demetra Slip On Black 10010858 Size 9M,Vionic Womens Demetra Slip On Black 10010858 Size 9M,FBALYB Amazon,-25,-26,1,0,1,0
,Vionic Womens Gemma Leopard Mule Slipper Natural 10011247 Size 10,Vionic Womens Gemma Leopard Mule Slipper Natural 10011247 Size 10,FBALYB Amazon,-4,-4,0,0,0,0
,Vionic Womens Gemma Leopard Mule Slipper Natural 10011247 Size 11,Vionic Womens Gemma Leopard Mule Slipper Natural 10011247 Size 11,FBALYB Amazon,-2,-2,0,0,0,0
,Vionic Womens Gemma Leopard Mule Slipper Natural 10011247 Size 7,Vionic Womens Gemma Leopard Mule Slipper Natural 10011247 Size 7,FBALYB Amazon,-8,-8,0,0,0,0
,Vionic Womens Gemma Leopard Mule Slipper Natural 10011247 Size 8,Vionic Womens Gemma Leopard Mule Slipper Natural 10011247 Size 8,FBALYB Amazon,-4,-4,0,0,0,0
,Vionic Womens Gemma Leopard Mule Slipper Natural 10011247 Size 9,Vionic Womens Gemma Leopard Mule Slipper Natural 10011247 Size 9,FBALYB Amazon,-4,-4,0,1,0,0
,Vionic Womens Gemma Mule Slipper Black 10000148 Size 10,Vionic Womens Gemma Mule Slipper Black 10000148 Size 10,FBALYB Amazon,-7,-7,0,0,0,0
,Vionic Womens Gemma Mule Slipper Black 10000148 Size 11,Vionic Womens Gemma Mule Slipper Black 10000148 Size 11,FBALYB Amazon,-1,-1,0,0,0,0
,Vionic Womens Gemma Mule Slipper Black 10000148 Size 7,Vionic Womens Gemma Mule Slipper Black 10000148 Size 7,FBALYB Amazon,-1,-1,0,0,0,0
,Vionic Womens Gemma Mule Slipper Black 10000148 Size 8,Vionic Womens Gemma Mule Slipper Black 10000148 Size 8,FBALYB Amazon,-6,-6,0,0,0,0
,Vionic Womens Gemma Mule Slipper Black 10000148 Size 9,Vionic Womens Gemma Mule Slipper Black 10000148 Size 9,FBALYB Amazon,-5,-5,0,0,0,0
,Vionic Womens Gemma Mule Slipper Light Gray 10000148 Size 10,Vionic Womens Gemma Mule Slipper Light Gray 10000148 Size 10,FBALYB Amazon,-6,-6,0,0,0,0
,Vionic Womens Gemma Mule Slipper Light Gray 10000148 Size 11,Vionic Womens Gemma Mule Slipper Light Gray 10000148 Size 11,FBALYB Amazon,-3,-3,0,0,0,0
,Vionic Womens Gemma Mule Slipper Light Gray 10000148 Size 7,Vionic Womens Gemma Mule Slipper Light Gray 10000148 Size 7,FBALYB Amazon,-4,-4,0,0,0,0
,Vionic Womens Gemma Mule Slipper Light Gray 10000148 Size 8,Vionic Womens Gemma Mule Slipper Light Gray 10000148 Size 8,FBALYB Amazon,-8,-8,0,0,0,0
,Vionic Womens Gemma Mule Slipper Light Gray 10000148 Size 9,Vionic Womens Gemma Mule Slipper Light Gray 10000148 Size 9,FBALYB Amazon,-12,-12,0,0,0,0
,Vionic Womens Gemma Mule Slipper Pink 10000148 Size 10,Vionic Womens Gemma Mule Slipper Pink 10000148 Size 10,FBALYB Amazon,-4,-4,0,0,0,0
,Vionic Womens Gemma Mule Slipper Pink 10000148 Size 11,Vionic Womens Gemma Mule Slipper Pink 10000148 Size 11,FBALYB Amazon,-2,-2,0,0,0,0
,Vionic Womens Gemma Mule Slipper Pink 10000148 Size 7,Vionic Womens Gemma Mule Slipper Pink 10000148 Size 7,FBALYB Amazon,-3,-3,0,0,0,0
,Vionic Womens Gemma Mule Slipper Pink 10000148 Size 8,Vionic Womens Gemma Mule Slipper Pink 10000148 Size 8,FBALYB Amazon,-9,-9,0,1,0,0
,Vionic Womens Gemma Mule Slipper Pink 10000148 Size 9,Vionic Womens Gemma Mule Slipper Pink 10000148 Size 9,FBALYB Amazon,-2,-2,0,0,0,0
,Vionic Womens Indulge Gracie Slipper Black 10001139 Size 10,Vionic Womens Indulge Gracie Slipper Black 10001139 Size 10,Default Ridgefield,0,-33,33,0,0,0
,Vionic Womens Indulge Gracie Slipper Black 10001139 Size 10,Vionic Womens Indulge Gracie Slipper Black 10001139 Size 10,FBALYB Amazon,-4,-4,0,0,0,0
,Vionic Womens Indulge Gracie Slipper Black 10001139 Size 11,Vionic Womens Indulge Gracie Slipper Black 10001139 Size 11,FBALYB Amazon,-2,-2,0,0,0,0
,Vionic Womens Indulge Gracie Slipper Black 10001139 Size 7,Vionic Womens Indulge Gracie Slipper Black 10001139 Size 7,FBALYB Amazon,-4,-4,0,0,0,0
,Vionic Womens Indulge Gracie Slipper Black 10001139 Size 8,Vionic Womens Indulge Gracie Slipper Black 10001139 Size 8,FBALYB Amazon,-3,-3,0,0,0,0
,Vionic Womens Indulge Gracie Slipper Black 10001139 Size 9,Vionic Womens Indulge Gracie Slipper Black 10001139 Size 9,FBALYB Amazon,-4,-4,0,0,0,0
,Vionic Womens Indulge Gracie Slipper Light Grey 10001139 Size 10,Vionic Womens Indulge Gracie Slipper Light Grey 10001139 Size 10,FBALYB Amazon,-11,-11,0,0,0,0
,Vionic Womens Indulge Gracie Slipper Light Grey 10001139 Size 11,Vionic Womens Indulge Gracie Slipper Light Grey 10001139 Size 11,FBALYB Amazon,-3,-3,0,0,0,0
,Vionic Womens Indulge Gracie Slipper Light Grey 10001139 Size 6,Vionic Womens Indulge Gracie Slipper Light Grey 10001139 Size 6,FBALYB Amazon,-3,-3,0,0,0,0
,Vionic Womens Indulge Gracie Slipper Light Grey 10001139 Size 7,Vionic Womens Indulge Gracie Slipper Light Grey 10001139 Size 7,FBALYB Amazon,-15,-15,0,0,0,0
,Vionic Womens Indulge Gracie Slipper Light Grey 10001139 Size 8M,Vionic Womens Indulge Gracie Slipper Light Grey 10001139 Size 8M,FBALYB Amazon,-15,-15,0,0,0,0
,Vionic Womens Indulge Gracie Slipper Light Grey 10001139 Size 9,Vionic Womens Indulge Gracie Slipper Light Grey 10001139 Size 9,FBALYB Amazon,-8,-8,0,0,0,0
,Vionic Womens Joy Serena Ankle Boot Black 10000681 Size  10M,Vionic Womens Joy Serena Ankle Boot Black 10000681 Size  10M,FBALYB Amazon,16,15,1,0,1,0
,Vionic Womens Joy Serena Ankle Boot Black 10000681 Size  10W,Vionic Womens Joy Serena Ankle Boot Black 10000681 Size  10W,FBALYB Amazon,17,17,0,0,0,0
,Vionic Womens Joy Serena Ankle Boot Black 10000681 Size 11M,Vionic Womens Joy Serena Ankle Boot Black 10000681 Size 11M,FBALYB Amazon,-3,-3,0,0,0,0
,Vionic Womens Joy Serena Ankle Boot Black 10000681 Size  5M,Vionic Womens Joy Serena Ankle Boot Black 10000681 Size  5M,FBALYB Amazon,22,22,0,0,0,0
,Vionic Womens Joy Serena Ankle Boot Black 10000681 Size  6.5M,Vionic Womens Joy Serena Ankle Boot Black 10000681 Size  6.5M,FBALYB Amazon,49,49,0,0,0,0
,Vionic Womens Joy Serena Ankle Boot Black 10000681 Size  6M,Vionic Womens Joy Serena Ankle Boot Black 10000681 Size  6M,FBALYB Amazon,24,24,0,0,0,0
,Vionic Womens Joy Serena Ankle Boot Black 10000681 Size  7.5M,Vionic Womens Joy Serena Ankle Boot Black 10000681 Size  7.5M,FBALYB Amazon,51,47,4,1,4,0
,Vionic Womens Joy Serena Ankle Boot Black 10000681 Size  7M,Vionic Womens Joy Serena Ankle Boot Black 10000681 Size  7M,FBALYB Amazon,51,50,1,0,1,0
,Vionic Womens Joy Serena Ankle Boot Black 10000681 Size  8.5M,Vionic Womens Joy Serena Ankle Boot Black 10000681 Size  8.5M,FBALYB Amazon,9,7,2,0,2,0
,Vionic Womens Joy Serena Ankle Boot Black 10000681 Size  8.5W,Vionic Womens Joy Serena Ankle Boot Black 10000681 Size  8.5W,FBALYB Amazon,-2,-2,0,0,0,0
,Vionic Womens Joy Serena Ankle Boot Black 10000681 Size  8M,Vionic Womens Joy Serena Ankle Boot Black 10000681 Size  8M,FBALYB Amazon,-7,-9,2,0,2,0
,Vionic Womens Joy Serena Ankle Boot Black 10000681 Size 8W,Vionic Womens Joy Serena Ankle Boot Black 10000681 Size 8W,FBALYB Amazon,9,9,0,0,0,0
,Vionic Womens Joy Serena Ankle Boot Black 10000681 Size  9.5M,Vionic Womens Joy Serena Ankle Boot Black 10000681 Size  9.5M,FBALYB Amazon,15,14,1,0,1,0
,Vionic Womens Joy Serena Ankle Boot Black 10000681 Size  9M,Vionic Womens Joy Serena Ankle Boot Black 10000681 Size  9M,FBALYB Amazon,-4,-6,2,0,2,0
,Vionic Womens Joy Serena Ankle Boot Griege10000681 Size  10M,Vionic Womens Joy Serena Ankle Boot Griege10000681 Size  10M,FBALYB Amazon,7,3,4,1,4,0
,Vionic Womens Joy Serena Ankle Boot Griege10000681 Size  10W,Vionic Womens Joy Serena Ankle Boot Griege10000681 Size  10W,FBALYB Amazon,49,47,2,0,2,0
,Vionic Womens Joy Serena Ankle Boot Griege10000681 Size 11M,Vionic Womens Joy Serena Ankle Boot Griege10000681 Size 11M,FBALYB Amazon,-3,-3,0,0,0,0
,Vionic Womens Joy Serena Ankle Boot Griege10000681 Size  5M,Vionic Womens Joy Serena Ankle Boot Griege10000681 Size  5M,FBALYB Amazon,24,24,0,0,0,0
,Vionic Womens Joy Serena Ankle Boot Griege10000681 Size  6.5M,Vionic Womens Joy Serena Ankle Boot Griege10000681 Size  6.5M,FBALYB Amazon,54,52,2,0,2,0
,Vionic Womens Joy Serena Ankle Boot Griege10000681 Size  6M,Vionic Womens Joy Serena Ankle Boot Griege10000681 Size  6M,FBALYB Amazon,33,33,0,0,0,0
,Vionic Womens Joy Serena Ankle Boot Griege10000681 Size  7.5M,Vionic Womens Joy Serena Ankle Boot Griege10000681 Size  7.5M,FBALYB Amazon,118,117,1,0,1,0
,Vionic Womens Joy Serena Ankle Boot Griege10000681 Size  7M,Vionic Womens Joy Serena Ankle Boot Griege10000681 Size  7M,Default Ridgefield,28,28,0,0,0,0
,Vionic Womens Joy Serena Ankle Boot Griege10000681 Size  7M,Vionic Womens Joy Serena Ankle Boot Griege10000681 Size  7M,FBALYB Amazon,53,49,4,0,4,0
,Vionic Womens Joy Serena Ankle Boot Griege10000681 Size  8.5M,Vionic Womens Joy Serena Ankle Boot Griege10000681 Size  8.5M,FBALYB Amazon,-16,-20,4,0,4,0
,Vionic Womens Joy Serena Ankle Boot Griege10000681 Size  8.5W,Vionic Womens Joy Serena Ankle Boot Griege10000681 Size  8.5W,Default Ridgefield,2,2,0,0,0,0
,Vionic Womens Joy Serena Ankle Boot Griege10000681 Size  8.5W,Vionic Womens Joy Serena Ankle Boot Griege10000681 Size  8.5W,FBALYB Amazon,-3,-6,3,0,3,0
,Vionic Womens Joy Serena Ankle Boot Griege10000681 Size  8M,Vionic Womens Joy Serena Ankle Boot Griege10000681 Size  8M,FBALYB Amazon,-15,-16,1,0,1,0
,Vionic Womens Joy Serena Ankle Boot Griege10000681 Size  8W,Vionic Womens Joy Serena Ankle Boot Griege10000681 Size  8W,FBALYB Amazon,7,6,1,0,1,0
,Vionic Womens Joy Serena Ankle Boot Griege10000681 Size  9.5M,Vionic Womens Joy Serena Ankle Boot Griege10000681 Size  9.5M,FBALYB Amazon,-18,-21,3,0,3,0
,Vionic Womens Joy Serena Ankle Boot Griege10000681 Size  9M,Vionic Womens Joy Serena Ankle Boot Griege10000681 Size  9M,FBALYB Amazon,-19,-21,2,0,2,0
,Vionic Womens Julianna Slip On Black 10010823 Size 10M,Vionic Womens Julianna Slip On Black 10010823 Size 10M,FBALYB Amazon,-5,-5,0,0,0,0
,Vionic Womens Julianna Slip On Black 10010823 Size 10W,Vionic Womens Julianna Slip On Black 10010823 Size 10W,FBALYB Amazon,-11,-11,0,0,0,0
,Vionic Womens Julianna Slip On Black 10010823 Size 12M,Vionic Womens Julianna Slip On Black 10010823 Size 12M,FBALYB Amazon,-6,-6,0,0,0,0
,Vionic Womens Julianna Slip On Black 10010823 Size 7.5M,Vionic Womens Julianna Slip On Black 10010823 Size 7.5M,FBALYB Amazon,-3,-3,0,0,0,0
,Vionic Womens Julianna Slip On Black 10010823 Size 8.5M,Vionic Womens Julianna Slip On Black 10010823 Size 8.5M,FBALYB Amazon,-14,-14,0,0,0,0
,Vionic Womens Julianna Slip On Black 10010823 Size 8.5W,Vionic Womens Julianna Slip On Black 10010823 Size 8.5W,FBALYB Amazon,-2,-2,0,0,0,0
,Vionic Womens Julianna Slip On Black 10010823 Size 9M,Vionic Womens Julianna Slip On Black 10010823 Size 9M,FBALYB Amazon,-12,-12,0,0,0,0
,Vionic Womens Kit Minnie Mary Jane Heel Black 10010854 Size  10M,Vionic Womens Kit Minnie Mary Jane Heel Black 10010854 Size  10M,FBALYB Amazon,13,11,2,0,2,0
,Vionic Womens Kit Minnie Mary Jane Heel Black 10010854 Size  10W,Vionic Womens Kit Minnie Mary Jane Heel Black 10010854 Size  10W,FBALYB Amazon,51,50,1,0,1,0
,Vionic Womens Kit Minnie Mary Jane Heel Black 10010854 Size  11M,Vionic Womens Kit Minnie Mary Jane Heel Black 10010854 Size  11M,Default Ridgefield,10,10,0,0,0,0
,Vionic Womens Kit Minnie Mary Jane Heel Black 10010854 Size  11M,Vionic Womens Kit Minnie Mary Jane Heel Black 10010854 Size  11M,FBALYB Amazon,11,10,1,0,1,0
,Vionic Womens Kit Minnie Mary Jane Heel Black 10010854 Size  6.5M,Vionic Womens Kit Minnie Mary Jane Heel Black 10010854 Size  6.5M,FBALYB Amazon,15,15,0,0,0,0
,Vionic Womens Kit Minnie Mary Jane Heel Black 10010854 Size  7.5M,Vionic Womens Kit Minnie Mary Jane Heel Black 10010854 Size  7.5M,FBALYB Amazon,20,20,0,0,0,0
,Vionic Womens Kit Minnie Mary Jane Heel Black 10010854 Size  8.5M,Vionic Womens Kit Minnie Mary Jane Heel Black 10010854 Size  8.5M,FBALYB Amazon,19,19,0,0,0,0
,Vionic Womens Kit Minnie Mary Jane Heel Black 10010854 Size  8M,Vionic Womens Kit Minnie Mary Jane Heel Black 10010854 Size  8M,FBALYB Amazon,80,80,0,0,0,0
,Vionic Womens Kit Minnie Mary Jane Heel Black 10010854 Size  9.5M,Vionic Womens Kit Minnie Mary Jane Heel Black 10010854 Size  9.5M,FBALYB Amazon,11,11,0,1,0,0
,Vionic Womens Kit Minnie Mary Jane Heel Black 10010854 Size  9M,Vionic Womens Kit Minnie Mary Jane Heel Black 10010854 Size  9M,FBALYB Amazon,12,12,0,0,0,0
,Vionic Womens Kit Minnie Mary Jane Heel Black 10010854 Size  9W,Vionic Womens Kit Minnie Mary Jane Heel Black 10010854 Size  9W,FBALYB Amazon,14,14,0,0,0,0
,Vionic Womens Magnolia Gianna Leather Flat Black 10010943 Size 6.5M,Vionic Womens Magnolia Gianna Leather Flat Black 10010943 Size 6.5M,Default Ridgefield,1,1,0,0,0,0
,Vionic Womens Magnolia Gianna Leather Flat Black 10010943 Size 6.5M,Vionic Womens Magnolia Gianna Leather Flat Black 10010943 Size 6.5M,FBALYB Amazon,10,9,1,0,1,0
,Vionic Womens Magnolia Gianna Leather Flat Black 10010943 Size 8.5M,Vionic Womens Magnolia Gianna Leather Flat Black 10010943 Size 8.5M,FBALYB Amazon,-26,-28,2,0,2,0
,Vionic Womens Magnolia Gianna Leather Flat Black 10010943 Size 8.5W,Vionic Womens Magnolia Gianna Leather Flat Black 10010943 Size 8.5W,FBALYB Amazon,-11,-11,0,0,0,0
,Vionic Womens Magnolia Gianna Leather Flat Black 10010943 Size 8M,Vionic Womens Magnolia Gianna Leather Flat Black 10010943 Size 8M,FBALYB Amazon,-34,-34,0,0,0,0
,Vionic Womens Magnolia Gianna Leather Flat Black 10010943 Size 9.5W,Vionic Womens Magnolia Gianna Leather Flat Black 10010943 Size 9.5W,FBALYB Amazon,-13,-13,0,0,0,0
,Vionic Womens Magnolia Gianna Leather Flat Black 10010943 Size 9M,Vionic Womens Magnolia Gianna Leather Flat Black 10010943 Size 9M,FBALYB Amazon,-17,-17,0,0,0,0
,Vionic Womens Magnolia Gianna Leather Flat Black 10010943 Size 9W,Vionic Womens Magnolia Gianna Leather Flat Black 10010943 Size 9W,FBALYB Amazon,-9,-9,0,0,0,0
,Vionic Womens Magnolia Shawna Slate Grey 10010645 Size  10M,Vionic Womens Magnolia Shawna Slate Grey 10010645 Size  10M,FBALYB Amazon,-12,-13,1,0,1,0
,Vionic Womens Magnolia Shawna Slate Grey 10010645 Size  11M,Vionic Womens Magnolia Shawna Slate Grey 10010645 Size  11M,FBALYB Amazon,-3,-4,1,0,1,0
,Vionic Womens Magnolia Shawna Slate Grey 10010645 Size  6.5M,Vionic Womens Magnolia Shawna Slate Grey 10010645 Size  6.5M,FBALYB Amazon,7,7,0,0,0,0
,Vionic Womens Magnolia Shawna Slate Grey 10010645 Size  6M,Vionic Womens Magnolia Shawna Slate Grey 10010645 Size  6M,FBALYB Amazon,11,11,0,1,0,0
,Vionic Womens Magnolia Shawna Slate Grey 10010645 Size  7.5M,Vionic Womens Magnolia Shawna Slate Grey 10010645 Size  7.5M,FBALYB Amazon,2,1,1,0,1,0
,Vionic Womens Magnolia Shawna Slate Grey 10010645 Size  7M,Vionic Womens Magnolia Shawna Slate Grey 10010645 Size  7M,FBALYB Amazon,30,29,1,0,1,0
,Vionic Womens Magnolia Shawna Slate Grey 10010645 Size  8.5M,Vionic Womens Magnolia Shawna Slate Grey 10010645 Size  8.5M,FBALYB Amazon,-1,-3,2,0,2,0
,Vionic Womens Magnolia Shawna Slate Grey 10010645 Size  8M,Vionic Womens Magnolia Shawna Slate Grey 10010645 Size  8M,FBALYB Amazon,-9,-9,0,0,0,0
,Vionic Womens Magnolia Shawna Slate Grey 10010645 Size  9.5M,Vionic Womens Magnolia Shawna Slate Grey 10010645 Size  9.5M,FBALYB Amazon,-16,-16,0,0,0,0
,Vionic Womens Magnolia Shawna Slate Grey 10010645 Size  9M,Vionic Womens Magnolia Shawna Slate Grey 10010645 Size  9M,FBALYB Amazon,-9,-9,0,0,0,0
,Vionic Womens Minna Ballet Flat Black 10000333 Size  10,Vionic Womens Minna Ballet Flat Black 10000333 Size  10,FBALYB Amazon,-7,-7,0,0,0,0
,Vionic Womens Minna Ballet Flat Black 10000333 Size  7,Vionic Womens Minna Ballet Flat Black 10000333 Size  7,FBALYB Amazon,41,41,0,0,0,0
,Vionic Womens Minna Ballet Flat Black 10000333 Size  7.5,Vionic Womens Minna Ballet Flat Black 10000333 Size  7.5,FBALYB Amazon,46,46,0,0,0,0
,Vionic Womens Minna Ballet Flat Black 10000333 Size  8,Vionic Womens Minna Ballet Flat Black 10000333 Size  8,FBALYB Amazon,19,19,0,0,0,0
,Vionic Womens Minna Ballet Flat Black 10000333 Size  8.5,Vionic Womens Minna Ballet Flat Black 10000333 Size  8.5,FBALYB Amazon,38,37,1,0,1,0
,Vionic Womens Minna Ballet Flat Black 10000333 Size 8W,Vionic Womens Minna Ballet Flat Black 10000333 Size 8W,FBALYB Amazon,-11,-13,2,0,2,0
,Vionic Womens Minna Ballet Flat Black 10000333 Size  9,Vionic Womens Minna Ballet Flat Black 10000333 Size  9,FBALYB Amazon,-2,-3,1,0,1,0
,Vionic Womens Minna Ballet Flat Black 10000333 Size 9.5,Vionic Womens Minna Ballet Flat Black 10000333 Size 9.5,FBALYB Amazon,3,3,0,0,0,0
,Vionic Womens Minnie Torteise Heel Black Seude 10010757 Size 10M,Vionic Womens Minnie Torteise Heel Black Seude 10010757 Size 10M,FBALYB Amazon,8,7,1,0,1,0
,Vionic Womens Minnie Torteise Heel Black Seude 10010757 Size 10W,Vionic Womens Minnie Torteise Heel Black Seude 10010757 Size 10W,FBALYB Amazon,47,47,0,0,0,0
,Vionic Womens Minnie Torteise Heel Black Seude 10010757 Size 11M,Vionic Womens Minnie Torteise Heel Black Seude 10010757 Size 11M,FBALYB Amazon,16,16,0,0,0,0
,Vionic Womens Minnie Torteise Heel Black Seude 10010757 Size 6.5M,Vionic Womens Minnie Torteise Heel Black Seude 10010757 Size 6.5M,FBALYB Amazon,16,16,0,0,0,0
,Vionic Womens Minnie Torteise Heel Black Seude 10010757 Size 7.5M,Vionic Womens Minnie Torteise Heel Black Seude 10010757 Size 7.5M,FBALYB Amazon,16,16,0,0,0,0
,Vionic Womens Minnie Torteise Heel Black Seude 10010757 Size 7M,Vionic Womens Minnie Torteise Heel Black Seude 10010757 Size 7M,FBALYB Amazon,94,93,1,0,1,0
,Vionic Womens Minnie Torteise Heel Black Seude 10010757 Size 8.5M,Vionic Womens Minnie Torteise Heel Black Seude 10010757 Size 8.5M,FBALYB Amazon,20,20,0,0,0,0
,Vionic Womens Minnie Torteise Heel Black Seude 10010757 Size 8M,Vionic Womens Minnie Torteise Heel Black Seude 10010757 Size 8M,FBALYB Amazon,72,72,0,0,0,0
,Vionic Womens Minnie Torteise Heel Black Seude 10010757 Size 9.5M,Vionic Womens Minnie Torteise Heel Black Seude 10010757 Size 9.5M,FBALYB Amazon,3,3,0,0,0,0
,Vionic Womens Minnie Torteise Heel Black Seude 10010757 Size 9M,Vionic Womens Minnie Torteise Heel Black Seude 10010757 Size 9M,FBALYB Amazon,-6,-6,0,0,0,0
,Vionic Womens Minnie Torteise Heel Black Seude 10010757 Size 9W,Vionic Womens Minnie Torteise Heel Black Seude 10010757 Size 9W,FBALYB Amazon,12,12,0,0,0,0
,Vionic Womens Relax Leopard Slipper Natrual Leopard 10011249 Size 10M,Vionic Womens Relax Leopard Slipper Natrual Leopard 10011249 Size 10M,FBALYB Amazon,-17,-17,0,0,0,0
,Vionic Womens Relax Leopard Slipper Natrual Leopard 10011249 Size 11M,Vionic Womens Relax Leopard Slipper Natrual Leopard 10011249 Size 11M,FBALYB Amazon,-8,-8,0,0,0,0
,Vionic Womens Relax Leopard Slipper Natrual Leopard 10011249 Size 12M,Vionic Womens Relax Leopard Slipper Natrual Leopard 10011249 Size 12M,FBALYB Amazon,-5,-5,0,0,0,0
,Vionic Womens Relax Leopard Slipper Natrual Leopard 10011249 Size 6M,Vionic Womens Relax Leopard Slipper Natrual Leopard 10011249 Size 6M,FBALYB Amazon,-1,-1,0,0,0,0
,Vionic Womens Relax Leopard Slipper Natrual Leopard 10011249 Size 7M,Vionic Womens Relax Leopard Slipper Natrual Leopard 10011249 Size 7M,FBALYB Amazon,-22,-22,0,0,0,0
,Vionic Womens Relax Leopard Slipper Natrual Leopard 10011249 Size 8M,Vionic Womens Relax Leopard Slipper Natrual Leopard 10011249 Size 8M,FBALYB Amazon,-34,-34,0,0,0,0
,Vionic Womens Relax Leopard Slipper Natrual Leopard 10011249 Size 9M,Vionic Womens Relax Leopard Slipper Natrual Leopard 10011249 Size 9M,FBALYB Amazon,-49,-49,0,0,0,0
,VIONIC Womens Relax Slipper Light Grey 10000153 Size  10,VIONIC Womens Relax Slipper Light Grey 10000153 Size  10,FBALYB Amazon,-10,-10,0,0,0,0
,VIONIC Womens Relax Slipper Light Grey 10000153 Size  11,VIONIC Womens Relax Slipper Light Grey 10000153 Size  11,FBALYB Amazon,-5,-5,0,0,0,0
,VIONIC Womens Relax Slipper Light Grey 10000153 Size  7,VIONIC Womens Relax Slipper Light Grey 10000153 Size  7,FBALYB Amazon,-30,-30,0,0,0,0
,VIONIC Womens Relax Slipper Light Grey 10000153 Size  8,VIONIC Womens Relax Slipper Light Grey 10000153 Size  8,FBALYB Amazon,-31,-31,0,0,0,0
,VIONIC Womens Relax Slipper Light Grey 10000153 Size  9,VIONIC Womens Relax Slipper Light Grey 10000153 Size  9,FBALYB Amazon,-50,-50,0,0,0,0
,Vionic Womens Relax Slipper Pink 10000153 Size 10,Vionic Womens Relax Slipper Pink 10000153 Size 10,FBALYB Amazon,-1,-1,0,0,0,0
,Vionic Womens Relax Slipper Pink 10000153 Size 11,Vionic Womens Relax Slipper Pink 10000153 Size 11,FBALYB Amazon,-2,-2,0,0,0,0
,Vionic Womens Relax Slipper Pink 10000153 Size 7,Vionic Womens Relax Slipper Pink 10000153 Size 7,FBALYB Amazon,-3,-3,0,0,0,0
,Vionic Womens Relax Slipper Pink 10000153 Size 8,Vionic Womens Relax Slipper Pink 10000153 Size 8,FBALYB Amazon,-6,-6,0,0,0,0
,Vionic Womens Relax Slipper Pink 10000153 Size 9,Vionic Womens Relax Slipper Pink 10000153 Size 9,FBALYB Amazon,-3,-3,0,0,0,0
,Vionic Womens Rest Kirra T-Strap Sandal Black 10001132 Size 10M,Vionic Womens Rest Kirra T-Strap Sandal Black 10001132 Size 10M,FBALYB Amazon,-12,-12,0,0,0,0
,Vionic Womens Rest Kirra T-Strap Sandal Black 10001132 Size 11M,Vionic Womens Rest Kirra T-Strap Sandal Black 10001132 Size 11M,FBALYB Amazon,-3,-3,0,0,0,0
,Vionic Womens Rest Kirra T-Strap Sandal Black 10001132 Size 6.5M,Vionic Womens Rest Kirra T-Strap Sandal Black 10001132 Size 6.5M,FBALYB Amazon,-2,-2,0,0,0,0
,Vionic Womens Rest Kirra T-Strap Sandal Black 10001132 Size 6M,Vionic Womens Rest Kirra T-Strap Sandal Black 10001132 Size 6M,FBALYB Amazon,-3,-3,0,0,0,0
,Vionic Womens Rest Kirra T-Strap Sandal Black 10001132 Size 7.5M,Vionic Womens Rest Kirra T-Strap Sandal Black 10001132 Size 7.5M,FBALYB Amazon,-9,-9,0,0,0,0
,Vionic Womens Rest Kirra T-Strap Sandal Black 10001132 Size 7M,Vionic Womens Rest Kirra T-Strap Sandal Black 10001132 Size 7M,FBALYB Amazon,-2,-2,0,0,0,0
,Vionic Womens Rest Kirra T-Strap Sandal Black 10001132 Size 8.5M,Vionic Womens Rest Kirra T-Strap Sandal Black 10001132 Size 8.5M,FBALYB Amazon,-19,-19,0,0,0,0
,Vionic Womens Rest Kirra T-Strap Sandal Black 10001132 Size 8M,Vionic Womens Rest Kirra T-Strap Sandal Black 10001132 Size 8M,FBALYB Amazon,-5,-5,0,0,0,0
,Vionic Womens Rest Kirra T-Strap Sandal Black 10001132 Size 9.5M,Vionic Womens Rest Kirra T-Strap Sandal Black 10001132 Size 9.5M,FBALYB Amazon,-5,-5,0,0,0,0
,Vionic Womens Rest Kirra T-Strap Sandal Black 10001132 Size 9M,Vionic Womens Rest Kirra T-Strap Sandal Black 10001132 Size 9M,FBALYB Amazon,-14,-14,0,0,0,0
,Vionic Womens Rest Kirra T-Strap Sandal Brown 10001132 Size 10M,Vionic Womens Rest Kirra T-Strap Sandal Brown 10001132 Size 10M,FBALYB Amazon,-7,-7,0,0,0,0
,Vionic Womens Rest Kirra T-Strap Sandal Brown 10001132 Size 11M,Vionic Womens Rest Kirra T-Strap Sandal Brown 10001132 Size 11M,FBALYB Amazon,-2,-2,0,0,0,0
,Vionic Womens Rest Kirra T-Strap Sandal Brown 10001132 Size 7.5M,Vionic Womens Rest Kirra T-Strap Sandal Brown 10001132 Size 7.5M,FBALYB Amazon,-11,-11,0,0,0,0
,Vionic Womens Rest Kirra T-Strap Sandal Brown 10001132 Size 7M,Vionic Womens Rest Kirra T-Strap Sandal Brown 10001132 Size 7M,FBALYB Amazon,-6,-6,0,0,0,0
,Vionic Womens Rest Kirra T-Strap Sandal Brown 10001132 Size 8.5M,Vionic Womens Rest Kirra T-Strap Sandal Brown 10001132 Size 8.5M,FBALYB Amazon,-13,-13,0,0,0,0
,Vionic Womens Rest Kirra T-Strap Sandal Brown 10001132 Size 8M,Vionic Womens Rest Kirra T-Strap Sandal Brown 10001132 Size 8M,FBALYB Amazon,-3,-3,0,0,0,0
,Vionic Womens Rest Kirra T-Strap Sandal Brown 10001132 Size 9.5M,Vionic Womens Rest Kirra T-Strap Sandal Brown 10001132 Size 9.5M,FBALYB Amazon,-8,-8,0,0,0,0
,Vionic Womens Rest Kirra T-Strap Sandal Brown 10001132 Size 9M,Vionic Womens Rest Kirra T-Strap Sandal Brown 10001132 Size 9M,FBALYB Amazon,-18,-18,0,0,0,0
,Vionic Womens Robyn Flat Charcoal 10011127 Size 10M,Vionic Womens Robyn Flat Charcoal 10011127 Size 10M,Default Ridgefield,20,20,0,0,0,0
,Vionic Womens Robyn Flat Charcoal 10011127 Size 11M,Vionic Womens Robyn Flat Charcoal 10011127 Size 11M,Default Ridgefield,20,20,0,0,0,0
,Vionic Womens Robyn Flat Charcoal 10011127 Size 6.5M,Vionic Womens Robyn Flat Charcoal 10011127 Size 6.5M,Default Ridgefield,20,20,0,0,0,0
,Vionic Womens Robyn Flat Charcoal 10011127 Size 7.5M,Vionic Womens Robyn Flat Charcoal 10011127 Size 7.5M,Default Ridgefield,40,40,0,0,0,0
,Vionic Womens Robyn Flat Charcoal 10011127 Size 7M,Vionic Womens Robyn Flat Charcoal 10011127 Size 7M,Default Ridgefield,40,40,0,0,0,0
,Vionic Womens Robyn Flat Charcoal 10011127 Size 8.5M,Vionic Womens Robyn Flat Charcoal 10011127 Size 8.5M,Default Ridgefield,20,20,0,0,0,0
,Vionic Womens Robyn Flat Charcoal 10011127 Size 8M,Vionic Womens Robyn Flat Charcoal 10011127 Size 8M,Default Ridgefield,40,40,0,0,0,0
,Vionic Womens Spark Caroll Ballet Flat Black 10010058 Size 10,Vionic Womens Spark Caroll Ballet Flat Black 10010058 Size 10,FBALYB Amazon,-15,-16,1,0,1,0
,Vionic Womens Spark Caroll Ballet Flat Black 10010058 Size 11,Vionic Womens Spark Caroll Ballet Flat Black 10010058 Size 11,FBALYB Amazon,-6,-6,0,0,0,0
,Vionic Womens Spark Caroll Ballet Flat Black 10010058 Size 7.5M,Vionic Womens Spark Caroll Ballet Flat Black 10010058 Size 7.5M,FBALYB Amazon,26,23,3,0,3,0
,Vionic Womens Spark Caroll Ballet Flat Black 10010058 Size 7.5W,Vionic Womens Spark Caroll Ballet Flat Black 10010058 Size 7.5W,FBALYB Amazon,33,33,0,0,0,0
,Vionic Womens Spark Caroll Ballet Flat Black 10010058 Size 7M,Vionic Womens Spark Caroll Ballet Flat Black 10010058 Size 7M,FBALYB Amazon,29,28,1,0,1,0
,Vionic Womens Spark Caroll Ballet Flat Black 10010058 Size 8.5M,Vionic Womens Spark Caroll Ballet Flat Black 10010058 Size 8.5M,FBALYB Amazon,25,24,1,0,1,0
,Vionic Womens Spark Caroll Ballet Flat Black 10010058 Size 8.5W,Vionic Womens Spark Caroll Ballet Flat Black 10010058 Size 8.5W,FBALYB Amazon,38,34,4,0,4,0
,Vionic Womens Spark Caroll Ballet Flat Black 10010058 Size 8M,Vionic Womens Spark Caroll Ballet Flat Black 10010058 Size 8M,Default Ridgefield,1,1,0,0,0,0
,Vionic Womens Spark Caroll Ballet Flat Black 10010058 Size 8M,Vionic Womens Spark Caroll Ballet Flat Black 10010058 Size 8M,FBALYB Amazon,34,33,1,0,1,0
,Vionic Womens Spark Caroll Ballet Flat Black 10010058 Size 9.5,Vionic Womens Spark Caroll Ballet Flat Black 10010058 Size 9.5,FBALYB Amazon,-7,-7,0,0,0,0
,Vionic Womens Spark Caroll Ballet Flat Black 10010058 Size 9.5W,Vionic Womens Spark Caroll Ballet Flat Black 10010058 Size 9.5W,Default Ridgefield,1,1,0,0,0,0
,Vionic Womens Spark Caroll Ballet Flat Black 10010058 Size 9.5W,Vionic Womens Spark Caroll Ballet Flat Black 10010058 Size 9.5W,FBALYB Amazon,25,25,0,0,0,0
,Vionic Womens Spark Caroll Ballet Flat Black 10010058 Size 9M,Vionic Womens Spark Caroll Ballet Flat Black 10010058 Size 9M,FBALYB Amazon,36,33,3,0,3,0
,Vionic Womens Spark Desiree Ballet Flat Black 10010885 Size 10M,Vionic Womens Spark Desiree Ballet Flat Black 10010885 Size 10M,FBALYB Amazon,23,22,1,0,1,0
,Vionic Womens Spark Desiree Ballet Flat Black 10010885 Size 11M,Vionic Womens Spark Desiree Ballet Flat Black 10010885 Size 11M,FBALYB Amazon,-2,-2,0,0,0,0
,Vionic Womens Spark Desiree Ballet Flat Black 10010885 Size 6M,Vionic Womens Spark Desiree Ballet Flat Black 10010885 Size 6M,FBALYB Amazon,40,40,0,0,0,0
,Vionic Womens Spark Desiree Ballet Flat Black 10010885 Size 7.5M,Vionic Womens Spark Desiree Ballet Flat Black 10010885 Size 7.5M,FBALYB Amazon,55,55,0,0,0,0
,Vionic Womens Spark Desiree Ballet Flat Black 10010885 Size 7M,Vionic Womens Spark Desiree Ballet Flat Black 10010885 Size 7M,FBALYB Amazon,-4,-4,0,0,0,0
,Vionic Womens Spark Desiree Ballet Flat Black 10010885 Size 8.5M,Vionic Womens Spark Desiree Ballet Flat Black 10010885 Size 8.5M,Default,0,0,0,0,0,10
,Vionic Womens Spark Desiree Ballet Flat Black 10010885 Size 8.5M,Vionic Womens Spark Desiree Ballet Flat Black 10010885 Size 8.5M,FBALYB Amazon,22,20,2,0,2,0
,Vionic Womens Spark Desiree Ballet Flat Black 10010885 Size 8M,Vionic Womens Spark Desiree Ballet Flat Black 10010885 Size 8M,FBALYB Amazon,-7,-9,2,0,2,0
,Vionic Womens Spark Desiree Ballet Flat Black 10010885 Size 9.5M,Vionic Womens Spark Desiree Ballet Flat Black 10010885 Size 9.5M,FBALYB Amazon,-6,-6,0,0,0,0
,Vionic Womens Spark Desiree Ballet Flat Black 10010885 Size 9M,Vionic Womens Spark Desiree Ballet Flat Black 10010885 Size 9M,FBALYB Amazon,-7,-8,1,0,1,0
,Vionic Womens Tide Aloe Leather Toes Post Sandal Black 10010887 Size 10M,Vionic Womens Tide Aloe Leather Toes Post Sandal Black 10010887 Size 10M,FBALYB Amazon,-9,-9,0,0,0,0
,Vionic Womens Tide Aloe Leather Toes Post Sandal Black 10010887 Size 11M,Vionic Womens Tide Aloe Leather Toes Post Sandal Black 10010887 Size 11M,FBALYB Amazon,-5,-5,0,0,0,0
,Vionic Womens Tide Aloe Leather Toes Post Sandal Black 10010887 Size 7M,Vionic Womens Tide Aloe Leather Toes Post Sandal Black 10010887 Size 7M,FBALYB Amazon,-8,-8,0,0,0,0
,Vionic Womens Tide Aloe Leather Toes Post Sandal Black 10010887 Size 8M,Vionic Womens Tide Aloe Leather Toes Post Sandal Black 10010887 Size 8M,FBALYB Amazon,-13,-13,0,0,0,0
,Vionic Womens Tide Aloe Leather Toes Post Sandal Black 10010887 Size 9M,Vionic Womens Tide Aloe Leather Toes Post Sandal Black 10010887 Size 9M,FBALYB Amazon,-16,-16,0,0,0,0
,Vionic Womens Tide Aloe Leather Toes Post Sandal Mocha 10010887 Size 10M,Vionic Womens Tide Aloe Leather Toes Post Sandal Mocha 10010887 Size 10M,FBALYB Amazon,-4,-4,0,0,0,0
,Vionic Womens Tide Aloe Leather Toes Post Sandal Mocha 10010887 Size 7M,Vionic Womens Tide Aloe Leather Toes Post Sandal Mocha 10010887 Size 7M,FBALYB Amazon,-12,-12,0,0,0,0
,Vionic Womens Tide Aloe Leather Toes Post Sandal Mocha 10010887 Size 8M,Vionic Womens Tide Aloe Leather Toes Post Sandal Mocha 10010887 Size 8M,FBALYB Amazon,-7,-7,0,0,0,0
,Vionic Womens Tide Aloe Leather Toes Post Sandal Mocha 10010887 Size 9M,Vionic Womens Tide Aloe Leather Toes Post Sandal Mocha 10010887 Size 9M,FBALYB Amazon,-8,-8,0,0,0,0
,Vitafusion Calcium Gummy Vitamins 100ct - 2pk,Vitafusion Calcium Gummy Vitamins 100ct - 2pk,Default,-24,-24,0,0,0,0
,Vitafusion Calcium Gummy Vitamins 100ct - 2pk,Vitafusion Calcium Gummy Vitamins 100ct - 2pk,FBALYB Amazon,1,1,0,0,0,0
,Vitakraft Drops SPotato 8.8oz,Vitakraft Drops SPotato 8.8oz,Default,0,0,0,0,0,1
,Vitakraft Rabbit Carrot Slims 1.76oz 4pk,Vitakraft Rabbit Carrot Slims 1.76oz 4pk,FBALYB Amazon,2,2,0,0,0,0
,Vitamin E Oil,Trader Joe's Vitamin E Oil,FBALYB Amazon,7,7,0,16,0,0
,Viviscal Extra Strength Hair Growth Supplement for Women 60ct,Viviscal Extra Strength Hair Growth SViviscal Extra Strength Hair Growth Supplement for Women 60ctupplement 60ct,Default Ridgefield,45,45,0,0,0,0
,Viviscal Extra Strength Hair Growth Supplement for Women 60ct,Viviscal Extra Strength Hair Growth SViviscal Extra Strength Hair Growth Supplement for Women 60ctupplement 60ct,FBALYB Amazon,3599,3443,156,1,156,0
,Viviscal Gorgeous Growth Densifying  Shampoo 250ml,Viviscal Gorgeous Growth Densifying  Shampoo 250ml,Default Ridgefield,946,946,0,0,0,0
,Viviscal Gorgeous Growth Densifying Shampoo 250ml 2 pack,Viviscal Gorgeous Growth Densifying Shampoo 250ml 2 pack,FBALYB Amazon,213,201,12,0,12,0
,Viviscal Gorgeous Growth Densifying Shampoo 250ml 2 pack,Viviscal Gorgeous Growth Densifying Shampoo 250ml 2 pack,FBALYB Canada,5,5,0,30,0,0
,Viviscal Gorgeous Growth Densifying Shampoo & Conditioner 250ml Set,Viviscal Gorgeous Growth Densifying Shampoo & Conditioner 250ml Set,FBALYB Amazon,2,2,0,0,0,0
,Viviscal Men Advanced Hair Growth Supplement 180ct,Viviscal Men Advanced Hair Growth Supplement 180ct,Default Ridgefield,511,511,0,0,0,0
,Viviscal Men Advanced Hair Growth Supplement 180ct,Viviscal Men Advanced Hair Growth Supplement 180ct,FBALYB Amazon,-2,-4,2,0,2,0
,Viviscal Men Advanced Hair Growth Supplement 60ct,Viviscal Men Advanced Hair Growth Supplement 60ct,Default Ridgefield,996,996,0,0,0,0
,Viviscal Men Advanced Hair Growth Supplement 60ct,Viviscal Men Advanced Hair Growth Supplement 60ct,FBALYB Amazon,2140,2140,0,0,0,0
,VIZIO SmartCast Crave 360 Speaker SP50-D5,VIZIO SmartCast Crave 360 Speaker SP50-D5,Default,0,0,0,0,0,30
,Vizio Sound Bar SB4031-D5,Vizio Sound Bar SB4031-D5,FBALYB Amazon,-1,-1,0,0,0,0
,Volcano Black Signature Jar Candle,Volcano Black Signature Jar Candle,FBALYB Amazon,-26,-26,0,32,0,0
,Volcano Body Wash,Volcano Body Wash,Avrami - Ebay,12,12,0,0,0,0
,Volcano Body Wash,Volcano Body Wash,Default Ridgefield,6,6,0,0,0,0
,Volcano Body Wash,Volcano Body Wash,FBALYB Amazon,-3,-3,0,0,0,0
,Volcano Diffuser Oil,Volcano Diffuser Oil,FBALYB Amazon,1,1,0,1,0,0
,Volcano Signature Eau De Parfum Spray Pen,Volcano Signature Eau De Parfum Spray Pen,Avrami - Ebay,12,12,0,0,0,0
,Volcano Signature Eau De Parfum Spray Pen,Volcano Signature Eau De Parfum Spray Pen,Default Ridgefield,404,404,0,0,0,0
,Volcano Signature Eau De Parfum Spray Pen,Volcano Signature Eau De Parfum Spray Pen,FBALYB Amazon,1,1,0,0,0,0
,Volcano Signature Eau De Parfum Spray Pen,Volcano Signature Eau De Parfum Spray Pen,WFS,-9,-9,0,0,0,0
,Volcano Signature Hand Wash Refill,Volcano Signature Hand Wash Refill,Avrami - Ebay,12,12,0,0,0,0
,Volcano Signature Hand Wash Refill,Volcano Signature Hand Wash Refill,FBALYB Amazon,8,8,0,0,0,0
,Volcano Signature Jar Capri Blue Signature Collection,Volcano Signature Jar Capri Blue Signature Collection  ,Avrami - Ebay,87,87,0,0,0,0
,Volcano Signature Jar Capri Blue Signature Collection,Volcano Signature Jar Capri Blue Signature Collection  ,Default,0,-136,136,0,0,0
,Volcano Signature Jar Capri Blue Signature Collection,Volcano Signature Jar Capri Blue Signature Collection  ,Default Ridgefield,173,173,0,0,0,0
,Volcano Signature Jar Capri Blue Signature Collection,Volcano Signature Jar Capri Blue Signature Collection  ,FBALYB Amazon,-65,-101,36,500,36,0
,Volcano Signature Jar Capri Blue Signature Collection,Volcano Signature Jar Capri Blue Signature Collection  ,WFS,-11,-11,0,0,0,0
,Volcano Signature Lotion,Volcano Signature Lotion,Avrami - Ebay,12,12,0,0,0,0
,Volcano Signature Lotion,Volcano Signature Lotion,FBALYB Amazon,3,1,2,0,2,0
,Volcano Signature Printed Travel Tin Candle,Volcano Signature Printed Travel Tin Candle,Avrami - Ebay,8,8,0,0,0,0
,Volcano Signature Printed Travel Tin Candle,Volcano Signature Printed Travel Tin Candle,Default,0,-800,800,0,0,0
,Volcano Signature Printed Travel Tin Candle,Volcano Signature Printed Travel Tin Candle,FBALYB Amazon,-290,-290,0,34,0,0
,Volcano Signature Room Spray,Volcano Signature Room Spray,FBALYB Amazon,-2,-2,0,0,0,0
,Volcano Watercolor Jar Candle,Volcano Watercolor Jar Candle,Default Ridgefield,65,62,3,0,0,0
,Volcano Watercolor Jar Candle,Volcano Watercolor Jar Candle,FBALYB Amazon,719,718,1,1,1,0
,Voltaren Emulgel Back & Muscle Pain - 2 tubes of 150g & 1 tube of 30g,Voltaren Emulgel Back & Muscle Pain - 2 tubes of 150g & 1 tube of 30g,Default Ridgefield,4223,4223,0,0,0,0
,"VR One Plus, Black","Zeiss VR One Plus Virtual Reality, Black",FBALYB Amazon,40,40,0,0,0,0
,VS TMC LOVE SPELL MIST 250ML +  VS TMC LOVE SPELL BODY LOTION 236ML,VS TMC LOVE SPELL MIST 250ML +  VS TMC LOVE SPELL BODY LOTION 236ML,FBALYB Amazon,839,820,19,0,19,0
,Vtech Kidijamz Studio 050803319410,VTech - KidiJamz Studio,FBALYB Amazon,-1,-1,0,0,0,0
,W5-C6NN-QBKA,Microsoft Type Cover for Surface Pro 4 - Bright Blue (QC7-00002),FBALYB Amazon,-2,-2,0,0,0,0
,Wag More 16oz 3pk bundle,Wag More 16oz 3pk bundle,FBALYB Amazon,-1,-1,0,0,0,0
,Wally's Organic Ear Oil 1oz,Wally's Organic Ear Oil 1oz,FBALYB Amazon,3,2,1,0,1,0
,Ware Critter Himalayan Salt on a Rope,Ware Critter Himalayan Salt on a Rope,FBALYB Amazon,2,2,0,0,0,0
,"Ware Flying Saucer Exercise Wheel 12""","Ware Flying Saucer Exercise Wheel 12""",FBALYB Amazon,-2,-2,0,0,0,0
,Ware Lg Gorilla Wild Dog Chew 2pk,Ware Lg Gorilla Wild Dog Chew 2pk,FBALYB Amazon,1,1,0,0,0,0
,"Ware Lock-N-Litter Bigger Pet Pan, Jumbo","Ware Lock-N-Litter Bigger Pet Pan, Jumbo",FBALYB Amazon,-5,-5,0,0,0,0
,Ware Medium Gorilla Wood Dog Chew,Ware Medium Gorilla Wood Dog Chew,Default,0,0,0,0,0,39
,Ware Medium Gorilla Wood Dog Chew,Ware Medium Gorilla Wood Dog Chew,FBALYB Amazon,1,1,0,0,0,0
,Ware Medium Gorilla Wood Dog Chew 2pk,Ware Medium Gorilla Wood Dog Chew 2pk,FBALYB Amazon,-2,-2,0,0,0,0
,"Ware Willow Branch Ball 4""","Ware Willow Branch Ball for Small Animals 4""",Default,0,0,0,0,0,13
,"Ware Willow Branch Ball 4"" 3pk","Ware Willow Branch Ball 4"" 3pk",FBALYB Amazon,4,4,0,70,0,0
,"Ware Willow Branch Ball 4"" 5pk","Ware Willow Branch Ball 4"" 5pk",FBALYB Amazon,-41,-41,0,0,0,0
,WaterBaby Wipes 6pk,WaterBaby Wipes 6pk,FBALYB Amazon,19,17,2,10,2,0
,Waterpik Complete Care 5.5 Water Flosser & Oscillating Toothbrush,Waterpik Complete Care 5.5 Water Flosser & Oscillating Toothbrush,FBALYB Amazon,1,1,0,0,0,0
,Waterpik Cordless Plus Water Flosser WP-464,Waterpik Cordless Plus Water Flosser WP-464,Default,0,0,0,0,0,6
,WATERPIK SET OF 2 (ULTRA & NANO) WP-140c/WP-310C,WATERPIK SET OF 2 (ULTRA & NANO) WP-140c/WP-310C,FBALYB Amazon,6,6,0,10,0,0
,Waterpik WP-100 Ultra Water Flosser,Waterpik WP-100 Ultra Water Flosser,FBALYB Amazon,-1,-1,0,0,0,0
,Water Wipes 60ct Pack,Water Wipes 60ct Pack,FBALYB Amazon,190,190,0,0,0,0
,WaterWipes Baby Wipes 60ct 12pk 1case,WaterWipes Baby Wipes 60ct 12pk 1case,FBALYB Amazon,938,929,9,222,9,0
,WaterWipes Baby Wipes 60ct 12pk 1case,WaterWipes Baby Wipes 60ct 12pk 1case,FBALYB Canada,20,20,0,0,0,0
,WaterWipes Baby Wipes 60ct 2pk,WaterWipes Baby Wipes 60ct 2pk,FBALYB Amazon,-7,-10,3,0,3,0
,WaterWipes Sensitive Baby Wipes 60ct 3pk,WaterWipes Sensitive Baby Wipes 60ct 3pk,FBALYB Amazon,-45,-88,43,192,43,0
,WaterWipes Sensitive Baby Wipes 60ct 4pk,WaterWipes Sensitive Baby Wipes 60ct 4pk,FBALYB Amazon,-19,-20,1,9,1,0
,WaterWipes Sensitive Baby Wipes 60ct 8pk,WaterWipes Sensitive Baby Wipes 60ct 8pk,FBALYB Amazon,-2,-5,3,0,3,0
,WaterWipes Sensitive Baby Wipes 60ct 9pk,WaterWipes Sensitive Baby Wipes 60ct 9pk,FBALYB Amazon,461,461,0,10,0,0
,WD-8TB External USB,WD- 8TB external USB 3.0 Hard Drive WDBCKA0080HBK-NESN,FBALYB Amazon,1,1,0,0,0,0
,Weahterproof Women's Boots Grey Katie Size 9,Weahterproof Women's Boots Grey Katie Size 9,FBALYB Amazon,-3,-4,1,0,1,0
,"Weatherproof Men's Original Vintage Comfort Stretch Pants Charcoal 42"" X 30"" #1231034","Weatherproof Men's Original Vintage Comfort Stretch Pants Charcoal 42"" X 30"" #1231034",Default Ridgefield,8,8,0,0,0,0
,"Weatherproof Men's Original Vintage Straight Fit Pants Navy Blue, Size 42x32 #1231034","Weatherproof Men's Original Vintage Straight Fit Pants Navy Blue, Size 42x32 #1231034",Default Ridgefield,2,2,0,0,0,0
,WeatherProof Vintage L Blue,WeatherProof Vintage Large Blue,Default,0,0,0,0,0,2
,WeatherProof Vintage L Navy,WeatherProof Vintage Large Navy,Default,0,0,0,0,0,1
,WeatherProof Vintage L Spice,WeatherProof Vintage Large Spice,Default,0,0,0,0,0,2
,WeatherProof Vintage L White,WeatherProof Vintage Large White,Default,0,0,0,0,0,3
,WeatherProof Vintage M Blue,WeatherProof Vintage Medium Blue,Default,0,0,0,0,0,2
,Weatherproof Vintage Men's 5 belt loop Straight Fit 5 Pocket Twill Pant 42X32/khaki #1231034,Weatherproof Vintage Men's 5 belt loop Straight Fit 5 Pocket Twill Pant 42X32/khaki #1231034,Default Ridgefield,6,6,0,0,0,0
,"Weatherproof Vintage Men's 5-pocket Comfort Stretch Pants, 34 X 32 Grey #1231034","Weatherproof Vintage Men's 5-pocket Comfort Stretch Pants, 34 X 32 Grey #1231034",Default Ridgefield,37,37,0,0,0,0
,Weatherproof Vintage Men's 5 Pocket Twill Pant 32X30/Charcoal,Weatherproof Vintage Men's 5 Pocket Twill Pant 32X30/Charcoal,Default Ridgefield,20,20,0,0,0,0
,"Weatherproof Vintage Men's 5 Pocket Twill Pant (36x32, Charcoal)","Weatherproof Vintage Men's 5 Pocket Twill Pant (36x32, Charcoal)",Default Ridgefield,32,32,0,0,0,0
,"Weatherproof Vintage Men's 5 Pocket Twill Pant (38x30, Navy) #1231034","Weatherproof Vintage Men's 5 Pocket Twill Pant (38x30, Navy) #1231034",Default Ridgefield,1,1,0,0,0,0
,"Weatherproof Vintage Men's 5 Pocket Twill Pant (38x34, Navy)","Weatherproof Vintage Men's 5 Pocket Twill Pant (38x34, Navy)",Default Ridgefield,3,3,0,0,0,0
,"Weatherproof Vintage Men's 5 Pocket Twill Pant, Charcoal, 32x32","Weatherproof Vintage Men's 5 Pocket Twill Pant, Charcoal, 32x32",Default Ridgefield,15,15,0,0,0,0
,"Weatherproof Vintage Men's 5 Pocket Twill Pant, Charcoal, 34x30","Weatherproof Vintage Men's 5 Pocket Twill Pant, Charcoal, 34x30",Default Ridgefield,8,8,0,0,0,0
,"Weatherproof Vintage Men's 5 Pocket Twill Pant, Charcoal, 34x30 #1231034","Weatherproof Vintage Men's 5 Pocket Twill Pant, Charcoal, 34x30 #1231034",Default Ridgefield,54,54,0,0,0,0
,"weatherproof vintage men's 5 pocket twill pant (charcoal, 34 x 34)","weatherproof vintage men's 5 pocket twill pant (charcoal, 34 x 34)",Default Ridgefield,10,10,0,0,0,0
,Weatherproof Vintage Men's 5 Pocket Twill Pant Khaki 32x32,Weatherproof Vintage Men's 5 Pocket Twill Pant Khaki 32x32,Default Ridgefield,2,2,0,0,0,0
,Weatherproof Vintage Men's 5 Pocket Twill Pant Khaki 34x30 #1231034,Weatherproof Vintage Men's 5 Pocket Twill Pant Khaki 34x30 #1231034,Default Ridgefield,12,12,0,0,0,0
,Weatherproof Vintage Men's 5 Pocket Twill Pant Khaki 34x32,Weatherproof Vintage Men's 5 Pocket Twill Pant Khaki 34x32,Default Ridgefield,3,3,0,0,0,0
,Weatherproof Vintage Men's 5 Pocket Twill Pant Khaki 36x34,Weatherproof Vintage Men's 5 Pocket Twill Pant Khaki 36x34,Default Ridgefield,1,1,0,0,0,0
,"Weatherproof Vintage Men's 5 Pocket Twill Pant, Navy, 34 X 32","Weatherproof Vintage Men's 5 Pocket Twill Pant, Navy, 34 X 32",Default Ridgefield,7,7,0,0,0,0
,Weatherproof Vintage Men's 5 Pocket Twill Pant Navy W36xl30 #1231034,Weatherproof Vintage Men's 5 Pocket Twill Pant Navy W36xl30 #1231034,Default Ridgefield,1,1,0,0,0,0
,Weatherproof Vintage Men's 5 Pocket zip fly with button closure Twill Pant 32x34 Khaki #1231034,Weatherproof Vintage Men's 5 Pocket zip fly with button closure Twill Pant 32x34 Khaki #1231034,Default Ridgefield,2,2,0,0,0,0
,Weatherproof Vintage Men's Flex Waistband Pant 38X34/Charcoal,Weatherproof Vintage Men's Flex Waistband Pant 38X34/Charcoal,Default Ridgefield,9,9,0,0,0,0
,Weatherproof Vintage Men's Flex Waistband Pant 42X32/Charcoal #1231034,Weatherproof Vintage Men's Flex Waistband Pant 42X32/Charcoal #1231034,Default Ridgefield,2,2,0,0,0,0
,WeatherProof Vintage M Navvy,WeatherProof Vintage Medium Navy,Default,0,0,0,0,0,3
,WeatherProof Vintage M Spice,WeatherProof Vintage Medium Spice,Default,0,0,0,0,0,1
,WeatherProof Vintage XL,WeatherProof Vintage XL White,Default,0,0,0,0,0,2
,WeatherProof Vintage XL Blue,WeatherProof Vintage XL Blue,Default,0,0,0,0,0,1
,WeatherProof Vintage XL Navy,WeatherProof Vintage XL Navy,Default,0,0,0,0,0,1
,WeatherProof Vintage XL Spice,WeatherProof Vintage XL Spice,Default,0,0,0,0,0,2
,Weatherproof Women's Boots Black Katie Size 6,Weatherproof Women's Boots Black Katie Size 6,Default Ridgefield,3,3,0,0,0,0
,Weatherproof Women's Boots Black Katie Size 8,Weatherproof Women's Boots Black Katie Size 8,FBALYB Amazon,-1,-1,0,0,0,0
,Weatherproof Women's Boots Black Katie Size 9,Weatherproof Women's Boots Black Katie Size 9,FBALYB Amazon,-3,-3,0,0,0,0
,Weatherproof Women's Boots Grey 10,Weatherproof Women's Boots Grey 10,FBALYB Amazon,-1,-1,0,0,0,0
,Weatherproof Women's Boots Grey Katie Size 8,Weatherproof Women's Boots Grey Katie Size 8,Default Ridgefield,4,4,0,0,0,0
,Wedderspoon Honey Lemon Drops 4oz,Wedderspoon Organic Manuka Honey Drops Unpasteurized Lemon Bee Propolis 4oz,Default Ridgefield,6,6,0,0,0,0
,Wedge Pillow Gray,Wedge Pillow Gray ,FBALYB Amazon,-1,-1,0,0,0,0
,Wedge Pillow White,Wedge Pillow White,FBALYB Amazon,-1,-1,0,1,0,0
,Weider Red 600mg 240 Tablets,Weider Red 600mg 240 Tablets,FBALYB Amazon,-2,-2,0,0,0,0
,Weight & Mature Care Dry Cat Food 5 Lb,Chicken Soup For The Soul Weight & Mature Care Dry Cat Food 5 Lb,Default,0,0,0,0,0,3
,Weight & Mature Care Dry Cat Food 5 Lb,Chicken Soup For The Soul Weight & Mature Care Dry Cat Food 5 Lb,FBALYB Amazon,101,101,0,0,0,0
,Welches Snack 2pk,Welches Snack 2pk,FBALYB Amazon,3,3,0,0,0,0
,"Welch's Fruit Rolls, 42 Rolls","Welch's Fruit Rolls Variety Pack - Berry, Strawberry, Tropical Punch (42 Rolls)",FBALYB Amazon,7,7,0,0,0,0
,Welch's Fruit snack 80ct,Welch's Fruit Snacks 80 CT (4.5 LBS),FBALYB Amazon,83,83,0,4,0,0
,Welch's Fruit Snacks 36 ct,"Welch's Mixed Fruit Fat Free Fruit Snacks, 36 ct./2.25 oz",FBALYB Amazon,32,32,0,1,0,0
,WELLA SP Luxe Oil Reconstructive Elixir 100 ml,WELLA SP Luxe Oil Reconstructive Elixir 100 ml,FBALYB Amazon,0,-1,1,0,1,0
,Wellesse Joint Movement 33.8 oz,Wellesse Joint Movement Glucosamine With Chondroitin & Msm 33.8 fl oz,Default,0,0,0,0,0,192
,Wellesse Joint Movement 33.8 oz,Wellesse Joint Movement Glucosamine With Chondroitin & Msm 33.8 fl oz,FBALYB Amazon,3,1,2,32,2,0
,Wellesse Joint Movement 33.8 oz 2pk,Wellesse Joint Movement 33.8 oz 2pk,FBALYB Amazon,2,2,0,11,0,0
,Wellness Hearty Turkey Dog Treats 8oz 2pk,Wellness Hearty Turkey Dog Treats 8oz 2pk,FBALYB Amazon,1,1,0,0,0,0
,"Wellness Lamb & Salmon Dog Treats, 3oz 2pk","Wellness Lamb & Salmon Dog Treats, 3oz 2pk",FBALYB Amazon,-27,-27,0,27,0,0
,Wellness Puppy Bites Chicken & Carrots 6oz 2pk,Wellness Puppy Bites Chicken 2pk,FBALYB Amazon,-2,-2,0,0,0,0
,"Wells Lamont Leather Work Glove, Large 3pk","Wells Lamont Leather Work Glove, Large 3pk",Default,0,0,0,0,0,13
,"Wells Lamont Leather Work Glove, Medium 3pk","Wells Lamont Leather Work Glove, Medium 3pk",FBALYB Amazon,1,1,0,0,0,0
,"Wells Lamont Leather Work Glove, X‑Large 3pk","Wells Lamont Leather Work Glove, X‑Large 3pk",FBALYB Amazon,1,1,0,0,0,0
,WERTHERS 34 OZ BUTTER CANDIES,WERTHERS 34 OZ BUTTER CANDIES,FBALYB Amazon,100,100,0,1,0,0
,"Werther's Original Hard Candy, Caramel, 34 Ounce","Werther's Original Hard Candy, Caramel, 34 Ounce ",Default,0,-468,468,0,0,0
,"Werther's Original Hard Candy, Caramel, 34 Ounce","Werther's Original Hard Candy, Caramel, 34 Ounce ",FBALYB Amazon,-15,-15,0,14,0,0
,"Werther's Original Hard Candy, Caramel, 34 Ounce","Werther's Original Hard Candy, Caramel, 34 Ounce ",WFS,-6,-6,0,0,0,0
,"Werther's Original Hard Candy, Caramel, 34 Ounce 2pk","Werther's Original Hard Candy, Caramel, 34 Ounce 2pk",FBALYB Amazon,-200,-200,0,222,0,0
,Wet Noses All Natural Dog Treats 5lb,Wet Noses All Natural Dog Treats Peanut Butter W Bananas 5lb,Default,0,0,0,0,0,29
,Wet Noses All Natural Dog Treats 5lb,Wet Noses All Natural Dog Treats Peanut Butter W Bananas 5lb,FBASKCK Amazon,27,27,0,0,0,0
,Wet Ones 20ct 5pk,Wet Ones 20ct 5pk,FBALYB Amazon,-1,-1,0,0,0,0
,Wet Ones Wipes Fresh Scent 40ct 12pk,Wet Ones Wipes Fresh Scent 40ct 12pk,FBALYB Amazon,-2,-2,0,1,0,0
,When Sheet Mask Set 184 ml 8 ct,When Sheet Mask Set 184 ml 8 ct,Default Ridgefield,47,47,0,0,0,0
,When Sheet Mask Set 184 ml 8 ct,When Sheet Mask Set 184 ml 8 ct,FBALYB Amazon,74,73,1,0,1,0
,Whisper Assembled Bio Bag Cartridge,Whisper Assembled Bio Bag Cartridge,Default,0,-2354,2354,0,0,234
,Whisper Assembled Bio Bag Cartridge,Whisper Assembled Bio Bag Cartridge,Default Ridgefield,190,190,0,0,0,71
,Whisper Assembled Bio Bag Cartridge,Whisper Assembled Bio Bag Cartridge,FBALYB Canada,129,129,0,20,0,0
,White Rectangle Dishpan,White Rectangle Dishpan,Default,0,0,0,0,0,24
,White Rectangle Dishpan,White Rectangle Dishpan,Default Ridgefield,1,1,0,0,0,0
,White Rectangle Dishpan,White Rectangle Dishpan,FBALYB Amazon,415,404,11,4,11,0
,White  Signature Jar - Volcano - Capri Blue Signature Collection,White  Signature Jar - Volcano - Capri Blue Signature Collection,Avrami - Ebay,323,323,0,0,0,0
,White  Signature Jar - Volcano - Capri Blue Signature Collection,White  Signature Jar - Volcano - Capri Blue Signature Collection,Default,0,-138,138,0,0,0
,White  Signature Jar - Volcano - Capri Blue Signature Collection,White  Signature Jar - Volcano - Capri Blue Signature Collection,Default Ridgefield,23,23,0,0,0,0
,White  Signature Jar - Volcano - Capri Blue Signature Collection,White  Signature Jar - Volcano - Capri Blue Signature Collection,FBALYB Amazon,77,76,1,255,1,0
,White  Signature Jar - Volcano - Capri Blue Signature Collection,White  Signature Jar - Volcano - Capri Blue Signature Collection,WFS,-14,-14,0,0,0,0
,Wholeme Almond Coconut Clusters 8 oz,Wholeme Almond Coconut Clusters 8 oz,Default,0,0,0,0,0,42
,Wilkinson sword double edge 20x5 100ct,Wilkinson sword double edge 20x5 100ct,FBALYB Amazon,1685,1670,15,60,15,0
,Wilkinson Sword Essential 5s,Wilkinson Sword Essential 5s,Default Ridgefield,51,51,0,0,0,0
,Willow Tree Father and Daughter Figurine,Willow Tree Father and Daughter Figurine ,FBALYB Amazon,-3,-3,0,0,0,0
,Willow Tree Generations Figurine,Willow Tree Generations Figurine ,FBALYB Amazon,-4,-4,0,0,0,0
,Willow Tree Grandmother Figurine,Willow Tree Grandmother Figurine ,FBALYB Amazon,-3,-3,0,0,0,0
,Willow Tree Mother Daughter Figurine,Willow Tree Mother Daughter Figurine ,FBALYB Amazon,-2,-2,0,0,0,0
,Willow Tree Quietly Figurine,Willow Tree Quietly Figurine ,Default,1,1,0,0,0,0
,Willow Tree Quietly Figurine,Willow Tree Quietly Figurine ,FBALYB Amazon,-5,-5,0,0,0,0
,Willow Tree Warm Embrace Figurine,Willow Tree Warm Embrace Figurine ,FBALYB Amazon,-1,-1,0,0,0,0
,Windex Trigger and Refill 169 + 32,Windex Trigger and Refill 169 + 32,Default,0,-192,192,0,0,0
,Windex Trigger and Refill 169 + 32,Windex Trigger and Refill 169 + 32,Default Ridgefield,1296,1296,0,0,0,0
,Windex Trigger and Refill 169 + 32,Windex Trigger and Refill 169 + 32,FBALYB Amazon,277,261,16,509,16,0
,Win pls power station,"Winplus Power Station With Bluetooth, Speaker And Led Work Light",FBALYB Amazon,-2,-2,0,0,0,0
,Winplus LED Folding Worklight,Winplus LED Folding Worklight,Default,0,0,0,0,0,2
,Winplus LED Folding Worklight,Winplus LED Folding Worklight,FBALYB Amazon,-1,-1,0,0,0,0
,Winter Carnival 24ct K Cups - Seasonal,Winter Carnival 24ct K Cups - Seasonal,Default,0,0,0,0,0,184
,Wireless remote control outlet,"Capstone 92923 Wireless Remote Controlled Outlet, 3 Pack",FBALYB Amazon,46,46,0,0,0,0
,Wobbler Red Dog Toy Large (1 Cup),Wobbler Red Durable Treat Dispensing Dog Toy Large ( 1 Cup ),FBALYB Amazon,-6,-6,0,0,0,0
,Wobbler Red Dog Toy Large (2 Cup),Wobbler Red Dog Toy Large (2 Cup),FBALYB Amazon,-1,-1,0,0,0,0
,Woman's PJ Set Purple Small,Woman's PJ Set Purple Small,FBALYB Amazon,-1,-1,0,0,0,0
,Woman's PJ Set Sapphire Medium,Woman's PJ Set Sapphire Medium,FBALYB Amazon,-1,-1,0,0,0,0
,Woman's Top Crystal White L,Woman's Top Crystal White L,FBALYB Amazon,63,63,0,0,0,0
,Woman's Top Crystal White M,Woman's Top Crystal White M,FBALYB Amazon,108,108,0,0,0,0
,Woman's Top Crystal White XL,Woman's Top Crystal White XL,FBALYB Amazon,5,5,0,0,0,0
,Woman's Top Crystal White XXL,Woman's Top Crystal White XXL,FBALYB Amazon,-2,-2,0,0,0,0
,Woman's Top Dry Rose L,Woman's Top Dry Rose L,FBALYB Amazon,-8,-8,0,0,0,0
,Woman's Top Dry Rose S,Woman's Top Dry Rose S,FBALYB Amazon,-1,-1,0,0,0,0
,Woman's Top Dry Rose XL,Woman's Top Dry Rose XL,FBALYB Amazon,-1,-1,0,0,0,0
,Woman's Top Midnight Affair L,Woman's Top Midnight Affair L,FBALYB Amazon,11,11,0,0,0,0
,Woman's Top Midnight Affair XL,Woman's Top Midnight Affair XL,FBALYB Amazon,-2,-2,0,0,0,0
,Woman's Top Midnight Affair XXL,Woman's Top Midnight Affair XXL,FBALYB Amazon,-1,-1,0,0,0,0
,Women Puma Socks Master Kit 9/1/2020,Women Puma Socks Master Kit 9/1/2020,Default Oxford,230,230,0,0,0,0
,Women Puma Socks Master Kit 9/1/2020,Women Puma Socks Master Kit 9/1/2020,Default Ridgefield,14,14,0,0,0,0
,"Women's Altra Timp 2 Trail Running Shoe, Size 6.5 M - Blue","Women's Altra Timp 2 Trail Running Shoe, Size 6.5 M - Blue",Default Ridgefield,6,6,0,0,0,0
,"Women's Altra Timp 2 Trail Running Shoe, Size 6.5 M - Blue","Women's Altra Timp 2 Trail Running Shoe, Size 6.5 M - Blue",FBALYB Amazon,-2,-2,0,0,0,0
,"Women's Jean Aqua Sky 16"" Short","Women's Jean Aqua Sky 16"" Short",Default,0,0,0,0,0,1
,"Women's Jean Desert Sage 10"" Average","Women's Jean Desert Sage 10"" Average",Default,0,0,0,0,0,3
,"Women's Jean Desert Sage 10"" Average","Women's Jean Desert Sage 10"" Average",Default Ridgefield,1,1,0,0,0,0
,"Women's Jean Desert Sage 10"" Short","Women's Jean Desert Sage 10"" Short",Default,0,0,0,0,0,3
,"Women's Jean Desert Sage 10"" Short","Women's Jean Desert Sage 10"" Short",Default Ridgefield,2,2,0,0,0,0
,"Women's Jean Desert Sage 12"" Average","Women's Jean Desert Sage 12"" Average",Default Ridgefield,9,9,0,0,0,0
,"Women's Jean Desert Sage 12"" Short","Women's Jean Desert Sage 12"" Short",Default,0,0,0,0,0,42
,"Women's Jean Desert Sage 14"" Average","Women's Jean Desert Sage 14"" Average",Default,0,0,0,0,0,16
,"Women's Jean Desert Sage 14"" Short","Women's Jean Desert Sage 14"" Short",Default,0,0,0,0,0,22
,"Women's Jean Desert Sage 16"" Average","Women's Jean Desert Sage 16"" Average",Default,0,0,0,0,0,13
,"Women's Jean Desert Sage 16"" Average","Women's Jean Desert Sage 16"" Average",Default Ridgefield,3,3,0,0,0,0
,"Women's Jean Desert Sage 16"" Short","Women's Jean Desert Sage 16"" Short",Default,0,0,0,0,0,28
,"Women's Jean Desert Sage 18"" Average","Women's Jean Desert Sage 18"" Average",Default,0,0,0,0,0,7
,"Women's Jean Desert Sage 18"" Short","Women's Jean Desert Sage 18"" Short",Default,0,0,0,0,0,15
,"Women's Jean Desert Sage 6"" Average","Women's Jean Desert Sage 6"" Average",Default,0,0,0,0,0,1
,"Women's Jean Desert Sage 6"" Average","Women's Jean Desert Sage 6"" Average",Default Ridgefield,9,9,0,0,0,0
,"Women's Jean Desert Sage 8"" Average","Women's Jean Desert Sage 8"" Average",Default,0,0,0,0,0,4
,"Women's Jean Desert Sage 8"" Average","Women's Jean Desert Sage 8"" Average",Default Ridgefield,1,1,0,0,0,0
,"Women's Jean Desert Sage 8"" Short","Women's Jean Desert Sage 8"" Short",Default Ridgefield,4,4,0,0,0,0
,"Women's Jean Lilac Burst 10"" Average","Women's Jean Lilac Burst 10"" Average",Default,0,0,0,0,0,8
,"Women's Jean Lilac Burst 10"" Average","Women's Jean Lilac Burst 10"" Average",Default Ridgefield,3,3,0,0,0,0
,"Women's Jean Lilac Burst 10"" Short","Women's Jean Lilac Burst 10"" Short",Default Ridgefield,3,3,0,0,0,0
,"Women's Jean Lilac Burst 12"" Average","Women's Jean Lilac Burst 12"" Average",Default,0,0,0,0,0,1
,"Women's Jean Lilac Burst 12"" Average","Women's Jean Lilac Burst 12"" Average",Default Ridgefield,2,2,0,0,0,0
,"Women's Jean Lilac Burst 14"" Average","Women's Jean Lilac Burst 14"" Average",Default,0,0,0,0,0,12
,"Women's Jean Lilac Burst 14"" Short","Women's Jean Lilac Burst 14"" Short",Default,0,0,0,0,0,2
,"Women's Jean Lilac Burst 16"" Average","Women's Jean Lilac Burst 16"" Average",Default,0,0,0,0,0,1
,"Women's Jean Lilac Burst 18"" Average","Women's Jean Lilac Burst 18"" Average",Default,0,0,0,0,0,11
,"Women's Jean Lilac Burst 6"" Average","Women's Jean Lilac Burst 6"" Average",Default Ridgefield,1,1,0,0,0,0
,"Women's Jean Lilac Burst 6"" Short","Women's Jean Lilac Burst 6"" Short",Default,0,0,0,0,0,2
,"Women's Jean Lilac Burst 8"" Average","Women's Jean Lilac Burst 8"" Average",Default,0,0,0,0,0,3
,"Women's Jean Lunar Wash 10"" Average","Women's Jean Lunar Wash 10"" Average",Default,0,0,0,0,0,5
,"Women's Jean Lunar Wash 10"" Short","Women's Jean Lunar Wash 10"" Short",Default,0,0,0,0,0,10
,"Women's Jean Lunar Wash 12"" Average","Women's Jean Lunar Wash 12"" Average",Default,0,0,0,0,0,14
,"Women's Jean Lunar Wash 12"" Short","Women's Jean Lunar Wash 12"" Short",Default,0,0,0,0,0,6
,"Women's Jean Lunar Wash 14"" Average","Women's Jean Lunar Wash 14"" Average",Default,0,0,0,0,0,10
,"Women's Jean Lunar Wash 14"" Short","Women's Jean Lunar Wash 14"" Short",Default,0,0,0,0,0,5
,"Women's Jean Lunar Wash 16"" Average","Women's Jean Lunar Wash 16"" Average",Default,0,0,0,0,0,12
,"Women's Jean Lunar Wash 16"" Short","Women's Jean Lunar Wash 16"" Short",Default,0,0,0,0,0,12
,"Women's Jean Lunar Wash 18"" Short","Women's Jean Lunar Wash 18"" Short",Default,0,0,0,0,0,3
,"Women's Jean Lunar Wash 6"" Average","Women's Jean Lunar Wash 6"" Average",Default,0,0,0,0,0,7
,"Women's Jean Lunar Wash 6"" Average","Women's Jean Lunar Wash 6"" Average",Default Ridgefield,2,2,0,0,0,0
,"Women's Jean Lunar Wash 6"" Short","Women's Jean Lunar Wash 6"" Short",Default,0,0,0,0,0,12
,"Women's Jean Lunar Wash 6"" Short","Women's Jean Lunar Wash 6"" Short",Default Ridgefield,3,3,0,0,0,0
,"Women's Jean Lunar Wash 8"" Average","Women's Jean Lunar Wash 8"" Average",Default,0,0,0,0,0,2
,"Women's Jean Lunar Wash 8"" Short","Women's Jean Lunar Wash 8"" Short",Default,0,0,0,0,0,2
,"Women's Jean Lunar Wash 8"" Short","Women's Jean Lunar Wash 8"" Short",Default Ridgefield,4,4,0,0,0,0
,"Women's Jean Pebble Stone 10"" Short","Women's Jean Pebble Stone 10"" Short",Default,0,0,0,0,0,1
,"Women's Jean Pebble Stone 14"" Short","Women's Jean Pebble Stone 14"" Short",Default,0,0,0,0,0,4
,"Women's Jean Pebble Stone 16"" Average","Women's Jean Pebble Stone 16"" Average",Default,0,0,0,0,0,14
,"Women's Jean Pebble Stone 16"" Short","Women's Jean Pebble Stone 16"" Short",Default,0,0,0,0,0,16
,"Women's Jean Pebble Stone 18"" Short","Women's Jean Pebble Stone 18"" Short",Default,0,0,0,0,0,3
,"Women's Jean Shell White 12"" Short","Women's Jean Shell White 12"" Short",Default,0,0,0,0,0,2
,"Women's Jean Shell White 14"" Average","Women's Jean Shell White 14"" Average",Default,0,0,0,0,0,1
,"Women's Jean Shell White 14"" Short","Women's Jean Shell White 14"" Short",Default,0,0,0,0,0,1
,"Women's Jean Shell White 16"" Short","Women's Jean Shell White 16"" Short",Default,0,0,0,0,0,1
,"Women's Jean Shell White 18"" Short","Women's Jean Shell White 18"" Short",Default,0,0,0,0,0,3
,Women's Stretch Denim Black 6,Women's Stretch Denim Black 6,FBALYB Amazon,-1,-1,0,0,0,0
,Women's Stretch Denim Black 8,Women's Stretch Denim Black 8,FBALYB Amazon,-6,-6,0,0,0,0
,Women's Stretch Denim Fig 10,Women's Stretch Denim Fig 10,FBALYB Amazon,-1,-1,0,0,0,0
,Women's Stretch Denim Fig 8,Women's Stretch Denim Fig 8,FBALYB Amazon,-1,-1,0,0,0,0
,Women's Stretch Denim True Fig 12,Women's Stretch Denim True Fig 12,FBALYB Amazon,-5,-5,0,0,0,0
,Women's Stretch Denim True Fig 16,Women's Stretch Denim True Fig 16,FBALYB Amazon,-3,-3,0,0,0,0
,Women's Top Midnight Affair S,Women's Top Midnight Affair S,FBALYB Amazon,31,31,0,0,0,0
,Woolite Dark (150oz. 75 loads),Woolite Dark (150oz. 75 loads),FBALYB Amazon,35,27,8,462,8,0
,Wpv Mens 5pkt Pant  Navy 36x30,Wpv Mens 5pkt Pant  Navy 36x30,Default Ridgefield,17,17,0,0,0,0
,Wwi Godog Furballz Rainbow Lg,Wwi Godog Furballz Rainbow Lg,Default,0,0,0,0,0,1
,Xbox 1 s 250. Gab minecraft bundle,Xbox One S 500GB Console - Minecraft Bundle [Xbox One],Default,0,0,0,0,0,13
,Xbox 1 s 250. Gab minecraft bundle,Xbox One S 500GB Console - Minecraft Bundle [Xbox One],FBALYB Amazon,-6,-6,0,0,0,0
,Xbox 1 titanfall 2 deluxe,Titanfall 2 Deluxe Edition - Xbox One [Xbox One],FBALYB Amazon,-1,-1,0,0,0,0
,Xbox 360 4gb peggle 2. Bundle,Xbox 360 4GB System Console with Peggle 2 Bundle [Xbox 360],FBALYB Amazon,-1,-1,0,0,0,0
,Xbox Kinect Adapter,Xbox Kinect Adapter for Xbox One S and Windows 10 PC,Default,0,0,0,0,0,1
,Xbox Kinect Adapter,Xbox Kinect Adapter for Xbox One S and Windows 10 PC,FBALYB Amazon,1,1,0,0,0,0
,Xbox one format 2,Forza Horizon 2 for Xbox One [Xbox One],FBALYB Amazon,-1,-1,0,0,0,0
,Xbox One Kinect Sensor,Xbox One Kinect Sensor,Default,0,0,0,0,0,2
,Xbox One Kinect Sensor,Xbox One Kinect Sensor,FBALYB Amazon,-6,-6,0,0,0,0
,Xbox One S 500GB Madden,Xbox One S 500GB Console - Madden NFL 18 Bundle,FBALYB Amazon,-1,-1,0,0,0,0
,Xbox One S 500GB Minecraft Complete Adventure,Xbox One S 500GB Console – Minecraft Complete Adventure Bundle,Default,0,0,0,0,0,2
,Xbox One S 500GB White,Xbox One S 500GB Console White,Default,0,0,0,0,0,9
,Xbox One S 500GB White,Xbox One S 500GB Console White,FBALYB Amazon,3,3,0,0,0,0
,Xbox One S Gears of War 4 1TB,Xbox One S Gears of War 4 1TB,FBALYB Amazon,-1,-1,0,1,0,0
,Xbox One S Halo Wars 2,Xbox One S 1TB Console ‑ Halo Wars 2 Bundle,Default,0,0,0,0,0,1
,Xbox One S Hot Wheels Bundle,Xbox One S Hot Wheels Bundle,Default,0,0,0,0,0,1
,Xbox watch Dogs,Xbox watch Dogs,FBALYB Amazon,-1,-1,0,0,0,0
,XD-UZ02-709M,"Green Mountain Coffee Breakfast Blend, K-Cup Portion Pack for Keurig K-Cup Br...",FBALYB Amazon,14,14,0,0,0,0
,Xlear Spry Anti-Plaque Peppermint 5oz,Xlear Spry Anti-Plaque Peppermint 5oz,Default,0,0,0,0,0,3
,Xpel Aqueous Cream Jar 500ml,Xpel Aqueous Cream Jar 500ml,Default,0,-162,162,0,0,0
,XR-L373-B7JG,"Starbucks Pike Place Roast Ground Coffee, Medium Roast (32 oz bag)",FBALYB Amazon,-1,-1,0,0,0,0
,XYZAL Allergy 110 Tablets,XYZAL Allergy 24 hour 110 Tablets,FBALYB Amazon,15,15,0,0,0,0
,Yardley London English Lavender 12pk,Yardley London English Lavender 12pk,FBALYB Amazon,12,12,0,0,0,0
,Yardley London Moisturizing Bar English Lavender with Essential Oils 4.25 oz,Yardley London Moisturizing Bar English Lavender with Essential Oils 4.25 oz,Default CT,752,752,0,0,0,0
,Yardley London Moisturizing Bar English Lavender with Essential Oils 4.25 oz 3pk,Yardley London Moisturizing Bar English Lavender with Essential Oils 4.25 oz 3pk,FBALYB Amazon,89,84,5,0,5,0
,Yardley London Moisturizing Bar English Lavender with Essential Oils 4.25 oz 6pk,Yardley London Moisturizing Bar English Lavender with Essential Oils 4.25 oz 6pk,FBALYB Amazon,5,5,0,0,0,0
,Yardley London Moisturizing Bar English Lavender with Essential Oils 4.25 oz 8pk,Yardley London Moisturizing Bar English Lavender with Essential Oils 4.25 oz 8pk,FBALYB Amazon,-10,-11,1,0,1,0
,Yardley Soap - Aloe & Avocado Bar Soap  4.25oz,Yardley Soap - Aloe & Avocado Bar Soap  4.25oz,Default CT,528,528,0,0,0,0
,Yardley Soap - Aloe & Avocado Bar Soap 4.25oz 12pk,Yardley Soap - Aloe & Avocado Bar Soap 4.25oz 12pk,FBALYB Amazon,-3,-3,0,0,0,0
,Yardley Soap - AquaNet Aer HS X-Super  Hold 11oz,Yardley Soap - AquaNet Aer HS X-Super  Hold 11oz,Default CT,240,240,0,0,0,0
,Yardley Soap - AquaNet Aer HS X-SuprHold  Unsc 11oz,Yardley Soap - AquaNet Aer HS X-SuprHold  Unsc 11oz,Default CT,672,672,0,0,0,0
,"Yardley Soap Bath Bar Bundle - English Lavender, Oatmeal and Almond, Aloe and Avocado, Cocoa Butter, Lemon Verbena 4.25oz Bars (Pack of 10 Bars, Two of each)","Yardley Soap Bath Bar Bundle - English Lavender, Oatmeal and Almond, Aloe and Avocado, Cocoa Butter, Lemon Verbena 4.25oz Bars (Pack of 10 Bars, Two of each)",FBALYB Amazon,22,18,4,0,4,0
,Yardley Soap - Cocoa Butter Bar Soap  4.25oz,Yardley Soap - Cocoa Butter Bar Soap  4.25oz,Default CT,704,704,0,0,0,0
,Yardley Soap - Cocoa Butter Bar Soap 4.25oz 8pk,Yardley Soap - Cocoa Butter Bar Soap 4.25oz 8pk,FBALYB Amazon,-2,-3,1,0,1,0
,Yardley Soap - Finesse CD Moisturizing  13oz,Yardley Soap - Finesse CD Moisturizing  13oz,Default CT,4,4,0,0,0,0
,Yardley Soap - Finesse CD Moisturizing 13oz 6pk,Yardley Soap - Finesse CD Moisturizing 13oz 6pk,FBALYB Amazon,6,6,0,0,0,0
,Yardley Soap - Finesse HS Extra Hold 12p -  7oz aerosol,Yardley Soap - Finesse HS Extra Hold 12p -  7oz aerosol,Default CT,336,336,0,0,0,0
,Yardley Soap - Finesse Normal- enhancing  SH Enhancing 13oz,Yardley Soap - Finesse Normal- enhancing  SH Enhancing 13oz,Default CT,672,672,0,0,0,0
,Yardley Soap - Finesse SH Moisturizing  13oz,Yardley Soap - Finesse SH Moisturizing  13oz,Default CT,83,83,0,0,0,0
,Yardley Soap - Finesse SH Moisturizing  13oz,Yardley Soap - Finesse SH Moisturizing  13oz,FBALYB Amazon,76,76,0,0,0,0
,Yardley Soap - Finesse SH Moisturizing 13oz 6pk,Yardley Soap - Finesse SH Moisturizing 13oz 6pk,FBALYB Amazon,4,4,0,0,0,0
,Yardley Soap - Finesse SH Volumizing 13oz,Yardley Soap - Finesse SH Volumizing 13oz,Default CT,144,144,0,0,0,0
,Yardley Soap - Lemon Verbena Bar Soap  4.25oz,Yardley Soap - Lemon Verbena Bar Soap  4.25oz,Default CT,24,24,0,0,0,0
,Yardley Soap - Lemon Verbena Bar Soap 4.25oz 12pk,Yardley Soap - Lemon Verbena Bar Soap 4.25oz 12pk,FBALYB Amazon,74,73,1,0,1,0
,Yardley Soap - LypMoisturizer Original  2.83g,Yardley Soap - LypMoisturizer Original  2.83g,Default CT,52,52,0,0,0,0
,Yardley Soap - LypMoisturizer Original  2.83g,Yardley Soap - LypMoisturizer Original  2.83g,FBALYB Amazon,108,107,1,1,1,0
,Yardley Soap - LypMoisturizer Original 2.83g 2pk,Yardley Soap - LypMoisturizer Original 2.83g 2pk,FBALYB Amazon,7,7,0,1,0,0
,Yardley Soap - LypMoisturizer Original 2.83g 3pk,Yardley Soap - LypMoisturizer Original 2.83g 3pk,FBALYB Amazon,1,1,0,0,0,0
,Yardley Soap - LypMoisturizer Original 2.83g 4pk,Yardley Soap - LypMoisturizer Original 2.83g 4pk,FBALYB Amazon,76,76,0,0,0,0
,Yardley Soap - LypMoisturizer Original 2.83g 6pk,Yardley Soap - LypMoisturizer Original 2.83g 6pk,FBALYB Amazon,2,2,0,0,0,0
,Yardley Soap - Oat Almond Bar Soap 4.25oz,Yardley Soap - Oat Almond Bar Soap 4.25oz,Default CT,650,-1350,2000,0,0,0
,Yardley Soap - Oat Almond Bar Soap 4.25oz 20pk,Yardley Soap - Oat Almond Bar Soap 4.25oz 20pk,FBALYB Amazon,9,1,8,0,8,0
,Yardley Soap - Oat Almond Bar Soap 4.25oz 24pk,Yardley Soap - Oat Almond Bar Soap 4.25oz 24pk,FBALYB Amazon,-1,-1,0,0,0,0
,Yardley Soap - Oat Almond Bar Soap 4.25oz 8pk,Yardley Soap - Oat Almond Bar Soap 4.25oz 8pk,FBALYB Amazon,325,321,4,0,4,0
,Yardley Soap - Shea Buttermilk Sensitive Skin Single Bar Soap 4.25oz 8pk,Yardley Soap - Shea Buttermilk Sensitive Skin Single Bar Soap 4.25oz 8pk,FBALYB Amazon,10,10,0,0,0,0
,y Feature Talking Bo Peep 14 Inch With Mcdimples 64433TS4,Toy Story Feature Talking Bo Peep 14 Inch With Mcdimples 64433TS4,Default,0,-14,14,0,0,0
,y Feature Talking Bo Peep 14 Inch With Mcdimples 64433TS4,Toy Story Feature Talking Bo Peep 14 Inch With Mcdimples 64433TS4,FBALYB Amazon,-3,-3,0,0,0,0
,Yip Yap Dog Breath Tin 1.4oz,Yip Yap Dog Breath Tin 1.4oz,FBALYB Amazon,1,1,0,0,0,0
,YL-5GRR-YNK7,"Starbucks French Roast Dark, K-Cup for Keurig Brewers, Dark Roast Coffee, 54 ...",FBALYB Amazon,3,3,0,0,0,0
,Yo-kai Watch Komasan,Yo-kai Watch Medal Moments Komasan,FBALYB Amazon,4,4,0,0,0,0
,Yo-kai Watch Plush Robonyan,Yo-kai Watch Plush Figure Robonyan,FBALYB Amazon,-1,-1,0,1,0,0
,Yo-kai Watch Plush Whisper,Yo-kai Watch Plush Figure Whisper,Default,1,1,0,0,0,0
,Yo-kai Watch Plush Whisper,Yo-kai Watch Plush Figure Whisper,FBALYB Amazon,-1,-1,0,0,0,0
,Youtheory Collagen 390ct,Youtheory Collagen 390ct,FBALYB Amazon,-2,-2,0,0,0,0
,YR-WIRJ-WSGY,"Power Air Fryer XL, 3.4 QT, Black",Default,1,1,0,0,0,0
,YR-WIRJ-WSGY,"Power Air Fryer XL, 3.4 QT, Black",FBALYB Amazon,-9,-9,0,8,0,0
,Yuan tradition,"Yuban Traditional Ground Coffee., 12 Ounce",FBALYB Amazon,1,1,0,0,0,0
,Yuge Butane Torch,Yuge Butane Torch,Default,0,0,0,0,0,203
,Yuge Butane Torch,Yuge Butane Torch,Default Ridgefield,656,656,0,0,0,0
,Yuge Butane Torch,Yuge Butane Torch,FBALYB Amazon,182,182,0,8,0,0
,Yummie Tights Large Black Grey,Yummie Tights Large Black Grey,Default Ridgefield,19,19,0,0,0,0
,Yummie Tights Large Black Grey,Yummie Tights Large Black Grey,FBALYB Amazon,22,22,0,0,0,0
,Yummie Tights Medium Black,Yummie Tights Medium Black,Default,0,0,0,0,0,1
,Yummie Tights Medium Black,Yummie Tights Medium Black,FBALYB Amazon,-1,-1,0,0,0,0
,Zantac 120 ct,"Zantac 150 Maximum Strength Tablets, Regular, 120 Count",FBALYB Amazon,4,4,0,0,0,0
,ZAVIDA hazelnut vanilla coffee,ZAVIDA hazelnut vanilla coffee,Avrami - Ebay,103,103,0,0,0,0
,ZAVIDA hazelnut vanilla coffee,ZAVIDA hazelnut vanilla coffee,Default Ridgefield,1,0,1,0,0,0
,ZAVIDA hazelnut vanilla coffee,ZAVIDA hazelnut vanilla coffee,FBALYB Amazon,305,285,20,197,20,0
,ZAVIDA hazelnut vanilla coffee,ZAVIDA hazelnut vanilla coffee,WFS,-79,-79,0,0,0,0
,ZAVIDA hazelnut vanilla coffee 2PK,ZAVIDA hazelnut vanilla coffee 2PK,FBALYB Amazon,-139,-141,2,15,2,0
,ZB-X7XT-P4A3,Shark Rotator Powered Lift-Away Speed (NV681),Default,0,0,0,0,0,19
,ZB-X7XT-P4A3,Shark Rotator Powered Lift-Away Speed (NV681),FBALYB Amazon,-22,-22,0,0,0,0
,ZC-999U-TK1U,"Hershey's Extra Dark Chocolate Assortment,  24 Ounce",FBALYB Amazon,1,1,0,0,0,0
,Zebra Z-Grip Flight Ball Point Pen 25 Ct,Zebra Z-Grip Flight Ball Point Pen 25 Ct,Default Ridgefield,440,440,0,0,0,0
,Zebra Z-Grip Flight Ball Point Pen 25 Ct,Zebra Z-Grip Flight Ball Point Pen 25 Ct,FBALYB Amazon,99,99,0,0,0,0
,ZEISS LENS WIPE  220CT,ZEISS LENS WIPE  220CT,Avrami - Ebay,210,210,0,0,0,0
,ZEISS LENS WIPE  220CT,ZEISS LENS WIPE  220CT,FBALYB Amazon,956,956,0,421,0,0
,ZEISS LENS WIPE  220CT,ZEISS LENS WIPE  220CT,FBALYB Canada,4,4,0,40,0,0
,ZEISS LENS WIPE  220CT,ZEISS LENS WIPE  220CT,WFS,-49,-49,0,0,0,0
,"ZEISS Lens Wipes, 220 ct. 2pk","ZEISS Lens Wipes, 220 ct. 2pk",Default Ridgefield,232,224,8,0,0,0
,"ZEISS Lens Wipes, 220 ct. 2pk","ZEISS Lens Wipes, 220 ct. 2pk",FBALYB Amazon,420,388,32,0,32,0
,"ZEISS Lens Wipes, 220 ct. 3pk","ZEISS Lens Wipes, 220 ct. 3pk",FBALYB Amazon,256,247,9,8,9,0
,Zero Grand WING OX - BLACK/BLACK - US Size: 10.5 W,Zero Grand WING OX - BLACK/BLACK - US Size: 10.5 W,FBALYB Amazon,-4,-4,0,0,0,0
,Zero Grand WING OX - BLACK/BLACK - US Size: 10 W,Zero Grand WING OX - BLACK/BLACK - US Size: 10 W,FBALYB Amazon,13,12,1,0,1,0
,Zero Grand WING OX - BLACK/BLACK - US Size: 11.5 W,Zero Grand WING OX - BLACK/BLACK - US Size: 11.5 W,FBALYB Amazon,-1,-2,1,0,1,0
,Zero Grand WING OX - BLACK/BLACK - US Size: 12 W,Zero Grand WING OX - BLACK/BLACK - US Size: 12 W,FBALYB Amazon,0,-1,1,0,1,0
,Zero Grand WING OX - BLACK/BLACK - US Size: 7.5 W,Zero Grand WING OX - BLACK/BLACK - US Size: 7.5 W,FBALYB Amazon,2,2,0,0,0,0
,Zero Grand WING OX - BLACK/BLACK - US Size: 8 W,Zero Grand WING OX - BLACK/BLACK - US Size: 8 W,FBALYB Amazon,9,9,0,0,0,0
,Zero Grand WING OX - BLACK/BLACK - US Size: 9 W,Zero Grand WING OX - BLACK/BLACK - US Size: 9 W,FBALYB Amazon,5,4,1,0,1,0
,"Zilla 11435 Fresh Air Screen Cover, 48 x 18","Zilla 11435 Fresh Air Screen Cover, 48 x 18",FBALYB Amazon,5,5,0,2,0,0
,Zilla 11896 Basking Platform Corner Ramp Large,Zilla 11896 Basking Platform Corner Ramp Large,Default,0,0,0,0,0,1
,Zilla 11896 Basking Platform Corner Ramp Large,Zilla 11896 Basking Platform Corner Ramp Large,FBALYB Amazon,2,2,0,0,0,0
,Zilla 13288 Cage 40 Gallon,Zilla 13288 Deluxe Critter Cage with Feeding Door 40 Gallon,Default,0,0,0,0,0,18
,Zilla 13288 Cage 40 Gallon,Zilla 13288 Deluxe Critter Cage with Feeding Door 40 Gallon,FBALYB Amazon,4,4,0,0,0,0
,Zilla Basking Platform Ramp Large,Zilla Basking Platform Ramp Large,FBALYB Amazon,1,1,0,0,0,0
,Zilla Day White Light Bulb 100W 3pk,Zilla Day White Light Bulb 100W 3pk,FBALYB Amazon,-2,-2,0,1,0,0
,Zilla Decor Floating Turtle Trunk,Zilla Decor Floating Turtle Trunk,FBALYB Amazon,2,2,0,0,0,0
,Zilla Green Terrarium Liner15 20H,Zilla Green Terrarium Liner15 20H,Default,0,0,0,0,0,2
,Zilla Green Terrarium Liner15 20H,Zilla Green Terrarium Liner15 20H,Default Ridgefield,2,2,0,0,0,0
,Zilla Green Terrarium Liner15 20H 2pk,Zilla Green Terrarium Liner15 20H 2pk,FBALYB Amazon,-5,-5,0,0,0,0
,Zilla Ground English Walnut Shells 5qt,Zilla Ground English Walnut Shells 5qt,Default,0,0,0,0,0,38
,Zilla Ground English Walnut Shells 5qt,Zilla Ground English Walnut Shells 5qt,FBALYB Amazon,6,6,0,0,0,0
,Zilla Halogen Mini Lamp White 25W,Zilla Halogen Mini Lamp White 25W,FBALYB Amazon,5,5,0,0,0,0
,Zilla Land Turtle Food 6.5oz 3pk,Zilla Land Turtle Food 6.5oz 3pk,FBALYB Amazon,-1,-1,0,0,0,0
,Zilla Mini Halogen Dome Light,Zilla Mini Halogen Dome Light for Reptitat,Default,0,0,0,0,0,24
,Zilla Mini Halogen Dome Light,Zilla Mini Halogen Dome Light for Reptitat,FBALYB Amazon,-4,-4,0,0,0,0
,Zilla Mini Halogen Dome Light 2pk,Zilla Mini Halogen Dome Light 2pk,FBALYB Amazon,3,3,0,0,0,0
,Zilla Night Red Heat Bulb 100W 3pk,Zilla Night Red Heat Bulb 100W 3pk,FBALYB Amazon,0,0,0,90,0,0
,"Zilla Reptile Bedding Liner, Brown, 20L","Zilla Reptile Terrarium Bedding Substrate Liner, Brown, 20L",Default,0,-1,1,0,0,0
,"Zilla Reptile Bedding Liner, Brown, 20L","Zilla Reptile Terrarium Bedding Substrate Liner, Brown, 20L",Default Ridgefield,4,4,0,0,0,0
,"Zilla Reptile Bedding Liner, Brown, 20L","Zilla Reptile Terrarium Bedding Substrate Liner, Brown, 20L",FBALYB Amazon,-2,-2,0,0,0,0
,"Zilla Reptile Health Calcium Spray, 8oz","Zilla Reptile Health Supplies Calcium Supplement Food Spray, 8-Ounce",FBALYB Amazon,-2,-2,0,1,0,0
,"Zilla Reptile Health Vitamin Spray, 8oz","Zilla Reptile Health Supplies Vitamin Supplement Food Spray, 8-Ounce",Default,0,-59816,59816,0,0,0
,Zilla Shrimp Turtle Treats 2oz 2pk,Zilla Floating Shrimp Turtle Treats 2oz 2pk,FBALYB Amazon,1,1,0,0,0,0
,"Zilla Slimline Reptile Lighting Fixture 18""","Zilla Reptile Slimline Reptile Lighting Fixture with UVB Lamp, 18-Inches",FBALYB Amazon,1,1,0,0,0,0
,Zilla Terrarium Liner Green 29 Gal,Zilla Terrarium Liner Green 29 Gal,Default,0,0,0,0,0,12
,Zilla Terrarium Liner Green 29 Gal 2pk,Zilla Terrarium Liner Green 29 Gal 2pk,FBALYB Amazon,-3,-3,0,0,0,0
,Zint Beef Gelatin Bag 10 oz INAB-010,Zint Beef Gelatin Bag 10 oz INAB-010,FBALYB Amazon,1,1,0,0,0,0
,Zint Beef Gelatin Bag 1lb INAB-016,Zint Beef Gelatin Bag 1lb INAB-016,Default,0,-68,68,0,0,0
,Zint Beef Gelatin Bag 1lb INAB-016,Zint Beef Gelatin Bag 1lb INAB-016,Default Ridgefield,349,249,100,0,0,0
,Zint Beef Gelatin Bag 1lb INAB-016,Zint Beef Gelatin Bag 1lb INAB-016,FBALYB Amazon,-80,-180,100,0,0,0
,Zint Cacao Nibs 1lb SUHB-016,Zint Cacao Nibs 1lb SUHB-016,FBALYB Amazon,0,0,0,1,0,0
,Zint Cacao Powder 1lb SUFB-016,Zint Cacao Powder 1lb SUFB-016,FBALYB Amazon,1,1,0,0,0,0
,Zint Cacao Powder 2lb SUFB-032,Zint Cacao Powder 2lb SUFB-032,FBALYB Amazon,0,0,0,1,0,0
,Zint Collagen Hydrolsate bag 1lb NUAB-016,Zint Collagen Hydrolsate bag 1lb NUAB-016,FBALYB Amazon,2,2,0,0,0,0
,Zint Collagen Hydrolysate Bag 2lb NUAB-032,Zint Collagen Hydrolysate Bag 2lb NUAB-032,Default Ridgefield,16,16,0,0,0,0
,Zint Collagen Hydrolysate Bag 2lb NUAB-032,Zint Collagen Hydrolysate Bag 2lb NUAB-032,FBALYB Amazon,-2,-2,0,1,0,0
,Zint Mesquite Powder Bag 8 OZ SUDB-008,Zint Mesquite Powder Bag 8 OZ SUDB-008,FBALYB Amazon,-1,-1,0,0,0,0
,Zint Pre-Mix Flavored Collagen 3 Flavor Assort BEEC-015,Zint Pre-Mix Flavored Collagen 3 Flavor Assort BEEC-015,Default,0,-40,40,0,0,0
,Zint Pre-Mix Flavored Collagen 3 Flavor Assort BEEC-015,Zint Pre-Mix Flavored Collagen 3 Flavor Assort BEEC-015,FBALYB Amazon,1,1,0,0,0,0
,Zint Yacon Syrup Bottle 8 Fl OZ SWBF-008, Zint Yacon Syrup Bottle 8 Fl OZ SWBF-008,FBALYB Amazon,223,197,26,32,26,0
,Zint Yacon Syrup Bottle 8 Fl OZ SWBF-008, Zint Yacon Syrup Bottle 8 Fl OZ SWBF-008,FBALYB Canada,1,1,0,0,0,0
,Ziploc Container,Ziploc Container,Default Ridgefield,289,289,0,0,0,0
,Ziploc Freezer Bags Large 3pk,Ziploc Freezer Bags Large 3pk,FBALYB Amazon,11,11,0,3,0,0
,Ziploc Freezer Bags Large 50ct,Ziploc Freezer Bags Large 50ct,Default Ridgefield,16321,15941,380,0,0,0
,Ziploc Freezer Bags Large 50ct 5 pack,Ziploc Freezer Bags Large 50ct 5 pack,Default Ridgefield,1,-75,76,0,0,0
,Ziploc Freezer Bags Large 50ct 5 pack,Ziploc Freezer Bags Large 50ct 5 pack,FBALYB Amazon,199,198,1,0,1,0
,Ziploc Freezer Bags Medium 3pk,Ziploc Freezer Bags Medium 3pk,Default Ridgefield,238,238,0,0,0,0
,Ziploc Freezer Bags Medium 3pk,Ziploc Freezer Bags Medium 3pk,FBALYB Amazon,12,12,0,11,0,0
,Ziploc Freezer Bags Medium 60 ct,Ziploc Freezer Bags Medium 60 ct,Default,0,-2824,2824,0,0,0
,Ziploc Freezer Bags Medium 60 ct,Ziploc Freezer Bags Medium 60 ct,Default Ridgefield,8092,8092,0,0,0,0
,Ziploc Freezer Bags Medium 60 ct,Ziploc Freezer Bags Medium 60 ct,FBALYB Amazon,-133,-133,0,2,0,0
,Ziploc Freezer Bags Medium 60 ct 2pk,Ziploc Freezer Bags Medium 60 ct 2pk,Default,0,-25,25,0,0,0
,Ziploc Freezer Bags Medium 60 ct 2pk,Ziploc Freezer Bags Medium 60 ct 2pk,FBALYB Amazon,-37,-61,24,453,24,0
,Ziploc Freezer Bags Medium 60 ct 4pk,Ziploc Freezer Bags Medium 60 ct 4pk,Default,0,-20,20,0,0,0
,Ziploc Freezer Bags Medium 60 ct 4pk,Ziploc Freezer Bags Medium 60 ct 4pk,FBALYB Amazon,21,21,0,2,0,0
,Ziploc Sandwich Bags,Ziploc Sandwich Bags ,Default Ridgefield,7849,7849,0,0,0,0
,Ziploc Sandwich Bags,Ziploc Sandwich Bags ,FBALYB Amazon,630,624,6,0,6,0
,Ziploc Sandwich Bags (2 Pack),Ziploc Sandwich Bags (2 Pack),FBALYB Amazon,304,300,4,14,4,0
,Ziploc Sandwich Bags (4 Pack),Ziploc Sandwich Bags (4 Pack),Default,0,-180,180,0,0,0
,Ziploc Sandwich Bags (4 Pack),Ziploc Sandwich Bags (4 Pack),FBALYB Amazon,799,786,13,3,13,0
,Zone Perfect 24ct peanut/fudge,Zone Perfect 24ct peanut/fudge,Default,0,0,0,0,0,11
,Zone Perfect 24ct peanut/fudge,Zone Perfect 24ct peanut/fudge,FBALYB Amazon,-4,-4,0,0,0,0
,ZonePerfect Bars 24 ct,"ZonePerfect High Protein Nutrition Bars, Dark Chocolate Almond & Double Dark Chocolate",FBALYB Amazon,-16,-16,0,17,0,0
,"Zoo Med 13W Fluorescent Lamp, Mini","Zoo Med 25157 Reprising 10.0 UVB Compact 13W Fluorescent Lamp, Mini",Default,6,6,0,0,0,0
,"Zoo Med 13W Fluorescent Lamp, Mini","Zoo Med 25157 Reprising 10.0 UVB Compact 13W Fluorescent Lamp, Mini",FBALYB Amazon,-12,-13,1,3,1,0
,"Zoo Med 13W Fluorescent Lamp, Mini 2pk","Zoo Med 13W Fluorescent Lamp, Mini 2pk",FBALYB Amazon,-1,-1,0,0,0,0
,"Zoo Med 24975 Avian Sun 5.0 Lamp, 26W","Zoo Med 24975 Avian Sun 5.0 Uvb Compact Fluorescent Lamp, 26W",FBALYB Amazon,-4,-4,0,0,0,0
,"Zoo Med 26053 Terrarium Hood, 24""","Zoo Med 26053 Reptisun T5-Ho Terrarium Hood, 24""",FBALYB Amazon,-15,-15,0,7,0,0
,"Zoo Med 26054 Terrarium Hood, 36""","Zoo Med 26054 Reptisun T5-Ho Terrarium Hood, 36""",Default Ridgefield,1,1,0,0,0,0
,"Zoo Med 26054 Terrarium Hood, 36""","Zoo Med 26054 Reptisun T5-Ho Terrarium Hood, 36""",FBALYB Amazon,-1,-1,0,0,0,0
,Zoo Med 26251 Repticare Rock Heater,Zoo Med 26251 Repticare Rock Heater,FBALYB Amazon,-1,-1,0,0,0,0
,Zoo Med 4pack Hermit Crab Soil,Zoo Med 4pack Hermit Crab Soil,FBALYB Amazon,-3,-3,0,0,0,0
,Zoo Med 501 Filter Media 4.75oz,Zoo Med 501 Filter Media 4.75oz,Default,0,0,0,0,0,3
,Zoo Med 511 Turtle Clean Canister Filter,Zoo Med 511 Turtle Clean Canister Filter,FBALYB Amazon,-14,-14,0,8,0,0
,"Zoo Med African Mopani Wood, Medium","Zoo Med African Mopani Wood, Medium",FBALYB Amazon,-1,-1,0,0,0,0
,Zoo med AquaCool Cooling Fan,Zoo med AquaCool Cooling Fan,FBALYB Amazon,-1,-1,0,0,0,0
,Zoo Med AquaSun 8 Outlet Timer/Power,Zoo Med AquaSun 8 Outlet Timer/Power Strip,FBALYB Amazon,72,69,3,0,3,0
,Zoo Med Aquatic Turtle Food 54oz,Zoo Med Aquatic Turtle Food 54oz,Default,0,0,0,0,0,150
,Zoo Med Aquatic Turtle Food Growth 8.75oz,Zoo Med Aquatic Turtle Food Growth 8.75oz,Default,0,0,0,0,0,30
,Zoo Med Aquatic Turtle Food Growth 8.75oz,Zoo Med Aquatic Turtle Food Growth 8.75oz,FBALYB Amazon,-8,-8,0,0,0,0
,Zoo Med Aquatic Turtle Lighting Combo Pack,Zoo Med Aquatic Turtle Lighting Combo Pack,FBALYB Amazon,-1,-1,0,0,0,0
,Zoo Med Aquatic Turtle Pellet 17.5oz,Zoo Med Aquatic Turtle Pellet 17.5oz,FBALYB Amazon,-1,-1,0,0,0,0
,Zoo Med Aquatic Turtle UVB & Heat Lighting Kit,Zoo Med Aquatic Turtle UVB & Heat Lighting Kit,Default,0,0,0,0,0,19
,Zoo Med Aquatic Turtle UVB & Heat Lighting Kit,Zoo Med Aquatic Turtle UVB & Heat Lighting Kit,FBALYB Amazon,-6,-6,0,4,0,0
,Zoo Med Aspen Snake Bedding 8qt,Zoo Med Aspen Snake Bedding 8qt,FBALYB Amazon,-2,-2,0,1,0,0
,Zoo Med Avian Calcium 3oz,Zoo Med Avian Calcium 3oz,FBALYB Amazon,-1,-1,0,1,0,0
,Zoo Med Avian Calcium 8 Oz,Zoo Med Avian Calcium 8 Oz,FBALYB Amazon,-60,-60,0,74,0,0
,Zoo Med Aviansun Deluxe Floor Lamp,Zoo Med Aviansun Deluxe Floor Lamp,FBALYB Amazon,-1,-1,0,0,0,0
,Zoo Med AZMFA50 Sinking Betta Log,Zoo Med AZMFA50 Sinking Betta Log,FBALYB Amazon,1,1,0,0,0,0
,Zoo Med AZMFA50 Sinking Betta Log 2pk,Zoo Med AZMFA50 Sinking Betta Log 2pk,Default,-4,-4,0,0,0,0
,"Zoo Med AZMMAM Mopani Wood, Medium","Zoo Med Laboratories AZMMAM Mopani Wood, Medium",FBALYB Amazon,1,1,0,0,0,0
,ZooMed Betta Bamboo Plant,ZooMed Betta Bamboo Plant,Default,0,0,0,0,0,2
,Zoo med betta bed leaf hammock,Zoo med betta bed leaf hammock,FBALYB Amazon,-38,-38,0,0,0,0
,Zoo med betta bed leaf hammock 2pk,Zoo med betta bed leaf hammock 2pk,FBALYB Amazon,9,9,0,0,0,0
,Zoo Med BettaMatic- Automatic Betta Feeder,Zoo Med BettaMatic- Automatic Betta Feeder,FBALYB Amazon,1,1,0,0,0,0
,Zoo Med BettaTherm Beta Bowl Heater 7.5W,Zoo Med BettaTherm Beta Bowl Heater 7.5W,FBALYB Amazon,-1,-1,0,0,0,0
,Zoo Med Bird Banquet Block Small,Zoo Med Bird Banquet Block Small,Default,0,0,0,0,0,1
,Zoo Med Bird Banquet Block Small,Zoo Med Bird Banquet Block Small,FBALYB Amazon,-1,-1,0,0,0,0
,"Zoo Med Block Feeders ,Giant Size 2pk","Zoo Med Block Feeders ,Giant Size 2pk",FBALYB Amazon,176,176,0,1,0,0
,"Zoo Med Block Feeders ,Giant Size 3pk","Zoo Med Block Feeders ,Giant Size 3pk",FBALYB Amazon,-1,-1,0,0,0,0
,Zoo Med Box Turtle Food 8.25oz,Zoo Med Box Turtle Food 8.25oz,Default,1,1,0,0,0,0
,Zoo Med Box Turtle Food 8.25oz,Zoo Med Box Turtle Food 8.25oz,FBALYB Amazon,-1,-1,0,0,0,0
,"Zoo Med Calcium Reptile Food, 3oz","Zoo Med Calcium With Vitamin D3 Reptile Food, 3-Ounce",FBALYB Amazon,391,391,0,0,0,0
,Zoo Med Calcium W/o D3 8oz,Zoo Med Calcium W/o D3 8oz,FBALYB Amazon,-2,-2,0,0,0,0
,Zoo Med Can O' Crickets 1.2oz,Zoo Med Can O' Crickets 1.2oz,Default,0,0,0,0,0,3
,Zoo Med Can O' Crickets 1.2oz 3pk,Zoo Med Can O' Crickets 1.2oz 3pk,FBALYB Amazon,-9,-9,0,9,0,0
,Zoo Med Can O' Cyclops 3.2oz,Zoo Med Can O' Cyclops 3.2oz,FBALYB Amazon,-3,-3,0,2,0,0
,Zoo Med Can O' Superworms 1.75oz,Zoo Med Can O' Superworms 1.75oz,Default,0,0,0,0,0,24
,Zoo Med Can O' Superworms 1.75oz,Zoo Med Can O' Superworms 1.75oz,FBALYB Amazon,-1,-1,0,0,0,0
,Zoo Med Cavern Kit 12lb,Zoo Med Cavern Kit 12lb,FBALYB Amazon,-4,-4,0,4,0,0
,Zoo Med Combo Deep Dome Lamp,Zoo Med Combo Deep Dome Lamp,FBALYB Amazon,-3,-3,0,0,0,0
,Zoo Med Daylight Blue Bulb 100W,Zoo Med Daylight Blue Bulb 100W,Default,0,0,0,0,0,4
,Zoo Med Daylight Blue Bulb 100W 4pk,Zoo Med Daylight Blue Bulb 100W 4pk,FBALYB Amazon,-1,-1,0,0,0,0
,Zoo Med Daylight Blue Reptile Bulb,Zoo Med Daylight Blue Reptile Bulb,FBALYB Amazon,12,12,0,0,0,0
,Zoo Med Daylight Blue Reptile Bulb 40W,Zoo Med Daylight Blue Reptile Bulb 40W,Default,0,0,0,0,0,5
,Zoo Med Daylight Blue Reptile Bulb 40W 2pk,Zoo Med Daylight Blue Reptile Bulb 40W 2pk,FBALYB Amazon,-1,-1,0,0,0,0
,Zoo Med Daylight Blue Reptile Bulb 60w 2pack,Zoo Med Daylight Blue Reptile Bulb 60w 2pack,Default CT,3,3,0,0,0,0
,Zoo Med Daylight Blue Reptile Bulb 60W 2pk,Zoo Med Daylight Blue Reptile Bulb 60W 2pk,FBALYB Amazon,-41,-41,0,42,0,0
,Zoo Med Day/Night Desert Lighting Kit,Zoo Med Day/Night Desert Lighting Kit,Default,0,0,0,0,0,9
,Zoo Med Day/Night Desert Lighting Kit,Zoo Med Day/Night Desert Lighting Kit,Default CT,108,108,0,0,0,0
,Zoo Med Day/Night Desert Lighting Kit,Zoo Med Day/Night Desert Lighting Kit,Default Ridgefield,11,11,0,0,0,0
,Zoo Med Day/Night Desert Lighting Kit,Zoo Med Day/Night Desert Lighting Kit,FBALYB Amazon,-15,-15,0,12,0,0
,Zoo Med Day/Night Reptile 60W 3pk,Zoo Med Day/Night Reptile 60W 3pk,FBALYB Amazon,-1,-1,0,1,0,0
,Zoo Med Day/Night Reptile Bulbs Combo Pack 60W,Zoo Med Day/Night Reptile Bulbs Combo Pack 60W,Default,0,0,0,0,0,7
,Zoo Med Day/Night Reptile Bulbs Combo Pack 60W,Zoo Med Day/Night Reptile Bulbs Combo Pack 60W,Default CT,8,8,0,0,0,0
,Zoo Med Day/Night Reptile Bulbs Combo Pack 60W,Zoo Med Day/Night Reptile Bulbs Combo Pack 60W,Default Ridgefield,12,12,0,0,0,0
,Zoo Med Day/Night Reptile Bulbs Combo Pack 60W,Zoo Med Day/Night Reptile Bulbs Combo Pack 60W,FBALYB Amazon,-16,-17,1,1,1,0
,Zoo Med Day & Night Tropical Lighting Kit Lighting Combo Pack,Zoo Med Day & Night Tropical Lighting Kit Lighting Combo Pack,FBALYB Amazon,-3,-3,0,0,0,0
,Zoo Med Deluxe Collapsible Snake Hook,Zoo Med Deluxe Collapsible Snake Hook,FBALYB Amazon,1,1,0,0,0,0
,Zoo Med Deluxe Porcelain Clamp Lamp,Zoo Med Deluxe Porcelain Clamp Lamp,Default Ridgefield,16,16,0,0,0,0
,Zoo Med Deluxe Porcelain Clamp Lamp,Zoo Med Deluxe Porcelain Clamp Lamp,FBALYB Amazon,47,47,0,0,0,0
,Zoo Med Deluxe Shovel Scooper,Zoo Med Deluxe Shovel Scooper,Default,0,0,0,0,0,8
,Zoo Med Deluxe Shovel Scooper,Zoo Med Deluxe Shovel Scooper,FBALYB Amazon,-8,-8,0,0,0,0
,Zoo Med Desert UVB & Heat Lighting Kit,Zoo Med Desert UVB & Heat Lighting Kit,FBALYB Amazon,-5,-5,0,0,0,0
,Zoo Med Digital Infrared Thermometer,Zoo Med ReptiTemp Digital Infrared Thermometer,FBALYB Amazon,0,-1,1,0,1,0
,Zoo Med Digital Terrarium Thermometer,Zoo Med Digital Terrarium Thermometer,FBALYB Amazon,14,14,0,0,0,0
,Zoo Med Digital Therm/Humidity Gauge 2pk,Zoo Med Digital Therm/Humidity Gauge 2pk,FBALYB Amazon,-5,-5,0,4,0,0
,Zoo Med Digital Thermometer Humidity Gauge,Zoo Med Digital Thermometer Humidity Gauge,Default,0,0,0,0,0,40
,Zoo Med Digital Thermometer Humidity Gauge,Zoo Med Digital Thermometer Humidity Gauge,FBALYB Amazon,-5,-5,0,0,0,0
,Zoo Med Disinfectant 32 oz,Zoo Med Wipe Out 1 Disinfectant 32 oz,Default,0,0,0,0,0,1
,Zoo Med Disinfectant 32 oz,Zoo Med Wipe Out 1 Disinfectant 32 oz,FBALYB Amazon,83,83,0,0,0,0
,Zoo Med Dr.Turtle Calcium Block,Zoo Med Dr.Turtle Slow-Release Calcium Block,Default Ridgefield,3,3,0,0,0,0
,"ZooMed Eco Cage Carpet for 55 Gal tank, 13""x48""","ZooMed Eco Cage Carpet for 55 Gallon tanks, 13""x48""",FBALYB Amazon,2,2,0,6,0,0
,Zoo Med Eco Carpet - 10 gal,Zoo Med Eco Carpet - 10 gal,FBALYB Amazon,-1,-1,0,0,0,0
,Zoo Med Eco Carpet for 40 Gallon Tanks,Zoo Med Eco Carpet for 40 Gallon Tanks,FBALYB Amazon,0,0,0,1,0,0
,Zoo Med Eco Earth Coconut Brick 3ct,Zoo Med Eco Earth Coconut Brick 3ct,Default,0,0,0,0,0,52
,Zoo Med Eco Earth Coconut Brick 3ct,Zoo Med Eco Earth Coconut Brick 3ct,FBALYB Amazon,-3,-3,0,4,0,0
,Zoo Med Eco Earth Coconut Brick 3ct 3pk,Zoo Med Eco Earth Coconut Brick 3ct 3pk,FBALYB Amazon,4,1,3,0,3,0
,"Zoo Med Eco Earth Coconut Fiber, 8 Qt 3pk","Zoo Med Eco Earth Coconut Fiber, 8 Qt 3pk",FBALYB Amazon,-97,-98,1,0,1,0
,"Zoo Med Eco Earth Coconut Fiber, 8 Quarts","Zoo Med Eco Earth Loose Coconut Fiber Substrate, 8 Quarts",FBALYB Amazon,387,385,2,45,2,0
,"Zoo Med Eco Earth Pet Bed, 1-Brick","Zoo Med Laboratories SZMEE10 Eco Earth Pet Bed, 1-Brick",Default,0,0,0,0,0,10
,"Zoo Med Eco Earth Pet Bed, 1-Brick","Zoo Med Laboratories SZMEE10 Eco Earth Pet Bed, 1-Brick",Default Ridgefield,63,63,0,0,0,0
,"Zoo Med Eco Earth Pet Bed, 1-Brick","Zoo Med Laboratories SZMEE10 Eco Earth Pet Bed, 1-Brick",FBALYB Amazon,-3,-3,0,0,0,0
,"Zoo Med Eco Earth Pet Bed, 1-Brick 2pk","Zoo Med Eco Earth Pet Bed, 1-Brick 2pk",FBALYB Amazon,-6,-6,0,0,0,0
,Zoo Med Economy Dual Gauge,Zoo Med Economy Dual Gauge,Default,0,0,0,0,0,14
,Zoo Med Economy Dual Gauge,Zoo Med Economy Dual Gauge,FBALYB Amazon,14,13,1,0,1,0
,Zoo Med Economy Lamp Stand 10-20gal,Zoo Med Economy Lamp Stand 10-20gal,Default Ridgefield,1,1,0,0,0,0
,Zoo Med Economy Lamp Stand 10-20gal,Zoo Med Economy Lamp Stand 10-20gal,FBALYB Amazon,-11,-11,0,4,0,0
,"Zoo Med Excavator Clay, 10 lb","Zoo Med Excavator Clay Burrowing Substrate, 10 lb",FBALYB Amazon,-5,-5,0,0,0,0
,Zoo Med Excavator Clay 5lb,Zoo Med Excavator Clay 5lb,FBALYB Amazon,-3,-3,0,2,0,0
,Zoo Med Feeding Tongs,Zoo Med Feeding Tongs,FBALYB Amazon,-1,-1,0,52,0,0
,Zoo Med Fine Sponge 511 Filter 3pk,Zoo Med Fine Sponge 511 Filter 3pk,FBALYB Amazon,-1,-1,0,0,0,0
,Zoo Med Floating Aquarium Log Small,Zoo Med Floating Aquarium Log Small,Default Ridgefield,22,22,0,0,0,0
,Zoo Med Floating Aquarium Log Small,Zoo Med Floating Aquarium Log Small,FBALYB Amazon,96,96,0,0,0,0
,Zoo Med Floating Betta Exercise Mirror,Zoo Med Floating Betta Exercise Mirror,Default,0,0,0,0,0,31
,Zoo Med Floating Betta Exercise Mirror,Zoo Med Floating Betta Exercise Mirror,FBALYB Amazon,28,28,0,0,0,0
,Zoo Med Floating Betta Exercise Mirror 2pk,Zoo Med Floating Betta Exercise Mirror 2pk,FBALYB Amazon,-2,-2,0,0,0,0
,Zoo Med Floating Betta Log 2oz,Zoo Med Floating Betta Log 2oz,FBALYB Amazon,1,1,0,0,0,0
,Zoo Med Floating Betta Log 2oz 2pk,Zoo Med Floating Betta Log 2oz 2pk,Default,-31,-31,0,0,0,0
,Zoo Med Floating Betta Log 2oz 2pk,Zoo Med Floating Betta Log 2oz 2pk,FBALYB Amazon,0,0,0,30,0,0
,Zoo Med Forest Floor Bedding 8qt,Zoo Med Forest Floor Bedding 8qt,FBALYB Amazon,173,173,0,0,0,0
,Zoo Med Frog and Tadpole Food 2oz,Zoo Med Frog and Tadpole Food 2oz,FBALYB Amazon,2,2,0,0,0,0
,Zoo Med Gourmet Reptisticks 8.5oz,Zoo Med Gourmet Reptisticks 8.5oz,FBALYB Amazon,1,1,0,0,0,0
,Zoo Med Gourmet Tortoise Food 13.25oz,Zoo Med Gourmet Tortoise Food 13.25oz,FBALYB Amazon,-52,-52,0,0,0,0
,Zoo Med Grassland Tortoise Food 15oz,Zoo Med Grassland Tortoise Food 15oz,FBALYB Amazon,-1,-1,0,0,0,0
,Zoo Med Grassland Tortoise Food 35oz,Zoo Med Grassland Tortoise Food 35oz,FBALYB Amazon,-3,-3,0,0,0,0
,Zoo Med Habba Hut Extra Large,Zoo Med Habba Hut Extra Large,Default,0,0,0,0,0,26
,Zoo Med Habba Hut Extra Large,Zoo Med Habba Hut Extra Large,Default Ridgefield,1,1,0,0,0,0
,Zoo Med Habba Hut Extra Large,Zoo Med Habba Hut Extra Large,FBALYB Amazon,127,127,0,1,0,0
,Zoo Med Habba Hut Giant,Zoo Med Habba Hut Giant,Default,1,1,0,0,0,0
,Zoo Med Habba Hut Giant,Zoo Med Habba Hut Giant,FBALYB Amazon,-12,-12,0,0,0,0
,Zoo Med Hermit Coconut Brick 600g 3pk,Zoo Med Hermit Coconut Brick 600g 3pk,FBALYB Amazon,-2,-2,0,0,0,0
,Zoo Med Hermit Crab Fruit Salad,Zoo Med Laboratories SZMHC61 Hermit Crab Fruit Salad,Default,0,0,0,0,0,1
,Zoo Med Hermit Crab Fruit Salad,Zoo Med Laboratories SZMHC61 Hermit Crab Fruit Salad,FBALYB Amazon,70,70,0,0,0,0
,Zoo Med Hermit Crab Growth Shell XL,Zoo Med Hermit Crab Growth Shell XL,FBALYB Amazon,-2,-2,0,0,0,0
,Zoo Med Hermit Crab Heater,Zoo Med Hermit Crab Heater,Default,0,0,0,0,0,7
,Zoo Med Hermit Crab Heater,Zoo Med Hermit Crab Heater,FBALYB Amazon,1,1,0,0,0,0
,Zoo Med Hermit Crab Humidity Gauge,Zoo Med Hermit Crab Thermometer and Humidity Gauge,Default,0,0,0,0,0,1
,Zoo Med Hermit Crab Humidity Gauge,Zoo Med Hermit Crab Thermometer and Humidity Gauge,FBALYB Amazon,-8,-8,0,2,0,0
,Zoo Med Hermit Crab Mineral Block,Zoo Med Hermit Crab Mineral Block,FBALYB Amazon,2,2,0,0,0,0
,Zoo Med Hermit Crab Mineral Block 2pk,Zoo Med Hermit Crab Mineral Block 2pk,FBALYB Amazon,-1,-1,0,1,0,0
,Zoo Med Hermit Crab Salt Water Conditioner,Zoo Med Hermit Crab Salt Water Conditioner,FBALYB Amazon,96,96,0,0,0,0
,Zoo Med Hermit Crab Scooper,Zoo Med Hermit Crab Scooper,Default,0,0,0,0,0,23
,Zoo Med Hermit Crab Scooper,Zoo Med Hermit Crab Scooper,FBALYB Amazon,124,124,0,1,0,0
,Zoo Med Hermit Crab Starter Kit,Zoo Med Hermit Crab Starter Kit,FBALYB Amazon,2,2,0,0,0,0
,Zoo Med Hermit Soil Coconut Fiber 2pk,Zoo Med Hermit Soil Coconut Fiber 2pk,FBALYB Amazon,-3,-3,0,2,0,0
,Zoo Med Hermit Soil Coconut Fiber Brick 600g,Zoo Med Hermit Soil Coconut Fiber Brick 600g,Default,0,0,0,0,0,2
,Zoo Med Hermit Soil Coconut Fiber Brick 600g,Zoo Med Hermit Soil Coconut Fiber Brick 600g,FBALYB Amazon,3,3,0,0,0,0
,Zoo Med HydroBalls 2.5lb,Zoo Med HydroBalls 2.5lb,Default,1,1,0,0,0,0
,Zoo Med HydroBalls 2.5lb,Zoo Med HydroBalls 2.5lb,FBALYB Amazon,-3,-3,0,1,0,0
,Zoo Med HygroTherm 2in1,Zoo Med HygroTherm 2in1,FBALYB Amazon,1,1,0,0,0,0
,Zoo Med Laboratories Giant Size,Zoo Med Laboratories Plankton Banquet Block Feeders - Giant Size,Default,0,0,0,0,0,2
,Zoo Med Laboratories Giant Size,Zoo Med Laboratories Plankton Banquet Block Feeders - Giant Size,Default Ridgefield,118,118,0,0,0,0
,Zoo Med Laboratories ‑ Terrarium Moss 10 Gallon,Zoo Med Laboratories ‑ Terrarium Moss 10 Gallon,FBALYB Amazon,19,19,0,0,0,0
,Zoo Med Lizard Ladder,Zoo Med Lizard Ladder,FBALYB Amazon,2,2,0,0,0,0
,Zoo Med Magclip Magnet Suction Cups,Zoo Med Magclip Magnet Suction Cups,FBALYB Amazon,1,1,0,0,0,0
,Zoo Med Mesh Reptile Hammock Small,Zoo Med Mesh Reptile Hammock Small,FBALYB Amazon,1,1,0,0,0,0
,Zoo Med Mini Combo Deep Dome Lamp Fixture,Zoo Med Mini Combo Deep Dome Lamp Fixture,FBALYB Amazon,-4,-4,0,1,0,0
,"Zoo Med Mini Combo Deep Dome Lamp Fixture, Black 2PK","Zoo Med Mini Combo Deep Dome Lamp Fixture, Black 2PK",FBALYB Amazon,19,19,0,0,0,0
,Zoo Med Mini Deep Dome,Zoo Med Mini Deep Dome,Default,0,0,0,0,0,12
,Zoo Med Mini Deep Dome,Zoo Med Mini Deep Dome,FBALYB Amazon,-4,-4,0,0,0,0
,"Zoo Med Mini Lamp Fixture, Black","Zoo Med Mini Combo Deep Dome Lamp Fixture, Black",Default,0,0,0,0,0,36
,"Zoo Med Mini Lamp Fixture, Black","Zoo Med Mini Combo Deep Dome Lamp Fixture, Black",Default Ridgefield,23,23,0,0,0,0
,"Zoo Med Mini Lamp Fixture, Black","Zoo Med Mini Combo Deep Dome Lamp Fixture, Black",FBALYB Amazon,-10,-10,0,0,0,0
,Zoo Med Mini Turtle Dock,Zoo Med Mini Turtle Dock,FBALYB Amazon,-7,-7,0,0,0,0
,Zoo Med Moonlite Reptile Bulb 25W 3pk,Zoo Med Moonlite Reptile Bulb 25W 3pk,FBALYB Amazon,-1,-1,0,0,0,0
,Zoo Med Moonlite Reptile Bulb 40W,Zoo Med Moonlite Reptile Bulb 40W,FBALYB Amazon,-1,-1,0,0,0,0
,Zoo Med Mopani Wood Small,Zoo Med Mopani Wood Small,Default,0,0,0,0,0,72
,Zoo Med Nano Basking Spot Lamp 25W 2pk,Zoo Med Nano Basking Spot Lamp 25W 2pk,FBALYB Amazon,-2,-2,0,0,0,0
,Zoo Med Nano Breeze Screen Cage 10x10x12,Zoo Med Nano Breeze Screen Cage 10x10x12,Default,0,0,0,0,0,1
,Zoo Med Nano Breeze Screen Cage 10x10x12,Zoo Med Nano Breeze Screen Cage 10x10x12,FBALYB Amazon,6,6,0,0,0,0
,Zoo Med Natural Aquatic Turtle Food 24oz,Zoo Med Natural Aquatic Turtle Food 24oz,FBALYB Amazon,-2,-2,0,0,0,0
,Zoo Med Natural Aquatic Turtle Food 30 oz,"Zoo Med Natural Aquatic Turtle Food, Growth Formula, 30 oz",FBALYB Amazon,1,1,0,0,0,0
,"Zoo Med Natural Cork Bark, Round, Medium"," Zoo Med Natural Cork Bark, Round, Medium",Default,3,3,0,0,0,0
,"Zoo Med Natural Cork Bark, Round, Medium"," Zoo Med Natural Cork Bark, Round, Medium",FBALYB Amazon,-4,-5,1,0,1,0
,"Zoo Med Natural Cork Bark Round, Small","Zoo Med Natural Cork Bark Round, Small",Default,3,3,0,0,0,0
,"Zoo Med Natural Cork Bark Round, Small","Zoo Med Natural Cork Bark Round, Small",FBALYB Amazon,-4,-4,0,0,0,0
,Zoo Med Naturalistic Terrarium Waterfall,Zoo Med Naturalistic Terrarium Waterfall,FBALYB Amazon,-2,-2,0,0,0,0
,"Zoo Med Natural Tortoise Food, 60oz","Zoo Med Natural Tortoise Food, 60-Ounce, Grassland",FBALYB Amazon,-2,-2,0,0,0,0
,Zoo Med New Zealand Sphagnum Moss,Zoo Med New Zealand Sphagnum Moss,FBALYB Amazon,3,3,0,0,0,0
,Zoo Med Nightlight Red Reptile Bulb 100W,Zoo Med Nightlight Red Reptile Bulb 100W,Default,0,0,0,0,0,1
,Zoo Med Nightlight Red Reptile Bulb 100W,Zoo Med Nightlight Red Reptile Bulb 100W,FBALYB Amazon,1,1,0,0,0,0
,Zoo Med Nocturnal Infrared Heat Lamp 75 watts,Zoo Med Nocturnal Infrared Heat Lamp 75 watts,Default Ridgefield,4,4,0,0,0,0
,Zoo Med Nocturnal Infrared Heat Lamp 75 watts 4pk,Zoo Med Nocturnal Infrared Heat Lamp 75 watts 4pk,FBALYB Amazon,4,2,2,0,2,0
,Zoo Med Original Banquet Block Giant 2pk,Zoo Med Original Banquet Block Giant 2pk,FBALYB Amazon,-1,-1,0,1,0,0
,Zoo Med Pleco Food Block,Zoo Med Pleco Food Block,Default,0,0,0,0,0,112
,Zoo Med Pleco Food Block 10pk,Zoo Med Pleco Food Block 10pk,FBALYB Amazon,29,29,0,0,0,0
,Zoo Med Pleco Food Block 5pk,Zoo Med Pleco Food Block 5pk,FBALYB Amazon,-2,-2,0,2,0,0
,Zoo Med PowerSun Mercury UVB Lamp 160 Watts,Zoo Med PowerSun Mercury UVB Lamp 160 Watts ,Default Ridgefield,2,2,0,0,0,0
,Zoo Med PowerSun Mercury UVB Lamp 160 Watts,Zoo Med PowerSun Mercury UVB Lamp 160 Watts ,FBALYB Amazon,-1,-1,0,0,0,0
,Zoo Med PowerSun UV-80W (Mercury Vapor),Zoo Med PowerSun UV-80W (Mercury Vapor),FBALYB Amazon,-5,-5,0,0,0,0
,Zoo Med PowerSun UVB Lamp (100 Watts),Zoo Med PowerSun UVB Lamp (100 Watts),FBALYB Amazon,-3,-3,0,0,0,0
,Zoo Med Repti Bark 8qt,Zoo Med Repti Bark 8qt,FBALYB Amazon,2,2,0,0,0,0
,"Zoo Med ReptiBreeze Cage, Medium","Zoo Med ReptiBreeze Open Air Screen Cage, Medium",Default,0,0,0,0,0,4
,"Zoo Med ReptiBreeze Cage, Medium","Zoo Med ReptiBreeze Open Air Screen Cage, Medium",FBALYB Amazon,-11,-11,0,2,0,0
,Zoo Med Reptibreeze Substrate Bottom Tray,Zoo Med Reptibreeze Substrate Bottom Tray,FBALYB Amazon,-3,-3,0,0,0,0
,Zoo Med Reptibreeze Tray 24x24,Zoo Med Reptibreeze Tray 24x24,FBALYB Amazon,-1,-1,0,0,0,0
,Zoo Med Repti Calcium without D3 Ultra Fine 12oz,Zoo Med Repti Calcium without D3 Ultra Fine 12oz,FBALYB Amazon,-1,-1,0,1,0,0
,Zoo Med ReptiCare Terrarium Timer,Zoo Med ReptiCare Terrarium Timer,FBALYB Amazon,-3,-3,0,0,0,0
,Zoo Med Repti-Fresh Substrate 8lb,Zoo Med Repti-Fresh Substrate 8lb,Default,0,0,0,0,0,14
,Zoo Med Repti-Fresh Substrate 8lb,Zoo Med Repti-Fresh Substrate 8lb,FBALYB Amazon,4,4,0,3,0,0
,Zoo Med Repti Heat Cable 11.5ft 15W,Zoo Med Repti Heat Cable 11.5ft 15W,Default,0,0,0,0,0,2
,Zoo Med Repti Heat Cable 11.5ft 15W,Zoo Med Repti Heat Cable 11.5ft 15W,FBALYB Amazon,-2,-2,0,0,0,0
,Zoo Med Repti Heat Cable 14.75ft 25W,Zoo Med Repti Heat Cable 14.75ft 25W,FBALYB Amazon,-4,-4,0,1,0,0
,Zoo Med Repti Lamp Stand 20-100gal,Zoo Med Repti Lamp Stand 20-100gal,Default,2,2,0,0,0,0
,Zoo Med Repti Lamp Stand 20-100gal,Zoo Med Repti Lamp Stand 20-100gal,Default Ridgefield,2,2,0,0,0,0
,Zoo Med Repti Lamp Stand 20-100gal,Zoo Med Repti Lamp Stand 20-100gal,FBALYB Amazon,-4,-4,0,0,0,0
,Zoo Med Reptile Basking Spot Lamp 150W,Zoo Med Reptile Basking Spot Lamp 150W,Default CT,100,100,0,0,0,0
,Zoo Med Reptile Basking Spot Lamp 150W,Zoo Med Reptile Basking Spot Lamp 150W,Default Ridgefield,551,551,0,0,0,0
,Zoo Med Reptile Basking Spot Lamp 150W 3pk,Zoo Med Reptile Basking Spot Lamp 150W 3pk,FBALYB Amazon,9,9,0,0,0,0
,Zoo Med Reptile Basking Spot Lamp 150W 4pk,Zoo Med Reptile Basking Spot Lamp 150W 4pk,FBALYB Amazon,160,160,0,1,0,0
,Zoo Med Reptile Calcium 8oz,"Zoo Med Reptile Calcium with Vitamin D3, 8-Ounce",Default,0,0,0,0,0,35
,Zoo Med Reptile Calcium 8oz,"Zoo Med Reptile Calcium with Vitamin D3, 8-Ounce",FBALYB Amazon,1,1,0,0,0,0
,"Zoo Med Reptile Calcium with Vitamin D3, 12oz","Zoo Med Reptile Calcium with Vitamin D3, 12oz",Default,0,0,0,0,0,18
,"Zoo Med Reptile Calcium with Vitamin D3, 12oz","Zoo Med Reptile Calcium with Vitamin D3, 12oz",FBALYB Amazon,10,10,0,1,0,0
,"Zoo Med Reptile Rock Food Water Dish, Medium","Zoo Med Combo Reptile Rock Food and Water Dish, Medium",FBALYB Amazon,-3,-3,0,0,0,0
,"Zoo Med Reptile Rock Water Dish, X-Large","Zoo Med Reptile Rock Water Dish, X-Large",FBALYB Amazon,-4,-4,0,0,0,0
,Zoo Med Repti Ramp Bowl Large,Zoo Med Repti Ramp Bowl Large,FBALYB Amazon,1,1,0,0,0,0
,Zoo Med Repti Reservoir 22oz,Zoo Med Repti Reservoir 22oz,Default,0,0,0,0,0,13
,Zoo Med Repti Reservoir 22oz 2pk,Zoo Med Repti Reservoir 22oz 2pk,Default Ridgefield,0,-48,48,0,0,0
,Zoo Med Repti Reservoir 22oz 2pk,Zoo Med Repti Reservoir 22oz 2pk,FBALYB Amazon,-1,-1,0,0,0,0
,Zoo Med Repti Rock Corner Water Dish Large,Zoo Med Repti Rock Corner Water Dish Large,FBALYB Amazon,-8,-8,0,0,0,0
,Zoo Med Repti Rock Corner Water Dish X-Large,Zoo Med Repti Rock Corner Water Dish X-Large,FBALYB Amazon,-15,-16,1,0,1,0
,Zoo Med Repti Rock Food Dish Extra Large,Zoo Med Repti Rock Food Dish Extra Large,FBALYB Amazon,-1,-1,0,1,0,0
,Zoo Med Repti Rock Food Dish Large,Zoo Med Repti Rock Food Dish Large,FBALYB Amazon,-1,-1,0,14,0,0
,Zoo Med Repti Rock Food Dish Medium,Zoo Med Repti Rock Food Dish Medium,Default,0,0,0,0,0,8
,Zoo Med Repti Rock Food Dish Medium,Zoo Med Repti Rock Food Dish Medium,FBALYB Amazon,-4,-4,0,0,0,0
,Zoo Med Repti Rock Water Dish Large,Zoo Med Repti Rock Water Dish Large,Default,0,0,0,0,0,25
,Zoo Med Repti Rock Water Dish Large,Zoo Med Repti Rock Water Dish Large,FBALYB Amazon,-9,-9,0,0,0,0
,"Zoo Med ReptiSafe Water Conditioner, 64 oz","Zoo Med ReptiSafe Water Conditioner, 64 oz",FBALYB Amazon,7,7,0,7,0,0
,Zoo Med Repti Sand Desert White 10lb,Zoo Med Repti Sand Desert White 10lb,FBALYB Amazon,-3,-3,0,3,0,0
,Zoo Med Repti Sand Desert White 5lb,Zoo Med Repti Sand Desert White 5lb,Default,0,0,0,0,0,6
,Zoo Med Repti Sand Desert White 5lb,Zoo Med Repti Sand Desert White 5lb,FBALYB Amazon,2,2,0,0,0,0
,Zoo Med Repti Sand Scooper,Zoo Med Repti Sand Scooper,Default,0,0,0,0,0,1
,Zoo Med Repti Sand Scooper,Zoo Med Repti Sand Scooper,FBALYB Amazon,-4,-4,0,0,0,0
,Zoo Med Repti Shelter 3 in 1 Cave Small,Zoo Med Repti Shelter 3 in 1 Cave Small,FBALYB Amazon,-4,-4,0,0,0,0
,Zoomed Reptisoil 10qt,Zoomed Reptisoil 10qt,Default,0,0,0,0,0,3
,Zoomed Reptisoil 10qt,Zoomed Reptisoil 10qt,FBALYB Amazon,11,10,1,0,1,0
,Zoo Med Repti Spot Lamp,Zoo Med Repti Basking Spot Lamp 100watt,Default Ridgefield,3,3,0,0,0,0
,Zoo Med Repti Spot Lamp,Zoo Med Repti Basking Spot Lamp 100watt,FBALYB Amazon,3,1,2,1,2,0
,Zoo Med Repti Spot Lamp 4pk,Zoo Med Repti Spot Lamp 4pk,Default,1,1,0,0,0,0
,Zoo Med Repti Spot Lamp 4pk,Zoo Med Repti Spot Lamp 4pk,FBALYB Amazon,-3,-3,0,0,0,0
,Zoo Med Repti Sticks Turtle 2.2lb,Zoo Med Repti Sticks Floating Aquatic Turtle 2.2lb,FBALYB Amazon,-2,-2,0,0,0,0
,Zoo Med Repti Sticks Turtle Food 1.2lb,Zoo Med Repti Sticks Turtle Food 1.2lb,FBALYB Amazon,-3,-3,0,2,0,0
,Zoo Med ReptiSun 10.0 High UVB 25x36,Zoo Med ReptiSun 10.0 High UVB 25x36,Default Ridgefield,60,60,0,0,0,0
,Zoo Med Reptisun 5.0 Uvb 2pack,Zoo Med Reptisun 5.0 Uvb 2pack,Default,0,-2,2,0,0,0
,Zoo Med Reptisun 5.0 Uvb 2pack,Zoo Med Reptisun 5.0 Uvb 2pack,FBALYB Amazon,-1,-1,0,0,0,0
,Zoo Med ReptiSun 5.0 UVB Mini Compact Fluorescent,Zoo Med ReptiSun 5.0 UVB Mini Compact Fluorescent,Default,0,-202,202,0,0,1
,Zoo Med ReptiSun 5.0 UVB Mini Compact Fluorescent,Zoo Med ReptiSun 5.0 UVB Mini Compact Fluorescent,FBALYB Amazon,-5,-5,0,0,0,0
,"Zoo Med Reptisun Led Uvb Terrarium Hood 24""","Zoo Med Reptisun Led Uvb Terrarium Hood 24""",FBALYB Amazon,-1,-1,0,0,0,0
,Zoo Med ReptiSun T5 HO 10.0 UVB Lamp 24W,Zoo Med ReptiSun T5 HO 10.0 UVB Lamp 24W,Default Ridgefield,60,60,0,0,0,0
,Zoo Med ReptiSun T5 HO Lamp 24x22,Zoo Med ReptiSun T5 HO Lamp 24x22,Default,0,0,0,0,0,8
,Zoo Med ReptiSun T5 HO Lamp 24x22,Zoo Med ReptiSun T5 HO Lamp 24x22,Default Ridgefield,42,42,0,0,0,0
,Zoo Med ReptiSun UVB Bulb 17 x 24,Zoo Med ReptiSun UVB Bulb 17 x 24,Default Ridgefield,100,100,0,0,0,0
,Zoo Med ReptiSun UVB T8 32 x 48,Zoo Med ReptiSun UVB T8 32 x 48,Default Ridgefield,40,40,0,0,0,0
,Zoo Med ReptiSun UVB Tropical 26W,Zoo Med ReptiSun UVB Tropical 26W,Default Ridgefield,30,30,0,0,0,0
,Zoo Med ReptiSun UVB Tropical 26W,Zoo Med ReptiSun UVB Tropical 26W,FBALYB Amazon,-4,-4,0,1,0,0
,Zoo Med ReptiTherm Mini 1-5gal 4x5,Zoo Med ReptiTherm Mini 1-5gal 4x5,Default,0,0,0,0,0,72
,Zoo Med ReptiTherm Mini 1-5gal 4x5,Zoo Med ReptiTherm Mini 1-5gal 4x5,Default Ridgefield,2,2,0,0,0,0
,Zoo Med ReptiTherm Mini 1-5gal 4x5,Zoo Med ReptiTherm Mini 1-5gal 4x5,FBALYB Amazon,-1,-1,0,1,0,0
,Zoo Med ReptiTherm Mini 1-5gal 4x5,Zoo Med ReptiTherm Mini 1-5gal 4x5,WFS,-5,-5,0,0,0,0
,Zoo Med Repti Turtle Eye Drops 2.25oz,Zoo Med Repti Turtle Eye Drops 2.25oz,Default,0,0,0,0,0,6
,Zoo Med Repti Turtle Eye Drops 2.25oz,Zoo Med Repti Turtle Eye Drops 2.25oz,FBALYB Amazon,-1,-1,0,0,0,0
,"Zoo Med Sphagnum Moss, 0.33lb","Zoo Med Laboratories SZMCF25 New Zealand Sphagnum Moss, .33-Pound",FBALYB Amazon,-1,-1,0,0,0,0
,Zoo Med Spirulina 20 Flake Fish 4oz 3pk,Zoo Med Spirulina 20 Flake Fish 4oz 3pk,FBALYB Amazon,24,24,0,0,0,0
,"Zoo Med Spirulina 20 Flake Fish Food, 4oz","Zoo Med Spirulina 20 Flake Fish Food, 4oz",FBALYB Amazon,1,1,0,0,0,0
,Zoo Med Splashproof Lamp 50 Watts,Zoo Med Repti Tuff Splashproof Halogen Lamp 50 Watts,Default CT,16,16,0,0,0,0
,Zoo Med Splashproof Lamp 50 Watts,Zoo Med Repti Tuff Splashproof Halogen Lamp 50 Watts,FBALYB Amazon,193,193,0,0,0,0
,Zoo Med Spot Lamp 100 Watts 2 Bulbs,Zoo Med Reptile Basking Spot Lamp 100 Watts 2 Bulb Value Pack,Default,0,0,0,0,0,115
,Zoo Med Spot Lamp 100 Watts 2 Bulbs,Zoo Med Reptile Basking Spot Lamp 100 Watts 2 Bulb Value Pack,FBALYB Amazon,2,2,0,1,0,0
,Zoo Med Spot Lamp 100 Watts 2 Bulbs 2pk,Zoo Med Spot Lamp 100 Watts 2 Bulbs 2pk,FBALYB Amazon,8,8,0,0,0,0
,Zoo Med Spot Lamp 100 Watts 2 Bulbs 3pk,Zoo Med Spot Lamp 100 Watts 2 Bulbs 3pk,FBALYB Amazon,4,4,0,12,0,0
,Zoo Med Spot Lamp 50 Watts 2 Pack,Zoo Med Reptile Basking Spot Lamp 50 Watts 2 Bulb Value Pack,Default,0,0,0,0,0,51
,Zoo Med Spot Lamp 50 Watts 2 Pack,Zoo Med Reptile Basking Spot Lamp 50 Watts 2 Bulb Value Pack,Default CT,216,216,0,0,0,0
,Zoo Med Spot Lamp 50 Watts 2 Pack,Zoo Med Reptile Basking Spot Lamp 50 Watts 2 Bulb Value Pack,FBALYB Amazon,-1,-1,0,3,0,0
,Zoo Med Spot Lamp 50 Watts 2 Pack 3pk,Zoo Med Spot Lamp 50 Watts 2 Pack 3pk,FBALYB Amazon,0,0,0,2,0,0
,Zoo Med Spot Lamp 75 Watts 2 Bulbs,Zoo Med Reptile Basking Spot Lamp 75 Watts 2 Bulb Value Pack,Default CT,3,3,0,0,0,0
,Zoo Med Spot Lamp 75 Watts 2 Bulbs,Zoo Med Reptile Basking Spot Lamp 75 Watts 2 Bulb Value Pack,Default Ridgefield,43,43,0,0,0,0
,Zoo Med Spot Lamp 75 Watts 2 Bulbs,Zoo Med Reptile Basking Spot Lamp 75 Watts 2 Bulb Value Pack,FBALYB Amazon,-2,-2,0,0,0,0
,Zoo Med Spot Lamp 75 Watts 2 Bulbs 3pk,Zoo Med Spot Lamp 75 Watts 2 Bulbs 3pk,FBALYB Amazon,-5,-5,0,0,0,0
,"Zoo Med Stainless Steel Tongs 10""","Zoo Med Stainless Steel Tongs 10""",Default,0,0,0,0,0,4
,Zoo Med Sun‑Dried Red Shrimp 5oz,"Zoo Med Large Sun‑Dried Red Shrimp Turtle Treats, 5‑oz jar",Default,0,0,0,0,0,10
,Zoo Med Sun‑Dried Red Shrimp 5oz,"Zoo Med Large Sun‑Dried Red Shrimp Turtle Treats, 5‑oz jar",FBALYB Amazon,-3,-3,0,1,0,0
,Zoo Med Sun‑Dried Red Shrimp 5oz 2pk,Zoo Med Sun‑Dried Red Shrimp 5oz 2pk,FBALYB Amazon,-1,-1,0,0,0,0
,Zoo Med Sun Dried Shrimp L 2.5oz 2pk,Zoo Med Sun Dried Shrimp L 2.5oz 2pk,FBALYB Amazon,-6,-6,0,6,0,0
,Zoo Med SZMLT10 Day Night Repti Timer,Zoo Med Laboratories SZMLT10 Repti Day Night Timer,FBALYB Amazon,-1,-1,0,0,0,0
,Zoo Med SZMLT12 Repti Terrarium Controller,Zoo Med Laboratories SZMLT12 Repti Terrarium Controller,FBALYB Amazon,-2,-2,0,0,0,0
,"ZooMed Tank Heater, Small","Zoo Med ReptiTherm Under Tank Heater, Small",Default CT,0,-2,2,0,0,0
,"ZooMed Tank Heater, Small","Zoo Med ReptiTherm Under Tank Heater, Small",FBALYB Amazon,-13,-13,0,0,0,0
,"Zoo Med Terrarium Hood 18""","Zoo Med Terrarium Hood Double Socket 18""",FBALYB Amazon,-6,-6,0,0,0,0
,Zoo Med Terrarium Moss 30-40gal,Zoo Med Terrarium Moss 30-40gal,Default,0,0,0,0,0,1
,Zoo Med Terrarium Moss 30-40gal,Zoo Med Terrarium Moss 30-40gal,FBALYB Amazon,-1,-1,0,1,0,0
,Zoo Med Thermometer/Gauge Glow in the Dark,Zoo Med Thermometer/Gauge Glow in the Dark,Default,0,0,0,0,0,1
,Zoo Med Thermometer/Gauge Glow in the Dark,Zoo Med Thermometer/Gauge Glow in the Dark,FBALYB Amazon,4,4,0,0,0,0
,Zoo Med Tortoise Block 5 oz,Zoo Med SZMBB55 Tortoise Block 5 oz,FBALYB Amazon,56,56,0,0,0,0
,Zoo Med Tropical UVB & Heat Lighting Kit,Zoo Med Tropical UVB & Heat Lighting Kit,FBALYB Amazon,-2,-2,0,0,0,0
,"Zoo Med Turtle Blocks, 2.25oz, 5ct","Zoo Med Turtle Blocks, 2.25oz, 5ct",FBALYB Amazon,71,71,0,0,0,0
,"Zoo Med Turtle Blocks, 2.25oz, 5ct 2pk","Zoo Med Turtle Blocks, 2.25oz, 5ct 2pk",FBALYB Amazon,243,243,0,0,0,0
,Zoo Med Turtle Clean 50 External Canister Filter,Zoo Med Turtle Clean 50 External Canister Filter,FBALYB Amazon,7,7,0,1,0,0
,"Zoo Med Turtle Dock for 10 Gal Tank, Small","Zoo Med Turtle Dock for 10 Gallon Tanks, Small",Default,0,0,0,0,0,3
,"Zoo Med Turtle Dock for 10 Gal Tank, Small","Zoo Med Turtle Dock for 10 Gallon Tanks, Small",FBALYB Amazon,-11,-11,0,0,0,0
,"Zoo Med Turtle Dock for 15 Gal Tank, Medium","Zoo Med Turtle Dock for 15 Gallon Tanks, Medium",Default Ridgefield,2,2,0,0,0,0
,"Zoo Med Turtle Dock for 15 Gal Tank, Medium","Zoo Med Turtle Dock for 15 Gallon Tanks, Medium",FBALYB Amazon,-5,-5,0,3,0,0
,Zoo Med Turtle Food 45oz,Zoo Med Turtle Food 45oz,FBALYB Amazon,-28,-28,0,24,0,0
,Zoo Med Turtle Food - Hatchling Pellets 15oz,Zoo Med Turtle Food - Hatchling Pellets 15oz,FBALYB Amazon,-4,-4,0,3,0,0
,Zoo Med Turtle Lamp Combo Pack,Zoo Med Turtle Lamp Combo Pack,Default Ridgefield,1,1,0,0,0,0
,Zoo Med Turtle Lamp Combo Pack,Zoo Med Turtle Lamp Combo Pack,FBALYB Amazon,-21,-21,0,17,0,0
,Zoo Med Turtle Micro Pellet 8oz,Zoo Med Turtle Micro Pellet 8oz,FBALYB Amazon,-1,-1,0,0,0,0
,Zoo Med Turtle Tuff Splashproof Halogen Lamp 90W,Zoo Med Turtle Tuff Splashproof Halogen Lamp 90W,Default,0,0,0,0,0,1
,Zoo Med Turtle Tuff Splashproof Halogen Lamp 90W,Zoo Med Turtle Tuff Splashproof Halogen Lamp 90W,FBALYB Amazon,-1,-1,0,0,0,0
,Zoo Med Vita-Sand Gobi Gold 10lb,Zoo Med Vita-Sand Gobi Gold 10lb,Default,0,0,0,0,0,30
,Zoo Med Vita-Sand Gobi Gold 10lb,Zoo Med Vita-Sand Gobi Gold 10lb,FBALYB Amazon,17,17,0,18,0,0
,"Zoo Med Water Conditioner, 8.75 oz","Zoo Med ReptiSafe Water Conditioner, 8.75 oz",Default,1,1,0,0,0,0
,"Zoo Med Water Conditioner, 8.75 oz","Zoo Med ReptiSafe Water Conditioner, 8.75 oz",FBALYB Amazon,-4,-4,0,0,0,0
,Zoo Med Wedge Sponge 501 Turtle Filter,Zoo Med Wedge Sponge 501 Turtle Filter,FBALYB Amazon,-1,-1,0,0,0,0
,"Zoo Med Wipe Out Cleaner, 8.75oz","Zoo Med Wipe Out 1 Terrarium Cleaner, 8.75-Ounce",FBALYB Amazon,1,1,0,0,0,0
,Zoom 'N Crawl Monster Toy,Fisher-Price DYM82 Zoom 'N Crawl Monster Toy,Default,0,0,0,0,0,1
,Zoom 'N Crawl Monster Toy,Fisher-Price DYM82 Zoom 'N Crawl Monster Toy,FBALYB Amazon,0,-1,1,3,1,0
,"ZTE Axon 7 Mini 5.2"" Ion Gold","ZTE Axon 7 Mini 5.2"" Unlocked Phone - Ion Gold",FBAAP Amazon,-21,-21,0,0,0,0
,zuke 16oz pbutter/beef/chicken,zuke 16oz pbutter/beef/chicken,FBALYB Amazon,165,165,0,0,0,0
,zuke 6oz 6pk bundle,zuke 6oz 6pk bundle,Default,0,-37,37,0,0,0
,zuke 6oz 6pk bundle,zuke 6oz 6pk bundle,FBALYB Amazon,-42,-43,1,18,1,0
,zuke 6oz duck/chicken/pbutter,zuke 6oz duck/chicken/pbutter,FBALYB Amazon,-28,-28,0,69,0,0
,zuke 6oz pbutter/pork/rabbit,zuke 6oz pbutter/pork/rabbit,FBALYB Amazon,-1,-1,0,0,0,0
,Zuke Hip Action Beef 16oz,Zuke Hip Action Beef 16oz,Default,0,-495,495,0,0,0
,Zuke Hip Action Beef 16oz,Zuke Hip Action Beef 16oz,Default Ridgefield,222,222,0,0,0,0
,Zuke Hip Action Beef 16oz 2pk,Zuke Hip Action Beef 16oz 2pk,FBALYB Amazon,-4,-4,0,4,0,0
,Zuke Hip Action Beef 16oz 3pk,Zuke Hip Action Beef 16oz 3pk,FBALYB Amazon,-1,-1,0,0,0,0
,Zuke Hip Action Beef 16oz 6pk,Zuke Hip Action Beef 16oz 6pk,FBALYB Amazon,0,-1,1,1,1,0
,Zuke Hip Action Beef 6oz 3pk,Zuke Hip Action Beef 6oz 3pk,FBALYB Amazon,-4,-4,0,0,0,0
,Zuke Hip Action Chicken 16oz,Zuke Hip Action Chicken 16oz,Default,0,-304,304,0,0,0
,Zuke Hip Action Chicken 16oz,Zuke Hip Action Chicken 16oz,Default Ridgefield,11,11,0,0,0,0
,Zuke Hip Action Chicken 16oz,Zuke Hip Action Chicken 16oz,FBALYB Amazon,1,0,1,0,1,0
,Zuke Hip Action Chicken 16oz 2pk,Zuke Hip Action Chicken 16oz 2pk,FBALYB Amazon,62,60,2,0,2,0
,Zuke Hip Action Peanut Butter 16oz,Zuke Hip Action Peanut Butter 16oz,Default Ridgefield,5,5,0,0,0,0
,Zuke Hip Action Peanut Butter 16oz,Zuke Hip Action Peanut Butter 16oz,FBALYB Amazon,34,27,7,18,7,0
,Zuke Hip Action Peanut Butter 16oz,Zuke Hip Action Peanut Butter 16oz,FBALYB Canada,0,0,0,45,0,0
,Zuke Hip Action Peanut Butter 16oz 2pk,Zuke Hip Action Peanut Butter 16oz 2pk,FBALYB Amazon,120,120,0,1,0,0
,Zuke Hip Action Peanut Butter 16oz 3pk,Zuke Hip Action Peanut Butter 16oz 3pk,FBALYB Amazon,3,3,0,0,0,0
,Zuke Lil Links Chicken/Apple 6oz,Zuke Lil Links Chicken/Apple 6oz,Default,0,0,0,0,0,1
,Zuke Lil Links Chicken/Apple 6oz,Zuke Lil Links Chicken/Apple 6oz,Default Ridgefield,1,1,0,0,0,0
,Zuke Lil Links Chicken/Apple 6oz 2pk,Zuke Lil Links Chicken/Apple 6oz 2pk,FBALYB Amazon,-1,-1,0,1,0,0
,Zuke Lil Links Chicken/Apple 6oz 3pk,Zuke Lil Links Chicken/Apple 6oz 3pk,FBALYB Amazon,33,32,1,0,1,0
,Zuke Lil Links Pork/Apple 6oz,Zuke Lil Links Pork/Apple 6oz,Default,0,0,0,0,0,83
,Zuke Lil Links Rabbit/Apple 6oz,Zuke Lil Links Rabbit/Apple 6oz,Default,0,-1530,1530,0,0,1
,Zuke Lil Links Rabbit/Apple 6oz 2pk,Zuke Lil Links Rabbit/Apple 6oz 2pk,FBALYB Amazon,-1,-1,0,0,0,0
,Zuke Lil Links Rabbit/Apple 6oz 3pk,Zuke Lil Links Rabbit/Apple 6oz 3pk,FBALYB Amazon,48,48,0,0,0,0
,Zuke Lil Links Rabbit/Apple 6oz 6pk,Zuke Lil Links Rabbit/Apple 6oz 6pk,FBALYB Amazon,23,5,18,2,18,0
,Zuke Mini Natural Lamb/Chickpea 5oz,Zuke Mini Natural Lamb/Chickpea 5oz,Default,0,0,0,0,0,2
,Zuke Mini Natural Lamb/Chickpea 5oz 2pk,Zuke Mini Natural Lamb/Chickpea 5oz 2pk,FBALYB Amazon,0,0,0,50,0,0
,Zuke Mini Naturals 3pk Variety,Zuke Mini Naturals 3pk Variety,FBALYB Amazon,33,28,5,0,5,0
,Zuke Mini Naturals Chicken 16oz,Zuke Mini Naturals Chicken 16oz,Default Ridgefield,42,42,0,0,0,0
,Zuke Mini Naturals Chicken 16oz,Zuke Mini Naturals Chicken 16oz,FBALYB Amazon,12,12,0,0,0,0
,Zuke Mini Naturals Chicken 16oz,Zuke Mini Naturals Chicken 16oz,FBALYB Canada,-1,-1,0,0,0,0
,Zuke Mini Naturals Chicken 16oz 2pk,Zuke Mini Naturals Chicken 16oz 2pk,FBALYB Amazon,44,43,1,0,1,0
,Zuke Mini Naturals Chicken 16oz 3pk,Zuke Mini Naturals Chicken 16oz 3pk,FBALYB Amazon,166,166,0,2,0,0
,Zuke Mini Naturals Chicken 6oz,Zuke Mini Naturals Chicken 6oz,Default Ridgefield,76,76,0,0,0,0
,Zuke Mini Naturals Chicken 6oz 3pk,Zuke Mini Naturals Chicken 6oz 3pk,FBALYB Amazon,44,44,0,4,0,0
,Zuke Mini Naturals Duck 16oz,Zuke Mini Naturals Duck 16oz,Default Ridgefield,216,216,0,0,0,0
,Zuke Mini Naturals Duck 16oz 2pk,Zuke Mini Naturals Duck 16oz 2pk,FBALYB Amazon,76,76,0,13,0,0
,Zuke Mini Naturals Duck 6oz,Zuke Mini Naturals Duck 6oz,Default Ridgefield,69,69,0,0,0,0
,Zuke Mini Naturals PButter 6oz,Zuke Mini Naturals PButter 6oz,Default Ridgefield,61,61,0,0,0,0
,Zuke Mini Naturals PButter 6oz 2pk,Zuke Mini Naturals PButter 6oz 2pk,FBALYB Amazon,-2,-2,0,0,0,0
,Zuke Mini Naturals Peanut Butter 16oz,Zuke Mini Naturals Peanut Butter 16oz,Default,0,-31824,31824,0,0,0
,Zuke Mini Naturals Peanut Butter 16oz,Zuke Mini Naturals Peanut Butter 16oz,Default Ridgefield,53,53,0,0,0,0
,Zuke Mini Naturals Peanut Butter 16oz,Zuke Mini Naturals Peanut Butter 16oz,FBALYB Amazon,-3,-5,2,22,2,0
,Zuke Mini Naturals Peanut Butter 16oz 2pk,Zuke Mini Naturals Peanut Butter 16oz 2pk,FBALYB Amazon,3,3,0,33,0,0
,Zuke Mini Naturals Peanut Butter 16oz 3pk,Zuke Mini Naturals Peanut Butter 16oz 3pk,FBALYB Amazon,-2,-2,0,1,0,0
,Zuke Mini Naturals Pork 16oz,Zuke Mini Naturals Pork 16oz,Default,0,-508,508,0,0,0
,Zuke Mini Naturals Pork 16oz,Zuke Mini Naturals Pork 16oz,Default Ridgefield,338,338,0,0,0,0
,Zuke Mini Naturals Pork 16oz,Zuke Mini Naturals Pork 16oz,FBALYB Canada,0,0,0,50,0,0
,Zuke Mini Naturals Pork 16oz 2pk,Zuke Mini Naturals Pork 16oz 2pk,FBALYB Amazon,50,-4,54,7,54,0
,Zuke Mini Naturals Pork 6oz,Zuke Mini Naturals Pork 6oz,Default Ridgefield,39,39,0,0,0,0
,Zuke Mini Naturals Rabbit 16oz,Zuke Mini Naturals Rabbit 16oz,Default,0,0,0,0,0,3
,Zuke Mini Naturals Rabbit 16oz,Zuke Mini Naturals Rabbit 16oz,Default Ridgefield,55,55,0,0,0,0
,Zuke Mini Naturals Rabbit 16oz 2pk,Zuke Mini Naturals Rabbit 16oz 2pk,FBALYB Amazon,5,5,0,9,0,0
,Zuke Mini Naturals Rabbit 16oz 3pk,Zuke Mini Naturals Rabbit 16oz 3pk,FBALYB Amazon,2,1,1,12,1,0
,Zuke Mini Naturals Rabbit 6oz,Zuke Mini Naturals Rabbit 6oz,Default Ridgefield,72,72,0,0,0,0
,Zuke Mini Naturals Rabbit 6oz 3pk,Zuke Mini Naturals Rabbit 6oz 3pk,FBALYB Amazon,134,134,0,0,0,0
,Zuke Mini Naturals Salmon 16oz,Zuke Mini Naturals Salmon 16oz,Default Ridgefield,267,211,56,0,0,0
,Zuke Mini Naturals Salmon 16oz,Zuke Mini Naturals Salmon 16oz,FBALYB Amazon,3,1,2,0,2,0
,Zuke Mini Naturals Salmon 16oz 2pk,Zuke Mini Naturals Salmon 16oz 2pk,Default,0,-7,7,0,0,0
,Zuke Mini Naturals Salmon 16oz 2pk,Zuke Mini Naturals Salmon 16oz 2pk,Default Ridgefield,38,28,10,0,0,0
,Zuke Mini Naturals Salmon 16oz 2pk,Zuke Mini Naturals Salmon 16oz 2pk,FBALYB Amazon,5,4,1,74,1,0
,Zuke Mini Naturals Salmon 16oz 3pk,Zuke Mini Naturals Salmon 16oz 3pk,FBALYB Amazon,4,4,0,0,0,0
,Zuke Mini Naturals Salmon 6oz,Zuke Mini Naturals Salmon 6oz,Default Ridgefield,79,79,0,0,0,0
,Zuke PB & Oats 6oz 12pk,Zuke PB & Oats 6oz 12pk,FBALYB Amazon,1,1,0,0,0,0
,Zuke Puppy Naturals Pork/Chickpea 5oz 2pk,Zuke Puppy Naturals Pork/Chickpea 5oz 2pk,FBALYB Amazon,-124,-124,0,0,0,0
,Zukes Crunchy Peanut Butter Banana Treat 12oz,Zukes Crunchy Peanut Butter Banana Treat 12oz,Default,0,-28,28,0,0,0
,Zukes Crunchy Peanut Butter Banana Treat 12oz 2pk,Zukes Crunchy Peanut Butter Banana Treat 12oz 2pk,FBALYB Amazon,2,2,0,7,0,0
,Zukes Crunchy Pumpkin Sweet Potato Treat 12oz,Zukes Crunchy Pumpkin Sweet Potato Treat 12oz,Default Ridgefield,23,23,0,0,0,0
,Zukes Crunchy Pumpkin Sweet Potato Treat 12oz 2pk,Zukes Crunchy Pumpkin Sweet Potato Treat 12oz 2pk,FBALYB Amazon,26,26,0,0,0,0
,Zukes Naturals Crunchy Baked Berries 12 oz,Zukes Naturals Crunchy Baked Berries 12 oz ,FBALYB Amazon,47,47,0,0,0,0
,Zukes PB/Duck/Rabbit 6 oz 3 pk,Zukes PB/Duck/Rabbit 6 oz 3 pk,FBALYB Amazon,20,20,0,0,0,0
,Zuke's Salmon Mini Naturals 6oz 2pk,Zuke's Salmon Mini Naturals 6oz 2pk,FBALYB Amazon,-2,-2,0,0,0,0
,Zuke's Super Betas Yummy Blend 6oz,Zuke's Super Betas Yummy Blend 6oz,Default,0,0,0,0,0,2
,Zuke's Super Betas Yummy Blend 6oz 2pk,Zuke's Super Betas Yummy Blend 6oz 2pk,FBALYB Amazon,1,1,0,0,0,0
,Zuke Superfood Great Greens 6oz,Zuke Superfood Great Greens 6oz,Default,0,0,0,0,0,124
,Zuke Superfood Great Greens 6oz 2pk,Zuke Superfood Great Greens 6oz 2pk,Default,-49,-49,0,0,0,0
,Zuke Superfood Great Greens 6oz 2pk,Zuke Superfood Great Greens 6oz 2pk,FBALYB Amazon,2,2,0,0,0,0
,Zukes Variety Z Bone Apple + Carrot,Zukes Variety Z Bone Apple + Carrot,FBALYB Amazon,-2,-2,0,0,0,0
,Zuke's Z-Bone Apple 12oz 2pk,Zuke's Z-Bone Apple 12oz 2pk,Default,0,-93,93,0,0,0
,Zuke's Z-Bone Apple 12oz 2pk,Zuke's Z-Bone Apple 12oz 2pk,FBALYB Amazon,-12,-12,0,11,0,0
,Zukes Z Bone Carrot 2pk 12oz,Zukes Z Bone Carrot 2pk 12oz,FBALYB Amazon,-15,-15,0,33,0,0
,Zukes Z Bone Mini Apple 8.25oz,Zukes Z Bone Mini Apple 8.25oz,Default Ridgefield,198,198,0,0,0,0
,Zukes Z Bone Mini Apple 8.25oz,Zukes Z Bone Mini Apple 8.25oz,FBALYB Amazon,257,257,0,0,0,0
,Zuke Z-bone Apple 12oz,Zuke Z-bone Apple 12oz,Default,0,-1398,1398,0,0,4
,Zuke Z-bone Apple 12oz,Zuke Z-bone Apple 12oz,Default Ridgefield,234,234,0,0,0,0
,ZUKE Z BONE APPLE DOG TREAT 12Z 4pk,ZUKE Z BONE APPLE DOG TREAT 12Z 4pk,FBALYB Amazon,-14,-14,0,18,0,0
,Zuke Z-bone Carrot 8.25oz,Zuke Z-bone Carrot 8.25oz,FBALYB Amazon,149,144,5,3,5,0
,Zuke Z-bone Carrot 8.25oz 2pk,Zuke Z-bone Carrot 8.25oz 2pk,FBALYB Amazon,10,10,0,0,0,0
,Zuke Z Bone Carrot Regular 12oz,Zuke Z Bone Carrot Regular 12oz,Default Ridgefield,131,131,0,0,0,0
,Zuke Z Bone Carrot Regular 12oz,Zuke Z Bone Carrot Regular 12oz,FBALYB Amazon,0,-1,1,0,1,0
,Zuke Z Bone Large Apple 15oz 2pk,Zuke Z Bone Large Apple 15oz 2pk,Default,0,-146,146,0,0,0
,Zuke Z Bone Large Apple 15oz 2pk,Zuke Z Bone Large Apple 15oz 2pk,FBALYB Amazon,49,49,0,0,0,0
,Zuke Z Bone Mini Apple/Carrot Variety 8.25 oz 2pk,Zuke Z Bone Mini Apple/Carrot Variety 8.25 oz 2pk,FBALYB Amazon,-1,-1,0,0,0,0
,Zuke Z-Bone Mini w/ Apples 36ct 2pk,Zuke Z-Bone Mini w/ Apples 36ct 2pk,FBALYB Amazon,-2,-2,0,10,0,0
,Zuke Z-Bones Apple Crisp L 2.5oz 6ct 4pk,Zuke Z-Bones Apple Crisp L 2.5oz 6ct 4pk,FBALYB Amazon,1,1,0,0,0,0
,Zuke Z-Bones Apple Crisp Large 2.5oz 6ct,Zuke Z-Bones Apple Crisp Large 2.5oz 6ct,Default,0,-408,408,0,0,0
,Zuke Z-Bones Apple Crisp Large 2.5oz 6ct,Zuke Z-Bones Apple Crisp Large 2.5oz 6ct,Default Ridgefield,128,128,0,0,0,0
,Zuke Z-Bones Carrot Crisp Large 6ct,Zuke Z-Bones Carrot Crisp Large 6ct,FBALYB Amazon,-1,-1,0,0,0,0
,Zuke Z-Bones Carrot Crisp Large 6ct 2pk,Zuke Z-Bones Carrot Crisp Large 6ct 2pk,FBALYB Amazon,-1,-2,1,2,1,0
,Zupreem Embrace Baby Bird 5lb,Zupreem Embrace Baby Bird 5lb,FBALYB Amazon,1,1,0,0,0,0
,Zupreem Ferret Food 8 lbs,Zupreem Premium Ferret Diet Food: 8 lbs,Default,0,0,0,0,0,60
,Zupreem Ferret Food 8 lbs,Zupreem Premium Ferret Diet Food: 8 lbs,FBALYB Amazon,9,9,0,9,0,0
,ZuPreem FruitBlend,"ZuPreem FruitBlend - Large Birds, Size 12 lb",Default,0,0,0,0,0,146
,ZuPreem FruitBlend,"ZuPreem FruitBlend - Large Birds, Size 12 lb",FBALYB Amazon,0,-1,1,40,1,0
,ZuPreem FruitBlend 12LB Conures Parrots,ZuPreem FruitBlend 12LB Conures Parrots,FBALYB Amazon,-74,-74,0,54,0,0
,Zupreem Fruit Blend Canary Finch XS 2LB,Zupreem Fruit Blend Canary Finch XS 2LB,FBALYB Amazon,42,42,0,14,0,0
,ZuPreem Fruitblend Flavor Small 10lb,ZuPreem Fruitblend Flavor Small 10lb,FBALYB Amazon,-1,-1,0,1,0,0
,ZuPreem Fruitblend Flavor Small 2lb,ZuPreem Fruitblend Flavor Small 2lb,Default,0,0,0,0,0,29
,ZuPreem Fruitblend Flavor Small 2lb,ZuPreem Fruitblend Flavor Small 2lb,FBALYB Amazon,2,1,1,2,1,0
,ZuPreem Fruitblend Flavor Small 2lb 2pk,ZuPreem Fruitblend Flavor Small 2lb 2pk,FBALYB Amazon,-9,-9,0,8,0,0
,Zupreem Large Bird 3.5lb,Zupreem Large Bird 3.5lb,FBALYB Amazon,-5,-5,0,11,0,0
,Zupreem Large Bird 3.5lb 2pk,Zupreem Large Bird 3.5lb 2pk,FBALYB Amazon,-52,-52,0,0,0,0
,Zupreem Medium Bird 2lb,Zupreem Medium Bird 2lb,Default,0,0,0,0,0,2
,Zupreem Medium Bird 2lb,Zupreem Medium Bird 2lb,FBALYB Amazon,976,976,0,24,0,0
,Zupreem Medium Bird 2lb 2pk,Zupreem Medium Bird 2lb 2pk,FBALYB Amazon,-2,-2,0,0,0,0
,Zupreem Natural Large Birds 3lb,Zupreem Natural Large Birds 3lb,Default,0,0,0,0,0,2
,Zupreem Natural Large Birds 3lb,Zupreem Natural Large Birds 3lb,FBALYB Amazon,8,8,0,1,0,0
,Zupreem Natural Large Birds 3lb 2pk,Zupreem Natural Large Birds 3lb 2pk,FBALYB Amazon,-1,-1,0,0,0,0
,Zupreem Natural Medium Bird 2.5lb,Zupreem Natural Medium Bird 2.5lb,Default,0,0,0,0,0,36
,Zupreem Natural Medium Bird 2.5lb,Zupreem Natural Medium Bird 2.5lb,FBALYB Amazon,2,2,0,0,0,0
,ZuPreem Natural Parrot Bird Food 3lb,ZuPreem Natural Parrot Bird Food 3lb,Default,0,0,0,0,0,3
,ZuPreem Natural Parrot Bird Food 3lb,ZuPreem Natural Parrot Bird Food 3lb,FBALYB Amazon,6,6,0,2,0,0
,Zupreem Natural Small Bird 2.25lb,Zupreem Natural Small Bird 2.25lb,FBALYB Amazon,1,1,0,0,0,0
,"ZUPREEM Premium Ferret Diet Food, 4 LB","ZUPREEM Premium Ferret Diet Food, 4 LB",FBALYB Amazon,50,50,0,1,0,0
,ZuPreem Pure Fun Large Bird 2lb 2pk,ZuPreem Pure Fun Large Bird 2lb 2pk,FBALYB Amazon,1,1,0,0,0,0
,ZuPreem Pure Fun Medium Bird 2lb 2pk,ZuPreem Pure Fun Medium Bird 2lb 2pk,FBALYB Amazon,2,2,0,0,0,0
,Zupreem Pure Fun Parrots 2lb,Zupreem Pure Fun Parrots 2lb,Default,0,-96,96,0,0,0
,Zupreem Pure Fun Parrots 2lb,Zupreem Pure Fun Parrots 2lb,FBALYB Amazon,2,2,0,0,0,0
,ZUPREEM SENSIBLE SEED BIRD SMALL 2LB,ZUPREEM SENSIBLE SEED BIRD SMALL 2LB,Default,0,0,0,0,0,60
,Zupreem Sensible Seed Parrots 2lb,Zupreem Sensible Seed Parrots 2lb,Default,0,-260,260,0,0,0
,Zupreem Sensible Seed Parrots 2lb,Zupreem Sensible Seed Parrots 2lb,FBALYB Amazon,3,3,0,0,0,0
,Zupreem Sensible Seed Parrots 2lb 2pk,Zupreem Sensible Seed Parrots 2lb 2pk,FBALYB Amazon,-3,-4,1,6,1,0
,"ZuPreem Smart Selects for Canary/Finch, 2 lb","ZuPreem Smart Selects for Canary/Finch, 2 lb",FBALYB Amazon,-1,-1,0,0,0,0
,Zupreem Smart Selects Keet 2LB,Zupreem Smart Selects Keet 2LB,Default,0,0,0,0,0,12
,Zupreem Smart Selects - Macaws 4LB,Zupreem Smart Selects - Macaws 4LB,FBALYB Amazon,1,1,0,0,0,0
,ZuPreem Smart Selects Parrot 4lb,ZuPreem Smart Selects Parrot 4lb,Default,0,0,0,0,0,4
,ZuPreem Smart Selects Parrot 4lb,ZuPreem Smart Selects Parrot 4lb,FBALYB Amazon,16,16,0,1,0,0
,ZuPreem Smart Selects Parrot 4lb 2pk,ZuPreem Smart Selects Parrot 4lb 2pk,FBALYB Amazon,-1,-1,0,0,0,0
,Zupreem Smart Selects Tiel/LoveBird 2.5Lbs,Zupreem Smart Selects Tiel/LoveBird 2.5Lbs,Default Ridgefield,10,10,0,0,0,0
,Zupreem Smart Selects Tiel/LoveBird 2.5Lbs,Zupreem Smart Selects Tiel/LoveBird 2.5Lbs,FBALYB Amazon,-969,-970,1,0,1,0
,ZuPreem VeggieBlend Parrot 3.25lb,ZuPreem VeggieBlend Parrot 3.25lb,FBALYB Amazon,2,2,0,1,0,0
,ZuPreem VeggieBlend Parrot 3.25lb 2pk,ZuPreem VeggieBlend Parrot 3.25lb 2pk,FBALYB Amazon,1,1,0,0,0,0
,Zupr Fruit Blend XS Bird,Zupreem Fruit Blend Extra Small Bird Food 10lb,Default,0,0,0,0,0,10
,Zupr Fruit Blend XS Bird,Zupreem Fruit Blend Extra Small Bird Food 10lb,FBALYB Amazon,0,0,0,7,0,0
,Zupr M/L Fruit Blend Diet,Medium-Large Fruit Blend Diet 3.5 lb,Default,0,0,0,0,0,26
,Zupr M/L Fruit Blend Diet,Medium-Large Fruit Blend Diet 3.5 lb,FBALYB Amazon,-15,-15,0,13,0,0
,Zupr M/L Fruit Blend Diet 2pk,Zupr M/L Fruit Blend Diet 2pk,FBALYB Amazon,-3,-3,0,1,0,0
,Zupr Nutblend Diet Bird Food,ZuPreem Nutblend Diet Bird Food,Default,0,0,0,0,0,29
,Zupr Nutblend Diet Bird Food,ZuPreem Nutblend Diet Bird Food,FBALYB Amazon,10,10,0,16,0,0
,Zweisel Pure Burgundy Pinot Noir Wine Glasses set of 6,,FBALYB Amazon,7,7,0,0,0,0
,Zwiesel Pure Cabernet Wine Glass set of 6,,FBALYB Amazon,37,37,0,0,0,0
,Zwiesel Pure Crystal Martini Glasses set of 6,,FBALYB Amazon,3,3,0,2,0,0
,Zymox Water Additive 8 oz.,Zymox Water Additive 8 oz.,FBALYB Amazon,-1,-1,0,0,0,0
,Zymox Water Additive 8 oz. 2pk,Zymox Water Additive 8 oz. 2pk,Default,-5,-5,0,0,0,0
,Zymox Water Additive 8 oz. 2pk,Zymox Water Additive 8 oz. 2pk,FBALYB Amazon,1,1,0,0,0,0
,"Zyrtec Liquid Gels, 65 Liquid Gels","Zyrtec Liquid Gels, 65 Liquid Gels",FBALYB Amazon,155,155,0,0,0,0
Alba Botanica,Alba Botanica Emlnt Dry Ltion,Alba Botanica Very Emollient Dry Lotion 32oz,Default Ridgefield,1,1,0,0,0,0
Alba Botanica,Alba Botanica Emlnt Dry Ltion,Alba Botanica Very Emollient Dry Lotion 32oz,FBALYB Amazon,55,40,15,62,15,0
Alba Botanica,Alba Botanica Emlnt Ltion Orig,Alba Botanica Very Emollient Body Lotion Original 32oz,Default CT,0,-1,1,0,0,0
Alba Botanica,Alba Botanica Emlnt Ltion Orig,Alba Botanica Very Emollient Body Lotion Original 32oz,Default Ridgefield,4,4,0,0,0,0
Altra,Altra AL0A4VQE224 Size 10,Altra Men LONE PEAK 5 AL0A4VQE224 Light Gray US Size 10,Default Ridgefield,0,0,0,0,0,96
Altra,Altra AL0A4VQE224 Size 10.5,Altra Men LONE PEAK 5 AL0A4VQE224 Light Gray US Size 10.5,Default Ridgefield,0,0,0,0,0,144
Altra,Altra AL0A4VQE224 Size 11,Altra Men LONE PEAK 5 AL0A4VQE224 Light Gray US Size 11,Default Ridgefield,0,0,0,0,0,144
Altra,Altra AL0A4VQE224 Size 11.5,Altra Men LONE PEAK 5 AL0A4VQE224 Light Gray US Size 11.5,Default Ridgefield,0,0,0,0,0,96
Altra,Altra AL0A4VQE224 Size 12,Altra Men LONE PEAK 5 AL0A4VQE224 Light Gray US Size 12,Default Ridgefield,0,0,0,0,0,120
Altra,Altra AL0A4VQE224 Size 12.5,Altra Men LONE PEAK 5 AL0A4VQE224 Light Gray US Size 12.5,Default Ridgefield,0,0,0,0,0,48
Altra,Altra AL0A4VQE224 Size 9,Altra Men LONE PEAK 5 AL0A4VQE224 Light Gray US Size 9,Default Ridgefield,0,0,0,0,0,48
Altra,Altra AL0A4VQE224 Size 9.5,Altra Men LONE PEAK 5 AL0A4VQE224 Light Gray US Size 9.5,Default Ridgefield,0,0,0,0,0,72
Altra,Altra AL0A4VQE408 Size 10,Altra Men LONE PEAK 5 AL0A4VQE408 Majolica Blue US Size 10,Default Ridgefield,0,0,0,0,0,156
Altra,Altra AL0A4VQE408 Size 10.5,Altra Men LONE PEAK 5 AL0A4VQE408 Majolica Blue US Size 10.5,Default Ridgefield,0,0,0,0,0,228
Altra,Altra AL0A4VQE408 Size 11,Altra Men LONE PEAK 5 AL0A4VQE408 Majolica Blue US Size 11,Default Ridgefield,0,0,0,0,0,228
Altra,Altra AL0A4VQE408 Size 11.5,Altra Men LONE PEAK 5 AL0A4VQE408 Majolica Blue US Size 11.5,Default Ridgefield,0,0,0,0,0,156
Altra,Altra AL0A4VQE408 Size 12,Altra Men LONE PEAK 5 AL0A4VQE408 Majolica Blue US Size 12,Default Ridgefield,0,0,0,0,0,192
Altra,Altra AL0A4VQE408 Size 12.5,Altra Men LONE PEAK 5 AL0A4VQE408 Majolica Blue US Size 12.5,Default Ridgefield,0,0,0,0,0,72
Altra,Altra AL0A4VQE408 Size 9,Altra Men LONE PEAK 5 AL0A4VQE408 Majolica Blue US Size 9,Default Ridgefield,0,0,0,0,0,72
Altra,Altra AL0A4VQE408 Size 9.5,Altra Men LONE PEAK 5 AL0A4VQE408 Majolica Blue US Size 9.5,Default Ridgefield,0,0,0,0,0,120
Altra,Altra AL0A4VR7019 Size 10,Altra Women LONE PEAK 5 AL0A4VR7019 Rose/Coral US Size 10,Default Ridgefield,0,0,0,0,0,48
Altra,Altra AL0A4VR7019 Size 6.5,Altra Women LONE PEAK 5 AL0A4VR7019 Rose/Coral US Size 6.5,Default Ridgefield,0,0,0,0,0,24
Altra,Altra AL0A4VR7019 Size 7,Altra Women LONE PEAK 5 AL0A4VR7019 Rose/Coral US Size 7,Default Ridgefield,0,0,0,0,0,36
Altra,Altra AL0A4VR7019 Size 7.5,Altra Women LONE PEAK 5 AL0A4VR7019 Rose/Coral US Size 7.5,Default Ridgefield,0,0,0,0,0,48
Altra,Altra AL0A4VR7019 Size 8,Altra Women LONE PEAK 5 AL0A4VR7019 Rose/Coral US Size 8,Default Ridgefield,0,0,0,0,0,72
Altra,Altra AL0A4VR7019 Size 8.5,Altra Women LONE PEAK 5 AL0A4VR7019 Rose/Coral US Size 8.5,Default Ridgefield,0,0,0,0,0,72
Altra,Altra AL0A4VR7019 Size 9,Altra Women LONE PEAK 5 AL0A4VR7019 Rose/Coral US Size 9,Default Ridgefield,0,0,0,0,0,60
Altra,Altra AL0A4VR7019 Size 9.5,Altra Women LONE PEAK 5 AL0A4VR7019 Rose/Coral US Size 9.5,Default Ridgefield,0,0,0,0,0,24
Altra,Altra AL0A4VR7408 Size 10,Altra Women LONE PEAK 5 AL0A4VR7408 Majolica Blue US Size 10,Default Ridgefield,0,0,0,0,0,48
Altra,Altra AL0A4VR7408 Size 6.5,Altra Women LONE PEAK 5 AL0A4VR7408 Majolica Blue US Size 6.5,Default Ridgefield,0,0,0,0,0,24
Altra,Altra AL0A4VR7408 Size 7,Altra Women LONE PEAK 5 AL0A4VR7408 Majolica Blue US Size 7,Default Ridgefield,0,0,0,0,0,36
Altra,Altra AL0A4VR7408 Size 7.5,Altra Women LONE PEAK 5 AL0A4VR7408 Majolica Blue US Size 7.5,Default Ridgefield,0,0,0,0,0,48
Altra,Altra AL0A4VR7408 Size 8,Altra Women LONE PEAK 5 AL0A4VR7408 Majolica Blue US Size 8,Default Ridgefield,0,0,0,0,0,72
Altra,Altra AL0A4VR7408 Size 8.5,Altra Women LONE PEAK 5 AL0A4VR7408 Majolica Blue US Size 8.5,Default Ridgefield,0,0,0,0,0,72
Altra,Altra AL0A4VR7408 Size 9,Altra Women LONE PEAK 5 AL0A4VR7408 Majolica Blue US Size 9,Default Ridgefield,0,0,0,0,0,60
Altra,Altra AL0A4VR7408 Size 9.5,Altra Women LONE PEAK 5 AL0A4VR7408 Majolica Blue US Size 9.5,Default Ridgefield,0,0,0,0,0,24
Altra,Altra AL0A4VRB442 Size 10,Altra Women TIMP 3 AL0A4VRB442 DARK BLUE US Size 10,Default Ridgefield,0,0,0,0,0,48
Altra,Altra AL0A4VRB442 Size 7,Altra Women TIMP 3 AL0A4VRB442 DARK BLUE US Size 7,Default Ridgefield,0,0,0,0,0,36
Altra,Altra AL0A4VRB442 Size 7.5,Altra Women TIMP 3 AL0A4VRB442 DARK BLUE US Size 7.5,Default Ridgefield,0,0,0,0,0,48
Altra,Altra AL0A4VRB442 Size 8,Altra Women TIMP 3 AL0A4VRB442 DARK BLUE US Size 8,Default Ridgefield,0,0,0,0,0,72
Altra,Altra AL0A4VRB442 Size 8.5,Altra Women TIMP 3 AL0A4VRB442 DARK BLUE US Size 8.5,Default Ridgefield,0,0,0,0,0,96
Altra,Altra AL0A4VRB442 Size 9,Altra Women TIMP 3 AL0A4VRB442 DARK BLUE US Size 9,Default Ridgefield,0,0,0,0,0,60
Altra,Altra AL0A4VRB442 Size 9.5,Altra Women TIMP 3 AL0A4VRB442 DARK BLUE US Size 9.5,Default Ridgefield,0,0,0,0,0,24
Altra,Altra AL0A546Z020 Size 10,Altra Men Superior 5 AL0A546Z020 Black/Gray US Size 10,Default Ridgefield,0,0,0,0,0,84
Altra,Altra AL0A546Z020 Size 10.5,Altra Men Superior 5 AL0A546Z020 Black/Gray US Size 10.5,Default Ridgefield,0,0,0,0,0,120
Altra,Altra AL0A546Z020 Size 11,Altra Men Superior 5 AL0A546Z020 Black/Gray US Size 11,Default Ridgefield,0,0,0,0,0,120
Altra,Altra AL0A546Z020 Size 11.5,Altra Men Superior 5 AL0A546Z020 Black/Gray US Size 11.5,Default Ridgefield,0,0,0,0,0,84
Altra,Altra AL0A546Z020 Size 12,Altra Men Superior 5 AL0A546Z020 Black/Gray US Size 12,Default Ridgefield,0,0,0,0,0,96
Altra,Altra AL0A546Z020 Size 12.5,Altra Men Superior 5 AL0A546Z020 Black/Gray US Size 12.5,Default Ridgefield,0,0,0,0,0,36
Altra,Altra AL0A546Z020 Size 9,Altra Men Superior 5 AL0A546Z020 Black/Gray US Size 9,Default Ridgefield,0,0,0,0,0,36
Altra,Altra AL0A546Z020 Size 9.5,Altra Men Superior 5 AL0A546Z020 Black/Gray US Size 9.5,Default Ridgefield,0,0,0,0,0,60
Altra,Altra AL0A546Z061 Size 10,Altra Men Superior 5 AL0A546Z061 Black/Red US Size 10,Default Ridgefield,0,0,0,0,0,24
Altra,Altra AL0A546Z061 Size 10.5,Altra Men Superior 5 AL0A546Z061 Black/Red US Size 10.5,Default Ridgefield,0,0,0,0,0,36
Altra,Altra AL0A546Z061 Size 11,Altra Men Superior 5 AL0A546Z061 Black/Red US Size 11,Default Ridgefield,0,0,0,0,0,36
Altra,Altra AL0A546Z061 Size 11.5,Altra Men Superior 5 AL0A546Z061 Black/Red US Size 11.5,Default Ridgefield,0,0,0,0,0,24
Altra,Altra AL0A546Z061 Size 12,Altra Men Superior 5 AL0A546Z061 Black/Red US Size 12,Default Ridgefield,0,0,0,0,0,24
Altra,Altra AL0A546Z061 Size 12.5,Altra Men Superior 5 AL0A546Z061 Black/Red US Size 12.5,Default Ridgefield,0,0,0,0,0,12
Altra,Altra AL0A546Z061 Size 9,Altra Men Superior 5 AL0A546Z061 Black/Red US Size 9,Default Ridgefield,0,0,0,0,0,12
Altra,Altra AL0A546Z061 Size 9.5,Altra Men Superior 5 AL0A546Z061 Black/Red US Size 9.5,Default Ridgefield,0,0,0,0,0,12
Altra,Altra AL0A546Z480 Size 10,Altra Men Superior 5 AL0A546Z480 Blue/Orange US Size 10,Default Ridgefield,0,0,0,0,0,24
Altra,Altra AL0A546Z480 Size 10.5,Altra Men Superior 5 AL0A546Z480 Blue/Orange US Size 10.5,Default Ridgefield,0,0,0,0,0,24
Altra,Altra AL0A546Z480 Size 11,Altra Men Superior 5 AL0A546Z480 Blue/Orange US Size 11,Default Ridgefield,0,0,0,0,0,24
Altra,Altra AL0A546Z480 Size 11.5,Altra Men Superior 5 AL0A546Z480 Blue/Orange US Size 11.5,Default Ridgefield,0,0,0,0,0,24
Altra,Altra AL0A546Z480 Size 12,Altra Men Superior 5 AL0A546Z480 Blue/Orange US Size 12,Default Ridgefield,0,0,0,0,0,24
Altra,Altra AL0A546Z480 Size 12.5,Altra Men Superior 5 AL0A546Z480 Blue/Orange US Size 12.5,Default Ridgefield,0,0,0,0,0,12
Altra,Altra AL0A546Z480 Size 9,Altra Men Superior 5 AL0A546Z480 Blue/Orange US Size 9,Default Ridgefield,0,0,0,0,0,12
Altra,Altra AL0A546Z480 Size 9.5,Altra Men Superior 5 AL0A546Z480 Blue/Orange US Size 9.5,Default Ridgefield,0,0,0,0,0,12
Altra,Altra AL0A546Z800 Size 10,Altra Men Superior 5 AL0A546Z800 Orange/Black US Size 10,Default Ridgefield,0,0,0,0,0,24
Altra,Altra AL0A546Z800 Size 10.5,Altra Men Superior 5 AL0A546Z800 Orange/Black US Size 10.5,Default Ridgefield,0,0,0,0,0,24
Altra,Altra AL0A546Z800 Size 11,Altra Men Superior 5 AL0A546Z800 Orange/Black US Size 11,Default Ridgefield,0,0,0,0,0,24
Altra,Altra AL0A546Z800 Size 11.5,Altra Men Superior 5 AL0A546Z800 Orange/Black US Size 11.5,Default Ridgefield,0,0,0,0,0,24
Altra,Altra AL0A546Z800 Size 12.5,Altra Men Superior 5 AL0A546Z800 Orange/Black US Size 12,Default Ridgefield,0,0,0,0,0,36
Altra,Altra AL0A546Z800 Size 9,Altra Men Superior 5 AL0A546Z800 Orange/Black US Size 9,Default Ridgefield,0,0,0,0,0,12
Altra,Altra AL0A546Z800 Size 9.5,Altra Men Superior 5 AL0A546Z800 Orange/Black US Size 9.5,Default Ridgefield,0,0,0,0,0,12
Altra,Altra AL0A547F000 Size 10,Altra Men Torin 5 AL0A547F000 Black US Size 10,Default Ridgefield,0,0,0,0,0,60
Altra,Altra AL0A547F000 Size 10.5,Altra Men Torin 5 AL0A547F000 Black US Size 10.5,Default Ridgefield,0,0,0,0,0,84
Altra,Altra AL0A547F000 Size 11,Altra Men Torin 5 AL0A547F000 Black US Size 11,Default Ridgefield,0,0,0,0,0,84
Altra,Altra AL0A547F000 Size 11.5,Altra Men Torin 5 AL0A547F000 Black US Size 11.5,Default Ridgefield,0,0,0,0,0,60
Altra,Altra AL0A547F000 Size 12,Altra Men Torin 5 AL0A547F000 Black US Size 12,Default Ridgefield,0,0,0,0,0,72
Altra,Altra AL0A547F000 Size 12.5,Altra Men Torin 5 AL0A547F000 Black US Size 12.5,Default Ridgefield,0,0,0,0,0,24
Altra,Altra AL0A547F000 Size 9,Altra Men Torin 5 AL0A547F000 Black US Size 9,Default Ridgefield,0,0,0,0,0,24
Altra,Altra AL0A547F000 Size 9.5,Altra Men Torin 5 AL0A547F000 Black US Size 9.5,Default Ridgefield,0,0,0,0,0,48
Altra,Altra AL0A547F232 Size 10,Altra Men Torin 5 AL0A547F232 Gray/Lime US Size 10,Default Ridgefield,0,0,0,0,0,48
Altra,Altra AL0A547F232 Size 10.5,Altra Men Torin 5 AL0A547F232 Gray/Lime US Size 10.5,Default Ridgefield,0,0,0,0,0,72
Altra,Altra AL0A547F232 Size 11,Altra Men Torin 5 AL0A547F232 Gray/Lime US Size 11,Default Ridgefield,0,0,0,0,0,72
Altra,Altra AL0A547F232 Size 11.5,Altra Men Torin 5 AL0A547F232 Gray/Lime US Size 11.5,Default Ridgefield,0,0,0,0,0,48
Altra,Altra AL0A547F232 Size 12,Altra Men Torin 5 AL0A547F232 Gray/Lime US Size 12,Default Ridgefield,0,0,0,0,0,60
Altra,Altra AL0A547F232 Size 12.5,Altra Men Torin 5 AL0A547F232 Gray/Lime US Size 12.5,Default Ridgefield,0,0,0,0,0,24
Altra,Altra AL0A547F232 Size 9,Altra Men Torin 5 AL0A547F232 Gray/Lime US Size 9,Default Ridgefield,0,0,0,0,0,24
Altra,Altra AL0A547F232 Size 9.5,Altra Men Torin 5 AL0A547F232 Gray/Lime US Size 9.5,Default Ridgefield,0,0,0,0,0,36
Altra,Altra AL0A547F408 Size 10,Altra Men Torin 5 AL0A547F408 Majolica Blue US Size 10,Default Ridgefield,0,0,0,0,0,24
Altra,Altra AL0A547F408 Size 10.5,Altra Men Torin 5 AL0A547F408 Majolica Blue US Size 10.5,Default Ridgefield,0,0,0,0,0,24
Altra,Altra AL0A547F408 Size 11,Altra Men Torin 5 AL0A547F408 Majolica Blue US Size 11,Default Ridgefield,0,0,0,0,0,24
Altra,Altra AL0A547F408 Size 11.5,Altra Men Torin 5 AL0A547F408 Majolica Blue US Size 11.5,Default Ridgefield,0,0,0,0,0,24
Altra,Altra AL0A547F408 Size 12,Altra Men Torin 5 AL0A547F408 Majolica Blue US Size 12,Default Ridgefield,0,0,0,0,0,24
Altra,Altra AL0A547F408 Size 12.5,Altra Men Torin 5 AL0A547F408 Majolica Blue US Size 12.5,Default Ridgefield,0,0,0,0,0,12
Altra,Altra AL0A547F408 Size 9,Altra Men Torin 5 AL0A547F408 Majolica Blue US Size 9,Default Ridgefield,0,0,0,0,0,12
Altra,Altra AL0A547F408 Size 9.5,Altra Men Torin 5 AL0A547F408 Majolica Blue US Size 9.5,Default Ridgefield,0,0,0,0,0,12
Arrowhead Mills,Arrowhead Mill Corn Flakes 10oz,Arrowhead Mills Organic Gluten Free Sprouted Corn Flakes 10oz,FBALYB Amazon,137,136,1,0,1,0
Bearpaw,Bearpaw 1653Y-667 Size 1,Bearpaw ROSIE YOUTH WINE 1653Y-667 US Size 1,Default Ridgefield,30,30,0,0,0,0
Bearpaw,Bearpaw 1653Y-667 Size 13,Bearpaw ROSIE YOUTH WINE 1653Y-667 US Size 13,Default Ridgefield,6,6,0,0,0,0
Bearpaw,Bearpaw 1653Y-667 Size 13,Bearpaw ROSIE YOUTH WINE 1653Y-667 US Size 13,FBALYB Amazon,20,20,0,0,0,0
Bearpaw,Bearpaw 1653Y-667 Size 2,Bearpaw ROSIE YOUTH WINE 1653Y-667 US Size 2,Default Ridgefield,1,1,0,0,0,6
Bearpaw,Bearpaw 1653Y-667 Size 2,Bearpaw ROSIE YOUTH WINE 1653Y-667 US Size 2,FBALYB Amazon,34,34,0,0,0,0
Bearpaw,Bearpaw 1653Y-667 Size 3,Bearpaw ROSIE YOUTH WINE 1653Y-667 US Size 3,Default Ridgefield,7,7,0,0,0,0
Bearpaw,Bearpaw 1653Y-667 Size 3,Bearpaw ROSIE YOUTH WINE 1653Y-667 US Size 3,FBALYB Amazon,23,23,0,0,0,0
Bearpaw,Bearpaw 1653Y-667 Size 4,Bearpaw ROSIE YOUTH WINE 1653Y-667 US Size 4,Default Ridgefield,6,6,0,0,0,0
Bearpaw,Bearpaw 1653Y-667 Size 4,Bearpaw ROSIE YOUTH WINE 1653Y-667 US Size 4,FBALYB Amazon,50,50,0,0,0,0
Bearpaw,Bearpaw 1653Y-667 Size 5,Bearpaw ROSIE YOUTH WINE 1653Y-667 US Size 5,Default Ridgefield,1,1,0,0,0,0
Bearpaw,Bearpaw 1653Y-667 Size 5,Bearpaw ROSIE YOUTH WINE 1653Y-667 US Size 5,FBALYB Amazon,45,45,0,0,0,0
Bearpaw,Bearpaw Alyssa Black 2130W-11 10,Bearpaw Women's Alyssa Women's Suede Winter Boots Black 2130W-11 US Size 10,FBALYB Amazon,1,0,1,0,1,0
Bearpaw,Bearpaw Alyssa Black 2130W-11 11,Bearpaw Women's Alyssa Women's Suede Winter Boots Black 2130W-11 US Size 11,FBALYB Amazon,13,11,2,0,2,0
Bearpaw,Bearpaw Alyssa Black 2130W-11 6,Bearpaw Women's Alyssa Women's Suede Winter Boots Black 2130W-11 US Size 6,Default Ridgefield,2,2,0,0,0,0
Bearpaw,Bearpaw Alyssa Black 2130W-11 6,Bearpaw Women's Alyssa Women's Suede Winter Boots Black 2130W-11 US Size 6,FBALYB Amazon,2,0,2,4,2,0
Bearpaw,Bearpaw Alyssa Black 2130W-11 7,Bearpaw Women's Alyssa Women's Suede Winter Boots Black 2130W-11 US Size 7,FBALYB Amazon,31,27,4,0,4,0
Bearpaw,Bearpaw Alyssa Black 2130W-11 8,Bearpaw Women's Alyssa Women's Suede Winter Boots Black 2130W-11 US Size 8,Default Ridgefield,1,1,0,0,0,0
Bearpaw,Bearpaw Alyssa Black 2130W-11 8,Bearpaw Women's Alyssa Women's Suede Winter Boots Black 2130W-11 US Size 8,FBALYB Amazon,28,24,4,0,4,0
Bearpaw,Bearpaw Alyssa Black 2130W-11 9,Bearpaw Women's Alyssa Women's Suede Winter Boots Black 2130W-11 US Size 9,FBALYB Amazon,71,67,4,0,4,0
Bearpaw,Bearpaw Alyssa Char 2130W-30 10,Bearpaw Women's Alyssa Women's Suede Winter Boots Charcoal 2130W-30 US Size 10,FBALYB Amazon,9,6,3,0,3,0
Bearpaw,Bearpaw Alyssa Char 2130W-30 11,Bearpaw Women's Alyssa Women's Suede Winter Boots Charcoal 2130W-30 US Size 11,FBALYB Amazon,14,14,0,0,0,0
Bearpaw,Bearpaw Alyssa Char 2130W-30 6,Bearpaw Women's Alyssa Women's Suede Winter Boots Charcoal 2130W-30 US Size 6,FBALYB Amazon,12,12,0,0,0,0
Bearpaw,Bearpaw Alyssa Char 2130W-30 7,Bearpaw Women's Alyssa Women's Suede Winter Boots Charcoal 2130W-30 US Size 7,FBALYB Amazon,36,36,0,0,0,0
Bearpaw,Bearpaw Alyssa Char 2130W-30 8,Bearpaw Women's Alyssa Women's Suede Winter Boots Charcoal 2130W-30 US Size 8,FBALYB Amazon,30,24,6,0,6,0
Bearpaw,Bearpaw Alyssa Char 2130W-30 9,Bearpaw Women's Alyssa Women's Suede Winter Boots Charcoal 2130W-30 US Size 9,Default Ridgefield,1,1,0,0,0,0
Bearpaw,Bearpaw Alyssa Char 2130W-30 9,Bearpaw Women's Alyssa Women's Suede Winter Boots Charcoal 2130W-30 US Size 9,FBALYB Amazon,45,43,2,0,2,0
Bearpaw,Bearpaw Alyssa Hckry 2130W-220 10,Bearpaw Women's Alyssa Women's Suede Winter Boots Hickory 2130W-220 US Size 10,Default Ridgefield,1,1,0,0,0,0
Bearpaw,Bearpaw Alyssa Hckry 2130W-220 10,Bearpaw Women's Alyssa Women's Suede Winter Boots Hickory 2130W-220 US Size 10,FBALYB Amazon,7,1,6,0,6,0
Bearpaw,Bearpaw Alyssa Hckry 2130W-220 11,Bearpaw Women's Alyssa Women's Suede Winter Boots Hickory 2130W-220 US Size 11,FBALYB Amazon,20,19,1,0,1,0
Bearpaw,Bearpaw Alyssa Hckry 2130W-220 13,Bearpaw Women's Alyssa Women's Suede Winter Boots Hickory 2130W-220 US Size 13,FBALYB Amazon,16,15,1,0,1,0
Bearpaw,Bearpaw Alyssa Hckry 2130W-220 5,Bearpaw Women's Alyssa Women's Suede Winter Boots Hickory 2130W-220 US Size 5,Default Ridgefield,1,1,0,0,0,0
Bearpaw,Bearpaw Alyssa Hckry 2130W-220 5,Bearpaw Women's Alyssa Women's Suede Winter Boots Hickory 2130W-220 US Size 5,FBALYB Amazon,9,9,0,0,0,0
Bearpaw,Bearpaw Alyssa Hckry 2130W-220 6,Bearpaw Women's Alyssa Women's Suede Winter Boots Hickory 2130W-220 US Size 6,Default Ridgefield,1,1,0,0,0,0
Bearpaw,Bearpaw Alyssa Hckry 2130W-220 6,Bearpaw Women's Alyssa Women's Suede Winter Boots Hickory 2130W-220 US Size 6,FBALYB Amazon,17,17,0,0,0,0
Bearpaw,Bearpaw Alyssa Hckry 2130W-220 7,Bearpaw Women's Alyssa Women's Suede Winter Boots Hickory 2130W-220 US Size 7,Default Ridgefield,1,1,0,0,0,0
Bearpaw,Bearpaw Alyssa Hckry 2130W-220 7,Bearpaw Women's Alyssa Women's Suede Winter Boots Hickory 2130W-220 US Size 7,FBALYB Amazon,40,36,4,0,4,0
Bearpaw,Bearpaw Alyssa Hckry 2130W-220 8,Bearpaw Women's Alyssa Women's Suede Winter Boots Hickory 2130W-220 US Size 8,Default Ridgefield,6,6,0,0,0,0
Bearpaw,Bearpaw Alyssa Hckry 2130W-220 8,Bearpaw Women's Alyssa Women's Suede Winter Boots Hickory 2130W-220 US Size 8,FBALYB Amazon,31,20,11,0,11,0
Bearpaw,Bearpaw Alyssa Hckry 2130W-220 9,Bearpaw Women's Alyssa Women's Suede Winter Boots Hickory 2130W-220 US Size 9,Default Ridgefield,2,2,0,0,0,0
Bearpaw,Bearpaw Alyssa Hckry 2130W-220 9,Bearpaw Women's Alyssa Women's Suede Winter Boots Hickory 2130W-220 US Size 9,FBALYB Amazon,77,72,5,0,5,0
Bearpaw,Bearpaw Boetis Black 1294W-11 10,Bearpaw Women's Boetis  Furry Boots Black 1294W-11 US Size 10,FBALYB Amazon,28,27,1,0,1,0
Bearpaw,Bearpaw Boetis Black 1294W-11 11,Bearpaw Women's Boetis  Furry Boots Black 1294W-11 US Size 11,FBALYB Amazon,16,16,0,0,0,0
Bearpaw,Bearpaw Boetis Black 1294W-11 6,Bearpaw Women's Boetis  Furry Boots Black 1294W-11 US Size 6,FBALYB Amazon,17,17,0,0,0,0
Bearpaw,Bearpaw Boetis Black 1294W-11 7,Bearpaw Women's Boetis  Furry Boots Black 1294W-11 US Size 7,FBALYB Amazon,29,29,0,0,0,0
Bearpaw,Bearpaw Boetis Black 1294W-11 8,Bearpaw Women's Boetis  Furry Boots Black 1294W-11 US Size 8,FBALYB Amazon,36,36,0,0,0,0
Bearpaw,Bearpaw Boetis Black 1294W-11 9,Bearpaw Women's Boetis  Furry Boots Black 1294W-11 US Size 9,FBALYB Amazon,25,24,1,0,1,0
Bearpaw,Bearpaw Boetis White 1294W-10 10,Bearpaw Women's Boetis  Furry Boots White 1294W-10 US Size 10,FBALYB Amazon,16,16,0,0,0,0
Bearpaw,Bearpaw Boetis White 1294W-10 7,Bearpaw Women's Boetis  Furry Boots White 1294W-10 US Size 7,FBALYB Amazon,13,12,1,0,1,0
Bearpaw,Bearpaw Boetis White 1294W-10 8,Bearpaw Women's Boetis  Furry Boots White 1294W-10 US Size 8,FBALYB Amazon,16,16,0,0,0,0
Bearpaw,Bearpaw Boetis White 1294W-10 9,Bearpaw Women's Boetis  Furry Boots White 1294W-10 US Size 9,FBALYB Amazon,16,16,0,0,0,0
Bearpaw,Bearpaw Boshie Black 1669W-11 10,Bearpaw Women's Boshie Wide Boot Black 1669W-11 US Size 10,FBALYB Amazon,15,15,0,0,0,0
Bearpaw,Bearpaw Boshie Black 1669W-11 7,Bearpaw Women's Boshie Wide Boot Black 1669W-11 US Size 7,FBALYB Amazon,29,29,0,0,0,0
Bearpaw,Bearpaw Boshie Black 1669W-11 8,Bearpaw Women's Boshie Wide Boot Black 1669W-11 US Size 8,FBALYB Amazon,13,13,0,0,0,0
Bearpaw,Bearpaw Boshie Black 1669W-11 9,Bearpaw Women's Boshie Wide Boot Black 1669W-11 US Size 9,FBALYB Amazon,13,12,1,0,1,0
Bearpaw,Bearpaw Boshie C/D 1669W-221 10,Bearpaw Women's Boshie Wide Boot Chesnut/Distressed 1669W-221 US Size 10,FBALYB Amazon,11,11,0,0,0,0
Bearpaw,Bearpaw Boshie C/D 1669W-221 7,Bearpaw Women's Boshie Wide Boot Chesnut/Distressed 1669W-221 US Size 7,FBALYB Amazon,23,22,1,0,1,0
Bearpaw,Bearpaw Boshie C/D 1669W-221 8,Bearpaw Women's Boshie Wide Boot Chesnut/Distressed 1669W-221 US Size 8,FBALYB Amazon,12,12,0,0,0,0
Bearpaw,Bearpaw Boshie C/D 1669W-221 9,Bearpaw Women's Boshie Wide Boot Chesnut/Distressed 1669W-221 US Size 9,FBALYB Amazon,9,8,1,0,1,0
Bearpaw,Bearpaw Boshie Hckry 1669W-220 10,Bearpaw Women's Boshie Wide Boot Hickory 1669W-220 US Size 10,FBALYB Amazon,14,13,1,0,1,0
Bearpaw,Bearpaw Boshie Hckry 1669W-220 7,Bearpaw Women's Boshie Wide Boot Hickory 1669W-220 US Size 7,FBALYB Amazon,26,26,0,0,0,0
Bearpaw,Bearpaw Boshie Hckry 1669W-220 8,Bearpaw Women's Boshie Wide Boot Hickory 1669W-220 US Size 8,Default Ridgefield,1,1,0,0,0,0
Bearpaw,Bearpaw Boshie Hckry 1669W-220 8,Bearpaw Women's Boshie Wide Boot Hickory 1669W-220 US Size 8,FBALYB Amazon,7,5,2,0,2,0
Bearpaw,Bearpaw Boshie Hckry 1669W-220 9,Bearpaw Women's Boshie Wide Boot Hickory 1669W-220 US Size 9,FBALYB Amazon,9,8,1,0,1,0
Bearpaw,Bearpaw Elle Black 1963W-11 11,Bearpaw Women's Elle Tall Water Resistant Boot Black 1963W-11 US Size 11,FBALYB Amazon,15,14,1,0,1,0
Bearpaw,Bearpaw Elle Black 1963W-11 7,Bearpaw Women's Elle Tall Water Resistant Boot Black 1963W-11 US Size 7,FBALYB Amazon,25,24,1,0,1,0
Bearpaw,Bearpaw Elle Black 1963W-11 8,Bearpaw Women's Elle Tall Water Resistant Boot Black 1963W-11 US Size 8,FBALYB Amazon,18,17,1,0,1,0
Bearpaw,Bearpaw Elle Black 1963W-11 9,Bearpaw Women's Elle Tall Water Resistant Boot Black 1963W-11 US Size 9,FBALYB Amazon,0,0,0,1,0,0
Bearpaw,Bearpaw Elle Charcoal 1963W-30 7,Bearpaw Women's Elle Tall Water Resistant Boot Charcoal 1963W-30 US Size 7,Default Ridgefield,5,5,0,0,0,0
Bearpaw,Bearpaw Elle Charcoal 1963W-30 7,Bearpaw Women's Elle Tall Water Resistant Boot Charcoal 1963W-30 US Size 7,FBALYB Amazon,10,9,1,0,1,0
Bearpaw,Bearpaw Elle Charcoal 1963W-30 8,Bearpaw Women's Elle Tall Water Resistant Boot Charcoal 1963W-30 US Size 8,Default Ridgefield,1,1,0,0,0,0
Bearpaw,Bearpaw Elle Charcoal 1963W-30 8,Bearpaw Women's Elle Tall Water Resistant Boot Charcoal 1963W-30 US Size 8,FBALYB Amazon,9,9,0,0,0,0
Bearpaw,Bearpaw Elle Charcoal 1963W-30 9,Bearpaw Women's Elle Tall Water Resistant Boot Charcoal 1963W-30 US Size 9,FBALYB Amazon,15,15,0,0,0,0
Bearpaw,Bearpaw Elle Hickory 1963W-220 11,Bearpaw Women's Elle Tall Water Resistant Boot Hickory 1963W-220 US Size 11,FBALYB Amazon,17,17,0,0,0,0
Bearpaw,Bearpaw Elle Hickory 1963W-220 7,Bearpaw Women's Elle Tall Water Resistant Boot Hickory 1963W-220 US Size 7,FBALYB Amazon,19,17,2,0,2,0
Bearpaw,Bearpaw Elle Hickory 1963W-220 8,Bearpaw Women's Elle Tall Water Resistant Boot Hickory 1963W-220 US Size 8,Default Ridgefield,1,1,0,0,0,0
Bearpaw,Bearpaw Elle Hickory 1963W-220 8,Bearpaw Women's Elle Tall Water Resistant Boot Hickory 1963W-220 US Size 8,FBALYB Amazon,22,20,2,0,2,0
Bearpaw,Bearpaw Elle Hickory 1963W-220 9,Bearpaw Women's Elle Tall Water Resistant Boot Hickory 1963W-220 US Size 9,FBALYB Amazon,13,12,1,0,1,0
Bearpaw,Bearpaw Knit Black 658W-11 10,Bearpaw Women's Knit Tall Boots Black 658W-11 US Size 10,FBALYB Amazon,14,12,2,0,2,0
Bearpaw,Bearpaw Knit Black 658W-11 6,Bearpaw Women's Knit Tall Boots Black 658W-11 US Size 6,FBALYB Amazon,15,13,2,0,2,0
Bearpaw,Bearpaw Knit Black 658W-11 7,Bearpaw Women's Knit Tall Boots Black 658W-11 US Size 7,FBALYB Amazon,10,9,1,0,1,0
Bearpaw,Bearpaw Knit Black 658W-11 8,Bearpaw Women's Knit Tall Boots Black 658W-11 US Size 8,FBALYB Amazon,6,6,0,0,0,0
Bearpaw,Bearpaw Knit Black 658W-11 9,Bearpaw Women's Knit Tall Boots Black 658W-11 US Size 9,FBALYB Amazon,6,4,2,0,2,0
Bearpaw,Bearpaw Knit Gray 658W-55 10,Bearpaw Women's Knit Tall Boots Gray 658W-55 US Size 10,Default Ridgefield,6,6,0,0,0,0
Bearpaw,Bearpaw Knit Gray 658W-55 10,Bearpaw Women's Knit Tall Boots Gray 658W-55 US Size 10,FBALYB Amazon,17,17,0,0,0,0
Bearpaw,Bearpaw Knit Gray 658W-55 6,Bearpaw Women's Knit Tall Boots Gray 658W-55 US Size 6,FBALYB Amazon,17,17,0,0,0,0
Bearpaw,Bearpaw Knit Gray 658W-55 7,Bearpaw Women's Knit Tall Boots Gray 658W-55 US Size 7,FBALYB Amazon,23,21,2,0,2,0
Bearpaw,Bearpaw Knit Gray 658W-55 8,Bearpaw Women's Knit Tall Boots Gray 658W-55 US Size 8,FBALYB Amazon,27,26,1,0,1,0
Bearpaw,Bearpaw Knit Gray 658W-55 9,Bearpaw Women's Knit Tall Boots Gray 658W-55 US Size 9,FBALYB Amazon,14,10,4,0,4,0
Bearpaw,Bearpaw Krista Black 2025W-11 10,Bearpaw Women's Krista Water Resistant Wedge Boot Black 2025W-11 US Size 10,FBALYB Amazon,13,12,1,0,1,0
Bearpaw,Bearpaw Krista Black 2025W-11 6,Bearpaw Women's Krista Water Resistant Wedge Boot Black 2025W-11 US Size 6,FBALYB Amazon,17,17,0,0,0,0
Bearpaw,Bearpaw Krista Black 2025W-11 7,Bearpaw Women's Krista Water Resistant Wedge Boot Black 2025W-11 US Size 7,FBALYB Amazon,29,29,0,0,0,0
Bearpaw,Bearpaw Krista Black 2025W-11 8,Bearpaw Women's Krista Water Resistant Wedge Boot Black 2025W-11 US Size 8,Default Ridgefield,1,1,0,0,0,0
Bearpaw,Bearpaw Krista Black 2025W-11 8,Bearpaw Women's Krista Water Resistant Wedge Boot Black 2025W-11 US Size 8,FBALYB Amazon,24,24,0,0,0,0
Bearpaw,Bearpaw Krista Black 2025W-11 9,Bearpaw Women's Krista Water Resistant Wedge Boot Black 2025W-11 US Size 9,Default Ridgefield,6,6,0,0,0,0
Bearpaw,Bearpaw Krista Black 2025W-11 9,Bearpaw Women's Krista Water Resistant Wedge Boot Black 2025W-11 US Size 9,FBALYB Amazon,17,17,0,0,0,0
Bearpaw,Bearpaw Krista Hckry 2025W-220 10,Bearpaw Women's Krista Water Resistant Wedge Boot Hickory 2025W-220 US Size 10,FBALYB Amazon,7,5,2,0,2,0
Bearpaw,Bearpaw Krista Hckry 2025W-220 6,Bearpaw Women's Krista Water Resistant Wedge Boot Hickory 2025W-220 US Size 6,FBALYB Amazon,13,13,0,0,0,0
Bearpaw,Bearpaw Krista Hckry 2025W-220 7,Bearpaw Women's Krista Water Resistant Wedge Boot Hickory 2025W-220 US Size 7,FBALYB Amazon,24,23,1,0,1,0
Bearpaw,Bearpaw Krista Hckry 2025W-220 8,Bearpaw Women's Krista Water Resistant Wedge Boot Hickory 2025W-220 US Size 8,Default Ridgefield,1,1,0,0,0,0
Bearpaw,Bearpaw Krista Hckry 2025W-220 8,Bearpaw Women's Krista Water Resistant Wedge Boot Hickory 2025W-220 US Size 8,FBALYB Amazon,17,16,1,0,1,0
Bearpaw,Bearpaw Krista Hckry 2025W-220 9,Bearpaw Women's Krista Water Resistant Wedge Boot Hickory 2025W-220 US Size 9,FBALYB Amazon,16,16,0,0,0,0
Bearpaw,Bearpaw Loketta Black 2299W-11 10,Bearpaw Women's Loketta Suede Slippers Black 2299W-11 US Size 10,FBALYB Amazon,39,39,0,0,0,0
Bearpaw,Bearpaw Loketta Black 2299W-11 11,Bearpaw Women's Loketta Suede Slippers Black 2299W-11 US Size 11,FBALYB Amazon,42,42,0,0,0,0
Bearpaw,Bearpaw Loketta Black 2299W-11 6,Bearpaw Women's Loketta Suede Slippers Black 2299W-11 US Size 6,FBALYB Amazon,15,15,0,0,0,0
Bearpaw,Bearpaw Loketta Black 2299W-11 7,Bearpaw Women's Loketta Suede Slippers Black 2299W-11 US Size 7,FBALYB Amazon,55,54,1,0,1,0
Bearpaw,Bearpaw Loketta Black 2299W-11 8,Bearpaw Women's Loketta Suede Slippers Black 2299W-11 US Size 8,Default Ridgefield,1,1,0,0,0,0
Bearpaw,Bearpaw Loketta Black 2299W-11 8,Bearpaw Women's Loketta Suede Slippers Black 2299W-11 US Size 8,FBALYB Amazon,26,26,0,0,0,0
Bearpaw,Bearpaw Loketta Black 2299W-11 9,Bearpaw Women's Loketta Suede Slippers Black 2299W-11 US Size 9,FBALYB Amazon,91,91,0,0,0,0
Bearpaw,Bearpaw Loketta GFog 2299W-51 10,Bearpaw Women's Loketta Suede Slippers Gray Fog 2299W-51 US Size 10,Default Ridgefield,1,1,0,0,0,0
Bearpaw,Bearpaw Loketta GFog 2299W-51 10,Bearpaw Women's Loketta Suede Slippers Gray Fog 2299W-51 US Size 10,FBALYB Amazon,37,37,0,0,0,0
Bearpaw,Bearpaw Loketta GFog 2299W-51 11,Bearpaw Women's Loketta Suede Slippers Gray Fog 2299W-51 US Size 11,FBALYB Amazon,41,41,0,0,0,0
Bearpaw,Bearpaw Loketta GFog 2299W-51 6,Bearpaw Women's Loketta Suede Slippers Gray Fog 2299W-51 US Size 6,FBALYB Amazon,16,15,1,0,1,0
Bearpaw,Bearpaw Loketta GFog 2299W-51 7,Bearpaw Women's Loketta Suede Slippers Gray Fog 2299W-51 US Size 7,Default Ridgefield,2,2,0,0,0,0
Bearpaw,Bearpaw Loketta GFog 2299W-51 7,Bearpaw Women's Loketta Suede Slippers Gray Fog 2299W-51 US Size 7,FBALYB Amazon,56,56,0,0,0,0
Bearpaw,Bearpaw Loketta GFog 2299W-51 8,Bearpaw Women's Loketta Suede Slippers Gray Fog 2299W-51 US Size 8,FBALYB Amazon,25,25,0,0,0,0
Bearpaw,Bearpaw Loketta GFog 2299W-51 9,Bearpaw Women's Loketta Suede Slippers Gray Fog 2299W-51 US Size 9,Default Ridgefield,1,1,0,0,0,0
Bearpaw,Bearpaw Loketta GFog 2299W-51 9,Bearpaw Women's Loketta Suede Slippers Gray Fog 2299W-51 US Size 9,FBALYB Amazon,80,79,1,0,1,0
Bearpaw,Bearpaw Loketta SBrwn 2299W-240 10,Bearpaw Women's Loketta Suede Slippers Seal Brown 2299W-240 US Size 10,Default Ridgefield,1,1,0,0,0,0
Bearpaw,Bearpaw Loketta SBrwn 2299W-240 10,Bearpaw Women's Loketta Suede Slippers Seal Brown 2299W-240 US Size 10,FBALYB Amazon,56,56,0,0,0,0
Bearpaw,Bearpaw Loketta SBrwn 2299W-240 11,Bearpaw Women's Loketta Suede Slippers Seal Brown 2299W-240 US Size 11,Default Ridgefield,1,1,0,0,0,0
Bearpaw,Bearpaw Loketta SBrwn 2299W-240 11,Bearpaw Women's Loketta Suede Slippers Seal Brown 2299W-240 US Size 11,FBALYB Amazon,71,71,0,0,0,0
Bearpaw,Bearpaw Loketta SBrwn 2299W-240 6,Bearpaw Women's Loketta Suede Slippers Seal Brown 2299W-240 US Size 6,FBALYB Amazon,17,17,0,0,0,0
Bearpaw,Bearpaw Loketta SBrwn 2299W-240 7,Bearpaw Women's Loketta Suede Slippers Seal Brown 2299W-240 US Size 7,Default Ridgefield,1,1,0,0,0,0
Bearpaw,Bearpaw Loketta SBrwn 2299W-240 7,Bearpaw Women's Loketta Suede Slippers Seal Brown 2299W-240 US Size 7,FBALYB Amazon,82,82,0,0,0,0
Bearpaw,Bearpaw Loketta SBrwn 2299W-240 8,Bearpaw Women's Loketta Suede Slippers Seal Brown 2299W-240 US Size 8,FBALYB Amazon,41,41,0,0,0,0
Bearpaw,Bearpaw Loketta SBrwn 2299W-240 9,Bearpaw Women's Loketta Suede Slippers Seal Brown 2299W-240 US Size 9,FBALYB Amazon,121,121,0,0,0,0
Bearpaw,Bearpaw Mens 1295M-001 Size 10,Bearpaw Mens MOC II BLACK 1295M-001 US Size 10,Default Ridgefield,5,5,0,0,0,0
Bearpaw,Bearpaw Mens 1295M-001 Size 10,Bearpaw Mens MOC II BLACK 1295M-001 US Size 10,FBALYB Amazon,21,20,1,0,1,0
Bearpaw,Bearpaw Mens 1295M-001 Size 11,Bearpaw Mens MOC II BLACK 1295M-001 US Size 11,FBALYB Amazon,47,46,1,0,1,0
Bearpaw,Bearpaw Mens 1295M-001 Size 12,Bearpaw Mens MOC II BLACK 1295M-001 US Size 12,Default Ridgefield,40,40,0,0,0,0
Bearpaw,Bearpaw Mens 1295M-001 Size 13,Bearpaw Mens MOC II BLACK 1295M-001 US Size 13,Default Ridgefield,6,6,0,0,0,0
Bearpaw,Bearpaw Mens 1295M-001 Size 13,Bearpaw Mens MOC II BLACK 1295M-001 US Size 13,FBALYB Amazon,32,32,0,0,0,0
Bearpaw,Bearpaw Mens 1295M-001 Size 9,Bearpaw Mens MOC II BLACK 1295M-001 US Size 9,Default Ridgefield,9,9,0,0,0,0
Bearpaw,Bearpaw Mens 1295M-220 Size 10,Bearpaw Mens MOC II HICKORY II 1295M-220 US Size 10,Default Ridgefield,2,2,0,0,0,0
Bearpaw,Bearpaw Mens 1295M-220 Size 10,Bearpaw Mens MOC II HICKORY II 1295M-220 US Size 10,FBALYB Amazon,195,190,5,0,5,0
Bearpaw,Bearpaw Mens 1295M-220 Size 11,Bearpaw Mens MOC II HICKORY II 1295M-220 US Size 11,Default Ridgefield,129,129,0,0,0,0
Bearpaw,Bearpaw Mens 1295M-220 Size 11,Bearpaw Mens MOC II HICKORY II 1295M-220 US Size 11,FBALYB Amazon,189,182,7,40,7,0
Bearpaw,Bearpaw Mens 1295M-220 Size 12,Bearpaw Mens MOC II HICKORY II 1295M-220 US Size 12,FBALYB Amazon,1,0,1,0,1,0
Bearpaw,Bearpaw Mens 1295M-220 Size 13,Bearpaw Mens MOC II HICKORY II 1295M-220 US Size 13,FBALYB Amazon,95,95,0,0,0,0
Bearpaw,Bearpaw Mens 1295M-220 Size 8,Bearpaw Mens MOC II HICKORY II 1295M-220 US Size 8,Default Ridgefield,309,309,0,0,0,0
Bearpaw,Bearpaw Mens 1295M-220 Size 9,Bearpaw Mens MOC II HICKORY II 1295M-220 US Size 9,Default Ridgefield,234,234,0,0,0,6
Bearpaw,Bearpaw Mens 1295M-220 Size 9,Bearpaw Mens MOC II HICKORY II 1295M-220 US Size 9,FBALYB Amazon,376,374,2,0,2,0
Bearpaw,Bearpaw Mens 1295M-901 Size 10,Bearpaw Mens MOC II BLACK MULTI KNIT 1295M-901 US Size 10,Default Ridgefield,97,97,0,0,0,0
Bearpaw,Bearpaw Mens 1295M-901 Size 10,Bearpaw Mens MOC II BLACK MULTI KNIT 1295M-901 US Size 10,FBALYB Amazon,6,5,1,0,1,0
Bearpaw,Bearpaw Mens 1295M-901 Size 11,Bearpaw Mens MOC II BLACK MULTI KNIT 1295M-901 US Size 11,Default Ridgefield,71,71,0,0,0,6
Bearpaw,Bearpaw Mens 1295M-901 Size 11,Bearpaw Mens MOC II BLACK MULTI KNIT 1295M-901 US Size 11,FBALYB Amazon,40,40,0,0,0,0
Bearpaw,Bearpaw Mens 1295M-901 Size 12,Bearpaw Mens MOC II BLACK MULTI KNIT 1295M-901 US Size 12,Default Ridgefield,6,6,0,0,0,0
Bearpaw,Bearpaw Mens 1295M-901 Size 12,Bearpaw Mens MOC II BLACK MULTI KNIT 1295M-901 US Size 12,FBALYB Amazon,78,76,2,0,2,0
Bearpaw,Bearpaw Mens 1295M-901 Size 13,Bearpaw Mens MOC II BLACK MULTI KNIT 1295M-901 US Size 13,FBALYB Amazon,58,58,0,0,0,0
Bearpaw,Bearpaw Mens 1295M-901 Size 8,Bearpaw Mens MOC II BLACK MULTI KNIT 1295M-901 US Size 8,FBALYB Amazon,18,18,0,0,0,0
Bearpaw,Bearpaw Mens 1295M-901 Size 9,Bearpaw Mens MOC II BLACK MULTI KNIT 1295M-901 US Size 9,Default Ridgefield,6,6,0,0,0,0
Bearpaw,Bearpaw Mens 1295M-901 Size 9,Bearpaw Mens MOC II BLACK MULTI KNIT 1295M-901 US Size 9,FBALYB Amazon,44,44,0,0,0,0
Bearpaw,Bearpaw Mens 1295M-905 Size 10,Bearpaw Mens MOC II CHOCOLATE MULTI KNIT 1295M-905 US Size 10,Default Ridgefield,78,78,0,0,0,0
Bearpaw,Bearpaw Mens 1295M-905 Size 10,Bearpaw Mens MOC II CHOCOLATE MULTI KNIT 1295M-905 US Size 10,FBALYB Amazon,2,2,0,0,0,0
Bearpaw,Bearpaw Mens 1295M-905 Size 11,Bearpaw Mens MOC II CHOCOLATE MULTI KNIT 1295M-905 US Size 11,Default Ridgefield,1,1,0,0,0,0
Bearpaw,Bearpaw Mens 1295M-905 Size 11,Bearpaw Mens MOC II CHOCOLATE MULTI KNIT 1295M-905 US Size 11,FBALYB Amazon,76,76,0,0,0,0
Bearpaw,Bearpaw Mens 1295M-905 Size 12,Bearpaw Mens MOC II CHOCOLATE MULTI KNIT 1295M-905 US Size 12,FBALYB Amazon,57,57,0,0,0,0
Bearpaw,Bearpaw Mens 1295M-905 Size 13,Bearpaw Mens MOC II CHOCOLATE MULTI KNIT 1295M-905 US Size 13,FBALYB Amazon,36,36,0,0,0,0
Bearpaw,Bearpaw Mens 1295M-905 Size 8,Bearpaw Mens MOC II CHOCOLATE MULTI KNIT 1295M-905 US Size 8,Default Ridgefield,3,3,0,0,0,0
Bearpaw,Bearpaw Mens 1295M-905 Size 8,Bearpaw Mens MOC II CHOCOLATE MULTI KNIT 1295M-905 US Size 8,FBALYB Amazon,24,24,0,0,0,0
Bearpaw,Bearpaw Mens 1295M-905 Size 9,Bearpaw Mens MOC II CHOCOLATE MULTI KNIT 1295M-905 US Size 9,FBALYB Amazon,58,58,0,0,0,0
Bearpaw,Bearpaw Mens 2055M-220 Size 10,Bearpaw Mens SPENCER HICKORY II 2055M-220 US Size 10,Default Ridgefield,28,28,0,0,0,0
Bearpaw,Bearpaw Mens 2055M-220 Size 11,Bearpaw Mens SPENCER HICKORY II 2055M-220 US Size 11,Default Ridgefield,25,25,0,0,0,0
Bearpaw,Bearpaw Mens 2055M-220 Size 12,Bearpaw Mens SPENCER HICKORY II 2055M-220 US Size 12,Default Ridgefield,1,1,0,0,0,0
Bearpaw,Bearpaw Mens 2055M-220 Size 12,Bearpaw Mens SPENCER HICKORY II 2055M-220 US Size 12,FBALYB Amazon,6,6,0,0,0,0
Bearpaw,Bearpaw Mens 2055M-220 Size 8,Bearpaw Mens SPENCER HICKORY II 2055M-220 US Size 8,FBALYB Amazon,2,2,0,0,0,0
Bearpaw,Bearpaw Mens 2166M-011 Size 10,Bearpaw Mens BRADY BLACK II 2166M-011 US Size 10,Default Ridgefield,3,3,0,0,0,0
Bearpaw,Bearpaw Mens 2166M-011 Size 10,Bearpaw Mens BRADY BLACK II 2166M-011 US Size 10,FBALYB Amazon,153,153,0,0,0,0
Bearpaw,Bearpaw Mens 2166M-011 Size 8,Bearpaw Mens BRADY BLACK II 2166M-011 US Size 8,FBALYB Amazon,11,11,0,0,0,0
Bearpaw,Bearpaw Mens 2166M-011 Size 9,Bearpaw Mens BRADY BLACK II 2166M-011 US Size 9,FBALYB Amazon,101,100,1,0,1,0
Bearpaw,Bearpaw Mens 2379M-011 Size 10,Bearpaw Mens BRADY WIDE BLACK II 2379M-011 US Size 10,Default Ridgefield,0,0,0,0,0,5
Bearpaw,Bearpaw Mindy Black 1961W-11 10,Bearpaw Women's Mindy Moccasin Slippers Black 1961W-11 US Size 10,FBALYB Amazon,27,27,0,0,0,0
Bearpaw,Bearpaw Mindy Black 1961W-11 11,Bearpaw Women's Mindy Moccasin Slippers Black 1961W-11 US Size 11,FBALYB Amazon,28,27,1,0,1,0
Bearpaw,Bearpaw Mindy Black 1961W-11 6,Bearpaw Women's Mindy Moccasin Slippers Black 1961W-11 US Size 6,Default Ridgefield,1,1,0,0,0,0
Bearpaw,Bearpaw Mindy Black 1961W-11 6,Bearpaw Women's Mindy Moccasin Slippers Black 1961W-11 US Size 6,FBALYB Amazon,38,38,0,0,0,0
Bearpaw,Bearpaw Mindy Black 1961W-11 7,Bearpaw Women's Mindy Moccasin Slippers Black 1961W-11 US Size 7,FBALYB Amazon,39,38,1,0,1,0
Bearpaw,Bearpaw Mindy Black 1961W-11 8,Bearpaw Women's Mindy Moccasin Slippers Black 1961W-11 US Size 8,Default Ridgefield,9,9,0,0,0,0
Bearpaw,Bearpaw Mindy Black 1961W-11 8,Bearpaw Women's Mindy Moccasin Slippers Black 1961W-11 US Size 8,FBALYB Amazon,44,44,0,0,0,0
Bearpaw,Bearpaw Mindy Black 1961W-11 9,Bearpaw Women's Mindy Moccasin Slippers Black 1961W-11 US Size 9,FBALYB Amazon,35,35,0,0,0,0
Bearpaw,Bearpaw Mindy Hckry 1961W-220 10,Bearpaw Women's Mindy Moccasin Slippers Hickory 1961W-220 US Size 10,FBALYB Amazon,29,26,3,0,3,0
Bearpaw,Bearpaw Mindy Hckry 1961W-220 11,Bearpaw Women's Mindy Moccasin Slippers Hickory 1961W-220 US Size 11,FBALYB Amazon,41,39,2,0,2,0
Bearpaw,Bearpaw Mindy Hckry 1961W-220 6,Bearpaw Women's Mindy Moccasin Slippers Hickory 1961W-220 US Size 6,FBALYB Amazon,41,40,1,0,1,0
Bearpaw,Bearpaw Mindy Hckry 1961W-220 7,Bearpaw Women's Mindy Moccasin Slippers Hickory 1961W-220 US Size 7,FBALYB Amazon,49,47,2,0,2,0
Bearpaw,Bearpaw Mindy Hckry 1961W-220 8,Bearpaw Women's Mindy Moccasin Slippers Hickory 1961W-220 US Size 8,FBALYB Amazon,61,61,0,0,0,0
Bearpaw,Bearpaw Mindy Hckry 1961W-220 9,Bearpaw Women's Mindy Moccasin Slippers Hickory 1961W-220 US Size 9,Default Ridgefield,6,6,0,0,0,0
Bearpaw,Bearpaw Mindy Hckry 1961W-220 9,Bearpaw Women's Mindy Moccasin Slippers Hickory 1961W-220 US Size 9,FBALYB Amazon,44,43,1,0,1,0
Bearpaw,Bearpaw Phylly Black 1955W-11 10,Bearpaw Women's Phylly Boot Black 1955W-11 US Size 10,FBALYB Amazon,10,9,1,0,1,0
Bearpaw,Bearpaw Phylly Black 1955W-11 7,Bearpaw Women's Phylly Boot Black 1955W-11 US Size 7,FBALYB Amazon,26,25,1,0,1,0
Bearpaw,Bearpaw Phylly Black 1955W-11 8,Bearpaw Women's Phylly Boot Black 1955W-11 US Size 8,Default Ridgefield,1,1,0,0,0,0
Bearpaw,Bearpaw Phylly Black 1955W-11 8,Bearpaw Women's Phylly Boot Black 1955W-11 US Size 8,FBALYB Amazon,24,23,1,0,1,0
Bearpaw,Bearpaw Phylly Black 1955W-11 9,Bearpaw Women's Phylly Boot Black 1955W-11 US Size 9,FBALYB Amazon,23,23,0,0,0,0
Bearpaw,Bearpaw Phylly Char 1955W-30 7,Bearpaw Women's Phylly Boot Charcoal 1955W-30 US Size 7,FBALYB Amazon,16,16,0,0,0,0
Bearpaw,Bearpaw Phylly Char 1955W-30 8,Bearpaw Women's Phylly Boot Charcoal 1955W-30 US Size 8,Default Ridgefield,17,17,0,0,0,0
Bearpaw,Bearpaw Phylly Char 1955W-30 9,Bearpaw Women's Phylly Boot Charcoal 1955W-30 US Size 9,Default Ridgefield,1,1,0,0,0,0
Bearpaw,Bearpaw Phylly Char 1955W-30 9,Bearpaw Women's Phylly Boot Charcoal 1955W-30 US Size 9,FBALYB Amazon,13,13,0,0,0,0
Bearpaw,Bearpaw Phylly Hckry 1955W-220 10,Bearpaw Women's Phylly Boot Hickory 1955W-220 US Size 10,FBALYB Amazon,17,17,0,0,0,0
Bearpaw,Bearpaw Phylly Hckry 1955W-220 7,Bearpaw Women's Phylly Boot Hickory 1955W-220 US Size 7,FBALYB Amazon,13,12,1,0,1,0
Bearpaw,Bearpaw Phylly Hckry 1955W-220 8,Bearpaw Women's Phylly Boot Hickory 1955W-220 US Size 8,FBALYB Amazon,21,21,0,0,0,0
Bearpaw,Bearpaw Phylly Hckry 1955W-220 9,Bearpaw Women's Phylly Boot Hickory 1955W-220 US Size 9,Default Ridgefield,17,17,0,0,0,0
Bearpaw,Bearpaw Women 1255W-220 Size 10,Bearpaw Womens TATUM SOLIDS HICKORY II 1255W-220 US Size 10,Default Ridgefield,2,2,0,0,0,0
Bearpaw,Bearpaw Women 1255W-220 Size 11,Bearpaw Womens TATUM SOLIDS HICKORY II 1255W-220 US Size 11,Default Ridgefield,4,4,0,0,0,0
Bearpaw,Bearpaw Women 1255W-220 Size 11,Bearpaw Womens TATUM SOLIDS HICKORY II 1255W-220 US Size 11,FBALYB Amazon,6,6,0,0,0,0
Bearpaw,Bearpaw Women 1255W-220 Size 6,Bearpaw Womens TATUM SOLIDS HICKORY II 1255W-220 US Size 6,Default Ridgefield,0,0,0,0,0,6
Bearpaw,Bearpaw Women 1255W-220 Size 7,Bearpaw Womens TATUM SOLIDS HICKORY II 1255W-220 US Size 7,Default Ridgefield,0,0,0,0,0,1
Bearpaw,Bearpaw Women 1255W-220 Size 7,Bearpaw Womens TATUM SOLIDS HICKORY II 1255W-220 US Size 7,FBALYB Amazon,15,15,0,0,0,0
Bearpaw,Bearpaw Women 1255W-220 Size 8,Bearpaw Womens TATUM SOLIDS HICKORY II 1255W-220 US Size 8,Default Ridgefield,1,1,0,0,0,0
Bearpaw,Bearpaw Women 1255W-220 Size 8,Bearpaw Womens TATUM SOLIDS HICKORY II 1255W-220 US Size 8,FBALYB Amazon,2,2,0,0,0,0
Bearpaw,Bearpaw Women 1255W-220 Size 9,Bearpaw Womens TATUM SOLIDS HICKORY II 1255W-220 US Size 9,Default Ridgefield,3,3,0,0,0,0
Bearpaw,Bearpaw Women 1674W-030 Size 11,Bearpaw Womens EFFIE CHARCOAL 1674W-030 US Size 11,Default Ridgefield,14,14,0,0,0,0
Bearpaw,Bearpaw Women 1674W-030 Size 11,Bearpaw Womens EFFIE CHARCOAL 1674W-030 US Size 11,FBALYB Amazon,23,23,0,0,0,0
Bearpaw,Bearpaw Women 1674W-030 Size 12,Bearpaw Womens EFFIE CHARCOAL 1674W-030 US Size 12,Default Ridgefield,4,4,0,0,0,0
Bearpaw,Bearpaw Women 1674W-030 Size 6,Bearpaw Womens EFFIE CHARCOAL 1674W-030 US Size 6,Default Ridgefield,34,34,0,0,0,0
Bearpaw,Bearpaw Women 1674W-030 Size 6,Bearpaw Womens EFFIE CHARCOAL 1674W-030 US Size 6,FBALYB Amazon,12,12,0,0,0,0
Bearpaw,Bearpaw Women 1705W-030 Size 6,Bearpaw Womens ISABELLA CHARCOAL 1705W-030 US Size 6,FBALYB Amazon,24,24,0,0,0,0
Bearpaw,Bearpaw Women 1705W-030 Size 7,Bearpaw Womens ISABELLA CHARCOAL 1705W-030 US Size 7,Default Ridgefield,1,1,0,0,0,0
Bearpaw,Bearpaw Women 1705W-030 Size 7,Bearpaw Womens ISABELLA CHARCOAL 1705W-030 US Size 7,FBALYB Amazon,53,53,0,0,0,0
Bearpaw,Bearpaw Women 1705W-220 Size 6,Bearpaw Womens ISABELLA HICKORY II 1705W-220 US Size 6,Default Ridgefield,0,0,0,0,0,24
Bearpaw,Bearpaw Women 1705W-220 Size 6,Bearpaw Womens ISABELLA HICKORY II 1705W-220 US Size 6,FBALYB Amazon,3,3,0,0,0,0
Bearpaw,Bearpaw Women 1705W-220 Size 7,Bearpaw Womens ISABELLA HICKORY II 1705W-220 US Size 7,FBALYB Amazon,81,80,1,0,1,0
Bearpaw,Bearpaw Women 1706W-011 Size 7,Bearpaw Womens DESDEMONA BLACK II 1706W-011 US Size 7,Default Ridgefield,0,0,0,0,0,1
Bearpaw,Bearpaw Women 1706W-220 Size 10,Bearpaw Womens DESDEMONA HICKORY II 1706W-220 US Size 10,Default Ridgefield,1,1,0,0,0,0
Bearpaw,Bearpaw Women 1706W-220 Size 10,Bearpaw Womens DESDEMONA HICKORY II 1706W-220 US Size 10,FBALYB Amazon,23,23,0,0,0,0
Bearpaw,Bearpaw Women 1706W-220 Size 8,Bearpaw Womens DESDEMONA HICKORY II 1706W-220 US Size 8,Default Ridgefield,25,25,0,0,0,0
Bearpaw,Bearpaw Women 1706W-220 Size 9,Bearpaw Womens DESDEMONA HICKORY II 1706W-220 US Size 9,FBALYB Amazon,14,14,0,0,0,0
Bearpaw,Bearpaw Women 1854W-011 Size 10,Bearpaw Womens BOO BLACK II 1854W-011 US Size 10,Default Ridgefield,4,4,0,0,0,0
Bearpaw,Bearpaw Women 1854W-011 Size 10,Bearpaw Womens BOO BLACK II 1854W-011 US Size 10,FBALYB Amazon,14,14,0,0,0,0
Bearpaw,Bearpaw Women 1854W-011 Size 11,Bearpaw Womens BOO BLACK II 1854W-011 US Size 11,Default Ridgefield,6,6,0,0,0,0
Bearpaw,Bearpaw Women 1854W-011 Size 7,Bearpaw Womens BOO BLACK II 1854W-011 US Size 7,Default Ridgefield,6,6,0,0,0,0
Bearpaw,Bearpaw Women 1854W-011 Size 7,Bearpaw Womens BOO BLACK II 1854W-011 US Size 7,FBALYB Amazon,6,6,0,0,0,0
Bearpaw,Bearpaw Women 1854W-011 Size 8,Bearpaw Womens BOO BLACK II 1854W-011 US Size 8,FBALYB Amazon,24,24,0,0,0,0
Bearpaw,Bearpaw Women 1854W-011 Size 9,Bearpaw Womens BOO BLACK II 1854W-011 US Size 9,FBALYB Amazon,24,24,0,0,0,0
Bearpaw,Bearpaw Women 1854W-030 Size 11,Bearpaw Womens BOO CHARCOAL 1854W-030 US Size 11,FBALYB Amazon,1,1,0,0,0,0
Bearpaw,Bearpaw Women 1854W-030 Size 7,Bearpaw Womens BOO CHARCOAL 1854W-030 US Size 7,Default Ridgefield,1,1,0,0,0,0
Bearpaw,Bearpaw Women 1934W-012 Size 10,Bearpaw Womens BECKA BLACK/GREY 1934W-012 US Size 10,Default Ridgefield,6,6,0,0,0,0
Bearpaw,Bearpaw Women 1934W-012 Size 10,Bearpaw Womens BECKA BLACK/GREY 1934W-012 US Size 10,FBALYB Amazon,4,4,0,0,0,0
Bearpaw,Bearpaw Women 1934W-012 Size 11,Bearpaw Womens BECKA BLACK/GREY 1934W-012 US Size 11,Default Ridgefield,12,12,0,0,0,0
Bearpaw,Bearpaw Women 1934W-012 Size 6,Bearpaw Womens BECKA BLACK/GREY 1934W-012 US Size 6,FBALYB Amazon,12,12,0,0,0,0
Bearpaw,Bearpaw Women 1934W-012 Size 7,Bearpaw Womens BECKA BLACK/GREY 1934W-012 US Size 7,FBALYB Amazon,30,30,0,0,0,0
Bearpaw,Bearpaw Women 1934W-012 Size 8,Bearpaw Womens BECKA BLACK/GREY 1934W-012 US Size 8,Default Ridgefield,42,42,0,0,0,0
Bearpaw,Bearpaw Women 1934W-012 Size 8,Bearpaw Womens BECKA BLACK/GREY 1934W-012 US Size 8,FBALYB Amazon,6,6,0,0,0,0
Bearpaw,Bearpaw Women 1934W-012 Size 9,Bearpaw Womens BECKA BLACK/GREY 1934W-012 US Size 9,Default Ridgefield,0,0,0,0,0,6
Bearpaw,Bearpaw Women 1934W-276 Size 10,Bearpaw Womens BECKA STONE 1934W-276 US Size 10,FBALYB Amazon,60,60,0,0,0,0
Bearpaw,Bearpaw Women 1934W-276 Size 11,Bearpaw Womens BECKA STONE 1934W-276 US Size 11,FBALYB Amazon,24,24,0,0,0,0
Bearpaw,Bearpaw Women 1934W-276 Size 6,Bearpaw Womens BECKA STONE 1934W-276 US Size 6,Default Ridgefield,6,6,0,0,0,0
Bearpaw,Bearpaw Women 1934W-276 Size 6,Bearpaw Womens BECKA STONE 1934W-276 US Size 6,FBALYB Amazon,18,17,1,0,1,0
Bearpaw,Bearpaw Women 1934W-276 Size 7,Bearpaw Womens BECKA STONE 1934W-276 US Size 7,Default Ridgefield,1,1,0,0,0,0
Bearpaw,Bearpaw Women 1934W-276 Size 7,Bearpaw Womens BECKA STONE 1934W-276 US Size 7,FBALYB Amazon,53,53,0,0,0,0
Bearpaw,Bearpaw Women 1934W-276 Size 8,Bearpaw Womens BECKA STONE 1934W-276 US Size 8,FBALYB Amazon,87,87,0,0,0,0
Bearpaw,Bearpaw Women 1934W-276 Size 9,Bearpaw Womens BECKA STONE 1934W-276 US Size 9,FBALYB Amazon,89,89,0,0,0,0
Bearpaw,Bearpaw Women 1959W-011 Size 10,Bearpaw Womens ELLE SHORT WIDE BLACK II 1959W-011 US Size 10,Default Ridgefield,4,4,0,0,0,0
Bearpaw,Bearpaw Women 1959W-011 Size 10,Bearpaw Womens ELLE SHORT WIDE BLACK II 1959W-011 US Size 10,FBALYB Amazon,49,49,0,0,0,0
Bearpaw,Bearpaw Women 1959W-011 Size 6,Bearpaw Womens ELLE SHORT WIDE BLACK II 1959W-011 US Size 6,Default Ridgefield,6,6,0,0,0,0
Bearpaw,Bearpaw Women 1959W-011 Size 6,Bearpaw Womens ELLE SHORT WIDE BLACK II 1959W-011 US Size 6,FBALYB Amazon,24,23,1,0,1,0
Bearpaw,Bearpaw Women 1959W-011 Size 7,Bearpaw Womens ELLE SHORT WIDE BLACK II 1959W-011 US Size 7,FBALYB Amazon,54,54,0,0,0,0
Bearpaw,Bearpaw Women 1959W-011 Size 8,Bearpaw Womens ELLE SHORT WIDE BLACK II 1959W-011 US Size 8,Default Ridgefield,6,6,0,0,0,0
Bearpaw,Bearpaw Women 1959W-011 Size 8,Bearpaw Womens ELLE SHORT WIDE BLACK II 1959W-011 US Size 8,FBALYB Amazon,69,67,2,0,2,0
Bearpaw,Bearpaw Women 1959W-011 Size 9,Bearpaw Womens ELLE SHORT WIDE BLACK II 1959W-011 US Size 9,Default Ridgefield,6,6,0,0,0,0
Bearpaw,Bearpaw Women 1959W-011 Size 9,Bearpaw Womens ELLE SHORT WIDE BLACK II 1959W-011 US Size 9,FBALYB Amazon,69,67,2,0,2,0
Bearpaw,Bearpaw Women 1959W-205 Size 10,Bearpaw Womens ELLE SHORT WIDE CHOCOLATE 1959W-205 US Size 10,FBALYB Amazon,18,17,1,0,1,0
Bearpaw,Bearpaw Women 1959W-205 Size 11,Bearpaw Womens ELLE SHORT WIDE CHOCOLATE 1959W-205 US Size 11,FBALYB Amazon,6,6,0,0,0,0
Bearpaw,Bearpaw Women 1959W-205 Size 8,Bearpaw Womens ELLE SHORT WIDE CHOCOLATE 1959W-205 US Size 8,FBALYB Amazon,11,11,0,0,0,0
Bearpaw,Bearpaw Women 1959W-205 Size 9,Bearpaw Womens ELLE SHORT WIDE CHOCOLATE 1959W-205 US Size 9,Default Ridgefield,12,12,0,0,0,0
Bearpaw,Bearpaw Women 1959W-205 Size 9,Bearpaw Womens ELLE SHORT WIDE CHOCOLATE 1959W-205 US Size 9,FBALYB Amazon,6,6,0,0,0,0
Bearpaw,Bearpaw Women 1959W-220 Size 10,Bearpaw Womens ELLE SHORT WIDE HICKORY II 1959W-220 US Size 10,Default Ridgefield,6,6,0,0,0,0
Bearpaw,Bearpaw Women 1959W-220 Size 10,Bearpaw Womens ELLE SHORT WIDE HICKORY II 1959W-220 US Size 10,FBALYB Amazon,46,46,0,0,0,0
Bearpaw,Bearpaw Women 1959W-220 Size 11,Bearpaw Womens ELLE SHORT WIDE HICKORY II 1959W-220 US Size 11,FBALYB Amazon,28,28,0,0,0,0
Bearpaw,Bearpaw Women 1959W-220 Size 7,Bearpaw Womens ELLE SHORT WIDE HICKORY II 1959W-220 US Size 7,FBALYB Amazon,10,9,1,0,1,0
Bearpaw,Bearpaw Women 1959W-220 Size 8,Bearpaw Womens ELLE SHORT WIDE HICKORY II 1959W-220 US Size 8,FBALYB Amazon,27,25,2,0,2,0
Bearpaw,Bearpaw Women 1959W-220 Size 9,Bearpaw Womens ELLE SHORT WIDE HICKORY II 1959W-220 US Size 9,FBALYB Amazon,53,53,0,0,0,0
Bearpaw,Bearpaw Women 1962W-011 Size 10,Bearpaw Womens ELLE SHORT BLACK II 1962W-011 US Size 10,FBALYB Amazon,142,137,5,0,5,0
Bearpaw,Bearpaw Women 1962W-011 Size 11,Bearpaw Womens ELLE SHORT BLACK II 1962W-011 US Size 11,FBALYB Amazon,23,22,1,0,1,0
Bearpaw,Bearpaw Women 1962W-011 Size 6,Bearpaw Womens ELLE SHORT BLACK II 1962W-011 US Size 6,FBALYB Amazon,50,49,1,0,1,0
Bearpaw,Bearpaw Women 1962W-011 Size 7,Bearpaw Womens ELLE SHORT BLACK II 1962W-011 US Size 7,FBALYB Amazon,95,95,0,0,0,0
Bearpaw,Bearpaw Women 1962W-011 Size 8,Bearpaw Womens ELLE SHORT BLACK II 1962W-011 US Size 8,FBALYB Amazon,191,186,5,0,5,0
Bearpaw,Bearpaw Women 1962W-011 Size 9,Bearpaw Womens ELLE SHORT BLACK II 1962W-011 US Size 9,Default Ridgefield,0,0,0,0,0,6
Bearpaw,Bearpaw Women 1962W-011 Size 9,Bearpaw Womens ELLE SHORT BLACK II 1962W-011 US Size 9,FBALYB Amazon,194,194,0,0,0,0
Bearpaw,Bearpaw Women 1962W-030 Size 10,Bearpaw Womens ELLE SHORT CHARCOAL 1962W-030 US Size 10,Default Ridgefield,2,2,0,0,0,0
Bearpaw,Bearpaw Women 1962W-030 Size 10,Bearpaw Womens ELLE SHORT CHARCOAL 1962W-030 US Size 10,FBALYB Amazon,243,241,2,0,2,0
Bearpaw,Bearpaw Women 1962W-030 Size 11,Bearpaw Womens ELLE SHORT CHARCOAL 1962W-030 US Size 11,FBALYB Amazon,148,147,1,0,1,0
Bearpaw,Bearpaw Women 1962W-030 Size 12,Bearpaw Womens ELLE SHORT CHARCOAL 1962W-030 US Size 12,Default Ridgefield,49,49,0,0,0,0
Bearpaw,Bearpaw Women 1962W-030 Size 12,Bearpaw Womens ELLE SHORT CHARCOAL 1962W-030 US Size 12,FBALYB Amazon,5,5,0,0,0,0
Bearpaw,Bearpaw Women 1962W-030 Size 6,Bearpaw Womens ELLE SHORT CHARCOAL 1962W-030 US Size 6,Default Ridgefield,6,6,0,0,0,0
Bearpaw,Bearpaw Women 1962W-030 Size 6,Bearpaw Womens ELLE SHORT CHARCOAL 1962W-030 US Size 6,FBALYB Amazon,67,67,0,0,0,0
Bearpaw,Bearpaw Women 1962W-030 Size 7,Bearpaw Womens ELLE SHORT CHARCOAL 1962W-030 US Size 7,FBALYB Amazon,148,147,1,0,1,0
Bearpaw,Bearpaw Women 1962W-030 Size 8,Bearpaw Womens ELLE SHORT CHARCOAL 1962W-030 US Size 8,Default Ridgefield,4,4,0,0,0,6
Bearpaw,Bearpaw Women 1962W-030 Size 8,Bearpaw Womens ELLE SHORT CHARCOAL 1962W-030 US Size 8,FBALYB Amazon,287,284,3,0,3,0
Bearpaw,Bearpaw Women 1962W-030 Size 9,Bearpaw Womens ELLE SHORT CHARCOAL 1962W-030 US Size 9,FBALYB Amazon,296,292,4,0,4,0
Bearpaw,Bearpaw Women 1962W-220 Size 10,Bearpaw Womens ELLE SHORT HICKORY II 1962W-220 US Size 10,FBALYB Amazon,147,146,1,0,1,0
Bearpaw,Bearpaw Women 1962W-220 Size 11,Bearpaw Womens ELLE SHORT HICKORY II 1962W-220 US Size 11,FBALYB Amazon,29,29,0,0,0,0
Bearpaw,Bearpaw Women 1962W-220 Size 6,Bearpaw Womens ELLE SHORT HICKORY II 1962W-220 US Size 6,FBALYB Amazon,51,47,4,0,4,0
Bearpaw,Bearpaw Women 1962W-220 Size 7,Bearpaw Womens ELLE SHORT HICKORY II 1962W-220 US Size 7,Default Ridgefield,7,7,0,0,0,0
Bearpaw,Bearpaw Women 1962W-220 Size 7,Bearpaw Womens ELLE SHORT HICKORY II 1962W-220 US Size 7,FBALYB Amazon,87,84,3,0,3,0
Bearpaw,Bearpaw Women 1962W-220 Size 8,Bearpaw Womens ELLE SHORT HICKORY II 1962W-220 US Size 8,FBALYB Amazon,162,162,0,0,0,0
Bearpaw,Bearpaw Women 1962W-220 Size 9,Bearpaw Womens ELLE SHORT HICKORY II 1962W-220 US Size 9,Default Ridgefield,0,0,0,0,0,6
Bearpaw,Bearpaw Women 1962W-220 Size 9,Bearpaw Womens ELLE SHORT HICKORY II 1962W-220 US Size 9,FBALYB Amazon,180,172,8,0,8,0
Bearpaw,Bearpaw Women 2025W-011 Size 5,Bearpaw Womens KRISTA BLACK II 2025W-011 US Size 5,FBALYB Amazon,4,4,0,0,0,0
Bearpaw,Bearpaw Women 2025W-011 Size 6,Bearpaw Womens KRISTA BLACK II 2025W-011 US Size 6,FBALYB Amazon,16,16,0,0,0,0
Bearpaw,Bearpaw Women 2025W-011 Size 7,Bearpaw Womens KRISTA BLACK II 2025W-011 US Size 7,FBALYB Amazon,19,19,0,0,0,0
Bearpaw,Bearpaw Women 2133W-055 Size 10,Bearpaw Womens VIRGINIA GRAY II 2133W-055 US Size 10,FBALYB Amazon,0,0,0,36,0,0
Bearpaw,Bearpaw Women 2133W-055 Size 6,Bearpaw Womens VIRGINIA GRAY II 2133W-055 US Size 6,FBALYB Amazon,10,10,0,0,0,0
Bearpaw,Bearpaw Women 2133W-055 Size 7,Bearpaw Womens VIRGINIA GRAY II 2133W-055 US Size 7,FBALYB Amazon,42,42,0,0,0,0
Bearpaw,Bearpaw Women 2133W-055 Size 8,Bearpaw Womens VIRGINIA GRAY II 2133W-055 US Size 8,FBALYB Amazon,56,56,0,0,0,0
Bearpaw,Bearpaw Women 2133W-055 Size 9,Bearpaw Womens VIRGINIA GRAY II 2133W-055 US Size 9,FBALYB Amazon,59,59,0,0,0,0
Bearpaw,Bearpaw Women 2133W-220 Size 10,Bearpaw Womens VIRGINIA HICKORY II 2133W-220 US Size 10,FBALYB Amazon,45,44,1,0,1,0
Bearpaw,Bearpaw Women 2133W-220 Size 11,Bearpaw Womens VIRGINIA HICKORY II 2133W-220 US Size 11,Default Ridgefield,6,6,0,0,0,0
Bearpaw,Bearpaw Women 2133W-220 Size 11,Bearpaw Womens VIRGINIA HICKORY II 2133W-220 US Size 11,FBALYB Amazon,18,17,1,0,1,0
Bearpaw,Bearpaw Women 2133W-220 Size 7,Bearpaw Womens VIRGINIA HICKORY II 2133W-220 US Size 7,Default Ridgefield,0,0,0,0,0,32
Bearpaw,Bearpaw Women 2133W-220 Size 8,Bearpaw Womens VIRGINIA HICKORY II 2133W-220 US Size 8,FBALYB Amazon,56,55,1,1,1,0
Bearpaw,Bearpaw Women 2133W-220 Size 9,Bearpaw Womens VIRGINIA HICKORY II 2133W-220 US Size 9,FBALYB Amazon,63,63,0,0,0,0
Bearpaw,Bearpaw Women 2305W-011 Size 10,Bearpaw Womens GENEVIEVE BLACK II 2305W-011 US Size 10,FBALYB Amazon,5,5,0,0,0,0
Bearpaw,Bearpaw Women 2305W-011 Size 6,Bearpaw Womens GENEVIEVE BLACK II 2305W-011 US Size 6,Default Ridgefield,0,0,0,0,0,1
Bearpaw,Bearpaw Women 2305W-011 Size 6,Bearpaw Womens GENEVIEVE BLACK II 2305W-011 US Size 6,FBALYB Amazon,5,5,0,0,0,0
Bearpaw,Bearpaw Women 2305W-011 Size 7,Bearpaw Womens GENEVIEVE BLACK II 2305W-011 US Size 7,FBALYB Amazon,7,7,0,0,0,0
Bearpaw,Bearpaw Women 2305W-051 Size 10,Bearpaw Womens GENEVIEVE GRAY FOG 2305W-051 US Size 10,FBALYB Amazon,3,2,1,0,1,0
Bearpaw,Bearpaw Women 2305W-051 Size 6,Bearpaw Womens GENEVIEVE GRAY FOG 2305W-051 US Size 6,FBALYB Amazon,4,4,0,0,0,0
Bearpaw,Bearpaw Women 2305W-051 Size 7,Bearpaw Womens GENEVIEVE GRAY FOG 2305W-051 US Size 7,FBALYB Amazon,3,3,0,0,0,0
Bearpaw,Bearpaw Women 2305W-051 Size 9,Bearpaw Womens GENEVIEVE GRAY FOG 2305W-051 US Size 9,FBALYB Amazon,9,8,1,0,1,0
Bearpaw,Bearpaw Women 2305W-240 Size 10,Bearpaw Womens GENEVIEVE SEAL BROWN 2305W-240 US Size 10,Default Ridgefield,0,0,0,0,0,5
Bearpaw,Bearpaw Women 2305W-240 Size 10,Bearpaw Womens GENEVIEVE SEAL BROWN 2305W-240 US Size 10,FBALYB Amazon,23,23,0,0,0,0
Bearpaw,Bearpaw Women 2305W-240 Size 11,Bearpaw Womens GENEVIEVE SEAL BROWN 2305W-240 US Size 11,FBALYB Amazon,5,5,0,0,0,0
Bearpaw,Bearpaw Women 2305W-240 Size 6,Bearpaw Womens GENEVIEVE SEAL BROWN 2305W-240 US Size 6,FBALYB Amazon,5,5,0,0,0,0
Bearpaw,Bearpaw Women 2305W-240 Size 7,Bearpaw Womens GENEVIEVE SEAL BROWN 2305W-240 US Size 7,FBALYB Amazon,30,29,1,0,1,0
Bearpaw,Bearpaw Women 2305W-240 Size 8,Bearpaw Womens GENEVIEVE SEAL BROWN 2305W-240 US Size 8,FBALYB Amazon,40,40,0,0,0,0
Bearpaw,Bearpaw Women 2305W-240 Size 9,Bearpaw Womens GENEVIEVE SEAL BROWN 2305W-240 US Size 9,FBALYB Amazon,41,41,0,0,0,0
Bearpaw,Bearpaw Women 2578W-011 Size 10,Bearpaw Womens SKYE BLACK II 2578W-011 US Size 10,FBALYB Amazon,51,51,0,0,0,0
Bearpaw,Bearpaw Women 2578W-011 Size 11,Bearpaw Womens SKYE BLACK II 2578W-011 US Size 11,FBALYB Amazon,21,21,0,0,0,0
Bearpaw,Bearpaw Women 2578W-011 Size 6,Bearpaw Womens SKYE BLACK II 2578W-011 US Size 6,FBALYB Amazon,24,24,0,0,0,0
Bearpaw,Bearpaw Women 2578W-011 Size 7,Bearpaw Womens SKYE BLACK II 2578W-011 US Size 7,FBALYB Amazon,36,34,2,0,2,0
Bearpaw,Bearpaw Women 2578W-011 Size 8,Bearpaw Womens SKYE BLACK II 2578W-011 US Size 8,FBALYB Amazon,80,78,2,0,2,0
Bearpaw,Bearpaw Women 2578W-011 Size 9,Bearpaw Womens SKYE BLACK II 2578W-011 US Size 9,FBALYB Amazon,78,75,3,0,3,0
Bearpaw,Bearpaw Women 2578W-051 Size 10,Bearpaw Womens SKYE GRAY FOG 2578W-051 US Size 10,FBALYB Amazon,52,52,0,0,0,0
Bearpaw,Bearpaw Women 2578W-051 Size 11,Bearpaw Womens SKYE GRAY FOG 2578W-051 US Size 11,FBALYB Amazon,24,24,0,0,0,0
Bearpaw,Bearpaw Women 2578W-051 Size 6,Bearpaw Womens SKYE GRAY FOG 2578W-051 US Size 6,FBALYB Amazon,19,19,0,3,0,0
Bearpaw,Bearpaw Women 2578W-051 Size 7,Bearpaw Womens SKYE GRAY FOG 2578W-051 US Size 7,FBALYB Amazon,41,41,0,0,0,0
Bearpaw,Bearpaw Women 2578W-051 Size 8,Bearpaw Womens SKYE GRAY FOG 2578W-051 US Size 8,Default Ridgefield,18,18,0,0,0,0
Bearpaw,Bearpaw Women 2578W-051 Size 8,Bearpaw Womens SKYE GRAY FOG 2578W-051 US Size 8,FBALYB Amazon,65,65,0,0,0,0
Bearpaw,Bearpaw Women 2578W-051 Size 9,Bearpaw Womens SKYE GRAY FOG 2578W-051 US Size 9,FBALYB Amazon,83,83,0,0,0,0
Bearpaw,Bearpaw Women 2578W-125 Size 10,Bearpaw Womens SKYE OAT 2578W-125 US Size 10,FBALYB Amazon,30,29,1,0,1,0
Bearpaw,Bearpaw Women 2578W-125 Size 11,Bearpaw Womens SKYE OAT 2578W-125 US Size 11,FBALYB Amazon,12,12,0,0,0,0
Bearpaw,Bearpaw Women 2578W-125 Size 7,Bearpaw Womens SKYE OAT 2578W-125 US Size 7,FBALYB Amazon,17,17,0,0,0,0
Bearpaw,Bearpaw Women 2578W-125 Size 8,Bearpaw Womens SKYE OAT 2578W-125 US Size 8,FBALYB Amazon,40,39,1,0,1,0
Bearpaw,Bearpaw Women 2578W-125 Size 9,Bearpaw Womens SKYE OAT 2578W-125 US Size 9,FBALYB Amazon,42,42,0,0,0,0
Bearpaw,Bearpaw Women 2578W-220 Size 10,Bearpaw Womens SKYE HICKORY II 2578W-220 US Size 10,Default Ridgefield,2,2,0,0,0,0
Bearpaw,Bearpaw Women 2578W-220 Size 10,Bearpaw Womens SKYE HICKORY II 2578W-220 US Size 10,FBALYB Amazon,51,51,0,0,0,0
Bearpaw,Bearpaw Women 2578W-220 Size 11,Bearpaw Womens SKYE HICKORY II 2578W-220 US Size 11,FBALYB Amazon,24,24,0,0,0,0
Bearpaw,Bearpaw Women 2578W-220 Size 6,Bearpaw Womens SKYE HICKORY II 2578W-220 US Size 6,FBALYB Amazon,22,22,0,0,0,0
Bearpaw,Bearpaw Women 2578W-220 Size 7,Bearpaw Womens SKYE HICKORY II 2578W-220 US Size 7,FBALYB Amazon,42,42,0,0,0,0
Bearpaw,Bearpaw Women 2578W-220 Size 8,Bearpaw Womens SKYE HICKORY II 2578W-220 US Size 8,Default Ridgefield,0,0,0,0,0,18
Bearpaw,Bearpaw Women 2578W-220 Size 8,Bearpaw Womens SKYE HICKORY II 2578W-220 US Size 8,FBALYB Amazon,0,0,0,66,0,0
Bearpaw,Bearpaw Women 2578W-220 Size 9,Bearpaw Womens SKYE HICKORY II 2578W-220 US Size 9,FBALYB Amazon,81,80,1,1,1,0
Bearpaw,Bearpaw Women 2578W-635 Size 10,Bearpaw Womens SKYE PALE PINK 2578W-635 US Size 10,FBALYB Amazon,36,36,0,0,0,0
Bearpaw,Bearpaw Women 2578W-635 Size 11,Bearpaw Womens SKYE PALE PINK 2578W-635 US Size 11,FBALYB Amazon,18,18,0,0,0,0
Bearpaw,Bearpaw Women 2578W-635 Size 6,Bearpaw Womens SKYE PALE PINK 2578W-635 US Size 6,FBALYB Amazon,18,18,0,0,0,0
Bearpaw,Bearpaw Women 2578W-635 Size 7,Bearpaw Womens SKYE PALE PINK 2578W-635 US Size 7,FBALYB Amazon,29,29,0,0,0,0
Bearpaw,Bearpaw Women 2578W-635 Size 8,Bearpaw Womens SKYE PALE PINK 2578W-635 US Size 8,FBALYB Amazon,64,64,0,0,0,0
Bearpaw,Bearpaw Women 2578W-635 Size 9,Bearpaw Womens SKYE PALE PINK 2578W-635 US Size 9,FBALYB Amazon,63,63,0,0,0,0
Bearpaw,Bearpaw Women 671W-011 Size 10,Bearpaw Womens LOKI II BLACK II 671W-011 US Size 10,FBALYB Amazon,3,0,3,0,3,0
Bearpaw,Bearpaw Women 671W-011 Size 11,Bearpaw Womens LOKI II BLACK II 671W-011 US Size 11,Default Ridgefield,204,204,0,0,0,0
Bearpaw,Bearpaw Women 671W-011 Size 12,Bearpaw Womens LOKI II BLACK II 671W-011 US Size 12,Default Ridgefield,30,30,0,0,0,0
Bearpaw,Bearpaw Women 671W-011 Size 12,Bearpaw Womens LOKI II BLACK II 671W-011 US Size 12,FBALYB Amazon,72,72,0,0,0,0
Bearpaw,Bearpaw Women 671W-011 Size 7,Bearpaw Womens LOKI II BLACK II 671W-011 US Size 7,Default Ridgefield,21,21,0,0,0,0
Bearpaw,Bearpaw Women 671W-220 Size 10,Bearpaw Womens LOKI II HICKORY II 671W-220 US Size 10,Default Ridgefield,500,500,0,0,0,0
Bearpaw,Bearpaw Women 671W-220 Size 10,Bearpaw Womens LOKI II HICKORY II 671W-220 US Size 10,FBALYB Amazon,386,382,4,0,4,0
Bearpaw,Bearpaw Women 671W-220 Size 11,Bearpaw Womens LOKI II HICKORY II 671W-220 US Size 11,Default Ridgefield,1,1,0,0,0,0
Bearpaw,Bearpaw Women 671W-220 Size 11,Bearpaw Womens LOKI II HICKORY II 671W-220 US Size 11,FBALYB Amazon,194,190,4,0,4,0
Bearpaw,Bearpaw Women 671W-220 Size 12,Bearpaw Womens LOKI II HICKORY II 671W-220 US Size 12,FBALYB Amazon,95,95,0,0,0,0
Bearpaw,Bearpaw Women 671W-220 Size 6,Bearpaw Womens LOKI II HICKORY II 671W-220 US Size 6,Default Ridgefield,2,2,0,0,0,0
Bearpaw,Bearpaw Women 671W-220 Size 6,Bearpaw Womens LOKI II HICKORY II 671W-220 US Size 6,FBALYB Amazon,200,199,1,0,1,0
Bearpaw,Bearpaw Women 671W-220 Size 7,Bearpaw Womens LOKI II HICKORY II 671W-220 US Size 7,Default Ridgefield,296,296,0,0,0,6
Bearpaw,Bearpaw Women 671W-220 Size 7,Bearpaw Womens LOKI II HICKORY II 671W-220 US Size 7,FBALYB Amazon,383,375,8,0,8,0
Bearpaw,Bearpaw Women 671W-220 Size 8,Bearpaw Womens LOKI II HICKORY II 671W-220 US Size 8,Default Ridgefield,800,800,0,0,0,0
Bearpaw,Bearpaw Women 671W-220 Size 8,Bearpaw Womens LOKI II HICKORY II 671W-220 US Size 8,FBALYB Amazon,353,330,23,0,23,0
Bearpaw,Bearpaw Women 671W-220 Size 9,Bearpaw Womens LOKI II HICKORY II 671W-220 US Size 9,Default Ridgefield,800,800,0,0,0,0
Bearpaw,Bearpaw Women 671W-220 Size 9,Bearpaw Womens LOKI II HICKORY II 671W-220 US Size 9,FBALYB Amazon,369,355,14,1,14,0
Bearpaw,Bearpaw Womens 1653W-205 Size 10,Bearpaw Womens ROSIE CHOCOLATE II 1653W-205 US Size 10,FBALYB Amazon,15,15,0,0,0,0
Bearpaw,Bearpaw Womens 1653W-205 Size 9,Bearpaw Womens ROSIE CHOCOLATE II 1653W-205 US Size 9,Default Ridgefield,6,6,0,0,0,0
Bearpaw,Bearpaw Womens 1653W-205 Size 9,Bearpaw Womens ROSIE CHOCOLATE II 1653W-205 US Size 9,FBALYB Amazon,2,2,0,0,0,0
Bearpaw,Bearpaw Womens 1854W-010 Size 10,Bearpaw Womens BOO WHITE 1854W-010 US Size 10,FBALYB Amazon,30,30,0,0,0,0
Bearpaw,Bearpaw Womens 1854W-010 Size 12,Bearpaw Womens BOO WHITE 1854W-010 US Size 12,FBALYB Amazon,6,6,0,0,0,0
Bearpaw,Bearpaw Womens 1854W-010 Size 7,Bearpaw Womens BOO WHITE 1854W-010 US Size 7,FBALYB Amazon,24,24,0,0,0,0
Bearpaw,Bearpaw Womens 1854W-010 Size 8,Bearpaw Womens BOO WHITE 1854W-010 US Size 8,Default Ridgefield,1,1,0,0,0,0
Bearpaw,Bearpaw Womens 1854W-010 Size 8,Bearpaw Womens BOO WHITE 1854W-010 US Size 8,FBALYB Amazon,40,40,0,0,0,0
Bearpaw,Bearpaw Womens 1854W-010 Size 9,Bearpaw Womens BOO WHITE 1854W-010 US Size 9,FBALYB Amazon,42,42,0,0,0,0
Bearpaw,Bearpaw Youth 1295Y-220 Size 1,Bearpaw MOC II YOUTH HICKORY II 1295Y-220 US Size 1,FBALYB Amazon,5,5,0,0,0,0
Bearpaw,Bearpaw Youth 1295Y-220 Size 13,Bearpaw MOC II YOUTH HICKORY II 1295Y-220 US Size 13,Default Ridgefield,6,6,0,0,0,0
Bearpaw,Bearpaw Youth 1295Y-220 Size 13,Bearpaw MOC II YOUTH HICKORY II 1295Y-220 US Size 13,FBALYB Amazon,3,2,1,0,1,0
Bearpaw,Bearpaw Youth 1295Y-220 Size 2,Bearpaw MOC II YOUTH HICKORY II 1295Y-220 US Size 2,FBALYB Amazon,6,6,0,0,0,0
Bearpaw,Bearpaw Youth 1295Y-220 Size 3,Bearpaw MOC II YOUTH HICKORY II 1295Y-220 US Size 3,Default Ridgefield,10,10,0,0,0,0
Bearpaw,Bearpaw Youth 1295Y-220 Size 4,Bearpaw MOC II YOUTH HICKORY II 1295Y-220 US Size 4,Default Ridgefield,8,8,0,0,0,0
Bearpaw,Bearpaw Youth 1295Y-220 Size 5,Bearpaw MOC II YOUTH HICKORY II 1295Y-220 US Size 5,FBALYB Amazon,5,5,0,0,0,0
Bearpaw,Bearpaw Youth 1854Y-011 Size 1,Bearpaw BOO YOUTH BLACK II 1854Y-011 US Size 1,Default Ridgefield,2,2,0,0,0,0
Bearpaw,Bearpaw Youth 1854Y-011 Size 1,Bearpaw BOO YOUTH BLACK II 1854Y-011 US Size 1,FBALYB Amazon,42,42,0,0,0,0
Bearpaw,Bearpaw Youth 1854Y-011 Size 3,Bearpaw BOO YOUTH BLACK II 1854Y-011 US Size 3,FBALYB Amazon,5,5,0,0,0,0
Bearpaw,Bearpaw Youth 1854Y-011 Size 4,Bearpaw BOO YOUTH BLACK II 1854Y-011 US Size 4,FBALYB Amazon,1,1,0,0,0,0
Bearpaw,Bearpaw Youth 1854Y-011 Size 5,Bearpaw BOO YOUTH BLACK II 1854Y-011 US Size 5,FBALYB Amazon,3,3,0,0,0,0
Bearpaw,Bearpaw Youth 1871Y-012 Size 1,Bearpaw KELLY YOUTH BLACK/GREY 1871Y-012 US Size 1,Default Ridgefield,24,24,0,0,0,0
Bearpaw,Bearpaw Youth 1871Y-012 Size 2,Bearpaw KELLY YOUTH BLACK/GREY 1871Y-012 US Size 2,FBALYB Amazon,24,24,0,0,0,0
Bearpaw,Bearpaw Youth 1871Y-012 Size 3,Bearpaw KELLY YOUTH BLACK/GREY 1871Y-012 US Size 3,Default Ridgefield,36,36,0,0,0,0
Bearpaw,Bearpaw Youth 1871Y-012 Size 3,Bearpaw KELLY YOUTH BLACK/GREY 1871Y-012 US Size 3,FBALYB Amazon,6,6,0,0,0,0
Bearpaw,Bearpaw Youth 1871Y-012 Size 4,Bearpaw KELLY YOUTH BLACK/GREY 1871Y-012 US Size 4,Default Ridgefield,36,36,0,0,0,0
Bearpaw,Bearpaw Youth 1871Y-012 Size 4,Bearpaw KELLY YOUTH BLACK/GREY 1871Y-012 US Size 4,FBALYB Amazon,6,6,0,0,0,0
Bearpaw,Bearpaw Youth 1871Y-012 Size 5,Bearpaw KELLY YOUTH BLACK/GREY 1871Y-012 US Size 5,FBALYB Amazon,60,60,0,0,0,0
Bearpaw,Bearpaw Youth 1871Y-220 Size 1,Bearpaw KELLY YOUTH HICKORY II 1871Y-220 US Size 1,FBALYB Amazon,42,42,0,0,0,0
Bearpaw,Bearpaw Youth 1871Y-220 Size 13,Bearpaw KELLY YOUTH HICKORY II 1871Y-220 US Size 13,FBALYB Amazon,24,24,0,0,0,0
Bearpaw,Bearpaw Youth 1871Y-220 Size 2,Bearpaw KELLY YOUTH HICKORY II 1871Y-220 US Size 2,Default Ridgefield,6,6,0,0,0,0
Bearpaw,Bearpaw Youth 1871Y-220 Size 2,Bearpaw KELLY YOUTH HICKORY II 1871Y-220 US Size 2,FBALYB Amazon,36,36,0,0,0,0
Bearpaw,Bearpaw Youth 1871Y-220 Size 3,Bearpaw KELLY YOUTH HICKORY II 1871Y-220 US Size 3,Default Ridgefield,34,34,0,0,0,0
Bearpaw,Bearpaw Youth 1871Y-220 Size 3,Bearpaw KELLY YOUTH HICKORY II 1871Y-220 US Size 3,FBALYB Amazon,49,49,0,0,0,0
Bearpaw,Bearpaw Youth 1871Y-220 Size 4,Bearpaw KELLY YOUTH HICKORY II 1871Y-220 US Size 4,Default Ridgefield,1,1,0,0,0,0
Bearpaw,Bearpaw Youth 1871Y-220 Size 4,Bearpaw KELLY YOUTH HICKORY II 1871Y-220 US Size 4,FBALYB Amazon,35,35,0,48,0,0
Bearpaw,Bearpaw Youth 1871Y-220 Size 5,Bearpaw KELLY YOUTH HICKORY II 1871Y-220 US Size 5,Default Ridgefield,54,54,0,0,0,0
Bearpaw,Bearpaw Youth 1871Y-220 Size 5,Bearpaw KELLY YOUTH HICKORY II 1871Y-220 US Size 5,FBALYB Amazon,48,48,0,0,0,0
Bearpaw,Bearpaw Youth 1871Y-652 Size 3,Bearpaw KELLY YOUTH PINK 1871Y-652 US Size 3,FBALYB Amazon,4,4,0,0,0,0
Bearpaw,Bearpaw Youth 1871Y-652 Size 4,Bearpaw KELLY YOUTH PINK 1871Y-652 US Size 4,FBALYB Amazon,23,23,0,0,0,0
Bearpaw,Bearpaw Youth 1871Y-652 Size 5,Bearpaw KELLY YOUTH PINK 1871Y-652 US Size 5,FBALYB Amazon,23,23,0,0,0,0
Bearpaw,bearpaw youth 1955y-011 size 1,Bearpaw PHYLLY YOUTH BLACK II 1955Y-011 US Size 1,FBALYB Amazon,78,78,0,0,0,0
Bearpaw,bearpaw youth 1955y-011 size 13,Bearpaw PHYLLY YOUTH BLACK II 1955Y-011 US Size 13,FBALYB Amazon,54,54,0,0,0,0
Bearpaw,bearpaw youth 1955y-011 size 2,Bearpaw PHYLLY YOUTH BLACK II 1955Y-011 US Size 2,FBALYB Amazon,102,102,0,0,0,0
Bearpaw,bearpaw youth 1955y-011 size 3,Bearpaw PHYLLY YOUTH BLACK II 1955Y-011 US Size 3,FBALYB Amazon,150,150,0,0,0,0
Bearpaw,bearpaw youth 1955y-011 size 4,Bearpaw PHYLLY YOUTH BLACK II 1955Y-011 US Size 4,FBALYB Amazon,203,203,0,0,0,0
Bearpaw,bearpaw youth 1955y-011 size 5,Bearpaw PHYLLY YOUTH BLACK II 1955Y-011 US Size 5,Default Ridgefield,11,11,0,0,0,0
Bearpaw,bearpaw youth 1955y-011 size 5,Bearpaw PHYLLY YOUTH BLACK II 1955Y-011 US Size 5,FBALYB Amazon,190,190,0,0,0,0
Bearpaw,Bearpaw Youth 1955Y-220 Size 1,Bearpaw PHYLLY YOUTH HICKORY II 1955Y-220 US Size 1,FBALYB Amazon,78,78,0,0,0,0
Bearpaw,Bearpaw Youth 1955Y-220 Size 13,Bearpaw PHYLLY YOUTH HICKORY II 1955Y-220 US Size 13,FBALYB Amazon,54,54,0,0,0,0
Bearpaw,Bearpaw Youth 1955Y-220 Size 2,Bearpaw PHYLLY YOUTH HICKORY II 1955Y-220 US Size 2,Default Ridgefield,0,0,0,0,0,6
Bearpaw,Bearpaw Youth 1955Y-220 Size 2,Bearpaw PHYLLY YOUTH HICKORY II 1955Y-220 US Size 2,FBALYB Amazon,96,96,0,0,0,0
Bearpaw,Bearpaw Youth 1955Y-220 Size 3,Bearpaw PHYLLY YOUTH HICKORY II 1955Y-220 US Size 3,Default Ridgefield,6,6,0,0,0,0
Bearpaw,Bearpaw Youth 1955Y-220 Size 3,Bearpaw PHYLLY YOUTH HICKORY II 1955Y-220 US Size 3,FBALYB Amazon,141,141,0,3,0,0
Bearpaw,Bearpaw Youth 1955Y-220 Size 4,Bearpaw PHYLLY YOUTH HICKORY II 1955Y-220 US Size 4,Default Ridgefield,0,0,0,0,0,1
Bearpaw,Bearpaw Youth 1955Y-220 Size 4,Bearpaw PHYLLY YOUTH HICKORY II 1955Y-220 US Size 4,FBALYB Amazon,189,189,0,0,0,0
Bearpaw,Bearpaw Youth 1955Y-220 Size 5,Bearpaw PHYLLY YOUTH HICKORY II 1955Y-220 US Size 5,FBALYB Amazon,204,204,0,0,0,0
Bearpaw,Bearpaw Youth 1962Y-011 Size 1,Bearpaw ELLE YOUTH BLACK II 1962Y-011 US Size 1,FBALYB Amazon,29,29,0,0,0,0
Bearpaw,Bearpaw Youth 1962Y-011 Size 13,Bearpaw ELLE YOUTH BLACK II 1962Y-011 US Size 13,FBALYB Amazon,29,29,0,0,0,0
Bearpaw,Bearpaw Youth 1962Y-011 Size 2,Bearpaw ELLE YOUTH BLACK II 1962Y-011 US Size 2,FBALYB Amazon,54,54,0,0,0,0
Bearpaw,Bearpaw Youth 1962Y-011 Size 3,Bearpaw ELLE YOUTH BLACK II 1962Y-011 US Size 3,FBALYB Amazon,54,54,0,0,0,0
Bearpaw,Bearpaw Youth 1962Y-011 Size 4,Bearpaw ELLE YOUTH BLACK II 1962Y-011 US Size 4,FBALYB Amazon,77,76,1,0,1,0
Bearpaw,Bearpaw Youth 1962Y-011 Size 5,Bearpaw ELLE YOUTH BLACK II 1962Y-011 US Size 5,FBALYB Amazon,78,78,0,0,0,0
Bearpaw,Bearpaw  Youth 1962Y-051 Size 1,Bearpaw ELLE YOUTH GRAY FOG 1962Y-051 US Size 1,FBALYB Amazon,27,27,0,0,0,0
Bearpaw,Bearpaw  Youth 1962Y-051 Size 13,Bearpaw ELLE YOUTH GRAY FOG 1962Y-051 US Size 13,FBALYB Amazon,29,29,0,0,0,0
Bearpaw,Bearpaw  Youth 1962Y-051 Size 2,Bearpaw ELLE YOUTH GRAY FOG 1962Y-051 US Size 2,FBALYB Amazon,49,48,1,0,1,0
Bearpaw,Bearpaw  Youth 1962Y-051 Size 3,Bearpaw ELLE YOUTH GRAY FOG 1962Y-051 US Size 3,FBALYB Amazon,1,1,0,0,0,0
Bearpaw,Bearpaw Youth 1962Y-220 Size 1,Bearpaw ELLE YOUTH HICKORY II 1962Y-220 US Size 1,FBALYB Amazon,30,30,0,0,0,0
Bearpaw,Bearpaw Youth 1962Y-220 Size 13,Bearpaw ELLE YOUTH HICKORY II 1962Y-220 US Size 13,FBALYB Amazon,30,30,0,0,0,0
Bearpaw,Bearpaw Youth 1962Y-220 Size 2,Bearpaw ELLE YOUTH HICKORY II 1962Y-220 US Size 2,FBALYB Amazon,53,53,0,0,0,0
Bearpaw,Bearpaw Youth 1962Y-220 Size 3,Bearpaw ELLE YOUTH HICKORY II 1962Y-220 US Size 3,FBALYB Amazon,52,52,0,0,0,0
Bearpaw,Bearpaw Youth 1962Y-220 Size 4,Bearpaw ELLE YOUTH HICKORY II 1962Y-220 US Size 4,FBALYB Amazon,78,78,0,0,0,0
Bearpaw,Bearpaw Youth 1962Y-220 Size 5,Bearpaw ELLE YOUTH HICKORY II 1962Y-220 US Size 5,Default Ridgefield,0,0,0,0,0,6
Bearpaw,Bearpaw Youth 1962Y-220 Size 5,Bearpaw ELLE YOUTH HICKORY II 1962Y-220 US Size 5,FBALYB Amazon,71,71,0,0,0,0
Bearpaw,Bearpaw Youth 2166Y-011 Size 2,Bearpaw BRADY YOUTH BLACK II 2166Y-011 US Size 2,FBALYB Amazon,20,19,1,0,1,0
Bearpaw,Bearpaw Youth 2166Y-011 Size 5,Bearpaw BRADY YOUTH BLACK II 2166Y-011 US Size 5,FBALYB Amazon,12,12,0,0,0,0
Bearpaw,Bearpaw Youth 608Y-205 Size 2,Bearpaw EMMA YOUTH CHOCOLATE II 608Y-205 US Size 2,FBALYB Amazon,14,14,0,0,0,0
Bearpaw,Bearpaw Youth 608Y-205 Size 4,Bearpaw EMMA YOUTH CHOCOLATE II 608Y-205 US Size 4,FBALYB Amazon,40,40,0,0,0,0
Bearpaw,Bearpaw Youth 618Y-011 Size 1,Bearpaw EMMA TALL YOUTH BLACK II 618Y-011 US Size 1,FBALYB Amazon,19,19,0,0,0,0
Bearpaw,Bearpaw Youth 618Y-011 Size 13,Bearpaw EMMA TALL YOUTH BLACK II 618Y-011 US Size 13,FBALYB Amazon,18,18,0,0,0,0
Bearpaw,Bearpaw Youth 618Y-011 Size 2,Bearpaw EMMA TALL YOUTH BLACK II 618Y-011 US Size 2,Default Ridgefield,2,2,0,0,0,0
Bearpaw,Bearpaw Youth 618Y-011 Size 2,Bearpaw EMMA TALL YOUTH BLACK II 618Y-011 US Size 2,FBALYB Amazon,193,193,0,0,0,0
Bearpaw,Bearpaw Youth 618Y-011 Size 3,Bearpaw EMMA TALL YOUTH BLACK II 618Y-011 US Size 3,Default Ridgefield,35,35,0,0,0,0
Bearpaw,Bearpaw Youth 618Y-011 Size 3,Bearpaw EMMA TALL YOUTH BLACK II 618Y-011 US Size 3,FBALYB Amazon,186,185,1,0,1,0
Bearpaw,Bearpaw Youth 618Y-011 Size 4,Bearpaw EMMA TALL YOUTH BLACK II 618Y-011 US Size 4,FBALYB Amazon,253,248,5,4,5,0
Bearpaw,Bearpaw Youth 618Y-011 Size 5,Bearpaw EMMA TALL YOUTH BLACK II 618Y-011 US Size 5,Default Ridgefield,2,2,0,0,0,2
Bearpaw,Bearpaw Youth 618Y-011 Size 5,Bearpaw EMMA TALL YOUTH BLACK II 618Y-011 US Size 5,FBALYB Amazon,15,11,4,0,4,0
Beauty & Personal Care,Kevin Murphy Re.Store 200ML,Kevin Murphy Re.Store 200ML,Default Ridgefield,2,2,0,0,0,0
Birch Benders,Birch Benders Brwnie Cup DBL CC,Birch Benders Brownie Cup Keto Friendly Double Chocolate,Default Ridgefield,29,29,0,0,0,0
Birch Benders,Birch Benders Cake Cup BDay cake,Birch Benders Cake Cup Keto Friendly Birthday Cake,Default Ridgefield,7,7,0,0,0,0
Birch Benders,Birch Benders Cookie Cup CC,Birch Benders Cookie Cup Keto Friendly Chocholate Chip,Default Ridgefield,6,6,0,0,0,0
Birch Benders,Birch Benders Mfn Cup Blueberry,Birch Benders Muffin Cup Keto Friendly Blueberry,Default Ridgefield,13,13,0,0,0,0
Bob's Red Mill,Bobs Red Mill Choc Cake Mix GF,Bob's Red Mill Chocolate Cake Mix Gluten Free,Default Ridgefield,3,3,0,0,0,0
Bob's Red Mill,Bobs Red Mill Choc Cake Mix GF,Bob's Red Mill Chocolate Cake Mix Gluten Free,FBALYB Amazon,295,292,3,0,3,0
Bob's Red Mill,Bobs Red Mill CranAlmond Granola,Bob's Red Mill Cranberry Almond Granola,Default Ridgefield,12,12,0,0,0,0
Bumble & Bumble,B&B 150ML ALL-STYLE BLOW DRY,Bumble & Bumble 150ML ALL-STYLE BLOW DRY,Default Ridgefield,96,96,0,0,0,0
Bumble & Bumble,B&B CNDITIONER 1000ML SUPER RICH,Bumble & Bumble CONDITIONER 1000ML SUPER RICH,Default Ridgefield,18,18,0,0,0,0
Bumble & Bumble,B&B CNDTNR 200ML HAIRDRESS INVIS,Bumble & Bumble CONDITIONER 200ML HAIRDRESSER INVISIBLE,Default Ridgefield,72,72,0,0,0,0
Bumble & Bumble,B&B CNDTNR 250ML CURL CUSTOM,Bumble & Bumble CONDITIONER 250ML CURL CUSTOM,Default Ridgefield,24,24,0,0,0,0
Bumble & Bumble,B&B CONDITIONER 150ML CLR MNDD,Bumble & Bumble CONDITIONER 150ML COLOR MINDED,Default Ridgefield,24,24,0,0,0,0
Bumble & Bumble,B&B CREME 150ML STRAIGHT BLOW-D,Bumble & Bumble CREME 150ML STRAIGHT BLOW DRY,Default Ridgefield,168,168,0,0,0,0
Bumble & Bumble,B&B CREME 250ML STYLING,Bumble & Bumble CREME 250ML STYLING,Default Ridgefield,288,288,0,0,0,0
Bumble & Bumble,B&B CURL DEFINING 250ML CREME,Bumble & Bumble CURL DEFINING 250ML CREME,Default Ridgefield,1,1,0,0,0,0
Bumble & Bumble,B&B CURL DEFINING 250ML CREME,Bumble & Bumble CURL DEFINING 250ML CREME,FBALYB Amazon,0,0,0,239,0,0
Bumble & Bumble,B&B FOAM 150ML SURF STYLING BDry,Bumble & Bumble FOAM 150ML SURF STYLING SPRAY BLOW DRY,Default Ridgefield,72,72,0,0,0,0
Bumble & Bumble,B&B GEL OIL 150ML ANTI HUMIDITY,Bumble & Bumble GEL OIL 150ML ANTI HUMIDITY,Default Ridgefield,144,144,0,0,0,0
Bumble & Bumble,B&B MOUSSE 146ML CURL,Bumble & Bumble MOUSSE 146ML CURL,Default Ridgefield,96,96,0,0,0,0
Bumble & Bumble,B&B MOUSSE 150ML FULL FORM,Bumble & Bumble MOUSSE 150ML FULL FORM,Default Ridgefield,144,144,0,0,0,0
Bumble & Bumble,B&B OIL MASK 200ML HAIRDRESS,Bumble & Bumble OIL MASK 200ML HAIRDRESSER'S,FBALYB Amazon,0,0,0,48,0,0
Bumble & Bumble,B&B POMADE 50ML SEMI SUMO,Bumble & Bumble POMADE 50ML SEMI SUMO,FBALYB Amazon,0,0,0,48,0,0
Bumble & Bumble,B&B REPAIR 150ML REPAIR B-DRY,Bumble & Bumble REPAIR 150ML REPAIR BLOW DRY,FBALYB Amazon,0,0,0,144,0,0
Bumble & Bumble,B&B SHAMP 250ML COLOR MIND,Bumble & Bumble SHAMPOO 250ML COLOR MINDED,FBALYB Amazon,0,0,0,24,0,0
Bumble & Bumble,B&B SHAMP 250ML CURL MOISTUR,Bumble & Bumble SHAMPOO 250ML CURL MOISTURIZING,FBALYB Amazon,0,0,0,48,0,0
Bumble & Bumble,B&B SHAMPOO 1000ML GENTLE,Bumble & Bumble SHAMPOO 1000ML GENTLE,FBALYB Amazon,0,0,0,24,0,0
Bumble & Bumble,B&B SHAMPOO 1000ML SEAWEED,Bumble & Bumble SHAMPOO 1000ML SEAWEED,FBALYB Amazon,0,0,0,24,0,0
Bumble & Bumble,B&B SHAMPOO 1000ML THICKENING,Bumble & Bumble SHAMPOO 1000ML THICKENING,Default Ridgefield,24,24,0,0,0,0
Bumble & Bumble,B&B SHAMPOO 250ML FULL POTEN,Bumble & Bumble SHAMPOO 250ML FULL POTENTIAL,Default Ridgefield,72,72,0,0,0,0
Bumble & Bumble,B&B SPRAY 150ML UV PRTCT DRY OIL,Bumble & Bumble SPRAY 150ML UV PROTECT DRY OIL,Default Ridgefield,48,48,0,0,0,0
Bumble & Bumble,B&B SPRAY 250ML HOLDING,Bumble & Bumble SPRAY 250ML HOLDING,FBALYB Amazon,24,24,0,0,0,0
Bumble & Bumble,B&B STYL 300ML DOES IT ALL SPRAY,Bumble & Bumble STYLING 300ML DOES IT ALL SPRAY,FBALYB Amazon,24,21,3,0,3,0
Bumble & Bumble,B&B STYLING LEAVE IN 150ML SURF,Bumble & Bumble STYLING LEAVE IN 150ML SURF,Default Ridgefield,48,48,0,0,0,0
Bumble & Bumble,B&B THICKENING 250ML GO BIG,Bumble & Bumble THICKENING 250ML GO BIG,Default Ridgefield,1,1,0,0,0,0
Bumble & Bumble,B&B THICKENING 250ML GO BIG,Bumble & Bumble THICKENING 250ML GO BIG,FBALYB Amazon,123,114,9,0,9,0
Bumble & Bumble,B&B TREATMENT OIL 4X15ML HOT,Bumble & Bumble TREATMENT OIL 4X15ML HOT,FBALYB Amazon,0,0,0,24,0,0
Bumble & Bumble,B&B VOLSHAMP 250ML THICKENING,Bumble & Bumble VOLUME SHAMPOO 250ML THICKENING,FBALYB Amazon,0,0,0,48,0,0
Bumble & Bumble,Bumble & Bumble 150ML BB. GEL,Bumble & Bumble 150ML BB. GEL,Default Ridgefield,48,48,0,0,0,0
Bumble & Bumble,Bumble & Bumble 45ML SUMO CLAY,Bumble & Bumble 45ML SUMO CLAY,Default Ridgefield,1,1,0,0,0,0
Bumble & Bumble,Bumble & Bumble 45ML SUMO CLAY,Bumble & Bumble 45ML SUMO CLAY,FBALYB Amazon,0,0,0,191,0,0
Camelbak,Camelbak Chs Bke Vst 50oz Bk uni,"Camelbak Chase Bike Vest 50oz, Black -UNISEX",Default Ridgefield,194,194,0,0,0,0
Camelbak,"Camelbak Lobo, 100 oz., Black","Camelbak Lobo, 100 oz., Black",Default Ridgefield,158,158,0,0,0,0
Camelbak,Camelbak Lobo 100oz Gibraltr Nvy,"Camelbak Lobo, 100 oz., Gibraltar Navy",Default Ridgefield,58,58,0,0,0,0
Camelbak,"Camelbak LUXE 100 oz., Black","Camelbak L.U.X.E., 100 oz., Black",Default Ridgefield,214,214,0,0,0,0
Camelbak,Camelbak LUXE 100oz Cerise/Pom,"Camelbak L.U.X.E., 100 oz.,Cerise/Pomegranate",Default Ridgefield,52,52,0,0,0,0
Camelbak,Camelbak LUXE 100 oz MB/BH,"Camelbak L.U.X.E., 100 oz., Mineral Blue/Blue Haze",Default Ridgefield,52,52,0,0,0,0
Camelbak,"Camelbak Magic, 70 oz., Black","Camelbak Magic, 70 oz., Black",Default Ridgefield,454,454,0,0,0,0
Camelbak,Camelbak Magic 70oz MB/BH,"Camelbak Magic, 70 oz., Mineral Blue/Blue Haze",Default Ridgefield,166,166,0,0,0,0
Camelbak,Camelbak Mini MULE 50oz Camflage,Camelbak Mini M.U.L.E. 50 oz Camelflage,Default Ridgefield,1438,1438,0,0,0,0
Camelbak,Camelbak Mini MULE 50oz HP/PS,"Camelbak Mini M.U.L.E., 50 oz Hot Pink/Purple Stripe",Default Ridgefield,78,78,0,0,0,0
Camelbak,Camelbak MULE 100oz Kelp/Black,"Camelbak M.U.L.E. 100 oz., Kelp/Black",Default Ridgefield,88,88,0,0,0,0
Camelbak,Camelbak Podium Flow Blt 21oz Bk,Camelbak Podium Flow Belt 21oz Black,Default Ridgefield,358,358,0,0,0,0
Camelbak,Camelbak Repack LR 4 50 oz Black,Camelbak Repack LR 4 50 oz Black,Default Ridgefield,98,98,0,0,0,0
Camelbak,Camelbak Scout 50oz Maui Bl Prnt,Camelbak Scout 50 oz Maui Blue Print,Default Ridgefield,184,184,0,0,0,0
Camelbak,Camelbak Scout 50oz PS/Az,Camelbak Scout 50 oz Purple Sapphire/Azaela,Default Ridgefield,21,21,0,0,0,0
Chaco,Chaco J105375 Size 10,Chaco Z1 CLASSIC/BLACK US Size: M10 Widht: M J105375,Default Ridgefield,0,0,0,0,0,102
Chaco,Chaco J105375 Size 12,Chaco Z1 CLASSIC/BLACK US Size: M12 Widht: M J105375,Default Ridgefield,0,0,0,0,0,72
Chaco,Chaco J105375 Size 13,Chaco Z1 CLASSIC/BLACK US Size: M13 Widht: M J105375,Default Ridgefield,0,0,0,0,0,60
Chaco,Chaco J105375 Size 14,Chaco Z1 CLASSIC/BLACK US Size: M14 Widht: M J105375,Default Ridgefield,0,0,0,0,0,12
Chaco,Chaco J105375 Size 8,Chaco Z1 CLASSIC/BLACK US Size: M8 Widht: M J105375,Default Ridgefield,0,0,0,0,0,36
Chaco,Chaco J105375 Size 9,Chaco Z1 CLASSIC/BLACK US Size: M9 Widht: M J105375,Default Ridgefield,0,0,0,0,0,84
Chaco,Chaco J105375W Size 10,Chaco Z1 CLASSIC/BLACK US Size: M10 Widht: W J105375W,Default Ridgefield,0,0,0,0,0,119
Chaco,Chaco J105375W Size 12,Chaco Z1 CLASSIC/BLACK US Size: M12 Widht: W J105375W,Default Ridgefield,0,0,0,0,0,59
Chaco,Chaco J105375W Size 8,Chaco Z1 CLASSIC/BLACK US Size: M8 Widht: W J105375W,Default Ridgefield,0,0,0,0,0,30
Chaco,Chaco J105414W Size 10,Chaco Z1 CLASSIC/BLACK US Size: W10 Widht: W J105414W,Default Ridgefield,0,0,0,0,0,41
Chaco,Chaco J105414W Size 6,Chaco Z1 CLASSIC/BLACK US Size: W6 Widht: W J105414W,Default Ridgefield,0,0,0,0,0,22
Chaco,Chaco J105414W Size 9,Chaco Z1 CLASSIC/BLACK US Size: W9 Widht: W J105414W,Default Ridgefield,0,0,0,0,0,63
Chaco,Chaco J105427 Size 14,Chaco Z2 CLASSIC/BLACK US Size: M14 Widht: M J105427,Default Ridgefield,0,0,0,0,0,12
Chaco,Chaco J105430 Size 10,Chaco Z2 CLASSIC/BLACK US Size: W10 Widht: M J105430,Default Ridgefield,0,0,0,0,0,54
Chaco,Chaco J105430 Size 11,Chaco Z2 CLASSIC/BLACK US Size: W11 Widht: M J105430,Default Ridgefield,0,0,0,0,0,12
Chaco,Chaco J105430 Size 7,Chaco Z2 CLASSIC/BLACK US Size: W7 Widht: M J105430,Default Ridgefield,0,0,0,0,0,90
Chaco,Chaco J105430 Size 8,Chaco Z2 CLASSIC/BLACK US Size: W8 Widht: M J105430,Default Ridgefield,0,0,0,0,0,138
Chaco,Chaco J105430 Size 9,Chaco Z2 CLASSIC/BLACK US Size: W9 Widht: M J105430,Default Ridgefield,0,0,0,0,0,90
Chaco,Chaco J105430W Size 10,Chaco Z2 CLASSIC/BLACK US Size: W10 Widht: W J105430W,Default Ridgefield,0,0,0,0,0,36
Chaco,Chaco J105430W Size 6,Chaco Z2 CLASSIC/BLACK US Size: W6 Widht: W J105430W,Default Ridgefield,0,0,0,0,0,18
Chaco,Chaco J105430W Size 8,Chaco Z2 CLASSIC/BLACK US Size: W8 Widht: W J105430W,Default Ridgefield,0,0,0,0,0,100
Chaco,Chaco J105430W Size 9,Chaco Z2 CLASSIC/BLACK US Size: W9 Widht: W J105430W,Default Ridgefield,0,0,0,0,0,65
Chaco,Chaco J105492 Size 6,Chaco ZX2 CLASSIC/BLACK US Size: W6 Widht: M J105492,Default Ridgefield,0,0,0,0,0,24
Chaco,Chaco J105492 Size 7,Chaco ZX2 CLASSIC/BLACK US Size: W7 Widht: M J105492,Default Ridgefield,0,0,0,0,0,78
Chaco,Chaco J105492 Size 8,Chaco ZX2 CLASSIC/BLACK US Size: W8 Widht: M J105492,Default Ridgefield,0,0,0,0,0,120
Chaco,Chaco J105492W Size 6,Chaco ZX2 CLASSIC/BLACK US Size: W6 Widht: W J105492W,Default Ridgefield,0,0,0,0,0,22
Chaco,Chaco J105492W Size 9,Chaco ZX2 CLASSIC/BLACK US Size: W9 Widht: W J105492W,Default Ridgefield,0,0,0,0,0,63
Chaco,Chaco J105961 Size 11,Chaco Z1 CLASSIC/SPLIT GRAY US Size: M11 Widht: M J105961,Default Ridgefield,0,0,0,0,0,72
Chaco,Chaco J105961 Size 13,Chaco Z1 CLASSIC/SPLIT GRAY US Size: M13 Widht: M J105961,Default Ridgefield,0,0,0,0,0,60
Chaco,Chaco J105961 Size 14,Chaco Z1 CLASSIC/SPLIT GRAY US Size: M14 Widht: M J105961,Default Ridgefield,0,0,0,0,0,12
Chaco,Chaco J105961W Size 11,Chaco Z1 CLASSIC/SPLIT GRAY US Size: M11 Widht: W J105961W,Default Ridgefield,0,0,0,0,0,45
Chaco,Chaco J105961W Size 12,Chaco Z1 CLASSIC/SPLIT GRAY US Size: M12 Widht: W J105961W,Default Ridgefield,0,0,0,0,0,45
Chaco,Chaco J105961W Size 8,Chaco Z1 CLASSIC/SPLIT GRAY US Size: M8 Widht: W J105961W,Default Ridgefield,0,0,0,0,0,28
Chaco,Chaco J106171 Size 10,Chaco Z2 CLASSIC/STEPPED NAVY US Size: M10 Widht: M J106171,Default Ridgefield,0,0,0,0,0,96
Chaco,Chaco J106171 Size 11,Chaco Z2 CLASSIC/STEPPED NAVY US Size: M11 Widht: M J106171,Default Ridgefield,0,0,0,0,0,72
Chaco,Chaco J106171 Size 12,Chaco Z2 CLASSIC/STEPPED NAVY US Size: M12 Widht: M J106171,Default Ridgefield,0,0,0,0,0,72
Chaco,Chaco J106171 Size 14,Chaco Z2 CLASSIC/STEPPED NAVY US Size: M14 Widht: M J106171,Default Ridgefield,0,0,0,0,0,12
Chaco,Chaco J106171 Size 9,Chaco Z2 CLASSIC/STEPPED NAVY US Size: M9 Widht: M J106171,Default Ridgefield,0,0,0,0,0,84
Chaco,Chaco J106171W Size 10,Chaco Z2 CLASSIC/STEPPED NAVY US Size: M10 Widht: W J106171W,Default Ridgefield,0,0,0,0,0,83
Chaco,Chaco J106171W Size 11,Chaco Z2 CLASSIC/STEPPED NAVY US Size: M11 Widht: W J106171W,Default Ridgefield,0,0,0,0,0,48
Chaco,Chaco J106171W Size 12,Chaco Z2 CLASSIC/STEPPED NAVY US Size: M12 Widht: W J106171W,Default Ridgefield,0,0,0,0,0,47
Chaco,Chaco J107320 size 10,Chaco Womens ZCLOUD X2 ZCLOUD X2 Black J107320 US size 10,Default Ridgefield,0,0,0,0,0,48
Chaco,Chaco J107320 size 11,Chaco Womens ZCLOUD X2 ZCLOUD X2 Black J107320 US size 11,Default Ridgefield,0,0,0,0,0,15
Chaco,Chaco J107320 size 6,Chaco Womens ZCLOUD X2 ZCLOUD X2 Black J107320 US size 6,Default Ridgefield,0,0,0,0,0,24
Chaco,Chaco J107320 size 7,Chaco Womens ZCLOUD X2 ZCLOUD X2 Black J107320 US size 7,Default Ridgefield,0,0,0,0,0,83
Chaco,Chaco J107320 size 8,Chaco Womens ZCLOUD X2 ZCLOUD X2 Black J107320 US size 8,Default Ridgefield,0,0,0,0,0,126
Chaco,Chaco J107320 size 9,Chaco Womens ZCLOUD X2 ZCLOUD X2 Black J107320 US size 9,Default Ridgefield,0,0,0,0,0,83
Chaco,Chaco J107366 Size 10,Chaco Womens ZCLOUD ZCLOUD J107366 Black US Size 10,Default Ridgefield,0,0,0,0,0,42
Chaco,Chaco J107366 Size 11,Chaco Womens ZCLOUD ZCLOUD J107366 Black US Size 11,Default Ridgefield,0,0,0,0,0,24
Chaco,Chaco J107366 Size 6,Chaco Womens ZCLOUD ZCLOUD J107366 Black US Size 6,Default Ridgefield,0,0,0,0,0,30
Chaco,Chaco J107366 Size 7,Chaco Womens ZCLOUD ZCLOUD J107366 Black US Size 7,Default Ridgefield,0,0,0,0,0,60
Chaco,Chaco J107366 Size 8,Chaco Womens ZCLOUD ZCLOUD J107366 Black US Size 8,Default Ridgefield,0,0,0,0,0,78
Chaco,Chaco J107366 Size 9,Chaco Womens ZCLOUD ZCLOUD J107366 Black US Size 9,Default Ridgefield,0,0,0,0,0,60
Chaco,Chaco JCH106829 Size 11,Chaco BANDED Z CLOUD/SOLID BLACK US size: M11 Width:M JCH106829,Default Ridgefield,0,0,0,0,0,47
Chaco,Chaco JCH106829 Size 12,Chaco BANDED Z CLOUD/SOLID BLACK US size: M12 Width:M JCH106829,Default Ridgefield,0,0,0,0,0,47
Chaco,Chaco JCH106829 Size 13,Chaco BANDED Z CLOUD/SOLID BLACK US size: M13 Width:M JCH106829,Default Ridgefield,0,0,0,0,0,41
Chaco,Chaco JCH106829 Size 14,Chaco BANDED Z CLOUD/SOLID BLACK US size: M14 Width:M JCH106829,Default Ridgefield,0,0,0,0,0,12
Chaco,Chaco JCH107624 Size 10,Chaco Womens Z1 CLASSIC Z1 CLASSIC JCH107624 Lavender US size 10,Default Ridgefield,0,0,0,0,0,42
Chaco,Chaco JCH107624 Size 11,Chaco Womens Z1 CLASSIC Z1 CLASSIC JCH107624 Lavender US size 11,Default Ridgefield,0,0,0,0,0,24
Chaco,Chaco JCH107624 Size 6,Chaco Womens Z1 CLASSIC Z1 CLASSIC JCH107624 Lavender US size 6,Default Ridgefield,0,0,0,0,0,30
Chaco,Chaco JCH107624 Size 7,Chaco Womens Z1 CLASSIC Z1 CLASSIC JCH107624 Lavender US size 7,Default Ridgefield,0,0,0,0,0,60
Chaco,Chaco JCH107624 Size 8,Chaco Womens Z1 CLASSIC Z1 CLASSIC JCH107624 Lavender US size 8,Default Ridgefield,0,0,0,0,0,78
Chaco,Chaco JCH107624 Size 9,Chaco Womens Z1 CLASSIC Z1 CLASSIC JCH107624 Lavender US size 9,Default Ridgefield,0,0,0,0,0,60
Chaco,Chaco JCH107986W Size 10,Chaco Womens ZCLOUD X ZCLOUD X Warren Pine US JCH107986W Size 10,Default Ridgefield,0,0,0,0,0,48
Chaco,Chaco JCH107986W Size 6,Chaco Womens ZCLOUD X ZCLOUD X Warren Pine US JCH107986W Size 6,Default Ridgefield,0,0,0,0,0,24
Chaco,Chaco JCH107986W Size 7,Chaco Womens ZCLOUD X ZCLOUD X Warren Pine US JCH107986W Size 7,Default Ridgefield,0,0,0,0,0,83
Chaco,Chaco JCH107986W Size 8,Chaco Womens ZCLOUD X ZCLOUD X Warren Pine US JCH107986W Size 8,Default Ridgefield,0,0,0,0,0,126
Chaco,Chaco JCH107986W Size 9,Chaco Womens ZCLOUD X ZCLOUD X Warren Pine US JCH107986W Size 9,Default Ridgefield,0,0,0,0,0,83
Chaco,Chaco Kids J180197 Size 4,Chaco KIDS Z1 ECOTREAD KIDS Z1 ECOTREAD KIDS J180197 US Size 4,Default Ridgefield,0,0,0,0,0,72
Chaco,Chaco Kids J180197 Size 5,Chaco KIDS Z1 ECOTREAD KIDS Z1 ECOTREAD KIDS J180197 US Size 5,Default Ridgefield,0,0,0,0,0,108
Chaco,Chaco Kids J180197 Size 6,Chaco KIDS Z1 ECOTREAD KIDS Z1 ECOTREAD KIDS J180197 US Size 6,Default Ridgefield,0,0,0,0,0,156
Champion,"Champion 9"" 81622407Q88-GUX S",Champion Mens 9-INCH CLASSIC MESH SHORT SURF THE WEB 81622407Q88-GUX Size Small,Default Ridgefield,0,0,0,0,0,50
Champion,"Champion 9"" G856HY07689-003 2XL",Champion Mens 9-INCH GRAPHIC JERSEY SHORT Black G856HY07689-003 Size 2XL,Default Ridgefield,0,0,0,0,0,73
Champion,"Champion 9"" G856HY07689-003 XL",Champion Mens 9-INCH GRAPHIC JERSEY SHORT Black G856HY07689-003 Size XL,Default Ridgefield,0,0,0,0,0,110
Champion,"Champion 9"" G856HY07689-031 2XL",Champion Mens 9-INCH GRAPHIC JERSEY SHORT Navy G856HY07689-031 Size 2XL,Default Ridgefield,0,0,0,0,0,60
Champion,"Champion 9"" G856HY07689-806 2XL",Champion Mens 9-INCH GRAPHIC JERSEY SHORT Oxford Gray G856HY07689-806 Size 2XL,Default Ridgefield,0,0,0,0,0,71
Champion,"Champion 9"" G856HY07689-806 L",Champion Mens 9-INCH GRAPHIC JERSEY SHORT Oxford Gray G856HY07689-806 Size L,Default Ridgefield,0,0,0,0,0,67
Champion,"Champion 9"" G856HY07689-806 XL",Champion Mens 9-INCH GRAPHIC JERSEY SHORT Oxford Gray G856HY07689-806 Size XL,Default Ridgefield,0,0,0,0,0,94
Champion,Champion GF88HY06794-BKC XXL,Champion Men POWERBLEND GRAPHIC CREW FLEECE Black GF88HY06794-BKC US Size Extra Extra Large,Default Ridgefield,0,0,0,0,0,33
Champion,Champion GHeath S0888407D55-G61 L,Champion Mens Powerblend Fleece Pullover Crew GRANITE HEATHER S0888407D55-G61 US Size Large,Default Ridgefield,0,0,0,0,0,50
Champion,Champion GP08H586296-806 L,Champion Men's Classic Jersey Jogger Pant Oxford Gray GP08H586296-806 US Size Large,Default Ridgefield,0,0,0,0,0,150
Champion,Champion GP08H586296-806 XL,Champion Men's Classic Jersey Jogger Pant Oxford Gray GP08H586296-806 US Size XL,Default Ridgefield,0,0,0,0,0,150
Champion,Champion GP08HY07234-G61 M,Champion Mens Graphic Jersey Joggers Granite Heather GP08HY07234-G61 US Size Medium,Default Ridgefield,0,0,0,0,0,9
Champion,Champion GT19Y06145-BKC XL,Champion Mens Left Chest C Logo Tee Black GT19Y06145-BKC US Size XL,Default Ridgefield,0,0,0,0,0,33
Champion,Champion GT19Y06145-WHC XL,Champion Mens Left Chest C Logo Tee White GT19Y06145-WHC US Size XL,Default Ridgefield,0,0,0,0,0,36
Champion,Champion GT19Y08254-BYC M,Champion Mens HERITAGE SHORT SLEEVE TEE C Gold GT19Y08254-BYC US Size Medium,Default Ridgefield,0,0,0,0,0,37
Champion,Champion GT19Y08254-BYC S,Champion Mens HERITAGE SHORT SLEEVE TEE C Gold GT19Y08254-BYC US Size Small,Default Ridgefield,0,0,0,0,0,28
Champion,Champion GT19Y08254-WHC M,Champion Mens HERITAGE SHORT SLEEVE TEE White GT19Y08254-WHC US Size Medium,Default Ridgefield,0,0,0,0,0,34
Champion,Champion GT19Y08254-WHC S,Champion Mens HERITAGE SHORT SLEEVE TEE White GT19Y08254-WHC US Size Small,Default Ridgefield,0,0,0,0,0,107
Champion,Champion GT23H586222-806 M,Champion Mens Short Sleeve Classic Logo Graphic Oxford Gray GT23H586222-806 US Size Medium,Default Ridgefield,0,0,0,0,0,13
Champion,Champion Maroon S0888407D55-029 M,Champion Mens Powerblend Fleece Pullover Crew Maroon S0888407D55-029 US Size Medium,Default Ridgefield,0,0,0,0,0,74
Champion,Champion Navy S0889407D55-031 XL,Champion Men's Powerblend Sweats Pullover Hoodie NAVY S0889407D55-031 US Size Extra Large,Default Ridgefield,0,0,0,0,0,150
Champion,Champion OGry S0888407D55-806 XL,Champion Mens Powerblend Fleece Pullover Crew Oxford Gray S0888407D55-806 US Size Extra Large,Default Ridgefield,0,0,0,0,0,164
Champion,Champion S0888407D55-806 S,Champion Mens Powerblend Fleece Pullover Crew Oxford Gray S0888407D55-806 US Size Small,Default Ridgefield,0,0,0,0,0,350
Champion,Champion S0888407D55-MLV M,Champion Mens Powerblend Fleece Pullover Crew Team Gold S0888407D55-MLV US Size Medium,Default Ridgefield,0,0,0,0,0,63
Champion,Champion S0888407D55-MLV S,Champion Mens Powerblend Fleece Pullover Crew Team Gold S0888407D55-MLV US Size Small,Default Ridgefield,0,0,0,0,0,54
Champion,Champion S0889407D55-029 L,Champion Men's Powerblend Sweats Pullover Hoodie MAROON S0889407D55-029 US Size Large,Default Ridgefield,0,0,0,0,0,418
Champion,Champion S0889407D55-029 M,Champion Men's Powerblend Sweats Pullover Hoodie MAROON S0889407D55-029 US Size Medium,Default Ridgefield,0,0,0,0,0,452
Champion,Champion S0889407D55-029 S,Champion Men's Powerblend Sweats Pullover Hoodie MAROON S0889407D55-029 US Size Small,Default Ridgefield,0,0,0,0,0,401
Champion,Champion S0891407D55-029 L,Champion Mens POWERBLEND FLEECE FULL ZIP Maroon S0891407D55-029 US Size Large,Default Ridgefield,0,0,0,0,0,100
Champion,Champion SprtBra Wte B1251-100 S,Champion The Absolute Workout Sports Bra White B1251-100 Size Small,Default Ridgefield,0,0,0,0,0,53
Champion,Champion White S0888407D55-045  M,Champion Mens Powerblend Fleece Pullover Crew White S0888407D55-045 US Size Medium,Default Ridgefield,0,0,0,0,0,197
Crocs,10126-530 Crocs Lavnder Size 4/6,10126-530 Crocs Baya Clog Lavender US Size M4/ W6,Default Ridgefield,0,0,0,0,0,71
Crocs,11999-001 Crocs Black Size 4/6,CRO-11999-001-M4W6 Crocs Baya Flip Black US Size M4 W6,Default Ridgefield,0,0,0,0,0,17
Crocs,11999-001 Crocs Black Size 5/7,CRO-11999-001-M5W7 Crocs Baya Flip Black US Size M5 W7,Default Ridgefield,0,0,0,0,0,41
Crocs,Crocs 10126-100 White Size 4/6,10126-100 CrocsBaya Clog CLR- White Size M4 W6,Default Ridgefield,0,0,0,0,0,131
Crocs,Crocs Bal-Pnk 204537-6GD C10,Crocs Crocband Ballerina Pink 204537-6GD Size C10,Default Ridgefield,0,0,0,0,0,58
Crocs,Crocs Bal-Pnk 204537-6GD C11,Crocs Crocband Ballerina Pink 204537-6GD Size C11,Default Ridgefield,0,0,0,0,0,46
Crocs,Crocs Bal-Pnk 204537-6GD C12,Crocs Crocband Ballerina Pink 204537-6GD Size C12,Default Ridgefield,0,0,0,0,0,58
Crocs,Crocs Bal-Pnk 204537-6GD C13,Crocs Crocband Ballerina Pink 204537-6GD Size C13,Default Ridgefield,0,0,0,0,0,94
Crocs,Crocs Bal-Pnk 204537-6GD C7,Crocs Crocband Ballerina Pink 204537-6GD Size C7,Default Ridgefield,0,0,0,0,0,24
Crocs,Crocs Bal-Pnk 204537-6GD C8,Crocs Crocband Ballerina Pink 204537-6GD Size C8,Default Ridgefield,0,0,0,0,0,48
Crocs,Crocs Bal-Pnk 204537-6GD C9,Crocs Crocband Ballerina Pink 204537-6GD Size C9,Default Ridgefield,0,0,0,0,0,72
Crocs,Crocs Bal-Pnk 204537-6GD J1,Crocs Crocband Ballerina Pink 204537-6GD Size J1,Default Ridgefield,0,0,0,0,0,94
Crocs,Crocs Bal-Pnk 204537-6GD J2,Crocs Crocband Ballerina Pink 204537-6GD Size J2,Default Ridgefield,0,0,0,0,0,92
Crocs,Crocs Bal-Pnk 204537-6GD J3,Crocs Crocband Ballerina Pink 204537-6GD Size J3,Default Ridgefield,0,0,0,0,0,128
Crocs,Crocs Baya 205483-410 C10,Crocs Baya Navy 205483-410 Size C10,Default Ridgefield,0,0,0,0,0,24
Crocs,Crocs Baya 205483-410 C11,Crocs Baya Navy 205483-410 Size C11,Default Ridgefield,0,0,0,0,0,24
Crocs,Crocs Baya 205483-410 C12,Crocs Baya Navy 205483-410 Size C12,Default Ridgefield,0,0,0,0,0,24
Crocs,Crocs Baya 205483-410 C13,Crocs Baya Navy 205483-410 Size C13,Default Ridgefield,0,0,0,0,0,47
Crocs,Crocs Baya 205483-410 J1,Crocs Baya Navy 205483-410 Size J1,Default Ridgefield,0,0,0,0,0,47
Crocs,Crocs Baya 205483-410 J2,Crocs Baya Navy 205483-410 Size J2,Default Ridgefield,0,0,0,0,0,47
Crocs,Crocs Baya 205483-410 J3,Crocs Baya Navy 205483-410 Size J3,Default Ridgefield,0,0,0,0,0,47
Crocs,Crocs Black Size M4/W6 12000-001,Crocs Baya Slide Black Size M4/W6 12000-001,Default Ridgefield,0,0,0,0,0,23
Crocs,Crocs Black Size M5/W7 12000-001,Crocs Baya Slide Black Size M5/W7 12000-001,Default Ridgefield,0,0,0,0,0,47
Crocs,Crocs Black Size M6/W8 12000-001,Crocs Baya Slide Black Size M6/W8 12000-001,Default Ridgefield,0,0,0,0,0,47
Crocs,Crocs Blk 205100-001 C10,Crocs Bayaband Black 205100-001 Size C10,Default Ridgefield,0,0,0,0,0,24
Crocs,Crocs Blk 205100-001 C11,Crocs Bayaband Black 205100-001 Size C11,Default Ridgefield,0,0,0,0,0,46
Crocs,Crocs Blk 205100-001 C12,Crocs Bayaband Black 205100-001 Size C12,Default Ridgefield,0,0,0,0,0,58
Crocs,Crocs Blk 205100-001 C13,Crocs Bayaband Black 205100-001 Size C13,Default Ridgefield,0,0,0,0,0,70
Crocs,Crocs Blk 205100-001 C7,Crocs Bayaband Black 205100-001 Size C7,Default Ridgefield,0,0,0,0,0,36
Crocs,Crocs Blk 205100-001 C8,Crocs Bayaband Black 205100-001 Size C8,Default Ridgefield,0,0,0,0,0,24
Crocs,Crocs Blk 205100-001 C9,Crocs Bayaband Black 205100-001 Size C9,Default Ridgefield,0,0,0,0,0,48
Crocs,Crocs Blk 205100-001 J1,Crocs Bayaband Black 205100-001 Size J1,Default Ridgefield,0,0,0,0,0,70
Crocs,Crocs Blk 205100-001 J2,Crocs Bayaband Black 205100-001 Size J2,Default Ridgefield,0,0,0,0,0,94
Crocs,Crocs Blk 205100-001 J3,Crocs Bayaband Black 205100-001 Size J3,Default Ridgefield,0,0,0,0,0,118
Crocs,Crocs Blk 205483-001 C10,Crocs Baya Black 205483-001 Size C10,Default Ridgefield,0,0,0,0,0,24
Crocs,Crocs Blk 205483-001 C11,Crocs Baya Black 205483-001 Size C11,Default Ridgefield,0,0,0,0,0,24
Crocs,Crocs Blk 205483-001 C12,Crocs Baya Black 205483-001 Size C12,Default Ridgefield,0,0,0,0,0,24
Crocs,Crocs Blk 205483-001 C13,Crocs Baya Black 205483-001 Size C13,Default Ridgefield,0,0,0,0,0,23
Crocs,Crocs Blk 205483-001 J1,Crocs Baya Black 205483-001 Size J1,Default Ridgefield,0,0,0,0,0,23
Crocs,Crocs Blk 205483-001 J2,Crocs Baya Black 205483-001 Size J2,Default Ridgefield,0,0,0,0,0,23
Crocs,Crocs Blk 205483-001 J3,Crocs Baya Black 205483-001 Size J3,Default Ridgefield,0,0,0,0,0,23
Crocs,Crocs B/W 205089-066 M10/ W12,Crocs Bayaband Black/White 205089-066 Size M10/ W12,Default Ridgefield,0,0,0,0,0,188
Crocs,Crocs B/W 205089-066 M11/ W13,Crocs Bayaband Black/White 205089-066 Size M11/ W13,Default Ridgefield,0,0,0,0,0,58
Crocs,Crocs B/W 205089-066 M12/ W14,Crocs Bayaband Black/White 205089-066 Size M12/ W14,Default Ridgefield,0,0,0,0,0,34
Crocs,Crocs B/W 205089-066 M4/ W6,Crocs Bayaband Black/White 205089-066 Size M4/ W6,Default Ridgefield,0,0,0,0,0,214
Crocs,Crocs B/W 205089-066 M5/ W7,Crocs Bayaband Black/White 205089-066 Size M5/ W7,Default Ridgefield,0,0,0,0,0,382
Crocs,Crocs B/W 205089-066 M6/ W8,Crocs Bayaband Black/White 205089-066 Size M6/ W8,Default Ridgefield,0,0,0,0,0,334
Crocs,Crocs B/W 205089-066 M7 W9,Crocs Bayaband Black/White 205089-066 Size M7 W9,Default Ridgefield,0,0,0,0,0,262
Crocs,Crocs B/W 205089-066 M8/ W10,Crocs Bayaband Black/White 205089-066 Size M8/ W10,Default Ridgefield,0,0,0,0,0,226
Crocs,Crocs B/W 205089-066 M9/ W11,Crocs Bayaband Black/White 205089-066 Size M9/ W11,Default Ridgefield,0,0,0,0,0,272
Crocs,Crocs B/W 205392-066 4/6,CRO-205392-066-M4W6 Crocs Bayaband Slide Black/White US Size M4 W6,Default Ridgefield,0,0,0,0,0,11
Crocs,Crocs B/W 205393-066 M10/ W12,Crocs Bayaband Black/White 205393-066 Size M10/ W12,Default Ridgefield,0,0,0,0,0,10
Crocs,Crocs B/W 205393-066 M4/ W6,Crocs Bayaband Black/White 205393-066 Size M4/ W6,Default Ridgefield,0,0,0,0,0,35
Crocs,Crocs B/W 205393-066 M5/ W7,Crocs Bayaband Black/White 205393-066 Size M5/ W7,Default Ridgefield,0,0,0,0,0,47
Crocs,Crocs B/W 205393-066 M6/ W8,Crocs Bayaband Black/White 205393-066 Size M6/ W8,Default Ridgefield,0,0,0,0,0,34
Crocs,Crocs B/W 205393-066 M7/ W9,Crocs Bayaband Black/White 205393-066 Size M7/ W9,Default Ridgefield,0,0,0,0,0,34
Crocs,Crocs B/W 205393-066 M8/ W10,Crocs Bayaband Black/White 205393-066 Size M8/ W10,Default Ridgefield,0,0,0,0,0,34
Crocs,Crocs B/W 205393-066 M9/ W11,Crocs Bayaband Black/White 205393-066 Size M9/ W11,Default Ridgefield,0,0,0,0,0,32
Crocs,Crocs Charc 205100-025 C11,Crocs Bayaband Charcoal 205100-025 Size C11,Default Ridgefield,0,0,0,0,0,23
Crocs,Crocs Charc 205100-025 C13,Crocs Bayaband Charcoal 205100-025 Size C13,Default Ridgefield,0,0,0,0,0,23
Crocs,Crocs Charc 205100-025 C7,Crocs Bayaband Charcoal 205100-025 Size C7,Default Ridgefield,0,0,0,0,0,5
Crocs,Crocs Charc 205100-025 C9,Crocs Bayaband Charcoal 205100-025 Size C9,Default Ridgefield,0,0,0,0,0,5
Crocs,Crocs Charc 205100-025 J2,Crocs Bayaband Charcoal 205100-025 Size J2,Default Ridgefield,0,0,0,0,0,23
Crocs,Crocs Charc 205100-025 J3,Crocs Bayaband Charcoal 205100-025 Size J3,Default Ridgefield,0,0,0,0,0,23
Crocs,Crocs Chrc/VGr 205089-0A3 10/12,Crocs Bayaband Charcoal/Volt Green 205089-0A3 Size M10/ W12,Default Ridgefield,0,0,0,0,0,22
Crocs,Crocs Chrc/VGr 205089-0A3 11/13,Crocs Bayaband Charcoal/Volt Green 205089-0A3 Size M11/ W13,Default Ridgefield,0,0,0,0,0,12
Crocs,Crocs Chrc/VGr 205089-0A3 4/6,Crocs Bayaband Charcoal/Volt Green 205089-0A3 Size M4/ W6,Default Ridgefield,0,0,0,0,0,34
Crocs,Crocs Chrc/VGr 205089-0A3 5/7,Crocs Bayaband Charcoal/Volt Green 205089-0A3 Size M5/ W7,Default Ridgefield,0,0,0,0,0,58
Crocs,Crocs Chrc/VGr 205089-0A3 6/8,Crocs Bayaband Charcoal/Volt Green 205089-0A3 Size M6/ W8,Default Ridgefield,0,0,0,0,0,34
Crocs,Crocs Chrc/VGr 205089-0A3 7/9,Crocs Bayaband Charcoal/Volt Green 205089-0A3 Size M7/ W9,Default Ridgefield,0,0,0,0,0,34
Crocs,Crocs Chrc/VGr 205089-0A3 8/10,Crocs Bayaband Charcoal/Volt Green 205089-0A3 Size M8/ W10,Default Ridgefield,0,0,0,0,0,34
Crocs,Crocs Chrc/VGr 205089-0A3 9/11,Crocs Bayaband Charcoal/Volt Green 205089-0A3 Size M9/ W11,Default Ridgefield,0,0,0,0,0,34
Crocs,Crocs C/VG 205392-0A3 9/11,Crocs Bayaband Charcoal/Volt Green 205392-0A3 Size M9/ W11,Default Ridgefield,0,0,0,0,0,12
Crocs,Crocs Lav 205483-530 C10,Crocs Baya Lavender 205483-530 Size C10,Default Ridgefield,0,0,0,0,0,24
Crocs,Crocs Lav 205483-530 C11,Crocs Baya Lavender 205483-530 Size C11,Default Ridgefield,0,0,0,0,0,24
Crocs,Crocs Lav 205483-530 C12,Crocs Baya Lavender 205483-530 Size C12,Default Ridgefield,0,0,0,0,0,24
Crocs,Crocs Lav 205483-530 C13,Crocs Baya Lavender 205483-530 Size C13,Default Ridgefield,0,0,0,0,0,47
Crocs,Crocs Lav 205483-530 J1,Crocs Baya Lavender 205483-530 Size J1,Default Ridgefield,0,0,0,0,0,47
Crocs,Crocs Lav 205483-530 J2,Crocs Baya Lavender 205483-530 Size J2,Default Ridgefield,0,0,0,0,0,47
Crocs,Crocs Lav 205483-530 J3,Crocs Baya Lavender 205483-530 Size J3,Default Ridgefield,0,0,0,0,0,71
Crocs,Crocs Lavndr 205089-530 M4/ W6,Crocs Bayaband Lavender 205089-530 Size M4/ W6,Default Ridgefield,0,0,0,0,0,94
Crocs,Crocs Lavndr 205089-530 M5/ W7,Crocs Bayaband Lavender 205089-530 Size M5/ W7,Default Ridgefield,0,0,0,0,0,142
Crocs,Crocs Lavndr 205089-530 M6/ W8,Crocs Bayaband Lavender 205089-530 Size M6/ W8,Default Ridgefield,0,0,0,0,0,70
Crocs,Crocs Lavndr 205089-530 M7/ W9,Crocs Bayaband Lavender 205089-530 Size M7/ W9,Default Ridgefield,0,0,0,0,0,22
Crocs,Crocs LGry/CPink 205089-0FS 4/6,Crocs Bayaband Light Grey/Candy Pink 205089-0FS Size M4/ W6,Default Ridgefield,0,0,0,0,0,106
Crocs,Crocs LGry/CPink 205089-0FS 5/7,Crocs Bayaband Light Grey/Candy Pink 205089-0FS Size M5/ W7,Default Ridgefield,0,0,0,0,0,152
Crocs,Crocs LGry/CPink 205089-0FS 6/8,Crocs Bayaband Light Grey/Candy Pink 205089-0FS Size M6/ W8,Default Ridgefield,0,0,0,0,0,92
Crocs,Crocs LGry/CPink 205089-0FS 7/9,Crocs Bayaband Light Grey/Candy Pink 205089-0FS Size M7/ W9,Default Ridgefield,0,0,0,0,0,12
Crocs,Crocs Navy 12000-410 Size 9/11,Crocs Baya Navy 12000-410 Size M9/ W11,Default Ridgefield,0,0,0,0,0,12
Crocs,Crocs N/P 205089-4CC M10/ W12,Crocs Bayaband Navy/Pepper 205089-4CC Size M10/ W12,Default Ridgefield,0,0,0,0,0,200
Crocs,Crocs N/P 205089-4CC M11/ W13,Crocs Bayaband Navy/Pepper 205089-4CC Size M11/ W13,Default Ridgefield,0,0,0,0,0,58
Crocs,Crocs N/P 205089-4CC M12/ W14,Crocs Bayaband Navy/Pepper 205089-4CC Size M12/ W14,Default Ridgefield,0,0,0,0,0,22
Crocs,Crocs N/P 205089-4CC M4/ W6,Crocs Bayaband Navy/Pepper 205089-4CC Size M4/ W6,Default Ridgefield,0,0,0,0,0,382
Crocs,Crocs N/P 205089-4CC M5/ W7,Crocs Bayaband Navy/Pepper 205089-4CC Size M5/ W7,Default Ridgefield,0,0,0,0,0,586
Crocs,Crocs N/P 205089-4CC M6/ W8,Crocs Bayaband Navy/Pepper 205089-4CC Size M6/ W8,Default Ridgefield,0,0,0,0,0,394
Crocs,Crocs N/P 205089-4CC M7/ W9,Crocs Bayaband Navy/Pepper 205089-4CC Size M7/ W9,Default Ridgefield,0,0,0,0,0,262
Crocs,Crocs N/P 205089-4CC M8/ W10,Crocs Bayaband Navy/Pepper 205089-4CC Size M8/ W10,Default Ridgefield,0,0,0,0,0,226
Crocs,Crocs N/P 205089-4CC M9/ W11,Crocs Bayaband Navy/Pepper 205089-4CC Size M9/ W11,Default Ridgefield,0,0,0,0,0,272
Crocs,Crocs N/P 205392-4CC 4/6,CRO-205392-4CC-M4W6 Crocs Bayaband Slide Navy/Pepper US Size M4 W6,Default Ridgefield,0,0,0,0,0,12
Crocs,Crocs N/P 205393-4CC M10/ W12,Crocs Bayaband Navy/Pepper 205393-4CC Size M10/ W12,Default Ridgefield,0,0,0,0,0,10
Crocs,Crocs N/P 205393-4CC M4/ W6,Crocs Bayaband Navy/Pepper 205393-4CC Size M4/ W6,Default Ridgefield,0,0,0,0,0,23
Crocs,Crocs N/P 205393-4CC M5/ W7,Crocs Bayaband Navy/Pepper 205393-4CC Size M5/ W7,Default Ridgefield,0,0,0,0,0,23
Crocs,Crocs N/P 205393-4CC M6/ W8,Crocs Bayaband Navy/Pepper 205393-4CC Size M6/ W8,Default Ridgefield,0,0,0,0,0,22
Crocs,Crocs N/P 205393-4CC M7/ W9,Crocs Bayaband Navy/Pepper 205393-4CC Size M7/ W9,Default Ridgefield,0,0,0,0,0,22
Crocs,Crocs N/P 205393-4CC M8/ W10,Crocs Bayaband Navy/Pepper 205393-4CC Size M8/ W10,Default Ridgefield,0,0,0,0,0,10
Crocs,Crocs N/P 205393-4CC M9/ W11,Crocs Bayaband Navy/Pepper 205393-4CC Size M9/ W11,Default Ridgefield,0,0,0,0,0,22
Crocs,Crocs Nvy 205100-410 C10,Crocs Bayaband Navy 205100-410 Size C10,Default Ridgefield,0,0,0,0,0,22
Crocs,Crocs Nvy 205100-410 C11,Crocs Bayaband Navy 205100-410 Size C11,Default Ridgefield,0,0,0,0,0,22
Crocs,Crocs Nvy 205100-410 C12,Crocs Bayaband Navy 205100-410 Size C12,Default Ridgefield,0,0,0,0,0,58
Crocs,Crocs Nvy 205100-410 C13,Crocs Bayaband Navy 205100-410 Size C13,Default Ridgefield,0,0,0,0,0,106
Crocs,Crocs Nvy 205100-410 C6,Crocs Bayaband Navy 205100-410 Size C6,Default Ridgefield,0,0,0,0,0,12
Crocs,Crocs Nvy 205100-410 C7,Crocs Bayaband Navy 205100-410 Size C7,Default Ridgefield,0,0,0,0,0,12
Crocs,Crocs Nvy 205100-410 C8,Crocs Bayaband Navy 205100-410 Size C8,Default Ridgefield,0,0,0,0,0,24
Crocs,Crocs Nvy 205100-410 C9,Crocs Bayaband Navy 205100-410 Size C9,Default Ridgefield,0,0,0,0,0,48
Crocs,Crocs Nvy 205100-410 J1,Crocs Bayaband Navy 205100-410 Size J1,Default Ridgefield,0,0,0,0,0,94
Crocs,Crocs Nvy 205100-410 J2,Crocs Bayaband Navy 205100-410 Size J2,Default Ridgefield,0,0,0,0,0,92
Crocs,Crocs Nvy 205100-410 J3,Crocs Bayaband Navy 205100-410 Size J3,Default Ridgefield,0,0,0,0,0,140
Crocs,Crocs Pink Lemnade 10126-669 4/6,Crocs Baya Pink Lemonade 10126-669 US Size M4/ W6,Default Ridgefield,0,0,0,0,0,35
Crocs,Crocs Pink Lemnade 10126-669 5/7,Crocs Baya Pink Lemonade 10126-669 US Size M5/ W7,Default Ridgefield,0,0,0,0,0,47
Crocs,Crocs Pink Lemnade 10126-669 6/8,Crocs Baya Pink Lemonade 10126-669 US Size M6/ W8,Default Ridgefield,0,0,0,0,0,23
Crocs,Crocs Ptl Pnk 205100-606 C10,Crocs Bayaband Petal Pink 205100-606 Size C10,Default Ridgefield,0,0,0,0,0,46
Crocs,Crocs Ptl Pnk 205100-606 C11,Crocs Bayaband Petal Pink 205100-606 Size C11,Default Ridgefield,0,0,0,0,0,46
Crocs,Crocs Ptl Pnk 205100-606 C12,Crocs Bayaband Petal Pink 205100-606 Size C12,Default Ridgefield,0,0,0,0,0,58
Crocs,Crocs Ptl Pnk 205100-606 C13,Crocs Bayaband Petal Pink 205100-606 Size C13,Default Ridgefield,0,0,0,0,0,94
Crocs,Crocs Ptl Pnk 205100-606 C7,Crocs Bayaband Petal Pink 205100-606 Size C7,Default Ridgefield,0,0,0,0,0,12
Crocs,Crocs Ptl Pnk 205100-606 C8,Crocs Bayaband Petal Pink 205100-606 Size C8,Default Ridgefield,0,0,0,0,0,48
Crocs,Crocs Ptl Pnk 205100-606 C9,Crocs Bayaband Petal Pink 205100-606 Size C9,Default Ridgefield,0,0,0,0,0,48
Crocs,Crocs Ptl Pnk 205100-606 J1,Crocs Bayaband Petal Pink 205100-606 Size J1,Default Ridgefield,0,0,0,0,0,82
Crocs,Crocs Ptl Pnk 205100-606 J2,Crocs Bayaband Petal Pink 205100-606 Size J2,Default Ridgefield,0,0,0,0,0,92
Crocs,Crocs Ptl Pnk 205100-606 J3,Crocs Bayaband Petal Pink 205100-606 Size J3,Default Ridgefield,0,0,0,0,0,116
Crocs,Crocs White 12000-100 Size 5/7,Crocs Baya White 12000-100 Size M5/ W7,Default Ridgefield,0,0,0,0,0,12
Crocs,Crocs W/N 205089-126 M10/ W12,Crocs Bayaband White/Navy 205089-126 Size M10/ W12,Default Ridgefield,0,0,0,0,0,58
Crocs,Crocs W/N 205089-126 M11/ W13,Crocs Bayaband White/Navy 205089-126 Size M11/ W13,Default Ridgefield,0,0,0,0,0,12
Crocs,Crocs W/N 205089-126 M4/ W6,Crocs Bayaband White/Navy 205089-126 Size M4/ W6,Default Ridgefield,0,0,0,0,0,464
Crocs,Crocs W/N 205089-126 M5/ W7,Crocs Bayaband White/Navy 205089-126 Size M5/ W7,Default Ridgefield,0,0,0,0,0,596
Crocs,Crocs W/N 205089-126 M6/ W8,Crocs Bayaband White/Navy 205089-126 Size M6/ W8,Default Ridgefield,0,0,0,0,0,332
Crocs,Crocs W/N 205089-126 M7/ W9,Crocs Bayaband White/Navy 205089-126 Size M7/ W9,Default Ridgefield,0,0,0,0,0,166
Crocs,Crocs W/N 205089-126 M8/ W10,Crocs Bayaband White/Navy 205089-126 Size M8/ W10,Default Ridgefield,0,0,0,0,0,82
Crocs,Crocs W/N 205089-126 M9/ W11,Crocs Bayaband White/Navy 205089-126 Size M9/ W11,Default Ridgefield,0,0,0,0,0,94
Crocs,Crocs W/N 205392-126 M4/ W6,Crocs Bayaband White/Navy 205392-126 Size M4/ W6,Default Ridgefield,0,0,0,0,0,23
Crocs,Crocs W/N 205392-126 M5/ W7,Crocs Bayaband White/Navy 205392-126 Size M5/ W7,Default Ridgefield,0,0,0,0,0,34
Crocs,Crocs W/N 205392-126 M6/ W8,Crocs Bayaband White/Navy 205392-126 Size M6/ W8,Default Ridgefield,0,0,0,0,0,23
Crocs,Crocs W/N 205392-126 M7/ W9,Crocs Bayaband White/Navy 205392-126 Size M7/ W9,Default Ridgefield,0,0,0,0,0,11
Crocs,Crocs W/N 205392-126 M9/ W11,Crocs Bayaband White/Navy 205392-126 Size M9/ W11,Default Ridgefield,0,0,0,0,0,11
Crocs,Crocs W/N 205393-126 M10/ W12,Crocs Bayaband White/Navy 205393-126 Size M10/ W12,Default Ridgefield,0,0,0,0,0,22
Crocs,Crocs W/N 205393-126 M4/ W6,Crocs Bayaband White/Navy 205393-126 Size M4/ W6,Default Ridgefield,0,0,0,0,0,70
Crocs,Crocs W/N 205393-126 M5/ W7,Crocs Bayaband White/Navy 205393-126 Size M5/ W7,Default Ridgefield,0,0,0,0,0,82
Crocs,Crocs W/N 205393-126 M6/ W8,Crocs Bayaband White/Navy 205393-126 Size M6/ W8,Default Ridgefield,0,0,0,0,0,46
Crocs,Crocs W/N 205393-126 M7 W9,Crocs Bayaband White/Navy 205393-126 Size M7 W9,Default Ridgefield,0,0,0,0,0,46
Crocs,Crocs W/N 205393-126 M8/ W10,Crocs Bayaband White/Navy 205393-126 Size M8/ W10,Default Ridgefield,0,0,0,0,0,22
Crocs,Crocs W/N 205393-126 M9/ W11,Crocs Bayaband White/Navy 205393-126 Size M9/ W11,Default Ridgefield,0,0,0,0,0,46
Darn Tough,Darn Tough Hikr Mid/Cush Chrc XL,Darn Tough 1466 Hiker Micro Crew Midweight with Cushion Charcoal XL,FBALYB Amazon,38,31,7,0,7,0
Dove,Dove APA Pomegranate USD,Dove APA Pomegranate USD,Default Ridgefield,0,0,0,0,0,3564
Dove,Dove M+C Sport Active Fresh Deo,Dove Men + Care Sport Active Fresh Deodorant Spray,Default Ridgefield,0,0,0,0,0,5328
Dove,Dove XL APA For Men Clean,Dove XL APA For Men Clean,Default Ridgefield,0,0,0,0,0,9000
Garmont,Garmont 481235/217 10,Garmont Men's T8 Extreme GTX Insulated Tactical Military Coyote Boot 481235/217 US Size 10,FBALYB Amazon,9,9,0,0,0,0
Garmont,Garmont 481235/217 10.5,Garmont Men's T8 Extreme GTX Insulated Tactical Military Coyote Boot 481235/217 US Size 10.5,FBALYB Amazon,26,26,0,0,0,0
Garmont,Garmont 481235/217 11,Garmont Men's T8 Extreme GTX Insulated Tactical Military Coyote Boot 481235/217 US Size 11,FBALYB Amazon,9,9,0,0,0,0
Garmont,Garmont 481235/217 11.5,Garmont Men's T8 Extreme GTX Insulated Tactical Military Coyote Boot 481235/217 US Size 11.5,FBALYB Amazon,14,13,1,0,1,0
Garmont,Garmont 481235/217 12,Garmont Men's T8 Extreme GTX Insulated Tactical Military Coyote Boot 481235/217 US Size 12,Default Ridgefield,6,6,0,0,0,0
Garmont,Garmont 481235/217 12,Garmont Men's T8 Extreme GTX Insulated Tactical Military Coyote Boot 481235/217 US Size 12,FBALYB Amazon,27,27,0,0,0,0
Garmont,Garmont 481235/217 12.5,Garmont Men's T8 Extreme GTX Insulated Tactical Military Coyote Boot 481235/217 US Size 12.5,Default Ridgefield,10,10,0,0,0,0
Garmont,Garmont 481235/217 12.5,Garmont Men's T8 Extreme GTX Insulated Tactical Military Coyote Boot 481235/217 US Size 12.5,FBALYB Amazon,7,7,0,0,0,0
Garmont,Garmont 481235/217 13,Garmont Men's T8 Extreme GTX Insulated Tactical Military Coyote Boot 481235/217 US Size 13,Default Ridgefield,8,8,0,0,0,0
Garmont,Garmont 481235/217 13,Garmont Men's T8 Extreme GTX Insulated Tactical Military Coyote Boot 481235/217 US Size 13,FBALYB Amazon,12,12,0,0,0,0
Garmont,Garmont 481235/217 8,Garmont Men's T8 Extreme GTX Insulated Tactical Military Coyote Boot 481235/217 US Size 8,FBALYB Amazon,11,11,0,0,0,0
Garmont,Garmont 481235/217 8.5,Garmont Men's T8 Extreme GTX Insulated Tactical Military Coyote Boot 481235/217 US Size 8.5,FBALYB Amazon,34,34,0,0,0,0
Garmont,Garmont 481235/217 9,Garmont Men's T8 Extreme GTX Insulated Tactical Military Coyote Boot 481235/217 US Size 9,FBALYB Amazon,9,8,1,0,1,0
Garmont,Garmont 481235/217 9.5,Garmont Men's T8 Extreme GTX Insulated Tactical Military Coyote Boot 481235/217 US Size 9.5,FBALYB Amazon,31,29,2,0,2,0
Garmont,Garmont 481235/218 10,Garmont Men's T8 Extreme GTX Insulated Tactical Military Coyote Boot Wide 481235/218 US Size 10,FBALYB Amazon,25,23,2,0,2,0
Garmont,Garmont 481235/218 10.5,Garmont Men's T8 Extreme GTX Insulated Tactical Military Coyote Boot Wide 481235/218 US Size 10.5,Default Ridgefield,15,15,0,0,0,0
Garmont,Garmont 481235/218 10.5,Garmont Men's T8 Extreme GTX Insulated Tactical Military Coyote Boot Wide 481235/218 US Size 10.5,FBALYB Amazon,23,23,0,0,0,0
Garmont,Garmont 481235/218 11,Garmont Men's T8 Extreme GTX Insulated Tactical Military Coyote Boot Wide 481235/218 US Size 11,Default Ridgefield,20,20,0,0,0,0
Garmont,Garmont 481235/218 11.5,Garmont Men's T8 Extreme GTX Insulated Tactical Military Coyote Boot Wide 481235/218 US Size 11.5,FBALYB Amazon,17,17,0,0,0,0
Garmont,Garmont 481235/218 12,Garmont Men's T8 Extreme GTX Insulated Tactical Military Coyote Boot Wide 481235/218 US Size 12,FBALYB Amazon,28,28,0,0,0,0
Garmont,Garmont 481235/218 12.5,Garmont Men's T8 Extreme GTX Insulated Tactical Military Coyote Boot Wide 481235/218 US Size 12.5,Default Ridgefield,20,20,0,0,0,0
Garmont,Garmont 481235/218 13,Garmont Men's T8 Extreme GTX Insulated Tactical Military Coyote Boot Wide 481235/218 US Size 13,FBALYB Amazon,14,14,0,0,0,0
Garmont,Garmont 481235/218 8,Garmont Men's T8 Extreme GTX Insulated Tactical Military Coyote Boot Wide 481235/218 US Size 8,Default Ridgefield,10,10,0,0,0,0
Garmont,Garmont 481235/218 8,Garmont Men's T8 Extreme GTX Insulated Tactical Military Coyote Boot Wide 481235/218 US Size 8,FBALYB Amazon,14,14,0,0,0,0
Garmont,Garmont 481235/218 8.5,Garmont Men's T8 Extreme GTX Insulated Tactical Military Coyote Boot Wide 481235/218 US Size 8.5,FBALYB Amazon,45,45,0,0,0,0
Garmont,Garmont 481235/218 9,Garmont Men's T8 Extreme GTX Insulated Tactical Military Coyote Boot Wide 481235/218 US Size 9,FBALYB Amazon,28,27,1,0,1,0
Garmont,Garmont 481235/218 9.5,Garmont Men's T8 Extreme GTX Insulated Tactical Military Coyote Boot Wide 481235/218 US Size 9.5,FBALYB Amazon,56,54,2,0,2,0
Garmont,Garmont 481435/203 10,Garmont Men's T8 Bifida Tactical Military 481435/203 US Size 10,Default Ridgefield,2,2,0,0,0,0
Garmont,Garmont 481435/203 10,Garmont Men's T8 Bifida Tactical Military 481435/203 US Size 10,FBALYB Amazon,61,59,2,0,2,0
Garmont,Garmont 481435/203 10.5,Garmont Men's T8 Bifida Tactical Military 481435/203 US Size 10.5,FBALYB Amazon,17,16,1,2,1,0
Garmont,Garmont 481435/203 11,Garmont Men's T8 Bifida Tactical Military 481435/203 US Size 11,Default Ridgefield,30,30,0,0,0,0
Garmont,Garmont 481435/203 11,Garmont Men's T8 Bifida Tactical Military 481435/203 US Size 11,FBALYB Amazon,-54,-54,0,54,0,0
Garmont,Garmont 481435/203 11.5,Garmont Men's T8 Bifida Tactical Military 481435/203 US Size 11.5,Default Ridgefield,15,15,0,0,0,0
Garmont,Garmont 481435/203 11.5,Garmont Men's T8 Bifida Tactical Military 481435/203 US Size 11.5,FBALYB Amazon,2,2,0,0,0,0
Garmont,Garmont 481435/203 12,Garmont Men's T8 Bifida Tactical Military 481435/203 US Size 12,FBALYB Amazon,-10,-10,0,10,0,0
Garmont,Garmont 481435/203 12.5,Garmont Men's T8 Bifida Tactical Military 481435/203 US Size 12.5,FBALYB Amazon,17,17,0,0,0,0
Garmont,Garmont 481435/203 13,Garmont Men's T8 Bifida Tactical Military 481435/203 US Size 13,Default Ridgefield,9,9,0,0,0,0
Garmont,Garmont 481435/203 13,Garmont Men's T8 Bifida Tactical Military 481435/203 US Size 13,FBALYB Amazon,1,1,0,0,0,0
Garmont,Garmont 481435/203 6.5,Garmont Men's T8 Bifida Tactical Military 481435/203 US Size 6.5,Default Ridgefield,10,10,0,0,0,0
Garmont,Garmont 481435/203 7,Garmont Men's T8 Bifida Tactical Military 481435/203 US Size 7,Default Ridgefield,5,5,0,0,0,0
Garmont,Garmont 481435/203 7,Garmont Men's T8 Bifida Tactical Military 481435/203 US Size 7,FBALYB Amazon,1,1,0,0,0,0
Garmont,Garmont 481435/203 7.5,Garmont Men's T8 Bifida Tactical Military 481435/203 US Size 7.5,FBALYB Amazon,10,9,1,0,1,0
Garmont,Garmont 481435/203 8.5,Garmont Men's T8 Bifida Tactical Military 481435/203 US Size 8.5,FBALYB Amazon,-1,-3,2,0,2,0
Garmont,Garmont 481435/203 9,Garmont Men's T8 Bifida Tactical Military 481435/203 US Size 9,FBALYB Amazon,13,12,1,3,1,0
Garmont,Garmont 481435/204 10,Garmont Men's T8 Bifida Tactical Military Wide 481435/204 US Size 10,FBALYB Amazon,1,1,0,0,0,0
Garmont,Garmont 481435/204 10.5,Garmont Men's T8 Bifida Tactical Military Wide 481435/204 US Size 10.5,Default Ridgefield,5,5,0,0,0,0
Garmont,Garmont 481435/204 10.5,Garmont Men's T8 Bifida Tactical Military Wide 481435/204 US Size 10.5,FBALYB Amazon,25,25,0,0,0,0
Garmont,Garmont 481435/204 11,Garmont Men's T8 Bifida Tactical Military Wide 481435/204 US Size 11,FBALYB Amazon,2,1,1,0,1,0
Garmont,Garmont 481435/204 11.5,Garmont Men's T8 Bifida Tactical Military Wide 481435/204 US Size 11.5,FBALYB Amazon,-1,-2,1,0,1,0
Garmont,Garmont 481435/204 12,Garmont Men's T8 Bifida Tactical Military Wide 481435/204 US Size 12,FBALYB Amazon,6,6,0,0,0,0
Garmont,Garmont 481435/204 12.5,Garmont Men's T8 Bifida Tactical Military Wide 481435/204 US Size 12.5,FBALYB Amazon,16,16,0,0,0,0
Garmont,Garmont 481435/204 13,Garmont Men's T8 Bifida Tactical Military Wide 481435/204 US Size 13,Default Ridgefield,15,15,0,0,0,0
Garmont,Garmont 481435/204 6.5,Garmont Men's T8 Bifida Tactical Military Wide 481435/204 US Size 6.5,Default Ridgefield,5,5,0,0,0,0
Garmont,Garmont 481435/204 6.5,Garmont Men's T8 Bifida Tactical Military Wide 481435/204 US Size 6.5,FBALYB Amazon,5,3,2,0,2,0
Garmont,Garmont 481435/204 7,Garmont Men's T8 Bifida Tactical Military Wide 481435/204 US Size 7,Default Ridgefield,5,5,0,0,0,0
Garmont,Garmont 481435/204 7,Garmont Men's T8 Bifida Tactical Military Wide 481435/204 US Size 7,FBALYB Amazon,14,14,0,0,0,0
Garmont,Garmont 481435/204 7.5,Garmont Men's T8 Bifida Tactical Military Wide 481435/204 US Size 7.5,Default Ridgefield,5,5,0,0,0,0
Garmont,Garmont 481435/204 8,Garmont Men's T8 Bifida Tactical Military Wide 481435/204 US Size 8,Default Ridgefield,5,4,1,0,0,0
Garmont,Garmont 481435/204 8.5,Garmont Men's T8 Bifida Tactical Military Wide 481435/204 US Size 8.5,Default Ridgefield,2,2,0,0,0,0
Garmont,Garmont 481435/204 8.5,Garmont Men's T8 Bifida Tactical Military Wide 481435/204 US Size 8.5,FBALYB Amazon,31,31,0,0,0,0
Garmont,Garmont 481435/204 9.5,Garmont Men's T8 Bifida Tactical Military Wide 481435/204 US Size 9.5,FBALYB Amazon,5,4,1,0,1,0
Garmont,Garmont 481996/205 10,Garmont T 8 NFS 670 Regular Coyote 481996/205 US Size 10,Default Ridgefield,50,50,0,0,0,0
Garmont,Garmont 481996/205 10.5,Garmont T 8 NFS 670 Regular Coyote 481996/205 US Size 10.5,Default Ridgefield,36,36,0,0,0,0
Garmont,Garmont 481996/205 10.5,Garmont T 8 NFS 670 Regular Coyote 481996/205 US Size 10.5,FBALYB Amazon,42,42,0,0,0,0
Garmont,Garmont 481996/205 11,Garmont T 8 NFS 670 Regular Coyote 481996/205 US Size 11,Default Ridgefield,40,40,0,0,0,0
Garmont,Garmont 481996/205 11,Garmont T 8 NFS 670 Regular Coyote 481996/205 US Size 11,FBALYB Amazon,2,0,2,0,2,0
Garmont,Garmont 481996/205 11.5,Garmont T 8 NFS 670 Regular Coyote 481996/205 US Size 11.5,Default Ridgefield,13,13,0,0,0,0
Garmont,Garmont 481996/205 11.5,Garmont T 8 NFS 670 Regular Coyote 481996/205 US Size 11.5,FBALYB Amazon,15,15,0,0,0,0
Garmont,Garmont 481996/205 12,Garmont T 8 NFS 670 Regular Coyote 481996/205 US Size 12,FBALYB Amazon,45,45,0,1,0,0
Garmont,Garmont 481996/205 12.5,Garmont T 8 NFS 670 Regular Coyote 481996/205 US Size 12.5,Default Ridgefield,6,6,0,0,0,0
Garmont,Garmont 481996/205 13,Garmont T 8 NFS 670 Regular Coyote 481996/205 US Size 13,Default Ridgefield,7,7,0,0,0,0
Garmont,Garmont 481996/205 7.5,Garmont T 8 NFS 670 Regular Coyote 481996/205 US Size 7.5,Default Ridgefield,10,10,0,0,0,0
Garmont,Garmont 481996/205 8.5,Garmont T 8 NFS 670 Regular Coyote 481996/205 US Size 8.5,FBALYB Amazon,29,28,1,0,1,0
Garmont,Garmont 481996/205 9,Garmont T 8 NFS 670 Regular Coyote 481996/205 US Size 9,Default Ridgefield,35,35,0,0,0,0
Garmont,Garmont 481996/205 9.5,Garmont T 8 NFS 670 Regular Coyote 481996/205 US Size 9.5,Default Ridgefield,40,40,0,0,0,0
Garmont,Garmont 481996/205 9.5,Garmont T 8 NFS 670 Regular Coyote 481996/205 US Size 9.5,FBALYB Amazon,3,3,0,0,0,0
Garmont,Garmont 481996/206 10,Garmont T 8 NFS 670 Wide Coyote 481996/206 US Size 10,FBALYB Amazon,12,9,3,0,3,0
Garmont,Garmont 481996/206 10.5,Garmont T 8 NFS 670 Wide Coyote 481996/206 US Size 10.5,FBALYB Amazon,80,80,0,0,0,0
Garmont,Garmont 481996/206 12,Garmont T 8 NFS 670 Wide Coyote 481996/206 US Size 12,FBALYB Amazon,33,33,0,0,0,0
Garmont,Garmont 481996/206 12.5,Garmont T 8 NFS 670 Wide Coyote 481996/206 US Size 12.5,FBALYB Amazon,6,6,0,0,0,0
Garmont,Garmont 481996/206 13,Garmont T 8 NFS 670 Wide Coyote 481996/206 US Size 13,Default Ridgefield,5,5,0,0,0,0
Garmont,Garmont 481996/206 7,Garmont T 8 NFS 670 Wide Coyote 481996/206 US Size 7,FBALYB Amazon,6,6,0,0,0,0
Garmont,Garmont 481996/206 7.5,Garmont T 8 NFS 670 Wide Coyote 481996/206 US Size 7.5,FBALYB Amazon,2,2,0,0,0,0
Garmont,Garmont 481996/206 8,Garmont T 8 NFS 670 Wide Coyote 481996/206 US Size 8,Default Ridgefield,10,10,0,0,0,0
Garmont,Garmont 481996/206 8.5,Garmont T 8 NFS 670 Wide Coyote 481996/206 US Size 8.5,FBALYB Amazon,37,36,1,0,1,0
Garmont,Garmont 481996/206 9,Garmont T 8 NFS 670 Wide Coyote 481996/206 US Size 9,FBALYB Amazon,1,1,0,1,0,0
Garmont,Garmont 481996/206 9.5,Garmont T 8 NFS 670 Wide Coyote 481996/206 US Size 9.5,FBALYB Amazon,0,0,0,20,0,0
General Finishes,General Finishes Ash Gray Gel Half Pint,"General Finishes Ash Gray Half Pint	",Default Ridgefield,96,96,0,0,0,0
General Finishes,General Finishes Ash Gray Gel Half Pint,"General Finishes Ash Gray Half Pint	",FBALYB Amazon,66,66,0,0,0,0
General Finishes,General Finishes Gray Half Pint,General Finishes Gray Half Pint,FBALYB Amazon,64,64,0,0,0,0
General Finishes,GF Alabaster Quart,General Finishes Alabaster Quart,FBALYB Amazon,0,0,0,48,0,0
General Finishes,GF Antique White Gallon,General Finishes Antique White Gallon,FBALYB Amazon,0,0,0,48,0,0
General Finishes,GF Antique White Pint,General Finishes Antique White Pint,FBALYB Amazon,0,0,0,50,0,0
General Finishes,GF Antique White Quart,General Finishes Antique White Quart,FBALYB Amazon,0,0,0,248,0,0
General Finishes,GF Arm-R-Seal Gloss Gal 8 lbs.,General Finishes Arm-R-Seal Gloss Gallon 8 lbs.,FBALYB Amazon,23,19,4,0,4,0
General Finishes,GF Arm-R-Seal Gloss Quart 2 lbs.,General Finishes Arm-R-Seal Gloss Quart 2 lbs.,Default Ridgefield,2,2,0,0,0,0
General Finishes,GF Arm-R-Seal Gloss Quart 2 lbs.,General Finishes Arm-R-Seal Gloss Quart 2 lbs.,FBALYB Amazon,74,69,5,0,5,0
General Finishes,GF Arm-R-Seal Satin Quart 2 lbs.,General Finishes Arm-R-Seal Satin Quart 2 lbs.,FBALYB Amazon,40,22,18,0,18,0
General Finishes,GF Arm-R-Seal SemGloss Gal 8 lbs.,"General Finishes Arm-R-Seal Semi-Gloss Gallon	8 lbs.",FBALYB Amazon,15,14,1,0,1,0
General Finishes,GF Arm-R-Seal SemGloss Pt 1 lbs.,General Finishes Arm-R-Seal Semi-Gloss Pint 1 lbs.,FBALYB Amazon,22,22,0,0,0,0
General Finishes,GF Arm-R-Seal SemGloss Qt 2 lbs.,General Finishes Arm-R-Seal Semi-Gloss Quart 2 lbs.,Default Ridgefield,13,13,0,0,0,0
General Finishes,GF Arm-R-Seal SemGloss Qt 2 lbs.,General Finishes Arm-R-Seal Semi-Gloss Quart 2 lbs.,FBALYB Amazon,159,152,7,0,7,0
General Finishes,GF Basil Quart,General Finishes Basil Quart,FBALYB Amazon,0,0,0,48,0,0
General Finishes,GF China Blue Quart,General Finishes China Blue Quart,FBALYB Amazon,0,0,0,48,0,0
General Finishes,GF Coastal Blue Quart,General Finishes Coastal Blue Quart,FBALYB Amazon,0,0,0,104,0,0
General Finishes,GF Dark Chocolate Pint,General Finishes Dark Chocolate Pint,FBALYB Amazon,0,0,0,50,0,0
General Finishes,GF Dark Chocolate Quart,General Finishes Dark Chocolate Quart,FBALYB Amazon,0,0,0,64,0,0
General Finishes,GF Driftwood Gallon,General Finishes Driftwood Gallon,FBALYB Amazon,0,0,0,24,0,0
General Finishes,GF Driftwood Quart,General Finishes Driftwood Quart,FBALYB Amazon,0,0,0,200,0,0
General Finishes,GF DS Blue Pint 1 lbs.,General Finishes DS Blue Pint 1 lbs.,FBALYB Amazon,99,99,0,1,0,0
General Finishes,GF DS Blue Quart 2 lbs.,General Finishes DS Blue Quart 2 lbs.,Default Ridgefield,176,176,0,0,0,0
General Finishes,GF DS Blue Quart 2 lbs.,General Finishes DS Blue Quart 2 lbs.,FBALYB Amazon,41,41,0,0,0,0
General Finishes,GF DS Empire Red Pint 1 lbs.,General Finishes DS Empire Red Pint 1 lbs.,FBALYB Amazon,29,28,1,0,1,0
General Finishes,GF DS Light Brown Pint 1 lbs.,General Finishes DS Light Brown Pint 1 lbs.,Default Ridgefield,100,100,0,0,0,0
General Finishes,GF DS Light Brown Pint 1 lbs.,General Finishes DS Light Brown Pint 1 lbs.,FBALYB Amazon,35,35,0,0,0,0
General Finishes,GF DS Light Brown Quart2 lbs.,"General Finishes DS Light Brown Quart	2 lbs.",Default Ridgefield,104,104,0,0,0,0
General Finishes,GF DS Light Brown Quart2 lbs.,"General Finishes DS Light Brown Quart	2 lbs.",FBALYB Amazon,39,38,1,0,1,0
General Finishes,GF DS Orange Pint 1 lbs.,General Finishes DS Orange Pint 1 lbs.,FBALYB Amazon,33,33,0,0,0,0
General Finishes,GF DS Yellow Pint 1 lbs.,General Finishes DS Yellow Pint 1 lbs.,Default Ridgefield,70,70,0,0,0,0
General Finishes,GF DS Yellow Pint 1 lbs.,General Finishes DS Yellow Pint 1 lbs.,FBALYB Amazon,31,31,0,0,0,0
General Finishes,GF ES Cedar Gallon9 lbs.,General Finishes ES Cedar Gallon        9 lbs.,Default Ridgefield,44,44,0,0,0,0
General Finishes,GF Extender Pint 1 lbs.,General Finishes Extender Pint 1 lbs.,FBALYB Amazon,183,179,4,0,4,0
General Finishes,GF Exterior 450 Satin Qt 2 lbs,General Finishes Exterior 450 Satin Quart 2 lbs,Default Ridgefield,8,8,0,0,0,0
General Finishes,GF Flat Out Flat Pint1 lbs.,"General Finishes Flat Out Flat Pint	1 lbs.",Default Ridgefield,200,200,0,0,0,0
General Finishes,GF Flat Out Flat Pint1 lbs.,"General Finishes Flat Out Flat Pint	1 lbs.",FBALYB Amazon,33,33,0,0,0,0
General Finishes,GF Flat Out Flat Quart 2 lbs.,General Finishes Flat Out Flat Quart 2 lbs.,Default Ridgefield,403,403,0,0,0,0
General Finishes,GF Flat Out Flat Quart 2 lbs.,General Finishes Flat Out Flat Quart 2 lbs.,FBALYB Amazon,165,164,1,0,1,0
General Finishes,GF GE Pitch Black Pint 1 lbs.,General Finishes GE Pitch Black Pint 1 lbs.,Default Ridgefield,40,40,0,0,0,0
General Finishes,GF GE Pitch Black Pint 1 lbs.,General Finishes GE Pitch Black Pint 1 lbs.,FBALYB Amazon,0,0,0,70,0,0
General Finishes,GF GE Pitch Black Quart2 lbs.,"General Finishes GE Pitch Black Quart	2 lbs.",Default Ridgefield,176,176,0,0,0,0
General Finishes,GF GE Van Dyke Brown Pint 1 lbs.,General Finishes GE Van Dyke Brown Pint 1 lbs.,Default Ridgefield,220,220,0,0,0,0
General Finishes,GF GE Van Dyke Brown Pint 1 lbs.,General Finishes GE Van Dyke Brown Pint 1 lbs.,FBALYB Amazon,0,0,0,100,0,0
General Finishes,GF GE Van Dyke Brown Qt 2 lbs.,"General Finishes GE Van Dyke Brown Quart	2 lbs.",Default Ridgefield,104,104,0,0,0,0
General Finishes,GF GE Van Dyke Brown Qt 2 lbs.,"General Finishes GE Van Dyke Brown Quart	2 lbs.",FBALYB Amazon,30,28,2,0,2,0
General Finishes,GF GS Antique Walnut Qt 2 lbs.,General Finishes GS Antique Walnut Quart 2 lbs.,FBALYB Amazon,154,144,10,0,10,0
General Finishes,GF GS Antique Wlnt Hlf Pt 7 lbs.,General Finishes GS Antique Walnut Half Pint 7 lbs.,Default Ridgefield,2,1,1,0,0,0
General Finishes,GF GS Antique Wlnt Hlf Pt 7 lbs.,General Finishes GS Antique Walnut Half Pint 7 lbs.,FBALYB Amazon,70,69,1,0,1,0
General Finishes,GF GS Ash Gray Gel Gallon 8 lbs.,General Finishes GS Ash Gray Gel Gallon 8 lbs.,Default Ridgefield,134,134,0,0,0,0
General Finishes,GF GS Ash Gray Gel Gallon 8 lbs.,General Finishes GS Ash Gray Gel Gallon 8 lbs.,FBALYB Amazon,33,31,2,0,2,0
General Finishes,GF GS Ash Gray Gel Pint1 lbs.,"General Finishes GS Ash Gray Gel Pint	1 lbs.",Default Ridgefield,150,150,0,0,0,0
General Finishes,GF GS Ash Gray Gel Pint1 lbs.,"General Finishes GS Ash Gray Gel Pint	1 lbs.",FBALYB Amazon,70,70,0,0,0,0
General Finishes,GF GS Ash Gray Gel Quart 2 lbs.,General Finishes GS Ash Gray Gel Quart 2 lbs.,Default Ridgefield,200,200,0,0,0,0
General Finishes,GF GS Ash Gray Gel Quart 2 lbs.,General Finishes GS Ash Gray Gel Quart 2 lbs.,FBALYB Amazon,75,73,2,0,2,0
General Finishes,GF GS Brown Mahogany Pint 1 lbs.,General Finishes GS Brown Mahogany Pint 1 lbs.,FBALYB Amazon,48,46,2,0,2,0
General Finishes,GF GS Brown Mahogany Qt 2 lbs.,General Finishes GS Brown Mahogany Quart 2 lbs.,FBALYB Amazon,26,22,4,0,4,0
General Finishes,GF GS Carbon Gray Half Pt 7 lbs.,General Finishes GS Carbon Gray Half Pint 7 lbs.,FBALYB Amazon,180,180,0,0,0,0
General Finishes,GF GS Georgain Cherry Pt 1 lbs.,General Finishes GS Georgain Cherry Pint 1 lbs.,FBALYB Amazon,90,90,0,0,0,0
General Finishes,GF GS Georgain Cherry Qt 2 lbs.,General Finishes GS Georgain Cherry Quart 2 lbs.,FBALYB Amazon,177,177,0,0,0,0
General Finishes,GF GS Georgn Chry Hlf Pt 7 lbs.,General Finishes GS Georgain Cherry Half Pint 7 lbs.,Default Ridgefield,3,3,0,0,0,0
General Finishes,GF GS Georgn Chry Hlf Pt 7 lbs.,General Finishes GS Georgain Cherry Half Pint 7 lbs.,FBALYB Amazon,55,53,2,0,2,0
General Finishes,GF GS Gray Pint 1 lbs.,General Finishes GS Gray Pint 1 lbs.,FBALYB Amazon,67,67,0,0,0,0
General Finishes,GF GS Gray Quart 2 lbs.,General Finishes GS Gray Quart 2 lbs.,FBALYB Amazon,15,14,1,0,1,0
General Finishes,GF GS Java Gallon 8 lbs.,General Finishes GS Java Gallon 8 lbs.,FBALYB Amazon,117,114,3,0,3,0
General Finishes,GF GS Java Half Pint 7 lbs.,General Finishes GS Java Half Pint 7 lbs.,FBALYB Amazon,214,214,0,0,0,0
General Finishes,GF GS Java Pint 1 lbs.,General Finishes GS Java Pint 1 lbs.,FBALYB Amazon,156,151,5,0,5,0
General Finishes,GF GS Java Quart 2 lbs.,General Finishes GS Java Quart 2 lbs.,Default Ridgefield,29,29,0,0,0,0
General Finishes,GF GS Java Quart 2 lbs.,General Finishes GS Java Quart 2 lbs.,FBALYB Amazon,403,369,34,0,34,0
General Finishes,GF GS White Half Pint 7 lbs.,General Finishes GS White Half Pint 7 lbs.,Default Ridgefield,98,98,0,0,0,0
General Finishes,GF GS White Half Pint 7 lbs.,General Finishes GS White Half Pint 7 lbs.,FBALYB Amazon,68,67,1,0,1,0
General Finishes,GF GS White Pint 1 lbs.,General Finishes GS White Pint 1 lbs.,Default Ridgefield,200,200,0,0,0,0
General Finishes,GF GS White Pint 1 lbs.,General Finishes GS White Pint 1 lbs.,FBALYB Amazon,92,92,0,0,0,0
General Finishes,GF GS White Quart 2 lbs.,General Finishes GS White Quart 2 lbs.,Default Ridgefield,152,152,0,0,0,0
General Finishes,GF GS White Quart 2 lbs.,General Finishes GS White Quart 2 lbs.,FBALYB Amazon,46,46,0,0,0,0
General Finishes,GF High Perform Flat Gal 9 lbs.,General Finishes High Performance Flat Gallon 9 lbs.,Default Ridgefield,248,248,0,0,0,0
General Finishes,GF High Perform Flat Gal 9 lbs.,General Finishes High Performance Flat Gallon 9 lbs.,FBALYB Amazon,102,101,1,0,1,0
General Finishes,GF High Perform Flat Pint1 lbs.,"General Finishes High Performance Flat Pint	1 lbs.",Default Ridgefield,200,200,0,0,0,0
General Finishes,GF High Perform Flat Pint1 lbs.,"General Finishes High Performance Flat Pint	1 lbs.",FBALYB Amazon,71,68,3,0,3,0
General Finishes,GF High Perform Flat Qt 2 lbs.,General Finishes High Performance Flat Quart 2 lbs.,Default Ridgefield,800,800,0,0,0,0
General Finishes,GF High Perform Flat Qt 2 lbs.,General Finishes High Performance Flat Quart 2 lbs.,FBALYB Amazon,367,364,3,0,3,0
General Finishes,GF High Perform Gloss Gal 9 lbs.,"General Finishes High Performance Gloss Gallon	9 lbs.",Default Ridgefield,48,48,0,0,0,0
General Finishes,GF High Perform Gloss Gal 9 lbs.,"General Finishes High Performance Gloss Gallon	9 lbs.",FBALYB Amazon,37,37,0,0,0,0
General Finishes,GF High Perform Gloss Pt 1 lbs.,General Finishes High Performance Gloss Pint 1 lbs.,Default Ridgefield,50,50,0,0,0,0
General Finishes,GF High Perform Gloss Pt 1 lbs.,General Finishes High Performance Gloss Pint 1 lbs.,FBALYB Amazon,36,35,1,0,1,0
General Finishes,GF High Perform Satin Gal 9 lbs.,"General Finishes High Performance Satin Gallon	9 lbs.",Default Ridgefield,200,200,0,0,0,0
General Finishes,GF High Perform Satin Gal 9 lbs.,"General Finishes High Performance Satin Gallon	9 lbs.",FBALYB Amazon,65,61,4,0,4,0
General Finishes,GF High Perform Satin Pt 1 lbs.,General Finishes High Performance Satin Pint 1 lbs.,Default Ridgefield,500,500,0,0,0,0
General Finishes,GF High Perform Satin Pt 1 lbs.,General Finishes High Performance Satin Pint 1 lbs.,FBALYB Amazon,245,243,2,0,2,0
General Finishes,GF High Perform SemGls Qt 2 lbs.,General Finishes High Performance Semi-Gloss Quart 2 lbs.,Default Ridgefield,201,201,0,0,0,0
General Finishes,GF High Perform SemGls Qt 2 lbs.,General Finishes High Performance Semi-Gloss Quart 2 lbs.,FBALYB Amazon,84,83,1,0,1,0
General Finishes,GF High Perfrm Gloss Qt 2 lbs.,General Finishes High Performance Gloss Quart 2 lbs.,Default Ridgefield,96,96,0,0,0,0
General Finishes,GF High Perfrm Gloss Qt 2 lbs.,General Finishes High Performance Gloss Quart 2 lbs.,FBALYB Amazon,78,77,1,0,1,0
General Finishes,GF HighPerfrm SemGloss Pt 1 lbs.,General Finishes High Performance Semi-Gloss Pint 1 lbs.,Default Ridgefield,100,100,0,0,0,0
General Finishes,GF HighPerfrm SemGloss Pt 1 lbs.,General Finishes High Performance Semi-Gloss Pint 1 lbs.,FBALYB Amazon,50,50,0,0,0,0
General Finishes,GF High Perfrm SemGls Gal 9 lbs.,General Finishes High Performance Semi-Gloss Gallon 9 lbs.,Default Ridgefield,1,1,0,0,0,0
General Finishes,GF High Perfrm SemGls Gal 9 lbs.,General Finishes High Performance Semi-Gloss Gallon 9 lbs.,FBALYB Amazon,42,42,0,0,0,0
General Finishes,GF Lamp Black Gallon,General Finishes Lamp Black Gallon,Default Ridgefield,40,40,0,0,0,0
General Finishes,GF Lamp Black Pint,General Finishes Lamp Black Pint,FBALYB Amazon,0,0,0,90,0,0
General Finishes,GF Lamp Black Quart,General Finishes Lamp Black Quart,Default Ridgefield,320,320,0,0,0,0
General Finishes,GF Linen Quart,General Finishes Linen Quart,Default Ridgefield,48,48,0,0,0,0
General Finishes,GF Outdoor Oil Quart 2 lbs.,General Finishes Outdoor Oil Quart 2 lbs.,Default Ridgefield,72,72,0,0,0,0
General Finishes,GF Perfect Gray Quart,General Finishes Perfect Gray Quart,Default Ridgefield,48,48,0,0,0,0
General Finishes,GF Persian Blue Quart,General Finishes Persian Blue Quart,Default Ridgefield,48,48,0,0,0,0
General Finishes,GF Queenstown Gray Quart,General Finishes Queenstown Gray Quart,FBALYB Amazon,0,0,0,104,0,0
General Finishes,GF Seagull Gray Gallon,General Finishes Seagull Gray Gallon,Default Ridgefield,32,32,0,0,0,0
General Finishes,GF Seagull Gray Pint,General Finishes Seagull Gray Pint,FBALYB Amazon,0,0,0,50,0,0
General Finishes,GF Seagull Gray Quart,General Finishes Seagull Gray Quart,FBALYB Amazon,0,0,0,104,0,0
General Finishes,GF Snow White Pint,General Finishes Snow White Pint,FBALYB Amazon,0,0,0,60,0,0
General Finishes,GF Snow White Quart,General Finishes Snow White Quart,FBALYB Amazon,0,0,0,304,0,0
General Finishes,GF Stain Blocker Gallon 12 lbs,General Finishes Stain Blocker Gallon 12 lbs,Default Ridgefield,48,48,0,0,0,0
General Finishes,GF Stain Blocker Gallon 12 lbs,General Finishes Stain Blocker Gallon 12 lbs,FBALYB Amazon,13,13,0,0,0,0
General Finishes,GF Stain Blocker Quart 3 lbs,General Finishes Stain Blocker Quart 3 lbs,Default Ridgefield,129,129,0,0,0,0
General Finishes,GF Stain Blocker Quart 3 lbs,General Finishes Stain Blocker Quart 3 lbs,FBALYB Amazon,31,31,0,0,0,0
General Finishes,GF WS Black Cherry Pint1 lbs.,"General Finishes WS Black Cherry Pint	1 lbs.",Default Ridgefield,50,50,0,0,0,0
General Finishes,GF WS Black Cherry Pint1 lbs.,"General Finishes WS Black Cherry Pint	1 lbs.",FBALYB Amazon,24,24,0,0,0,0
General Finishes,GF WS Black Pint 1 lbs.,General Finishes WS Black Pint 1 lbs.,FBALYB Amazon,25,25,0,0,0,0
General Finishes,GF WS Black Quart 2 lbs.,General Finishes WS Black Quart 2 lbs.,Default Ridgefield,64,64,0,0,0,0
General Finishes,GF WS Black Quart 2 lbs.,General Finishes WS Black Quart 2 lbs.,FBALYB Amazon,32,32,0,0,0,0
General Finishes,GF WS Brown Mahogany Qt 2 lbs.,General Finishes WS Brown Mahogany Quart 2 lbs.,Default Ridgefield,200,200,0,0,0,0
General Finishes,GF WS Brown Mahogany Qt 2 lbs.,General Finishes WS Brown Mahogany Quart 2 lbs.,FBALYB Amazon,70,70,0,0,0,0
General Finishes,GF WS Cabernet Quart 2 lbs.,General Finishes WS Cabernet Quart 2 lbs.,FBALYB Amazon,32,32,0,0,0,0
General Finishes,GF WS Espresso Quart 2 lbs.,General Finishes WS Espresso Quart 2 lbs.,Default Ridgefield,249,249,0,0,0,0
General Finishes,GF WS Espresso Quart 2 lbs.,General Finishes WS Espresso Quart 2 lbs.,FBALYB Amazon,115,115,0,0,0,0
General Finishes,GF WS Graphite Gallon 9 lbs.,General Finishes WS Graphite Gallon 9 lbs.,Default Ridgefield,48,48,0,0,0,0
General Finishes,GF WS Graphite Gallon 9 lbs.,General Finishes WS Graphite Gallon 9 lbs.,FBALYB Amazon,24,24,0,0,0,0
General Finishes,GF WS Graphite Pint 1 lbs.,General Finishes WS Graphite Pint 1 lbs.,FBALYB Amazon,33,33,0,0,0,0
General Finishes,GF WS Graystone Pint 1 lbs.,General Finishes WS Graystone Pint 1 lbs.,Default Ridgefield,153,153,0,0,0,0
General Finishes,GF WS Graystone Pint 1 lbs.,General Finishes WS Graystone Pint 1 lbs.,FBALYB Amazon,50,50,0,0,0,0
General Finishes,GF WS Graystone Quart,General Finishes WS Graystone Quart,Default Ridgefield,5,5,0,0,0,0
General Finishes,GF WS Graystone Quart,General Finishes WS Graystone Quart,FBALYB Amazon,0,0,0,99,0,0
General Finishes,GF WS Tobacco Gallon 9 lbs.,General Finishes WS Tobacco Gallon 9 lbs.,Default Ridgefield,100,100,0,0,0,0
General Finishes,GF WS Tobacco Gallon 9 lbs.,General Finishes WS Tobacco Gallon 9 lbs.,FBALYB Amazon,27,27,0,0,0,0
General Finishes,GF WS Tobacco Quart 2 lbs.,General Finishes WS Tobacco Quart 2 lbs.,Default Ridgefield,104,104,0,0,0,0
General Finishes,GF WS Tobacco Quart 2 lbs.,General Finishes WS Tobacco Quart 2 lbs.,FBALYB Amazon,45,45,0,0,0,0
General Finishes,GF WS Walnut Quart Quart,General Finishes WS Walnut Quart Quart,Default Ridgefield,48,48,0,0,0,0
General Finishes,GF WS Walnut Quart Quart,General Finishes WS Walnut Quart Quart,FBALYB Amazon,27,27,0,0,0,0
General Finishes,GF WS Whitewash Quart2 lbs.,"General Finishes WS Whitewash Quart	2 lbs.",Default Ridgefield,152,152,0,0,0,0
General Finishes,GF WS Whitewash Quart2 lbs.,"General Finishes WS Whitewash Quart	2 lbs.",FBALYB Amazon,63,63,0,0,0,0
Hey Dude,Hey Dude 110350127 Size 47,Hey Dude WALLY SOX 110350127 ICE GREY Size: 47,Default Ridgefield,0,0,0,0,0,15
Hey Dude,Hey Dude 110353500 SIZE 41,Hey Dude WALLY SOX ASH 110353500 SIZE: 41,Default Ridgefield,0,0,0,0,0,36
Hey Dude,Hey Dude 110353500 SIZE 42,Hey Dude WALLY SOX ASH 110353500 SIZE: 42,Default Ridgefield,0,0,0,0,0,138
Hey Dude,Hey Dude 110353500 SIZE 43,Hey Dude WALLY SOX ASH 110353500 SIZE: 43,Default Ridgefield,0,0,0,0,0,276
Hey Dude,Hey Dude 110353500 SIZE 44,Hey Dude WALLY SOX ASH 110353500 SIZE: 44,Default Ridgefield,0,0,0,0,0,378
Hey Dude,Hey Dude 110353500 SIZE 45,Hey Dude WALLY SOX ASH 110353500 SIZE: 45,Default Ridgefield,0,0,0,0,0,180
Hey Dude,Hey Dude 110353500 SIZE 46,Hey Dude WALLY SOX ASH 110353500 SIZE: 46,Default Ridgefield,0,0,0,0,0,150
Hey Dude,Hey Dude 110353500 SIZE 47,Hey Dude WALLY SOX ASH 110353500 SIZE: 47,Default Ridgefield,0,0,0,0,0,36
Hey Dude,Hey Dude 110390500 SIZE 41,Hey Dude WALLY WOVEN BEIGE 110390500 SIZE 41,Default Ridgefield,0,0,0,0,0,12
Hey Dude,Hey Dude 110390500 SIZE 42,Hey Dude WALLY WOVEN BEIGE 110390500 SIZE 42,Default Ridgefield,0,0,0,0,0,36
Hey Dude,Hey Dude 110390500 SIZE 43,Hey Dude WALLY WOVEN BEIGE 110390500 SIZE 43,Default Ridgefield,0,0,0,0,0,72
Hey Dude,Hey Dude 110390500 SIZE 44,Hey Dude WALLY WOVEN BEIGE 110390500 SIZE 44,Default Ridgefield,0,0,0,0,0,102
Hey Dude,Hey Dude 110390500 SIZE 45,Hey Dude WALLY WOVEN BEIGE 110390500 SIZE 45,Default Ridgefield,0,0,0,0,0,48
Hey Dude,Hey Dude 110390500 SIZE 46,Hey Dude WALLY WOVEN BEIGE 110390500 SIZE 46,Default Ridgefield,0,0,0,0,0,42
Hey Dude,Hey Dude 110390500 SIZE 47,Hey Dude WALLY WOVEN BEIGE 110390500 SIZE 47,Default Ridgefield,0,0,0,0,0,12
Hey Dude,Hey Dude 110394300 Size 45,Hey Dude WALLY WOVEN 110394300 CARBONE Size: 45,Default Ridgefield,0,0,0,0,0,90
Hey Dude,Hey Dude 110394300 Size 46,Hey Dude WALLY WOVEN 110394300 CARBONE Size: 46,Default Ridgefield,0,0,0,0,0,78
Hey Dude,Hey Dude 110394300 Size 47,Hey Dude WALLY WOVEN 110394300 CARBONE Size: 47,Default Ridgefield,0,0,0,0,0,24
Hey Dude,Hey Dude 110793901 Size 46,Hey Dude WALLY LINEN 110793901 IRON Size: 46,Default Ridgefield,0,0,0,0,0,108
Hey Dude,Hey Dude 110793901 Size 47,Hey Dude WALLY LINEN 110793901 IRON Size: 47,Default Ridgefield,0,0,0,0,0,30
Hey Dude,Hey Dude 111163200  Size 47,Hey Dude WALLY L STRETCH 111163200 STEEL Size: 47,Default Ridgefield,0,0,0,0,0,24
Hey Dude,Hey Dude 121410123 Size 42,Hey Dude WENDY 121410123 CHAMBRAY WHITE Size: 42,Default Ridgefield,0,0,0,0,0,6
Hey Dude,Hey Dude 121412526 Size 40,Hey Dude WENDY 121412526 CHAMBRAY NAVY WHITE Size: 40,Default Ridgefield,0,0,0,0,0,30
Hey Dude,Hey Dude 121412526 Size 41,Hey Dude WENDY 121412526 CHAMBRAY NAVY WHITE Size: 41,Default Ridgefield,0,0,0,0,0,24
Hey Dude,Hey Dude 121412526 Size 42,Hey Dude WENDY 121412526 CHAMBRAY NAVY WHITE Size: 42,Default Ridgefield,0,0,0,0,0,6
Hey Dude,Hey Dude 121413058 Size 42,Hey Dude WENDY 121413058 CHAMBRAY LIGHT GREY Size: 42,Default Ridgefield,0,0,0,0,0,12
Hey Dude,Hey Dude 121533901 Size 42,Hey Dude WENDY L LINEN 121533901 IRON Size: 42,Default Ridgefield,0,0,0,0,0,12
Hey Dude,Hey Dude 121704900 Size 42,Hey Dude WENDY L 121704900 BLACK Size: 42,Default Ridgefield,0,0,0,0,0,6
Hunter,Hunter WFS1000RMA-OLG Size 4/6,Hunter WOMEN ORIGINAL SHORT WFS1000RMA-OLG Olive Green Size UK 4 US 6,Default Ridgefield,0,0,0,0,0,20
Hunter,Hunter WFS1000RMA-OLG Size 5/7,Hunter WOMEN ORIGINAL SHORT WFS1000RMA-OLG Olive Green Size UK 5 US 7,Default Ridgefield,0,0,0,0,0,40
Hunter,Hunter WFS1000RMA-OLG Size 6/8,Hunter WOMEN ORIGINAL SHORT WFS1000RMA-OLG Olive Green Size UK 6 US 8,Default Ridgefield,0,0,0,0,0,24
Hunter,Hunter WFS1000RMA-OLG Size 7/9,Hunter WOMEN ORIGINAL SHORT WFS1000RMA-OLG Olive Green Size UK 7 US 9,Default Ridgefield,0,0,0,0,0,44
Hunter,Hunter WFS1000RMA-OLG Size 8/10,Hunter WOMEN ORIGINAL SHORT WFS1000RMA-OLG Olive Green Size UK 8 US 10,Default Ridgefield,0,0,0,0,0,16
Hunter,Hunter WFS1026RMA-BLK Size 3/5,Hunter WOMEN ORIGINAL TOUR SHORT WFS1026RMA-BLK Black Size UK 3 US 5,Default Ridgefield,0,0,0,0,0,20
Hunter,Hunter WFS1026RMA-BLK Size 4/6,Hunter WOMEN ORIGINAL TOUR SHORT WFS1026RMA-BLK Black Size UK 4 US 6,Default Ridgefield,0,0,0,0,0,40
Hunter,Hunter WFS1026RMA-BLK Size 5/7,Hunter WOMEN ORIGINAL TOUR SHORT WFS1026RMA-BLK Black Size UK 5 US 7,Default Ridgefield,0,0,0,0,0,20
Hunter,Hunter WFS1026RMA-BLK Size 6/8,Hunter WOMEN ORIGINAL TOUR SHORT WFS1026RMA-BLK Black Size UK 6 US 8,Default Ridgefield,0,0,0,0,0,40
Hunter,Hunter WFS1026RMA-BLK Size 7/9,Hunter WOMEN ORIGINAL TOUR SHORT WFS1026RMA-BLK Black Size UK 7 US 9,Default Ridgefield,0,0,0,0,0,16
Hunter,Hunter WFS1026RMA-BLK Size 8/10,Hunter WOMEN ORIGINAL TOUR SHORT WFS1026RMA-BLK Black Size UK 8 US 10,Default Ridgefield,0,0,0,0,0,12
Hunter,Hunter WFS2078RMA-BLK Size 4/6,HUNTER WOMEN BLACK ORIGINAL CHELSEA WFS2078RMA-BLK Size UK 4 US 6,Default Ridgefield,0,0,0,0,0,210
Hunter,Hunter WFS2078RMA-BLK Size 6/8,HUNTER WOMEN BLACK ORIGINAL CHELSEA WFS2078RMA-BLK Size UK 6 US 8,Default Ridgefield,0,0,0,0,0,288
Hunter,Hunter WFS2078RMA-BLK Size 7/9,HUNTER WOMEN BLACK ORIGINAL CHELSEA WFS2078RMA-BLK Size UK 7 US 9,Default Ridgefield,0,0,0,0,0,312
Hunter,Hunter WFS2078RMA-BLK Size 8/10,HUNTER WOMEN BLACK ORIGINAL CHELSEA WFS2078RMA-BLK Size UK 8 US 10,Default Ridgefield,0,0,0,0,0,210
Hunter,Hunter WFS2078RMA-MLR Size 3/5,HUNTER WOMEN ORIGINAL CHELSEA WFS2078RMA-MLR Military Red Size UK 3 US 5,Default Ridgefield,0,0,0,0,0,42
Hunter,Hunter WFS2078RMA-MLR Size 4/6,HUNTER WOMEN ORIGINAL CHELSEA WFS2078RMA-MLR Military Red Size UK 4 US 6,Default Ridgefield,0,0,0,0,0,18
Hunter,Hunter WFS2078RMA-MLR Size 5/7,HUNTER WOMEN ORIGINAL CHELSEA WFS2078RMA-MLR Military Red Size UK 5 US 7,Default Ridgefield,0,0,0,0,0,18
Hunter,Hunter WFS2078RMA-MLR Size 6/8,HUNTER WOMEN ORIGINAL CHELSEA WFS2078RMA-MLR Military Red Size UK 6 US 8,Default Ridgefield,0,0,0,0,0,42
Hunter,Hunter WFS2078RMA-MLR Size 7/9,HUNTER WOMEN ORIGINAL CHELSEA WFS2078RMA-MLR Military Red Size UK 7 US 9,Default Ridgefield,0,0,0,0,0,18
Hunter,Hunter WFS2078RMA-MLR Size 8/10,HUNTER WOMEN ORIGINAL CHELSEA WFS2078RMA-MLR Military Red Size UK 8 US 10,Default Ridgefield,0,0,0,0,0,12
Hunter,Hunter WFS2078RMA-NVY Size 3/5,HUNTER WOMEN ORIGINAL CHELSEA WFS2078RMA-NVY Navy Size UK 3 US 5,Default Ridgefield,0,0,0,0,0,6
Hunter,Hunter WFS2078RMA-NVY Size 4/6,HUNTER WOMEN ORIGINAL CHELSEA WFS2078RMA-NVY Navy Size UK 4 US 6,Default Ridgefield,0,0,0,0,0,18
Hunter,Hunter WFS2078RMA-NVY Size 5/7,HUNTER WOMEN ORIGINAL CHELSEA WFS2078RMA-NVY Navy Size UK 5 US 7,Default Ridgefield,0,0,0,0,0,30
Hunter,Hunter WFS2078RMA-NVY Size 6/8,HUNTER WOMEN ORIGINAL CHELSEA WFS2078RMA-NVY Navy Size UK 6 US 8,Default Ridgefield,0,0,0,0,0,42
Hunter,Hunter WFS2078RMA-NVY Size 7/9,HUNTER WOMEN ORIGINAL CHELSEA WFS2078RMA-NVY Navy Size UK 7 US 9,Default Ridgefield,0,0,0,0,0,36
Hunter,Hunter WFS2078RMA-NVY Size 8/10,HUNTER WOMEN ORIGINAL CHELSEA WFS2078RMA-NVY Navy Size UK 8 US 10,Default Ridgefield,0,0,0,0,0,12
Hunter,Hunter Wmn WFS1000RGL-MLR 3/5,Hunter Womens Short Gloss Boots Military Red UK3 US5,FBALYB Amazon,48,48,0,0,0,0
Hunter,Hunter Wmn WFS1000RGL-MLR 7/9,Hunter Womens Short Gloss Boots Military Red UK7 US9,Default Ridgefield,1,1,0,0,0,0
Hunter,Hunter Wmn WFS1000RGL-MLR 7/9,Hunter Womens Short Gloss Boots Military Red UK7 US9,FBALYB Amazon,127,127,0,0,0,0
Hunter,Hunter Wmn WFS1000RGL-MLR 9/11,Hunter Womens Short Gloss Boots Military Red UK9 US11,FBALYB Amazon,32,32,0,0,0,0
Hunter,Hunter Wmn WFS1000RGL-NVY 3/5,Hunter Womens Short Gloss Boots Navy UK3 US5,Default Ridgefield,0,0,0,0,0,12
Hunter,Hunter Wmn WFS1000RGL-NVY 4/6,Hunter Womens Short Gloss Boots Navy UK4 US6,Default Ridgefield,0,0,0,0,0,12
Hunter,Hunter Wmn WFS1000RGL-NVY 8/10,Hunter Womens Short Gloss Boots Navy UK8 US10,Default Ridgefield,0,0,0,0,0,28
Hunter,Hunter Wmn WFS1000RGL-NVY 9/11,Hunter Womens Short Gloss Boots Navy UK9 US11,Default Ridgefield,0,0,0,0,0,8
Hunter,Hunter Wmn WFS1000RMA-BLK 3/5,Hunter Womens Original Short Black WFS1000RMA-BLK UK3 US5,Default Ridgefield,0,0,0,0,0,24
Hunter,Hunter Wmn WFS1000RMA-BLK 9/11,Hunter Womens Original Short Black WFS1000RMA-BLK UK9 US11,Default Ridgefield,0,0,0,0,0,76
Hunter,Hunter Wmn WFS1000RMA-HGR 4/6,Hunter Womens Original Short Hunter Green WFS1000RMA-HGR UK4 US6,Default Ridgefield,1,1,0,0,0,0
Hunter,Hunter Wmn WFS1000RMA-HGR 4/6,Hunter Womens Original Short Hunter Green WFS1000RMA-HGR UK4 US6,FBALYB Amazon,0,0,0,19,0,0
Hunter,Hunter Wmn WFS1000RMA-HGR 5/7,Hunter Womens Original Short Hunter Green WFS1000RMA-HGR UK5 US7,FBALYB Amazon,39,39,0,1,0,0
Hunter,Hunter Wmn WFS1000RMA-HGR 6/8,Hunter Womens Original Short Hunter Green WFS1000RMA-HGR UK6 US8,FBALYB Amazon,0,0,0,24,0,0
Hunter,Hunter Wmn WFS1000RMA-HGR 7/9,Hunter Womens Original Short Hunter Green WFS1000RMA-HGR UK7 US9,FBALYB Amazon,44,44,0,0,0,0
Hunter,Hunter Wmn WFS1000RMA-HGR 810,Hunter Womens Original Short Hunter Green WFS1000RMA-HGR UK8 US10,Default Ridgefield,1,1,0,0,0,0
Hunter,Hunter Wmn WFS1000RMA-HGR 810,Hunter Womens Original Short Hunter Green WFS1000RMA-HGR UK8 US10,FBALYB Amazon,15,14,1,0,1,0
Hunter,Hunter Wmn WFS1000RMA-MLR 3/5,Hunter Womens Original Short Military Red WFS1000RMA-MLR UK3 US5,Default Ridgefield,0,0,0,0,0,4
Hunter,Hunter Wmn WFS1000RMA-MLR 4/6,Hunter Womens Original Short Military Red WFS1000RMA-MLR UK4 US6,Default Ridgefield,0,0,0,0,0,12
Hunter,Hunter Wmn WFS1000RMA-MLR 5/7,Hunter Womens Original Short Military Red WFS1000RMA-MLR UK5 US7,Default Ridgefield,0,0,0,0,0,40
Hunter,Hunter Wmn WFS1000RMA-MLR 7/9,Hunter Womens Original Short Military Red WFS1000RMA-MLR UK7 US9,Default Ridgefield,0,0,0,0,0,48
Hunter,Hunter Wmn WFS1000RMA-MLR 8/10,Hunter Womens Original Short Military Red WFS1000RMA-MLR UK8 US10,Default Ridgefield,0,0,0,0,0,16
Hunter,Hunter Wmn WFS1000RMA-MLR 9/11,Hunter Womens Original Short Military Red WFS1000RMA-MLR UK9 US11,Default Ridgefield,0,0,0,0,0,8
Hunter,Hunter Wmn WFS1000RMA-NVY 3/5,HUNTER NAVY WOMENS ORIGINAL SHORT UK 3 US 5,Default Ridgefield,0,0,0,0,0,8
Hunter,Hunter Wmn WFS1000RMA-NVY 9/11,HUNTER NAVY WOMENS ORIGINAL SHORT UK 9 US 11,Default Ridgefield,0,0,0,0,0,24
Hunter,Hunter Wmn WFS1000RMA-RYL 4/6,Hunter Womens Original Short Yellow WFS1000RMA-RYL UK4 US6,Default Ridgefield,4,4,0,0,0,0
Hunter,Hunter Wmn WFS1000RMA-RYL 4/6,Hunter Womens Original Short Yellow WFS1000RMA-RYL UK4 US6,FBALYB Amazon,0,0,0,16,0,0
Hunter,Hunter Wmn WFS1000RMA-RYL 5/7,Hunter Womens Original Short Yellow WFS1000RMA-RYL UK5 US7,FBALYB Amazon,40,40,0,0,0,0
Hunter,Hunter Wmn WFS1000RMA-RYL 6/8,Hunter Womens Original Short Yellow WFS1000RMA-RYL UK6 US8,FBALYB Amazon,20,19,1,0,1,0
Hunter,Hunter Wmn WFS1000RMA-RYL 7/9,Hunter Womens Original Short Yellow WFS1000RMA-RYL UK7 US9,FBALYB Amazon,0,0,0,40,0,0
Hunter,Hunter Wmn WFS1000RMA-RYL 8/10,Hunter Womens Original Short Yellow WFS1000RMA-RYL UK8 US10,FBALYB Amazon,16,16,0,0,0,0
Hunter,Hunter Wmn WFS1000RMA-RYL 9/11,Hunter Womens Original Short Yellow WFS1000RMA-RYL UK9 US11,FBALYB Amazon,12,12,0,0,0,0
Hunter,Hunter Wmn WFS2201RMA-BLK 3/5,Hunter Womens Refined Slim Fit Chelsea Black WFS2201RMA-BLK UK3 US5,Default Ridgefield,6,6,0,0,0,0
Hunter,Hunter Wmn WFS2201RMA-BLK 4/6,Hunter Womens Refined Slim Fit Chelsea Black WFS2201RMA-BLK UK4 US6,Default Ridgefield,24,24,0,0,0,0
Hunter,Hunter Wmn WFS2201RMA-BLK 5/7,Hunter Womens Refined Slim Fit Chelsea Black WFS2201RMA-BLK UK5 US7,Default Ridgefield,36,36,0,0,0,0
Hunter,Hunter Wmn WFS2201RMA-BLK 6/8,Hunter Womens Refined Slim Fit Chelsea Black WFS2201RMA-BLK UK6 US8,Default Ridgefield,42,42,0,0,0,0
Hunter,Hunter Wmn WFS2201RMA-BLK 7/9,Hunter Womens Refined Slim Fit Chelsea Black WFS2201RMA-BLK UK7 US9,Default Ridgefield,36,36,0,0,0,0
Hunter,Hunter Wmn WFS2201RMA-BLK 8/10,Hunter Womens Refined Slim Fit Chelsea Black WFS2201RMA-BLK UK8 US10,Default Ridgefield,24,24,0,0,0,0
Hunter,Hunter Wmn WFT1000RMA-BLK 3/5,Hunter Womens Original Tall Black UK 3 EU 38 US 5 WFT1000RMA-BLK,Default Ridgefield,0,0,0,0,0,20
Hunter,Hunter Wmn WFT1000RMA-BLK 4/6,Hunter Womens Original Tall Black UK 4 EU 38 US 6 WFT1000RMA-BLK,Default Ridgefield,0,0,0,0,0,44
Hunter,Hunter Wmn WFT1000RMA-BLK 9/11,Hunter Womens Original Tall Black UK 9 EU 38 US 11 WFT1000RMA-BLK,Default Ridgefield,0,0,0,0,0,36
Hunter,Hunter Wmn WFT1000RMA-HGR 9/11,Hunter Womens Original Tall Hunter Green UK9 US11,Default Ridgefield,0,0,0,0,0,44
Hunter,Hunter Wmn WFT1000RMA-MLR 3/5,Hunter Womens Original Tall Military Red WFT1000RMA-MLR UK3 US5,FBALYB Amazon,0,0,0,16,0,0
Hunter,Hunter Wmn WFT1000RMA-MLR 4/6,Hunter Womens Original Tall Military Red WFT1000RMA-MLR UK4 US6,FBALYB Amazon,20,20,0,0,0,0
Hunter,Hunter Wmn WFT1000RMA-MLR 5/7,Hunter Womens Original Tall Military Red WFT1000RMA-MLR UK5 US7,FBALYB Amazon,0,0,0,20,0,0
Hunter,Hunter Wmn WFT1000RMA-MLR 6/8,Hunter Womens Original Tall Military Red WFT1000RMA-MLR UK6 US8,Default Ridgefield,4,4,0,0,0,0
Hunter,Hunter Wmn WFT1000RMA-MLR 6/8,Hunter Womens Original Tall Military Red WFT1000RMA-MLR UK6 US8,FBALYB Amazon,24,24,0,0,0,0
Hunter,Hunter Wmn WFT1000RMA-MLR 7/9,Hunter Womens Original Tall Military Red WFT1000RMA-MLR UK7 US9,Default Ridgefield,8,8,0,0,0,0
Hunter,Hunter Wmn WFT1000RMA-MLR 7/9,Hunter Womens Original Tall Military Red WFT1000RMA-MLR UK7 US9,FBALYB Amazon,16,16,0,0,0,0
Hunter,Hunter Wmn WFT1000RMA-MLR 8/10,Hunter Womens Original Tall Military Red WFT1000RMA-MLR UK8 US10,FBALYB Amazon,0,0,0,20,0,0
Hunter,Hunter Wmn WFT1000RMA-MLR 9/11,Hunter Womens Original Tall Military Red WFT1000RMA-MLR UK9 US11,FBALYB Amazon,16,16,0,0,0,0
Hunter,Hunter Wmn WFT1000RMA-NVY 3/5,Hunter Womens Original Tall Navy UK3 EU36 US5 WFT1000RMA-NVY,FBALYB Amazon,16,16,0,0,0,0
Hunter,Hunter Wmn WFT1000RMA-NVY 5/7,Hunter Womens Original Tall Navy UK5 EU38 US7 WFT1000RMA-NVY,FBALYB Amazon,20,20,0,0,0,0
Hunter,Hunter Wmn WFT1000RMA-NVY 7/9,Hunter Womens Original Tall Navy UK7 EU40/41 US9 WFT1000RMA-NVY,Default Ridgefield,1,1,0,0,0,0
Hunter,Hunter Wmn WFT1000RMA-NVY 7/9,Hunter Womens Original Tall Navy UK7 EU40/41 US9 WFT1000RMA-NVY,FBALYB Amazon,22,22,0,1,0,0
Hunter,Hunter Wmn WFT1000RMA-NVY 9/11,Hunter Womens Original Tall Navy UK9 EU43 US11 WFT1000RMA-NVY,FBALYB Amazon,16,16,0,0,0,0
Hunter,Hunter Wmn WFT1000RMA-RYL 3/5,Hunter Womens Original Tall Yellow WFT1000RMA-RYL UK3 US5,Default Ridgefield,0,0,0,0,0,12
Hunter,Hunter Wmn WFT1000RMA-RYL 4/6,Hunter Womens Original Tall Yellow WFT1000RMA-RYL UK4 US6,Default Ridgefield,0,0,0,0,0,24
Hunter,Hunter Wmn WFT1000RMA-RYL 5/7,Hunter Womens Original Tall Yellow WFT1000RMA-RYL UK5 US7,Default Ridgefield,0,0,0,0,0,40
Hunter,Hunter Wmn WFT1000RMA-RYL 6/8,Hunter Womens Original Tall Yellow WFT1000RMA-RYL UK6 US8,Default Ridgefield,0,0,0,0,0,48
Hunter,Hunter Wmn WFT1000RMA-RYL 7/9,Hunter Womens Original Tall Yellow WFT1000RMA-RYL UK7 US9,Default Ridgefield,0,0,0,0,0,32
Hunter,Hunter Wmn WFT1000RMA-RYL 8/10,Hunter Womens Original Tall Yellow WFT1000RMA-RYL UK8 US10,Default Ridgefield,0,0,0,0,0,28
Hunter,Hunter Wmn WFT1000RMA-RYL 9/11,Hunter Womens Original Tall Yellow WFT1000RMA-RYL UK9 US11,Default Ridgefield,0,0,0,0,0,20
Hydrant,Hydrant Hydrate Grapefruit 30ct,Hydrant Hydrate Drink Mix Grapefruit 30ct,Default Ridgefield,2,2,0,0,0,0
Hydrant,Hydrant Hydrate Grapefruit 30ct,Hydrant Hydrate Drink Mix Grapefruit 30ct,FBALYB Amazon,-1,-1,0,0,0,0
Hydrant,Hydrant Hydration Immunity 30ct,Hydrant Hydration Immunity Drink Mix 30ct,Default Ridgefield,3,3,0,0,0,0
Hydrant,Hydrant Hydration Immunity 30ct,Hydrant Hydration Immunity Drink Mix 30ct,FBALYB Amazon,53,51,2,0,2,0
HydroFlask,HydroFlask 16oz Tmblr Wte,HydroFlask 16oz Tumbler White,Default Ridgefield,0,0,0,0,0,120
HydroFlask,HydroFlask 16oz Tumblr Blk,HydroFlask 16 OZ Tumbler Black,Default Ridgefield,0,0,0,0,0,240
HydroFlask,HydroFlask 24oz Carnation,HydroFlask 24 OZ Standard Flex Cap Carnation,Default Ridgefield,0,0,0,0,0,48
HydroFlask,HydroFlask 24oz P-Apple,HydroFlask 24 OZ Standard Flex Cap Pineapple,Default Ridgefield,0,0,0,0,0,48
HydroFlask,HydroFlask 64oz Wide Black,HydroFlask 64oz Wide Flex Cap Black,Default Ridgefield,0,0,0,0,0,96
Keratin Complex,Keratin Complex CC Shamp 13.5oz,Keratin Complex Color Care Shampoo 13.5oz,Default Ridgefield,0,0,0,0,0,36000
Keratin Complex,Keratin Complex CC Shamp 33.8oz,Keratin Complex Color Care Shampoo 33.8oz 1L,Default Ridgefield,0,0,0,0,0,18000
Keratin Complex,Keratin Complex Cond 33.8oz,Keratin Complex Conditioner 33.8oz 1L,Default Ridgefield,0,0,0,0,0,18000
Keratin Complex,Keratin Complex Dbrs Cond 33.8oz,Keratin Complex Blondeshell Debrass Conditioner 33.8oz/ 1000ml,Default Ridgefield,0,0,0,0,0,360
Keratin Complex,Keratin Complex Dbrs Shamp 33.8,Keratin Complex Blondeshell Debrass Shampoo 33.8oz/ 1000ml,Default Ridgefield,0,0,0,0,0,264
Keratin Complex,Keratin Complex Fd-Dfy Cond 13.5,Keratin Complex Timeless Color Fade-Defy Conditioner 13.5oz / 400ml,Default Ridgefield,0,0,0,0,0,204
Keratin Complex,Keratin Complex Fd-Dfy Sham 13.5,Keratin Complex Timeless Color Fade-Defy Shampoo 13.5oz / 400ml,Default Ridgefield,0,0,0,0,0,204
Keratin Complex,Keratin Complex Infus 2.5oz/75ml,Keratin Complex Infusion 2.5oz/75ml,Default Ridgefield,0,0,0,0,0,1008
Keratin Complex,Keratin Complex KC Shamp 13.5oz,Keratin Complex Keratin Care Shampoo 13.5oz,Default Ridgefield,0,0,0,0,0,4320
Keratin Complex,Keratin Complex KC Sth Cond 33.8,Keratin Complex Keratin Care Smoothing Conditioner 33.8oz,Default Ridgefield,0,0,0,0,0,204
Keratin Complex,Keratin Complex KC Sth Shmp 33.8,Keratin Complex Keratin Care Smoothing Shampoo 33.8oz,Default Ridgefield,0,0,0,0,0,504
Keratin Complex,Keratin Complex Keratin Obss 5oz,Keratin Complex Keratin Obsessed 5oz/ 148ml,Default Ridgefield,0,0,0,0,0,504
Keratin Complex,Keratin Complex Ker CC Cnd 13.5,Keratin Complex Keratin Color Care Conditioner 13.5oz,Default Ridgefield,0,0,0,0,0,36000
Keratin Complex,Keratin Complex Vn Bn Dp Cnd 7oz,Keratin Complex Vanilla Bean Deep Conditioner 7oz,Default Ridgefield,0,0,0,0,0,2448
Keratin Complex,Keratin Complex Xprss BlwOut 4oz,Keratin Complex Express Blow Out 4oz,Default Ridgefield,0,0,0,0,0,6192
Kirk's,Kirk's Castile 3-in-1 Fresh 32oz,Kirk's Castile 3-in-1 Head To Toe Nourishing Body Wash Fresh 32oz,Default Ridgefield,2,2,0,0,0,0
Kirk's,Kirk's Hand Soap Eucalyptus 12oz,Kirk's Odor-Neutralizing Natural Hand Soap Eucalyptus 12oz,Default Ridgefield,1,1,0,0,0,0
Kirk's,Kirk's Hand Soap Eucalyptus 12oz,Kirk's Odor-Neutralizing Natural Hand Soap Eucalyptus 12oz,FBALYB Amazon,195,193,2,0,2,0
Kirk's,Kirks Rosemar & Sge Hnd Wsh 12oz,Kirk's Rosemary & Sage Odor Neutralizing Hand Wash 12oz,Default Ridgefield,2,2,0,0,0,0
Mattel,DC-SHHS,DC Super hero high school,FBALYB Amazon,-3,-3,0,0,0,0
Mattel,IKEA SIGNUM Cable Management Rack 2 PK,IKEA SIGNUM Cable Management Rack 2 PK,FBALYB Amazon,-2,-2,0,0,0,0
Merrell,Merrell J06011W - Size 7.5,Merrell J06011W - Size 7.5,Default Ridgefield,0,0,0,0,0,12
Merrell,Merrell J06014W - Size 5.5,Merrell J06014W - Size 5.5,Default Ridgefield,0,0,0,0,0,12
Merrell,Merrell J06014W - Size 6,Merrell J06014W - Size 6,Default Ridgefield,0,0,0,0,0,24
Merrell,Merrell J06017W - Size 10,Merrell J06017W - Size 10,Default Ridgefield,0,0,0,0,0,60
Merrell,Merrell J06017W - Size 10.5,Merrell J06017W - Size 10.5,Default Ridgefield,0,0,0,0,0,60
Merrell,Merrell J06017W - Size 11,Merrell J06017W - Size 11,Default Ridgefield,0,0,0,0,0,60
Merrell,Merrell J06017W - Size 11.5,Merrell J06017W - Size 11.5,Default Ridgefield,0,0,0,0,0,48
Merrell,Merrell J06017W - Size 12,Merrell J06017W - Size 12,Default Ridgefield,0,0,0,0,0,48
Merrell,Merrell J06017W - Size 13,Merrell J06017W - Size 13,Default Ridgefield,0,0,0,0,0,48
Merrell,Merrell J06017W - Size 7.5,Merrell J06017W - Size 7.5,Default Ridgefield,0,0,0,0,0,12
Merrell,Merrell J06017W - Size 8,Merrell J06017W - Size 8,Default Ridgefield,0,0,0,0,0,12
Merrell,Merrell J06017W - Size 8.5,Merrell J06017W - Size 8.5,Default Ridgefield,0,0,0,0,0,24
Merrell,Merrell J06017W - Size 9,Merrell J06017W - Size 9,Default Ridgefield,0,0,0,0,0,36
Merrell,Merrell J06017W - Size 9.5,Merrell J06017W - Size 9.5,Default Ridgefield,0,0,0,0,0,48
Merrell,Merrell J06020W - Size 10,Merrell J06020W - Size 10,Default Ridgefield,0,0,0,0,0,16
Merrell,Merrell J06020W - Size 6.5,Merrell J06020W - Size 6.5,Default Ridgefield,0,0,0,0,0,18
Merrell,Merrell J06020W - Size 7,Merrell J06020W - Size 7,Default Ridgefield,0,0,0,0,0,30
Merrell,Merrell J06020W - Size 7.5,Merrell J06020W - Size 7.5,Default Ridgefield,0,0,0,0,0,28
Merrell,Merrell J06020W - Size 8,Merrell J06020W - Size 8,Default Ridgefield,0,0,0,0,0,28
Merrell,Merrell J06020W - Size 8.5,Merrell J06020W - Size 8.5,Default Ridgefield,0,0,0,0,0,28
Merrell,Merrell J06020W - Size 9,Merrell J06020W - Size 9,Default Ridgefield,0,0,0,0,0,16
Merrell,Merrell J06020W - Size 9.5,Merrell J06020W - Size 9.5,Default Ridgefield,0,0,0,0,0,16
Merrell,Merrell J06026 - Size 10,Merrell J06026 - Size 10,Default Ridgefield,0,0,0,0,0,24
Merrell,Merrell J06026 - Size 10,Merrell J06026 - Size 10,FBALYB Amazon,5,2,3,0,3,0
Merrell,Merrell J06026 - Size 10.5,Merrell J06026 - Size 10.5,Default Ridgefield,0,0,0,0,0,24
Merrell,Merrell J06026 - Size 10.5,Merrell J06026 - Size 10.5,FBALYB Amazon,8,8,0,0,0,0
Merrell,Merrell J06026 - Size 6,Merrell J06026 - Size 6,Default Ridgefield,12,12,0,0,0,24
Merrell,Merrell J06026 - Size 6.5,Merrell J06026 - Size 6.5,Default Ridgefield,12,12,0,0,0,24
Merrell,Merrell J06026 - Size 7,Merrell J06026 - Size 7,Default Ridgefield,0,0,0,0,0,48
Merrell,Merrell J06026 - Size 7,Merrell J06026 - Size 7,FBALYB Amazon,22,21,1,0,1,0
Merrell,Merrell J06026 - Size 7.5,Merrell J06026 - Size 7.5,Default Ridgefield,0,0,0,0,0,48
Merrell,Merrell J06026 - Size 7.5,Merrell J06026 - Size 7.5,FBALYB Amazon,19,16,3,0,3,0
Merrell,Merrell J06026 - Size 8,Merrell J06026 - Size 8,Default Ridgefield,0,0,0,0,0,48
Merrell,Merrell J06026 - Size 8,Merrell J06026 - Size 8,FBALYB Amazon,19,19,0,0,0,0
Merrell,Merrell J06026 - Size 8.5,Merrell J06026 - Size 8.5,Default Ridgefield,0,0,0,0,0,48
Merrell,Merrell J06026 - Size 8.5,Merrell J06026 - Size 8.5,FBALYB Amazon,18,18,0,0,0,0
Merrell,Merrell J06026 - Size 9,Merrell J06026 - Size 9,Default Ridgefield,0,0,0,0,0,48
Merrell,Merrell J06026 - Size 9,Merrell J06026 - Size 9,FBALYB Amazon,20,20,0,0,0,0
Merrell,Merrell J06026 - Size 9.5,Merrell J06026 - Size 9.5,Default Ridgefield,0,0,0,0,0,48
Merrell,Merrell J06026 - Size 9.5,Merrell J06026 - Size 9.5,FBALYB Amazon,22,22,0,0,0,0
Merrell,Merrell J06028 - Size 5.5,Merrell J06028 - Size 5.5,Default Ridgefield,12,12,0,0,0,12
Merrell,Merrell J06029W - Size 10,Merrell J06029W - Size 10,Default Ridgefield,0,0,0,0,0,96
Merrell,Merrell J06029W - Size 10.5,Merrell J06029W - Size 10.5,Default Ridgefield,0,0,0,0,0,96
Merrell,Merrell J06029W - Size 11,Merrell J06029W - Size 11,Default Ridgefield,0,0,0,0,0,96
Merrell,Merrell J06029W - Size 11.5,Merrell J06029W - Size 11.5,Default Ridgefield,0,0,0,0,0,72
Merrell,Merrell J06029W - Size 12,Merrell J06029W - Size 12,Default Ridgefield,0,0,0,0,0,72
Merrell,Merrell J06029W - Size 13,Merrell J06029W - Size 13,Default Ridgefield,0,0,0,0,0,72
Merrell,Merrell J06029W - Size 8,Merrell J06029W - Size 8,Default Ridgefield,0,0,0,0,0,24
Merrell,Merrell J06029W - Size 8.5,Merrell J06029W - Size 8.5,Default Ridgefield,0,0,0,0,0,36
Merrell,Merrell J06029W - Size 9,Merrell J06029W - Size 9,Default Ridgefield,0,0,0,0,0,48
Merrell,Merrell J06029W - Size 9.5,Merrell J06029W - Size 9.5,Default Ridgefield,0,0,0,0,0,72
Merrell,Merrell J06052 - Size 10,Merrell J06052 - Size 10,Default Ridgefield,0,0,0,0,0,40
Merrell,Merrell J06052 - Size 6.5,Merrell J06052 - Size 6.5,Default Ridgefield,0,0,0,0,0,42
Merrell,Merrell J06052 - Size 7,Merrell J06052 - Size 7,Default Ridgefield,0,0,0,0,0,54
Merrell,Merrell J06052 - Size 7.5,Merrell J06052 - Size 7.5,Default Ridgefield,0,0,0,0,0,64
Merrell,Merrell J06052 - Size 8,Merrell J06052 - Size 8,Default Ridgefield,0,0,0,0,0,52
Merrell,Merrell J06052 - Size 8.5,Merrell J06052 - Size 8.5,Default Ridgefield,0,0,0,0,0,52
Merrell,Merrell J06052 - Size 9,Merrell J06052 - Size 9,Default Ridgefield,0,0,0,0,0,40
Merrell,Merrell J06052 - Size 9.5,Merrell J06052 - Size 9.5,Default Ridgefield,0,0,0,0,0,16
Merrell,Merrell J06055W -  Size 10,Merrell J06055W -  Size 10,Default Ridgefield,0,0,0,0,0,28
Merrell,Merrell J06055W -  Size 10.5,Merrell J06055W -  Size 10.5,Default Ridgefield,0,0,0,0,0,28
Merrell,Merrell J06055W -  Size 11,Merrell J06055W -  Size 11,Default Ridgefield,0,0,0,0,0,28
Merrell,Merrell J06055W -  Size 11.5,Merrell J06055W -  Size 11.5,Default Ridgefield,0,0,0,0,0,16
Merrell,Merrell J06055W -  Size 12,Merrell J06055W -  Size 12,Default Ridgefield,0,0,0,0,0,16
Merrell,Merrell J06055W -  Size 13,Merrell J06055W -  Size 13,Default Ridgefield,0,0,0,0,0,16
Merrell,Merrell J06055W -  Size 8.5,Merrell J06055W -  Size 8.5,Default Ridgefield,0,0,0,0,0,16
Merrell,Merrell J06055W -  Size 9,Merrell J06055W -  Size 9,Default Ridgefield,0,0,0,0,0,16
Merrell,Merrell J06055W -  Size 9.5,Merrell J06055W -  Size 9.5,Default Ridgefield,0,0,0,0,0,16
Merrell,Merrell J06057 - Size 8,Merrell J06057 - Size 8,Default Ridgefield,0,0,0,0,0,12
Merrell,Merrell J06057 - Size 8.5,Merrell J06057 - Size 8.5,Default Ridgefield,0,0,0,0,0,12
Merrell,Merrell J06057W - Size 10,Merrell J06057W - Size 10,Default Ridgefield,0,0,0,0,0,28
Merrell,Merrell J06057W - Size 10.5,Merrell J06057W - Size 10.5,Default Ridgefield,0,0,0,0,0,28
Merrell,Merrell J06057W - Size 11,Merrell J06057W - Size 11,Default Ridgefield,0,0,0,0,0,28
Merrell,Merrell J06057W - Size 11.5,Merrell J06057W - Size 11.5,Default Ridgefield,0,0,0,0,0,16
Merrell,Merrell J06057W - Size 12,Merrell J06057W - Size 12,Default Ridgefield,0,0,0,0,0,16
Merrell,Merrell J06057W - Size 13,Merrell J06057W - Size 13,Default Ridgefield,0,0,0,0,0,16
Merrell,Merrell J06057W - Size 8.5,Merrell J06057W - Size 8.5,Default Ridgefield,0,0,0,0,0,16
Merrell,Merrell J06057W - Size 9,Merrell J06057W - Size 9,Default Ridgefield,0,0,0,0,0,16
Merrell,Merrell J06057W - Size 9.5,Merrell J06057W - Size 9.5,Default Ridgefield,0,0,0,0,0,16
Merrell,Merrell J08871 - size 7.5,Merrell J08871 - size 7.5,Default Ridgefield,0,0,0,0,0,12
Merrell,Merrell J08871 - size 7.5,Merrell J08871 - size 7.5,FBALYB Amazon,12,12,0,0,0,0
Merrell,Merrell J08871W - Size 10,Merrell J08871W - Size 10,Default Ridgefield,0,0,0,0,0,28
Merrell,Merrell J08871W - Size 10.5,Merrell J08871W - Size 10.5,Default Ridgefield,0,0,0,0,0,28
Merrell,Merrell J08871W - Size 11,Merrell J08871W - Size 11,Default Ridgefield,0,0,0,0,0,28
Merrell,Merrell J08871W - Size 11.5,Merrell J08871W - Size 11.5,Default Ridgefield,0,0,0,0,0,16
Merrell,Merrell J08871W - Size 12,Merrell J08871W - Size 12,Default Ridgefield,0,0,0,0,0,16
Merrell,Merrell J08871W - Size 13,Merrell J08871W - Size 13,Default Ridgefield,0,0,0,0,0,16
Merrell,Merrell J08871W - Size 8.5,Merrell J08871W - Size 8.5,Default Ridgefield,0,0,0,0,0,16
Merrell,Merrell J08871W - Size 9,Merrell J08871W - Size 9,Default Ridgefield,0,0,0,0,0,16
Merrell,Merrell J08871W - Size 9.5,Merrell J08871W - Size 9.5,Default Ridgefield,0,0,0,0,0,16
Merrell,Merrell  J15853 BLACK 10,Merrell Mens MOAB 2 MID TACTICAL WP BLACK J15853 US Size 10,FBALYB Amazon,0,0,0,72,0,0
Merrell,Merrell  J15853 BLACK 10.5,Merrell Mens MOAB 2 MID TACTICAL WP BLACK J15853 US Size 10.5,Default Ridgefield,2,2,0,0,0,0
Merrell,Merrell  J15853 BLACK 10.5,Merrell Mens MOAB 2 MID TACTICAL WP BLACK J15853 US Size 10.5,FBALYB Amazon,0,0,0,69,0,0
Merrell,Merrell  J15853 BLACK 11,Merrell Mens MOAB 2 MID TACTICAL WP BLACK J15853 US Size 11,FBALYB Amazon,34,34,0,38,0,0
Merrell,Merrell  J15853 BLACK 11.5,Merrell Mens MOAB 2 MID TACTICAL WP BLACK J15853 US Size 11.5,Default Ridgefield,1,1,0,0,0,0
Merrell,Merrell  J15853 BLACK 11.5,Merrell Mens MOAB 2 MID TACTICAL WP BLACK J15853 US Size 11.5,FBALYB Amazon,24,24,0,23,0,0
Merrell,Merrell  J15853 BLACK 12,Merrell Mens MOAB 2 MID TACTICAL WP BLACK J15853 US Size 12,FBALYB Amazon,4,4,0,44,0,0
Merrell,Merrell  J15853 BLACK 13,Merrell Mens MOAB 2 MID TACTICAL WP BLACK J15853 US Size 13,Default Ridgefield,24,24,0,0,0,0
Merrell,Merrell  J15853 BLACK 13,Merrell Mens MOAB 2 MID TACTICAL WP BLACK J15853 US Size 13,FBALYB Amazon,0,0,0,24,0,0
Merrell,Merrell  J15853 BLACK 8.5,Merrell Mens MOAB 2 MID TACTICAL WP BLACK J15853 US Size 8.5,Default Ridgefield,12,12,0,0,0,0
Merrell,Merrell  J15853 BLACK 8.5,Merrell Mens MOAB 2 MID TACTICAL WP BLACK J15853 US Size 8.5,FBALYB Amazon,0,0,0,12,0,0
Merrell,Merrell  J15853 BLACK 9,Merrell Mens MOAB 2 MID TACTICAL WP BLACK J15853 US Size 9,Default Ridgefield,12,12,0,0,0,0
Merrell,Merrell  J15853 BLACK 9,Merrell Mens MOAB 2 MID TACTICAL WP BLACK J15853 US Size 9,FBALYB Amazon,0,0,0,12,0,0
Merrell,Merrell  J15853 BLACK 9.5,Merrell Mens MOAB 2 MID TACTICAL WP BLACK J15853 US Size 9.5,Default Ridgefield,1,1,0,0,0,0
Merrell,Merrell  J15853 BLACK 9.5,Merrell Mens MOAB 2 MID TACTICAL WP BLACK J15853 US Size 9.5,FBALYB Amazon,46,46,0,1,0,0
Merrell,Merrell J52931 - Size 10,Merrell J52931 - Size 10,Default Ridgefield,0,0,0,0,0,36
Merrell,Merrell J52931 - Size 10.5,Merrell J52931 - Size 10.5,Default Ridgefield,0,0,0,0,0,36
Merrell,Merrell J52931 - Size 11,Merrell J52931 - Size 11,Default Ridgefield,0,0,0,0,0,36
Merrell,Merrell J52931 - Size 11.5,Merrell J52931 - Size 11.5,Default Ridgefield,0,0,0,0,0,24
Merrell,Merrell J52931 - Size 12,Merrell J52931 - Size 12,Default Ridgefield,0,0,0,0,0,24
Merrell,Merrell J52931 - Size 13,Merrell J52931 - Size 13,Default Ridgefield,0,0,0,0,0,24
Merrell,Merrell J52931 - Size 8,Merrell J52931 - Size 8,Default Ridgefield,0,0,0,0,0,12
Merrell,Merrell J52931 - Size 8.5,Merrell J52931 - Size 8.5,Default Ridgefield,0,0,0,0,0,12
Merrell,Merrell J52931 - Size 9,Merrell J52931 - Size 9,Default Ridgefield,0,0,0,0,0,24
Merrell,Merrell J52931 - Size 9.5,Merrell J52931 - Size 9.5,Default Ridgefield,0,0,0,0,0,24
Merrell,Merrell J92025 - Size 8,Merrell J92025 - Size 8,Default Ridgefield,12,12,0,0,0,12
Merrell,Merrell J99764 - Size 10,Merrell J99764 - Size 10,Default Ridgefield,0,0,0,0,0,12
Merrell,Merrell J99764 - Size 10.5,Merrell J99764 - Size 10.5,Default Ridgefield,0,0,0,0,0,12
Merrell,Merrell J99764 - Size 11,Merrell J99764 - Size 11,Default Ridgefield,0,0,0,0,0,12
Merrell,Merrell J99764 - Size 5.5,Merrell J99764 - Size 5.5,Default Ridgefield,0,0,0,0,0,12
Merrell,Merrell J99764 - Size 6,Merrell J99764 - Size 6,Default Ridgefield,0,0,0,0,0,12
Merrell,Merrell J99764 - Size 6.5,Merrell J99764 - Size 6.5,Default Ridgefield,0,0,0,0,0,12
Merrell,Merrell J99764 - Size 7,Merrell J99764 - Size 7,Default Ridgefield,0,0,0,0,0,36
Merrell,Merrell J99764 - Size 7.5,Merrell J99764 - Size 7.5,Default Ridgefield,0,0,0,0,0,24
Merrell,Merrell J99764 - Size 8,Merrell J99764 - Size 8,Default Ridgefield,0,0,0,0,0,36
Merrell,Merrell J99764 - Size 8.5,Merrell J99764 - Size 8.5,Default Ridgefield,0,0,0,0,0,36
Merrell,Merrell J99764 - Size 9,Merrell J99764 - Size 9,Default Ridgefield,0,0,0,0,0,36
Merrell,Merrell J99764 - Size 9.5,Merrell J99764 - Size 9.5,Default Ridgefield,0,0,0,0,0,24
Nair,Nair 4 Men 13oz Crmp PMP,Nair For Men 13oz Cream (Pump),Default Ridgefield,6480,6480,0,0,0,0
Natural Vitality,Natural Vitality Calm Gum BBry,Natural Vitality Calm Sleep 120 Gummies Blueberry,Default Ridgefield,0,-108,108,0,0,0
Natural Vitality,Natural Vitality Calm Gum BBry,Natural Vitality Calm Sleep 120 Gummies Blueberry,FBALYB Amazon,55,49,6,0,6,0
Natural Vitality,Natural Vitality Calm RasLemn 8oz,Natural Vitality Calm Raspberry Lemon 8 oz,FBALYB Amazon,-3,-3,0,0,0,0
Natural Vitality,Natural Vitality Calm RasLemon 300,Natural Vitality Calm 120 Gummies Raspberry Lemon 300g,Default Ridgefield,120,120,0,0,0,0
Natural Vitality,Natural Vitality Clm Lem/Ras 16Oz,Natural Vitality Natural Calm Lemon/Raspberry 16 Oz,FBALYB Amazon,12,12,0,0,0,0
Natural Vitality,Natural Vitality Clm Orange 120,Natural Vitality Calm Gummies Orange Flavor 120 Gummies,Default Ridgefield,12,12,0,0,0,0
Natural Vitality,Natural Vitality Natural Calm orig,Natural Vitality Natural Calm original 8 oz,Default Ridgefield,1,1,0,0,0,0
Natural Vitality,Natural Vitality Natural Calm orig,Natural Vitality Natural Calm original 8 oz,FBALYB Amazon,62,62,0,0,0,0
NeoCell,NeoCell Clgn Powder 6600mg 1&3,NeoCell Super Collagen Powder 6600mg Type 1&3 7oz,Default Ridgefield,7,7,0,0,0,0
NeoCell,NeoCell Clgn SChews FP 2000mg,"NeoCell Beauty Bursts Collagen Soft Chews 60ct Fruit Punch 2,000mg",Default Ridgefield,156,156,0,0,0,0
Nike,Nike Kids 943307-004 P-1/ 11C,Nike Kids Nike Revolution 4 Negro Fuschia 943307-004 P-1 US Size 11C,Default Ridgefield,25,25,0,0,0,0
Nike,Nike Kids 943307-004 P-1/ 12C,Nike Kids Nike Revolution 4 Negro Fuschia 943307-004 P-1 US Size 12C,Default Ridgefield,25,25,0,0,0,0
Nike,Nike Kids 943307-004 P-1/ 13C,Nike Kids Nike Revolution 4 Negro Fuschia 943307-004 P-1 US Size 13C,Default Ridgefield,24,24,0,0,0,0
Nike,Nike Kids 943307-004 P-2/ 1Y,Nike Kids Nike Revolution 4 Negro Fuschia 943307-004 P-2 US Size 1Y,Default Ridgefield,26,26,0,0,0,0
Nike,Nike Kids 943307-004 P-2/ 2Y,Nike Kids Nike Revolution 4 Negro Fuschia 943307-004 P-2 US Size 2Y,Default Ridgefield,26,26,0,0,0,0
Nike,Nike Kids 943307-004 P-2/ 3Y,Nike Kids Nike Revolution 4 Negro Fuschia 943307-004 P-2 US Size 3Y,Default Ridgefield,23,23,0,0,0,0
Nike,Nike Men 908988-011 M-8/ 10,Nike Mens Nike Revolution 4 Black/Red/White 908988-011 M-8 US Size 10,FBALYB Amazon,32,32,0,0,0,0
Nike,Nike Men 908988-011 M-8/ 8.5,Nike Mens Nike Revolution 4 Black/Red/White 908988-011 M-8 US Size 8.5,FBALYB Amazon,29,29,0,0,0,0
Nike,Nike Men 908988-011 M-8/ 9,Nike Mens Nike Revolution 4 Black/Red/White 908988-011 M-8 US Size 9,FBALYB Amazon,66,66,0,0,0,0
Nike,Nike Men 908988-011 M-8/ 9.5,Nike Mens Nike Revolution 4 Black/Red/White 908988-011 M-8 US Size 9.5,FBALYB Amazon,59,53,6,0,6,0
Nike,Nike Men BQ3198-101 11.5,Nike Men NIKE TODOS WHITE/UNIV RED-BLACK BQ3198-101 Size 11.5,Default Ridgefield,1,1,0,0,0,24
Nike,Nike Men BQ3198-101 11.5,Nike Men NIKE TODOS WHITE/UNIV RED-BLACK BQ3198-101 Size 11.5,FBALYB Amazon,42,42,0,0,0,0
Nike,Nike Men BQ3198-101 13,Nike Men NIKE TODOS WHITE/UNIV RED-BLACK BQ3198-101 Size 13,Default Ridgefield,1,1,0,0,0,24
Nike,Nike Men BQ3198-101 13,Nike Men NIKE TODOS WHITE/UNIV RED-BLACK BQ3198-101 Size 13,FBALYB Amazon,42,42,0,0,0,0
Nike,Nike Men BQ3202-010 M9/10,Nike Mens Nike Zoom Gravity Gray Copper/ Brown BQ3202-010 M9 US Size 10,Default Ridgefield,98,98,0,0,0,0
Nike,Nike Men BQ3202-010 M9/10.5,Nike Mens Nike Zoom Gravity Gray Copper/ Brown BQ3202-010 M9 US Size 10.5,Default Ridgefield,98,98,0,0,0,0
Nike,Nike Men BQ3202-010 M9/11,Nike Mens Nike Zoom Gravity Gray Copper/ Brown BQ3202-010 M9 US Size 11,FBALYB Amazon,49,48,1,0,1,0
Nike,Nike Men BQ3202-010 M9/12,Nike Mens Nike Zoom Gravity Gray Copper/ Brown BQ3202-010 M9 US Size 12,Default Ridgefield,49,49,0,0,0,0
Nike,Nike Men BQ4235-005 M6/ 10,Nike Mens Nike Renew Lucent Black/ Volt/ Pure Platinum/ BQ4235-005 M6/ US Size 10,FBALYB Amazon,17,17,0,0,0,0
Nike,Nike Men BQ4235-005 M6/ 10.5,Nike Mens Nike Renew Lucent Black/ Volt/ Pure Platinum/ BQ4235-005 M6/ US Size 10.5,FBALYB Amazon,17,17,0,0,0,0
Nike,Nike Men BQ4235-005 M6/ 11,Nike Mens Nike Renew Lucent Black/ Volt/ Pure Platinum/ BQ4235-005 M6/ US Size 11,FBALYB Amazon,17,17,0,0,0,0
Nike,Nike Men BQ4235-005 M6/ 11.5,Nike Mens Nike Renew Lucent Black/ Volt/ Pure Platinum/ BQ4235-005 M6/ US Size 11.5,Default Ridgefield,1,1,0,0,0,0
Nike,Nike Men BQ4235-005 M6/ 11.5,Nike Mens Nike Renew Lucent Black/ Volt/ Pure Platinum/ BQ4235-005 M6/ US Size 11.5,FBALYB Amazon,16,16,0,0,0,0
Nike,Nike Men BQ4235-005 M6/ 12,Nike Mens Nike Renew Lucent Black/ Volt/ Pure Platinum/ BQ4235-005 M6/ US Size 12,FBALYB Amazon,17,17,0,0,0,0
Nike,Nike Men BQ4235-005 M6/ 13,Nike Mens Nike Renew Lucent Black/ Volt/ Pure Platinum/ BQ4235-005 M6/ US Size 13,FBALYB Amazon,16,16,0,0,0,0
Nike,Nike Men  CD4162-606 M9/ 10,Nike Mens Nike Phantom Vision 2 Pro DF FG Laser Crimson/Metallic Silver/Black CD4162-606 M9/ US Size 10,Default Ridgefield,28,28,0,0,0,0
Nike,Nike Men  CD4162-606 M9/ 10.5,Nike Mens Nike Phantom Vision 2 Pro DF FG Laser Crimson/Metallic Silver/Black CD4162-606 M9/ US Size 10.5,Default Ridgefield,22,22,0,0,0,0
Nike,Nike Men  CD4162-606 M9/ 11,Nike Mens Nike Phantom Vision 2 Pro DF FG Laser Crimson/Metallic Silver/Black CD4162-606 M9/ US Size 11,Default Ridgefield,11,11,0,0,0,0
Nike,Nike Mens AO0566-606 10,Nike Mens PHANTOM VENOM ACADEMY FG Black Laser Crimson AO0566-606 US Size 10,Default Ridgefield,0,0,0,0,0,20
Nike,Nike Mens AO0566-606 10.5,Nike Mens PHANTOM VENOM ACADEMY FG Black Laser Crimson AO0566-606 US Size 10.5,Default Ridgefield,0,0,0,0,0,20
Nike,Nike Mens AO0566-606 11,Nike Mens PHANTOM VENOM ACADEMY FG Black Laser Crimson AO0566-606 US Size 11,Default Ridgefield,0,0,0,0,0,10
Nike,Nike Mens AO0566-606 12,Nike Mens PHANTOM VENOM ACADEMY FG Black Laser Crimson AO0566-606 US Size 12,Default Ridgefield,0,0,0,0,0,10
Nike,Nike Mens AQ2730-001 10,Nike Mens Joyride Run Flyknit Black White AQ2730-001 US Size 10,Default Ridgefield,0,0,0,0,0,24
Nike,Nike Mens AQ2730-001 10.5,Nike Mens Joyride Run Flyknit Black White AQ2730-001 US Size 10.5,Default Ridgefield,0,0,0,0,0,15
Nike,Nike Mens AQ2730-001 11,Nike Mens Joyride Run Flyknit Black White AQ2730-001 US Size 11,Default Ridgefield,0,0,0,0,0,10
Nike,Nike Mens AQ2730-001 11.5,Nike Mens Joyride Run Flyknit Black White AQ2730-001 US Size 11.5,Default Ridgefield,0,0,0,0,0,5
Nike,Nike Mens AQ2730-001 12,Nike Mens Joyride Run Flyknit Black White AQ2730-001 US Size 12,Default Ridgefield,0,0,0,0,0,10
Nike,Nike Mens AQ2730-001 13,Nike Mens Joyride Run Flyknit Black White AQ2730-001 US Size 13,Default Ridgefield,0,0,0,0,0,5
Nike,Nike Mens AQ2730-001 8.5,Nike Mens Joyride Run Flyknit Black White AQ2730-001 US Size 8.5,Default Ridgefield,0,0,0,0,0,10
Nike,Nike Mens AQ2730-001 9,Nike Mens Joyride Run Flyknit Black White AQ2730-001 US Size 9,Default Ridgefield,0,0,0,0,0,20
Nike,Nike Mens AQ2730-001 9.5,Nike Mens Joyride Run Flyknit Black White AQ2730-001 US Size 9.5,Default Ridgefield,0,0,0,0,0,20
Nike,Nike Mens AQ2730-401 10,Nike Mens Joyride Run Flyknit Obsidian Mist/Hydrogen Blue AQ2730-401 US Size 10,Default Ridgefield,0,0,0,0,0,7
Nike,Nike Mens AQ2730-401 10.5,Nike Mens Joyride Run Flyknit Obsidian Mist/Hydrogen Blue AQ2730-401 US Size 10.5,Default Ridgefield,0,0,0,0,0,4
Nike,Nike Mens AQ2730-401 11,Nike Mens Joyride Run Flyknit Obsidian Mist/Hydrogen Blue AQ2730-401 US Size 11,Default Ridgefield,0,0,0,0,0,4
Nike,Nike Mens AQ2730-401 11.5,Nike Mens Joyride Run Flyknit Obsidian Mist/Hydrogen Blue AQ2730-401 US Size 11.5,Default Ridgefield,0,0,0,0,0,4
Nike,Nike Mens AQ2730-401 12,Nike Mens Joyride Run Flyknit Obsidian Mist/Hydrogen Blue AQ2730-401 US Size 12,Default Ridgefield,0,0,0,0,0,4
Nike,Nike Mens AQ2730-401 13,Nike Mens Joyride Run Flyknit Obsidian Mist/Hydrogen Blue AQ2730-401 US Size 13,Default Ridgefield,0,0,0,0,0,4
Nike,Nike Mens AQ2730-401 8.5,Nike Mens Joyride Run Flyknit Obsidian Mist/Hydrogen Blue AQ2730-401 US Size 8.5,Default Ridgefield,0,0,0,0,0,4
Nike,Nike Mens AQ2730-401 9,Nike Mens Joyride Run Flyknit Obsidian Mist/Hydrogen Blue AQ2730-401 US Size 9,Default Ridgefield,0,0,0,0,0,8
Nike,Nike Mens AQ2730-401 9.5,Nike Mens Joyride Run Flyknit Obsidian Mist/Hydrogen Blue AQ2730-401 US Size 9.5,Default Ridgefield,0,0,0,0,0,8
Nike,Nike Mens AT2863-001 10,Nike Mens Zoom Pegasus Turbo 2 Black Gunsmoke AT2863-001 US Size 10,Default Ridgefield,0,0,0,0,0,21
Nike,Nike Mens AT2863-001 10.5,Nike Mens Zoom Pegasus Turbo 2 Black Gunsmoke AT2863-001 US Size 10.5,Default Ridgefield,0,0,0,0,0,10
Nike,Nike Mens AT2863-001 11,Nike Mens Zoom Pegasus Turbo 2 Black Gunsmoke AT2863-001 US Size 11,Default Ridgefield,0,0,0,0,0,5
Nike,Nike Mens AT2863-001 12,Nike Mens Zoom Pegasus Turbo 2 Black Gunsmoke AT2863-001 US Size 12,Default Ridgefield,0,0,0,0,0,5
Nike,Nike Mens AT2863-001 8.5,Nike Mens Zoom Pegasus Turbo 2 Black Gunsmoke AT2863-001 US Size 8.5,Default Ridgefield,0,0,0,0,0,24
Nike,Nike Mens AT2863-001 9,Nike Mens Zoom Pegasus Turbo 2 Black Gunsmoke AT2863-001 US Size 9,Default Ridgefield,0,0,0,0,0,34
Nike,Nike Mens AT2863-001 9.5,Nike Mens Zoom Pegasus Turbo 2 Black Gunsmoke AT2863-001 US Size 9.5,Default Ridgefield,0,0,0,0,0,33
Nike,Nike Mens AT7946-606 10,Nike Mens Mercurial SUPERFLY 7 ACADEMY FG/MG Laser Crimson/Black AT7946-606 US Size 10,Default Ridgefield,0,0,0,0,0,16
Nike,Nike Mens AT7946-606 10.5,Nike Mens Mercurial SUPERFLY 7 ACADEMY FG/MG Laser Crimson/Black AT7946-606 US Size 10.5,Default Ridgefield,0,0,0,0,0,16
Nike,Nike Mens AT7946-606 11,Nike Mens Mercurial SUPERFLY 7 ACADEMY FG/MG Laser Crimson/Black AT7946-606 US Size 11,Default Ridgefield,0,0,0,0,0,8
Nike,Nike Mens AT7946-606 12,Nike Mens Mercurial SUPERFLY 7 ACADEMY FG/MG Laser Crimson/Black AT7946-606 US Size 12,Default Ridgefield,0,0,0,0,0,7
Nike,Nike Mens AT7946-906 10,Nike Mens Mercurial SUPERFLY 7 ACADEMY FG/MG Grey/Black/Particle Grey AT7946-906 US Size 10,Default Ridgefield,0,0,0,0,0,4
Nike,Nike Mens AT7946-906 10.5,Nike Mens Mercurial SUPERFLY 7 ACADEMY FG/MG Grey/Black/Particle Grey AT7946-906 US Size 10.5,Default Ridgefield,0,0,0,0,0,4
Nike,Nike Mens AT7946-906 11,Nike Mens Mercurial SUPERFLY 7 ACADEMY FG/MG Grey/Black/Particle Grey AT7946-906 US Size 11,Default Ridgefield,0,0,0,0,0,4
Nike,Nike Mens AT7946-906 11.5,Nike Mens Mercurial SUPERFLY 7 ACADEMY FG/MG Grey/Black/Particle Grey AT7946-906 US Size 11.5,Default Ridgefield,0,0,0,0,0,4
Nike,Nike Mens AT7946-906 12,Nike Mens Mercurial SUPERFLY 7 ACADEMY FG/MG Grey/Black/Particle Grey AT7946-906 US Size 12,Default Ridgefield,0,0,0,0,0,4
Nike,Nike Mens AT7946-906 13,Nike Mens Mercurial SUPERFLY 7 ACADEMY FG/MG Grey/Black/Particle Grey AT7946-906 US Size 13,Default Ridgefield,0,0,0,0,0,4
Nike,Nike Mens CD5461-007 10,Nike Mens Atsuma Grey/ White CD5461-007 US Size 10,Default Ridgefield,0,0,0,0,0,74
Nike,Nike Mens CD5461-007 10.5,Nike Mens Atsuma Grey/ White CD5461-007 US Size 10.5,Default Ridgefield,0,0,0,0,0,74
Nike,Nike Mens CD5461-007 11,Nike Mens Atsuma Grey/ White CD5461-007 US Size 11,Default Ridgefield,0,0,0,0,0,38
Nike,Nike Mens CD5461-007 12,Nike Mens Atsuma Grey/ White CD5461-007 US Size 12,Default Ridgefield,0,0,0,0,0,38
Nike,Nike Mens CJ1670-001 10,Nike Mens Air Max Fusion Triple Black CJ1670-001 US Size 10,Default Ridgefield,0,0,0,0,0,24
Nike,Nike Mens CJ1670-001 10.5,Nike Mens Air Max Fusion Triple Black CJ1670-001 US Size 10.5,Default Ridgefield,0,0,0,0,0,20
Nike,Nike Mens CJ1670-001 11,Nike Mens Air Max Fusion Triple Black CJ1670-001 US Size 11,Default Ridgefield,0,0,0,0,0,12
Nike,Nike Mens CJ1670-001 11.5,Nike Mens Air Max Fusion Triple Black CJ1670-001 US Size 11.5,Default Ridgefield,0,0,0,0,0,4
Nike,Nike Mens CJ1670-001 12,Nike Mens Air Max Fusion Triple Black CJ1670-001 US Size 12,Default Ridgefield,0,0,0,0,0,12
Nike,Nike Mens CJ1670-001 13,Nike Mens Air Max Fusion Triple Black CJ1670-001 US Size 13,Default Ridgefield,0,0,0,0,0,4
Nike,Nike Mens CJ1670-001 8.5,Nike Mens Air Max Fusion Triple Black CJ1670-001 US Size 8.5,Default Ridgefield,0,0,0,0,0,4
Nike,Nike Mens CJ1670-001 9,Nike Mens Air Max Fusion Triple Black CJ1670-001 US Size 9,Default Ridgefield,0,0,0,0,0,8
Nike,Nike Mens CJ1670-001 9.5,Nike Mens Air Max Fusion Triple Black CJ1670-001 US Size 9.5,Default Ridgefield,0,0,0,0,0,8
Nike,Nike Mens CJ1670-002 8.5,Nike Mens Air Max Fusion Black/White CJ1670-002 US Size 8.5,Default Ridgefield,0,0,0,0,0,10
Nike,Nike Mens CJ1670-002 9,Nike Mens Air Max Fusion Black/White CJ1670-002 US Size 9,Default Ridgefield,0,0,0,0,0,10
Nike,Nike Mens CJ1670-002 9.5,Nike Mens Air Max Fusion Black/White CJ1670-002 US Size 9.5,Default Ridgefield,0,0,0,0,0,10
Nike,Nike Mens CJ1670-003 10,Nike Mens Air Max Fusion Pure Platinum/Indigo Fog/White CJ1670-003 US Size 10,Default Ridgefield,0,0,0,0,0,16
Nike,Nike Mens CJ1670-003 10.5,Nike Mens Air Max Fusion Pure Platinum/Indigo Fog/White CJ1670-003 US Size 10.5,Default Ridgefield,0,0,0,0,0,16
Nike,Nike Mens CJ1670-003 11,Nike Mens Air Max Fusion Pure Platinum/Indigo Fog/White CJ1670-003 US Size 11,Default Ridgefield,0,0,0,0,0,8
Nike,Nike Mens CJ1670-003 12,Nike Mens Air Max Fusion Pure Platinum/Indigo Fog/White CJ1670-003 US Size 12,Default Ridgefield,0,0,0,0,0,7
Nike,Nike Mens CJ1670-102 10,Nike Mens Air Max Fusion White/Black CJ1670-102 US Size 10,Default Ridgefield,0,0,0,0,0,19
Nike,Nike Mens CJ1670-102 10.5,Nike Mens Air Max Fusion White/Black CJ1670-102 US Size 10.5,Default Ridgefield,0,0,0,0,0,19
Nike,Nike Mens CJ1670-102 11,Nike Mens Air Max Fusion White/Black CJ1670-102 US Size 11,Default Ridgefield,0,0,0,0,0,10
Nike,Nike Mens CJ1670-102 11.5,Nike Mens Air Max Fusion White/Black CJ1670-102 US Size 11.5,Default Ridgefield,0,0,0,0,0,1
Nike,Nike Mens CJ1670-102 12,Nike Mens Air Max Fusion White/Black CJ1670-102 US Size 12,Default Ridgefield,0,0,0,0,0,10
Nike,Nike Mens CJ1670-102 13,Nike Mens Air Max Fusion White/Black CJ1670-102 US Size 13,Default Ridgefield,0,0,0,0,0,1
Nike,Nike Mens CJ1670-103 10,Nike Mens Air Max Fusion White/Black/Oracle Aqua CJ1670-103 US Size 10,Default Ridgefield,0,0,0,0,0,12
Nike,Nike Mens CJ1670-103 10.5,Nike Mens Air Max Fusion White/Black/Oracle Aqua CJ1670-103 US Size 10.5,Default Ridgefield,0,0,0,0,0,12
Nike,Nike Mens CJ1670-103 11,Nike Mens Air Max Fusion White/Black/Oracle Aqua CJ1670-103 US Size 11,Default Ridgefield,0,0,0,0,0,7
Nike,Nike Mens CJ1670-103 12,Nike Mens Air Max Fusion White/Black/Oracle Aqua CJ1670-103 US Size 12,Default Ridgefield,0,0,0,0,0,7
Nike,Nike Women AO2982-010 10,Nike Womens Metcon 5 Black/ White/ Wolf Grey AO2982-010 US Size 10,Default Ridgefield,0,0,0,0,0,23
Nike,Nike Women AO2982-010 8,Nike Womens Metcon 5 Black/ White/ Wolf Grey AO2982-010 US Size 8,Default Ridgefield,0,0,0,0,0,48
Nike,Nike Women AO2982-010 8.5,Nike Womens Metcon 5 Black/ White/ Wolf Grey AO2982-010 US Size 8.5,Default Ridgefield,0,0,0,0,0,58
Nike,Nike Women AO2982-010 9,Nike Womens Metcon 5 Black/ White/ Wolf Grey AO2982-010 US Size 9,Default Ridgefield,0,0,0,0,0,34
Nike,Nike Women AO2982-010 9.5,Nike Womens Metcon 5 Black/ White/ Wolf Grey AO2982-010 US Size 9.5,Default Ridgefield,0,0,0,0,0,10
Nike,Nike Women AQ1316-008 W6/10,Nike Womens Nike Free RN 5.0 BLK/MTLC Gold-Anthracite H19 AQ1316-008 W6 US Size 10,FBALYB Amazon,7,7,0,0,0,0
Nike,Nike Women AQ1316-008 W6/8,Nike Womens Nike Free RN 5.0 BLK/MTLC Gold-Anthracite H19 AQ1316-008 W6 US Size 8,FBALYB Amazon,14,14,0,0,0,0
Nike,Nike Women AQ1316-008 W6/ 8.5,Nike Womens Nike Free RN 5.0 BLK/MTLC Gold-Anthracite H19 AQ1316-008 W6 US Size 8.5,FBALYB Amazon,14,14,0,0,0,0
Nike,Nike Women AQ1316-008 W6/9,Nike Womens Nike Free RN 5.0 BLK/MTLC Gold-Anthracite H19 AQ1316-008 W6 US Size 9,FBALYB Amazon,7,7,0,0,0,0
Nike,Nike Women AQ2731-005 10,Nike Womens Joyride Run Flyknit Sky Grey/Teal AQ2731-005 US Size 10,Default Ridgefield,0,0,0,0,0,5
Nike,Nike Women AQ2731-005 7,Nike Womens Joyride Run Flyknit Sky Grey/Teal AQ2731-005 US Size 7,Default Ridgefield,0,0,0,0,0,8
Nike,Nike Women AQ2731-005 7.5,Nike Womens Joyride Run Flyknit Sky Grey/Teal AQ2731-005 US Size 7.5,Default Ridgefield,0,0,0,0,0,8
Nike,Nike Women AQ2731-005 8,Nike Womens Joyride Run Flyknit Sky Grey/Teal AQ2731-005 US Size 8,Default Ridgefield,0,0,0,0,0,18
Nike,Nike Women AQ2731-005 8.5,Nike Womens Joyride Run Flyknit Sky Grey/Teal AQ2731-005 US Size 8.5,Default Ridgefield,0,0,0,0,0,10
Nike,Nike Women AQ2731-005 9,Nike Womens Joyride Run Flyknit Sky Grey/Teal AQ2731-005 US Size 9,Default Ridgefield,0,0,0,0,0,5
Nike,Nike Women BQ3203-004 W13/5.5,Nike Womens Nike Zoom Gravity Black/ Copper Burgundy BQ3203-004 W13 US Size 5.5,Default Ridgefield,13,13,0,0,0,0
Nike,Nike Women BQ3203-004 W13/6,Nike Womens Nike Zoom Gravity Black/ Copper Burgundy BQ3203-004 W13 US Size 6,Default Ridgefield,13,13,0,0,0,0
Nike,Nike Women BQ3203-004 W13/6.5,Nike Womens Nike Zoom Gravity Black/ Copper Burgundy BQ3203-004 W13 US Size 6.5,Default Ridgefield,1,1,0,0,0,0
Nike,Nike Women BQ3203-004 W13/6.5,Nike Womens Nike Zoom Gravity Black/ Copper Burgundy BQ3203-004 W13 US Size 6.5,FBALYB Amazon,12,12,0,0,0,0
Nike,Nike Women BQ3203-004 W13/8,Nike Womens Nike Zoom Gravity Black/ Copper Burgundy BQ3203-004 W13 US Size 8,Default Ridgefield,13,13,0,0,0,0
Nike,Nike Women BQ3203-004 W13/8.5,Nike Womens Nike Zoom Gravity Black/ Copper Burgundy BQ3203-004 W13 US Size 8.5,Default Ridgefield,13,13,0,0,0,0
Nike,Nike Women BQ3203-004 W13/9,Nike Womens Nike Zoom Gravity Black/ Copper Burgundy BQ3203-004 W13 US Size 9,Default Ridgefield,13,13,0,0,0,0
Nuco,Nuco Organic Coconut Wraps 5 oz,Nuco Organic Coconut Wraps 5 oz,Default Ridgefield,169,169,0,0,0,0
Nuco,Nuco Organic Coconut Wraps 5 oz,Nuco Organic Coconut Wraps 5 oz,FBALYB Amazon,7,1,6,0,6,0
Orajel,Orjl 4X Med Gum Gl 25oz,"Orajel 4X Medicated For Toothache and Gum, Gel .25oz",Default Ridgefield,0,0,0,0,0,1920
Orajel,Orjl 4X Med PM Crm 25oz,"Orajel 4X Medicated PM For Toothache and Gum, Cream .25oz",Default Ridgefield,0,0,0,0,0,1200
Oral B,Oral B CrossAction (Clean Maximizer) 10 ct,Oral B Cross Action (Clean Maximizer) 10 ct,Default Ridgefield,2062,2062,0,0,0,0
Oral B,Oral B CrossAction (Clean Maximizer) 10 ct,Oral B Cross Action (Clean Maximizer) 10 ct,FBALYB Amazon,707,703,4,0,4,0
Oral B,Oral B Prec Clean (Clean Maximizer) 10 ct,Oral B Precision Clean (Clean Maximizer) 10 ct,FBALYB Amazon,232,216,16,0,16,0
Oral B,Oral B Prec Clean (Clean Maximizer) 6 ct,Oral B Precision Clean (Clean Maximizer) 6 ct,Default Ridgefield,1476,1476,0,0,0,0
Oral B,Oral B Prec Clean (Clean Maximizer) 6 ct,Oral B Precision Clean (Clean Maximizer) 6 ct,FBALYB Amazon,36,35,1,0,1,0
Pamelas,Pamelas Bkng & Pncke Mix 24oz,Pamelas Ultimate Baking & Pancake Mix 24 oz,Default Ridgefield,3,3,0,0,0,0
Pamelas,Pamelas Bkng & Pncke Mix 4lb,Pamelas Ultimate Baking & Pancake Mix 4lb,Default Ridgefield,26,26,0,0,0,0
Pamelas,Pamelas Bkng & Pncke Mix 4lb,Pamelas Ultimate Baking & Pancake Mix 4lb,FBALYB Amazon,925,902,23,30,23,0
Pamelas,Pamelas F&G Mission GF f,Pamelas Figgies and Jammies Cookie Mission Fig Gluten Free,Default Ridgefield,18,18,0,0,0,0
Pamelas,Pamelas Honey Grahams GF,Pamelas Honey Grahams Gluten Free,Default Ridgefield,76,76,0,0,0,0
Pamelas,Pamelas Org Cassava Flour 14oz,Pamelas Organic Cassava Flour 14 oz,Default Ridgefield,6,6,0,0,0,0
Pamelas,Pamelas Wnv Bar GF Oat/CranAlmnd,Pamelas Whenever Bars Oat/Cranberry/Almond Gluten Free 5pk,Default Ridgefield,96,96,0,0,0,0
Pamelas,Pamelas Wnvr Bar GF Oat/Bbry/Lm,Pamelas Whenever Bars Oat/Blueberry/Lemon Gluten Free 5ct,Default Ridgefield,96,96,0,0,0,0
Pamelas,Pamelas Wnvr Bar GF Oat/CC/Cocont,Pamelas Whenever Bars Oat/Chocolate Chip/Coconut Gluten Free 5pk,Default Ridgefield,906,906,0,0,0,0
Peugeot,Peugeot 12 cm  Pepper Mill Choc,Peugeot Paris U'Select 12 cm Pepper Mill Chocolate,Default Ridgefield,12,12,0,0,0,0
Peugeot,Peugeot 12 cm  Pepper Mill Choc,Peugeot Paris U'Select 12 cm Pepper Mill Chocolate,FBALYB Amazon,224,223,1,0,1,0
Peugeot,Peugeot 13cm Pepper Mill ChiliRed,Peugeot Olivier Roellinger 13 cm Pepper Mill Chili Red,FBALYB Amazon,89,85,4,0,4,0
Peugeot,Peugeot 18 cm Pepper Mill Choc,Peugeot Paris U'Select 18 cm Pepper Mill Chocolate,Default Ridgefield,502,502,0,0,0,0
Peugeot,Peugeot 18 cm Pepper Mill Choc,Peugeot Paris U'Select 18 cm Pepper Mill Chocolate,FBALYB Amazon,387,386,1,0,1,0
Peugeot,Peugeot 18cm Pepper Mill S-Steel,Peugeot Paris Chef U'Select 18cm Pepper Mill Stainless Steel,FBALYB Amazon,99,99,0,0,0,0
Peugeot,Peugeot 18 cm Salt Mill Choc,Peugeot Paris U'Select 18 cm Salt Mill Chocolate,Default Ridgefield,6,6,0,0,0,0
Peugeot,Peugeot 18 cm Salt Mill Choc,Peugeot Paris U'Select 18 cm Salt Mill Chocolate,FBALYB Amazon,96,96,0,0,0,0
Peugeot,Peugeot 22 cm Pepper Mill Choc,Peugeot Paris U'Select 22 cm Pepper Mill Chocolate,Default Ridgefield,5,5,0,0,0,0
Peugeot,Peugeot 22 cm Pepper Mill Choc,Peugeot Paris U'Select 22 cm Pepper Mill Chocolate,FBALYB Amazon,1779,1773,6,3,6,0
Peugeot,Peugeot 27 cm Pepper Mill Choc,Peugeot Paris U'Select 27 cm Pepper Mill Chocolate,Default Ridgefield,2,2,0,0,0,0
Peugeot,Peugeot 27 cm Pepper Mill Choc,Peugeot Paris U'Select 27 cm Pepper Mill Chocolate,FBALYB Amazon,171,170,1,0,1,0
Peugeot,Peugeot 30 cm Pepper Mill Choc,Peugeot Paris U'Select 30 cm Pepper Mill Chocolate,FBALYB Amazon,97,96,1,0,1,0
Peugeot,Peugeot 40 cm Pepper Mill Choc,Peugeot Paris U'Select 40 cm Pepper Mill Chocolate,FBALYB Amazon,102,102,0,0,0,0
Peugeot,Peugeot Clef du Vin Travel Wine,Peugeot Clef du Vin Travel Wine Tool,FBALYB Amazon,102,102,0,0,0,0
Peugeot,Peugeot Tidore Nutmeg Mill,Peugeot Tidore Nutmeg Mill,FBALYB Amazon,102,102,0,0,0,0
Poo Pourri,Poo Pourri Vanilla 8oz,Poo Pourri Vanilla 8oz,Default Ridgefield,1,1,0,0,0,0
Poo Pourri,Poo Pourri Vanilla 8oz,Poo Pourri Vanilla 8oz,FBALYB Amazon,547,546,1,0,1,0
Project 7,Project 7 Gum Peppermint,Project 7 Gum Peppermint,Default Ridgefield,4488,4488,0,0,0,0
Project 7,Project 7 Gum Peppermint,Project 7 Gum Peppermint,FBALYB Amazon,400,398,2,0,2,0
ROSMAR,ROSMAR- Sanidry 300 Dsnfct Wipes,ROSMAR- Sanidry 300-Count Unscented Disinfectant Wipes All-Purpose Cleaner,Default Ridgefield,1120,1120,0,0,0,0
ROSMAR,ROSMAR- Sanidry 300 Dsnfct Wipes,ROSMAR- Sanidry 300-Count Unscented Disinfectant Wipes All-Purpose Cleaner,FBALYB Amazon,1006,927,79,600,79,0
Rubbermaid,Rubbermaid Ruby TKA SvBwl 15.7/2,Rubbermaid Ruby Take Alongs Serving Bowls 15.7 cups 2ct,Default Ridgefield,5208,5208,0,0,0,0
Rubbermaid,Rubbermaid Ruby TKA SvBwl 15.7/2,Rubbermaid Ruby Take Alongs Serving Bowls 15.7 cups 2ct,FBALYB Amazon,592,586,6,0,6,0
RUBBERMAID,RUBBERMAID ANTMCRBL L DSH DRAINR,RUBBERMAID ANTIMICROBIAL LARGE DISH DRAINER,Default Ridgefield,486,486,0,0,0,0
RUBBERMAID,RUBBERMAID ANTMCRBL L DSH DRAINR,RUBBERMAID ANTIMICROBIAL LARGE DISH DRAINER,FBALYB Amazon,0,0,0,498,0,0
RUBBERMAID,RUBBERMAID TKA BWL 50OZ 6/3CT,RUBBERMAID TAKEALONGS BOWL 50OZ 6/3CT,Default Ridgefield,620,620,0,0,0,0
RUBBERMAID,RUBBERMAID TKA BWL 50OZ 6/3CT,RUBBERMAID TAKEALONGS BOWL 50OZ 6/3CT,FBALYB Amazon,100,100,0,0,0,0
RUBBERMAID,RUBBERMAID TKA DIVIDED RCT 8/3CT,RUBBERMAID TAKEALONG DIVIDED RECT 8/3CT,Default Ridgefield,0,0,0,0,0,1520
Salomon,Salomon L41117400 10/10.5,Salomon Mens SHOES SPEEDCROSS 5 GTX Martini Olive/Pea L41117400 UK 10 US 10.5,Default Ridgefield,20,20,0,0,0,0
Salomon,Salomon L41117400 10.5/11,Salomon Mens SHOES SPEEDCROSS 5 GTX Martini Olive/Pea L41117400 UK 10.5 US 11,Default Ridgefield,20,20,0,0,0,0
Salomon,Salomon L41117400 11/11.5,Salomon Mens SHOES SPEEDCROSS 5 GTX Martini Olive/Pea L41117400 UK 11 US 11.5,Default Ridgefield,15,15,0,0,0,0
Salomon,Salomon L41117400 11.5/12,Salomon Mens SHOES SPEEDCROSS 5 GTX Martini Olive/Pea L41117400 UK 11.5 US 12,Default Ridgefield,15,15,0,0,0,0
Salomon,Salomon L41117400 12/12.5,Salomon Mens SHOES SPEEDCROSS 5 GTX Martini Olive/Pea L41117400 UK 12 US 12.5,Default Ridgefield,5,5,0,0,0,0
Salomon,Salomon L41117400 8.5/9,Salomon Mens SHOES SPEEDCROSS 5 GTX Martini Olive/Pea L41117400 UK 8.5 US 9,Default Ridgefield,5,5,0,0,0,0
Salomon,Salomon L41117400 9.5/10,Salomon Mens SHOES SPEEDCROSS 5 GTX Martini Olive/Pea L41117400 UK 9.5 US 10,Default Ridgefield,15,15,0,0,0,0
Salomon,Salomon L41117400 9/9.5,Salomon Mens SHOES SPEEDCROSS 5 GTX Martini Olive/Pea L41117400 UK 9 US 9.5,Default Ridgefield,10,10,0,0,0,0
Salomon,Salomon L41309000 4.5/6,Salomon Shoes Speedcross 5 W Brick Dust/Persimon L41309000 Women's UK 4.5/US 6,Default Ridgefield,10,10,0,0,0,0
Salomon,Salomon L41444200 10/10.5,Salomon Mens SHOES XA PRO 3D v8 GTX Quar/Saffron/OlvN L41444200 UK 10 US 10.5,Default Ridgefield,20,20,0,0,0,0
Salomon,Salomon L41444200 10/10.5,Salomon Mens SHOES XA PRO 3D v8 GTX Quar/Saffron/OlvN L41444200 UK 10 US 10.5,FBALYB Amazon,2,2,0,0,0,0
Salomon,Salomon L41444200 10.5/11,Salomon Mens SHOES XA PRO 3D v8 GTX Quar/Saffron/OlvN L41444200 UK 10.5 US 11,Default Ridgefield,20,20,0,0,0,0
Salomon,Salomon L41444200 10.5/11,Salomon Mens SHOES XA PRO 3D v8 GTX Quar/Saffron/OlvN L41444200 UK 10.5 US 11,FBALYB Amazon,14,14,0,0,0,0
Salomon,Salomon L41444200 11/11.5,Salomon Mens SHOES XA PRO 3D v8 GTX Quar/Saffron/OlvN L41444200 UK 11 US 11.5,Default Ridgefield,25,25,0,0,0,0
Salomon,Salomon L41444200 11.5/12,Salomon Mens SHOES XA PRO 3D v8 GTX Quar/Saffron/OlvN L41444200 UK 11.5 US 12,Default Ridgefield,30,30,0,0,0,0
Salomon,Salomon L41444200 12/12.5,Salomon Mens SHOES XA PRO 3D v8 GTX Quar/Saffron/OlvN L41444200 UK 12 US 12.5,Default Ridgefield,15,15,0,0,0,0
Salomon,Salomon L41444200 8.5/9,Salomon Mens SHOES XA PRO 3D v8 GTX Quar/Saffron/OlvN L41444200 UK 8.5 US 9,Default Ridgefield,15,15,0,0,0,0
Salomon,Salomon L41444200 9.5/10,Salomon Mens SHOES XA PRO 3D v8 GTX Quar/Saffron/OlvN L41444200 UK 9.5 US 10,Default Ridgefield,25,25,0,0,0,0
Salomon,Salomon L41444200 9/9.5,Salomon Mens SHOES XA PRO 3D v8 GTX Quar/Saffron/OlvN L41444200 UK 9 US 9.5,Default Ridgefield,20,20,0,0,0,0
Salomon,Salomon  L41447300 10/10.5,Salomon Mens SHOES XA PRO 3D v8 GTX Black/Green Gecko L41447300 UK 10 US 10.5,Default Ridgefield,20,20,0,0,0,0
Salomon,Salomon  L41447300 10.5/11,Salomon Mens SHOES XA PRO 3D v8 GTX Black/Green Gecko L41447300 UK 10.5 US 11,Default Ridgefield,20,20,0,0,0,0
Salomon,Salomon  L41447300 11/11.5,Salomon Mens SHOES XA PRO 3D v8 GTX Black/Green Gecko L41447300 UK 11 US 11.5,Default Ridgefield,15,15,0,0,0,0
Salomon,Salomon  L41447300 11.5/12,Salomon Mens SHOES XA PRO 3D v8 GTX Black/Green Gecko L41447300 UK 11.5 US 12,Default Ridgefield,15,15,0,0,0,0
Salomon,Salomon  L41447300 12/12.5,Salomon Mens SHOES XA PRO 3D v8 GTX Black/Green Gecko L41447300 UK 12 US 12.5,Default Ridgefield,5,5,0,0,0,0
Salomon,Salomon  L41447300 8.5/9,Salomon Mens SHOES XA PRO 3D v8 GTX Black/Green Gecko L41447300 UK 8.5 US 9,Default Ridgefield,5,5,0,0,0,0
Salomon,Salomon  L41447300 9.5/10,Salomon Mens SHOES XA PRO 3D v8 GTX Black/Green Gecko L41447300 UK 9.5 US 10,Default Ridgefield,15,15,0,0,0,0
Salomon,Salomon  L41447300 9/9.5,Salomon Mens SHOES XA PRO 3D v8 GTX Black/Green Gecko L41447300 UK 9 US 9.5,Default Ridgefield,10,10,0,0,0,0
Salomon,Salomon L41461300 10/10.5,Salomon Mens SHOES SPEEDCROSS 5 GTX Monument/Black/Sa L41461300 UK 10 US 10.5,Default Ridgefield,30,30,0,0,0,0
Salomon,Salomon L41461300 10/10.5,Salomon Mens SHOES SPEEDCROSS 5 GTX Monument/Black/Sa L41461300 UK 10 US 10.5,FBALYB Amazon,2,2,0,0,0,0
Salomon,Salomon L41461300 10.5/11,Salomon Mens SHOES SPEEDCROSS 5 GTX Monument/Black/Sa L41461300 UK 10.5 US 11,Default Ridgefield,40,40,0,0,0,0
Salomon,Salomon L41461300 11/11.5,Salomon Mens SHOES SPEEDCROSS 5 GTX Monument/Black/Sa L41461300 UK 11 US 11.5,Default Ridgefield,25,25,0,0,0,0
Salomon,Salomon L41461300 11.5/12,Salomon Mens SHOES SPEEDCROSS 5 GTX Monument/Black/Sa L41461300 UK 11.5 US 12,Default Ridgefield,30,30,0,0,0,0
Salomon,Salomon L41461300 12/12.5,Salomon Mens SHOES SPEEDCROSS 5 GTX Monument/Black/Sa L41461300 UK 12 US 12.5,Default Ridgefield,15,15,0,0,0,0
Salomon,Salomon L41461300 8.5/9,Salomon Mens SHOES SPEEDCROSS 5 GTX Monument/Black/Sa L41461300 UK 8.5 US 9,Default Ridgefield,15,15,0,0,0,0
Salomon,Salomon L41461300 9.5/10,Salomon Mens SHOES SPEEDCROSS 5 GTX Monument/Black/Sa L41461300 UK 9.5 US 10,Default Ridgefield,25,25,0,0,0,0
Salomon,Salomon L41461300 9/9.5,Salomon Mens SHOES SPEEDCROSS 5 GTX Monument/Black/Sa L41461300 UK 9 US 9.5,Default Ridgefield,20,20,0,0,0,0
Salomon,Salomon L41461500 10/10.5,Salomon Mens SHOES SPEEDCROSS 5 GTX Nisk/Reef/Evening L41461500 UK 10 US 10.5,Default Ridgefield,40,40,0,0,0,0
Salomon,Salomon L41461500 10.5/11,Salomon Mens SHOES SPEEDCROSS 5 GTX Nisk/Reef/Evening L41461500 UK 10.5 US 11,Default Ridgefield,40,40,0,0,0,0
Salomon,Salomon L41461500 11/11.5,Salomon Mens SHOES SPEEDCROSS 5 GTX Nisk/Reef/Evening L41461500 UK 11 US 11.5,Default Ridgefield,25,25,0,0,0,0
Salomon,Salomon L41461500 11.5/12,Salomon Mens SHOES SPEEDCROSS 5 GTX Nisk/Reef/Evening L41461500 UK 11.5 US 12,Default Ridgefield,30,30,0,0,0,0
Salomon,Salomon L41461500 12/12.5,Salomon Mens SHOES SPEEDCROSS 5 GTX Nisk/Reef/Evening L41461500 UK 12 US 12.5,Default Ridgefield,15,15,0,0,0,0
Salomon,Salomon L41461500 8.5/9,Salomon Mens SHOES SPEEDCROSS 5 GTX Nisk/Reef/Evening L41461500 UK 8.5 US 9,Default Ridgefield,15,15,0,0,0,0
Salomon,Salomon L41461500 9.5/10,Salomon Mens SHOES SPEEDCROSS 5 GTX Nisk/Reef/Evening L41461500 UK 9.5 US 10,Default Ridgefield,25,25,0,0,0,0
Salomon,Salomon L41461500 9/9.5,Salomon Mens SHOES SPEEDCROSS 5 GTX Nisk/Reef/Evening L41461500 UK 9 US 9.5,Default Ridgefield,20,20,0,0,0,0
Salomon,Salomon L41462100 4.5/6,Salomon Women SHOES SPEEDCROSS 5 W Eve bl/Cadet/Yucc L41462100 UK 4.5 US 6,Default Ridgefield,30,30,0,0,0,0
Salomon,Salomon L41462100 5.5/7,Salomon Women SHOES SPEEDCROSS 5 W Eve bl/Cadet/Yucc L41462100 UK 5.5 US 7,Default Ridgefield,32,32,0,0,0,0
Salomon,Salomon L41462100 5.5/7,Salomon Women SHOES SPEEDCROSS 5 W Eve bl/Cadet/Yucc L41462100 UK 5.5 US 7,FBALYB Amazon,47,47,0,0,0,0
Salomon,Salomon L41462100 5/6.5,Salomon Women SHOES SPEEDCROSS 5 W Eve bl/Cadet/Yucc L41462100 UK 5 US 6.5,Default Ridgefield,40,40,0,0,0,0
Salomon,Salomon L41462100 6.5/8,Salomon Women SHOES SPEEDCROSS 5 W Eve bl/Cadet/Yucc L41462100 UK 6.5 US 8,Default Ridgefield,80,80,0,0,0,0
Salomon,Salomon L41462100 6/7.5,Salomon Women SHOES SPEEDCROSS 5 W Eve bl/Cadet/Yucc L41462100 UK 6 US 7.5,FBALYB Amazon,62,60,2,0,2,0
Salomon,Salomon L41462100 7.5/9,Salomon Women SHOES SPEEDCROSS 5 W Eve bl/Cadet/Yucc L41462100 UK 7.5 US 9,Default Ridgefield,60,60,0,0,0,0
Salomon,Salomon L41462100 7.5/9,Salomon Women SHOES SPEEDCROSS 5 W Eve bl/Cadet/Yucc L41462100 UK 7.5 US 9,FBALYB Amazon,17,17,0,0,0,0
Salomon,Salomon L41462100 7/8.5,Salomon Women SHOES SPEEDCROSS 5 W Eve bl/Cadet/Yucc L41462100 UK 7 US 8.5,FBALYB Amazon,77,77,0,0,0,0
Salomon,Salomon L41462100 8.5/10,Salomon Women SHOES SPEEDCROSS 5 W Eve bl/Cadet/Yucc L41462100 UK 8.5 US 10,FBALYB Amazon,38,38,0,0,0,0
Salomon,Salomon L41462100 8/9.5,Salomon Women SHOES SPEEDCROSS 5 W Eve bl/Cadet/Yucc L41462100 UK 8 US 9.5,Default Ridgefield,70,70,0,0,0,0
Salomon,Salomon L41462100 9/10.5,Salomon Women SHOES SPEEDCROSS 5 W Eve bl/Cadet/Yucc L41462100 UK 9 US 10.5,Default Ridgefield,20,20,0,0,0,0
Salomon,Salomon L41462300 4.5/6,Salomon Women SHOES SPEEDCROSS 5 W Slate/Trooper/Cryst L41462300 UK 4.5 US 6,Default Ridgefield,10,10,0,0,0,0
Salomon,Salomon L41462300 5.5/7,Salomon Women SHOES SPEEDCROSS 5 W Slate/Trooper/Cryst L41462300 UK 5.5 US 7,Default Ridgefield,30,30,0,0,0,0
Salomon,Salomon L41462300 5/6.5,Salomon Women SHOES SPEEDCROSS 5 W Slate/Trooper/Cryst L41462300 UK 5 US 6.5,Default Ridgefield,20,20,0,0,0,0
Salomon,Salomon L41462300 6.5/8,Salomon Women SHOES SPEEDCROSS 5 W Slate/Trooper/Cryst L41462300 UK 6.5 US 8,Default Ridgefield,30,30,0,0,0,0
Salomon,Salomon L41462300 6/7.5,Salomon Women SHOES SPEEDCROSS 5 W Slate/Trooper/Cryst L41462300 UK 6 US 7.5,Default Ridgefield,30,30,0,0,0,0
Salomon,Salomon L41462300 7.5/9,Salomon Women SHOES SPEEDCROSS 5 W Slate/Trooper/Cryst L41462300 UK 7.5 US 9,Default Ridgefield,30,30,0,0,0,0
Salomon,Salomon L41462300 7/8.5,Salomon Women SHOES SPEEDCROSS 5 W Slate/Trooper/Cryst L41462300 UK 7 US 8.5,Default Ridgefield,40,40,0,0,0,0
Salomon,Salomon L41462300 8.5/10,Salomon Women SHOES SPEEDCROSS 5 W Slate/Trooper/Cryst L41462300 UK 8.5 US 10,Default Ridgefield,20,20,0,0,0,0
Salomon,Salomon L41462300 8/9.5,Salomon Women SHOES SPEEDCROSS 5 W Slate/Trooper/Cryst L41462300 UK 8 US 9.5,Default Ridgefield,30,30,0,0,0,0
Schmidt's,Schmidts Chrc Mg Deodornt 3.25oz,Schmidt's Charcoal Magnesium Mineral Rich Natural Deodorant 3.25oz,Default Ridgefield,4,4,0,0,0,0
Schmidt's,Schmidt's Ddrnt Brgmt Lme 3.25oz,Schmidt's Deodorant Stick Bergamot Lime 3.25oz,Default Ridgefield,125,125,0,0,0,0
Schmidt's,Schmidt's Ddrnt Brgmt Lme 3.25oz,Schmidt's Deodorant Stick Bergamot Lime 3.25oz,FBALYB Amazon,60,41,19,0,19,0
Schmidt's,Schmidt's Ddrnt Coc Pnpl 3.25oz,Schmidt's Natural Deodorant Sensitive Skin Formula Coconut Pineapple 3.25oz,Default Ridgefield,3,3,0,0,0,0
Schmidt's,Schmidt's Ddrnt Coc Pnpl 3.25oz,Schmidt's Natural Deodorant Sensitive Skin Formula Coconut Pineapple 3.25oz,FBALYB Amazon,534,520,14,0,14,0
Schmidt's,Schmidts Ddrnt Jasmn Tea 3.25 oz,Schmidt's Natural Deodorant Sensitive Skin Formula Jasmine Tea 3.25oz,Default Ridgefield,2,2,0,0,0,0
Schmidt's,Schmidts Deodornt FrgFree 3.25oz,Schmidt's Sensitive Skin Deodorant Stick Fragrance Free 3.25oz,FBALYB Amazon,396,396,0,0,0,0
Skechers,Skechers Women 111103WHT 11,Skechers Womens Go Walk 5 Astonished White 111103WHT US Size 11,Default Ridgefield,2,2,0,0,0,0
Skechers,Skechers Women 111103WHT 6,Skechers Womens Go Walk 5 Astonished White 111103WHT US Size 6,Default Ridgefield,2,2,0,0,0,0
Skechers,Skechers Women 111103WHT 6,Skechers Womens Go Walk 5 Astonished White 111103WHT US Size 6,FBALYB Amazon,6,6,0,0,0,0
Skechers,Skechers Women 111103WHT 7,Skechers Womens Go Walk 5 Astonished White 111103WHT US Size 7,Default Ridgefield,15,15,0,0,0,0
Skechers,Skechers Women 111103WHT 8,Skechers Womens Go Walk 5 Astonished White 111103WHT US Size 8,Default Ridgefield,13,13,0,0,0,0
Skechers,Skechers Women 111103WHT 9,Skechers Womens Go Walk 5 Astonished White 111103WHT US Size 9,Default Ridgefield,9,9,0,0,0,0
Skechers,Sketchers Women 117010BLSH 11,Sketchers Womens Bobs Sport Arianas Metro Racket Blush 117010BLSH US Size 11,Default Ridgefield,9,9,0,0,0,0
Skechers,Sketchers Women 117010BLSH 5,Sketchers Womens Bobs Sport Arianas Metro Racket Blush 117010BLSH US Size 5,Default Ridgefield,5,5,0,0,0,0
Skechers,Sketchers Women 117010BLSH 6,Sketchers Womens Bobs Sport Arianas Metro Racket Blush 117010BLSH US Size 6,Default Ridgefield,20,20,0,0,0,0
Skechers,Sketchers Women 117010BLSH 6.5,Sketchers Womens Bobs Sport Arianas Metro Racket Blush 117010BLSH US Size 6.5,Default Ridgefield,10,10,0,0,0,0
Skechers,Sketchers Women 117010BLSH 7,Sketchers Womens Bobs Sport Arianas Metro Racket Blush 117010BLSH US Size 7,Default Ridgefield,6,6,0,0,0,0
Skechers,Sketchers Women 117010BLSH 7.5,Sketchers Womens Bobs Sport Arianas Metro Racket Blush 117010BLSH US Size 7.5,Default Ridgefield,10,10,0,0,0,0
Skechers,Sketchers Women 117010BLSH 8,Sketchers Womens Bobs Sport Arianas Metro Racket Blush 117010BLSH US Size 8,Default Ridgefield,36,36,0,0,0,0
Skechers,Sketchers Women 117010BLSH 9,Sketchers Womens Bobs Sport Arianas Metro Racket Blush 117010BLSH US Size 9,Default Ridgefield,36,36,0,0,0,0
Skechers,Sketchers Women 117010BLSH 9.5,Sketchers Womens Bobs Sport Arianas Metro Racket Blush 117010BLSH US Size 9.5,Default Ridgefield,15,15,0,0,0,0
Skechers,Sketchers Women 117010WHT 11,Sketchers Womens Bobs Sport Arianas Metro Racket White 117010WHT US Size 11,Default Ridgefield,6,6,0,0,0,0
Skechers,Sketchers Women 117010WHT 6,Sketchers Womens Bobs Sport Arianas Metro Racket White 117010WHT US Size 6,Default Ridgefield,12,12,0,0,0,0
Skechers,Sketchers Women 117010WHT 6.5,Sketchers Womens Bobs Sport Arianas Metro Racket White 117010WHT US Size 6.5,Default Ridgefield,11,11,0,0,0,0
Skechers,Sketchers Women 117010WHT 7,Sketchers Womens Bobs Sport Arianas Metro Racket White 117010WHT US Size 7,Default Ridgefield,10,10,0,0,0,0
Skechers,Sketchers Women 117010WHT 7.5,Sketchers Womens Bobs Sport Arianas Metro Racket White 117010WHT US Size 7.5,Default Ridgefield,15,15,0,0,0,0
Skechers,Sketchers Women 117010WHT 8,Sketchers Womens Bobs Sport Arianas Metro Racket White 117010WHT US Size 8,Default Ridgefield,24,24,0,0,0,0
Skechers,Sketchers Women 117010WHT 8.5,Sketchers Womens Bobs Sport Arianas Metro Racket White 117010WHT US Size 8.5,Default Ridgefield,14,14,0,0,0,0
Skechers,Sketchers Women 117010WHT 9,Sketchers Womens Bobs Sport Arianas Metro Racket White 117010WHT US Size 9,Default Ridgefield,12,12,0,0,0,0
Skechers,Sketchers Women 124094NVY 6,Sketchers Womens Go Walk Joy Ecstatic Navy 124094NVY US Size 6,FBALYB Amazon,10,10,0,0,0,0
Skechers,Sketchers Women 124094NVY 6.5,Sketchers Womens Go Walk Joy Ecstatic Navy 124094NVY US Size 6.5,Default Ridgefield,5,5,0,0,0,0
Skechers,Sketchers Women 124094NVY 7,Sketchers Womens Go Walk Joy Ecstatic Navy 124094NVY US Size 7,Default Ridgefield,10,10,0,0,0,0
Skechers,Sketchers Women 124094NVY 7.5,Sketchers Womens Go Walk Joy Ecstatic Navy 124094NVY US Size 7.5,FBALYB Amazon,7,7,0,0,0,0
Skechers,Sketchers Women 124094NVY 8,Sketchers Womens Go Walk Joy Ecstatic Navy 124094NVY US Size 8,FBALYB Amazon,30,30,0,0,0,0
Skechers,Sketchers Women 124094NVY 8.5,Sketchers Womens Go Walk Joy Ecstatic Navy 124094NVY US Size 8.5,Default Ridgefield,11,11,0,0,0,0
Skechers,Sketchers Women 124094NVY 9,Sketchers Womens Go Walk Joy Ecstatic Navy 124094NVY US Size 9,Default Ridgefield,3,3,0,0,0,0
Skechers,Sketchers Women 12607BBK 6,Sketchers Womens Bountiful Quick Path Black 12607BBK US Size 6,Default Ridgefield,10,10,0,0,0,0
Skechers,Sketchers Women 12607BBK 7,Sketchers Womens Bountiful Quick Path Black 12607BBK US Size 7,Default Ridgefield,20,20,0,0,0,0
Skechers,Sketchers Women 12607BKW 6,Sketchers Womens Bountiful Quick Path Black/White 12607BKW US Size 6,Default Ridgefield,5,5,0,0,0,0
Skechers,Sketchers Women 12607BKW 6.5,Sketchers Womens Bountiful Quick Path Black/White 12607BKW US Size 6.5,Default Ridgefield,5,5,0,0,0,0
Skechers,Sketchers Women 12607BKW 7,Sketchers Womens Bountiful Quick Path Black/White 12607BKW US Size 7,Default Ridgefield,10,10,0,0,0,0
Skechers,Sketchers Women 12607BKW 8,Sketchers Womens Bountiful Quick Path Black/White 12607BKW US Size 8,Default Ridgefield,15,15,0,0,0,0
Skechers,Sketchers Women 12607BKW 8.5,Sketchers Womens Bountiful Quick Path Black/White 12607BKW US Size 8.5,Default Ridgefield,20,20,0,0,0,0
Skechers,Sketchers Women 12607BKW 9,Sketchers Womens Bountiful Quick Path Black/White 12607BKW US Size 9,Default Ridgefield,10,10,0,0,0,0
Skechers,Sketchers Women 12607NHP 6,Sketchers Womens Bountiful Quick Path Navy/Hot Pink 12607NHP US Size 6,Default Ridgefield,20,20,0,0,0,0
Skechers,Sketchers Women 12607NHP 7,Sketchers Womens Bountiful Quick Path Navy/Hot Pink 12607NHP US Size 7,Default Ridgefield,10,10,0,0,0,0
Skechers,Sketchers Women 12607ROS 6,Sketchers Womens Bountiful Quick Path Rose 12607ROS US Size 6,Default Ridgefield,1,1,0,0,0,0
Skechers,Sketchers Women 12607ROS 8.5,Sketchers Womens Bountiful Quick Path Rose 12607ROS US Size 8.5,Default Ridgefield,1,1,0,0,0,0
Skechers,Sketchers Women 12607ROS 9.5,Sketchers Womens Bountiful Quick Path Rose 12607ROS US Size 9.5,Default Ridgefield,3,3,0,0,0,0
Skechers,Sketchers Women 12983BKLB 11,Sketchers Womens Summits Quick Getaway Black/Light Blue 12983BKLB US Size 11,FBALYB Amazon,1,1,0,0,0,0
Skechers,Sketchers Women 12983BKLB 5,Sketchers Womens Summits Quick Getaway Black/Light Blue 12983BKLB US Size 5,Default Ridgefield,10,10,0,0,0,0
Skechers,Sketchers Women 12983BKLB 5.5,Sketchers Womens Summits Quick Getaway Black/Light Blue 12983BKLB US Size 5.5,FBALYB Amazon,10,10,0,0,0,0
Skechers,Sketchers Women 12983BKLB 6,Sketchers Womens Summits Quick Getaway Black/Light Blue 12983BKLB US Size 6,Default Ridgefield,30,30,0,0,0,0
Skechers,Sketchers Women 12983BKLB 6,Sketchers Womens Summits Quick Getaway Black/Light Blue 12983BKLB US Size 6,FBALYB Amazon,30,30,0,0,0,0
Skechers,Sketchers Women 12983BKLB 6.5,Sketchers Womens Summits Quick Getaway Black/Light Blue 12983BKLB US Size 6.5,FBALYB Amazon,24,24,0,0,0,0
Skechers,Sketchers Women 12983BKLB 7,Sketchers Womens Summits Quick Getaway Black/Light Blue 12983BKLB US Size 7,Default Ridgefield,74,74,0,0,0,0
Skechers,Sketchers Women 12983BKLB 7,Sketchers Womens Summits Quick Getaway Black/Light Blue 12983BKLB US Size 7,FBALYB Amazon,50,49,1,0,1,0
Skechers,Sketchers Women 12983BKLB 7.5,Sketchers Womens Summits Quick Getaway Black/Light Blue 12983BKLB US Size 7.5,Default Ridgefield,22,22,0,0,0,0
Skechers,Sketchers Women 12983BKLB 7.5,Sketchers Womens Summits Quick Getaway Black/Light Blue 12983BKLB US Size 7.5,FBALYB Amazon,50,50,0,0,0,0
Skechers,Sketchers Women 12983BKLB 8,Sketchers Womens Summits Quick Getaway Black/Light Blue 12983BKLB US Size 8,Default Ridgefield,39,39,0,0,0,0
Skechers,Sketchers Women 12983BKLB 8,Sketchers Womens Summits Quick Getaway Black/Light Blue 12983BKLB US Size 8,FBALYB Amazon,50,50,0,0,0,0
Skechers,Sketchers Women 12983BKLB 8.5,Sketchers Womens Summits Quick Getaway Black/Light Blue 12983BKLB US Size 8.5,FBALYB Amazon,8,7,1,0,1,0
Skechers,Sketchers Women 12983BKLB 9,Sketchers Womens Summits Quick Getaway Black/Light Blue 12983BKLB US Size 9,Default Ridgefield,21,21,0,0,0,0
Skechers,Sketchers Women 12983BKLB 9,Sketchers Womens Summits Quick Getaway Black/Light Blue 12983BKLB US Size 9,FBALYB Amazon,20,18,2,0,2,0
Skechers,Sketchers Women 12983NVPR 11,Sketchers Womens Summits Quick Getaway Navy/Purple 12983NVPR US Size 11,Default Ridgefield,3,3,0,0,0,0
Skechers,Sketchers Women 12983NVPR 8,Sketchers Womens Summits Quick Getaway Navy/Purple 12983NVPR US Size 8,Default Ridgefield,13,13,0,0,0,0
Skechers,Sketchers Women 12983NVPR 9,Sketchers Womens Summits Quick Getaway Navy/Purple 12983NVPR US Size 9,Default Ridgefield,9,9,0,0,0,0
Skechers,Sketchers Women 12998BKGD 6,Sketchers Womens Summits Fresh Take Black/Gold 12998BKGD US Size 6,Default Ridgefield,20,20,0,0,0,0
Skechers,Sketchers Women 12998BKGD 7,Sketchers Womens Summits Fresh Take Black/Gold 12998BKGD US Size 7,Default Ridgefield,40,40,0,0,0,0
Skechers,Sketchers Women 12998BKGD 7.5,Sketchers Womens Summits Fresh Take Black/Gold 12998BKGD US Size 7.5,Default Ridgefield,25,25,0,0,0,0
Skechers,Sketchers Women 12998BKGD 8,Sketchers Womens Summits Fresh Take Black/Gold 12998BKGD US Size 8,Default Ridgefield,48,48,0,0,0,0
Skechers,Sketchers Women 12998BKGD 8.5,Sketchers Womens Summits Fresh Take Black/Gold 12998BKGD US Size 8.5,Default Ridgefield,48,48,0,0,0,0
Skechers,Sketchers Women 12998BKGD 9,Sketchers Womens Summits Fresh Take Black/Gold 12998BKGD US Size 9,Default Ridgefield,48,48,0,0,0,0
Skechers,Sketchers Women 13087BKRG 11,Sketchers Womens D'Lites Glamour Feels Black/Rose Gold 13087BKRG US Size 11,Default Ridgefield,7,7,0,0,0,0
Skechers,Sketchers Women 13087BKRG 5,Sketchers Womens D'Lites Glamour Feels Black/Rose Gold 13087BKRG US Size 5,Default Ridgefield,1,1,0,0,0,0
Skechers,Sketchers Women 13087BKRG 5,Sketchers Womens D'Lites Glamour Feels Black/Rose Gold 13087BKRG US Size 5,FBALYB Amazon,1,1,0,0,0,0
Skechers,Sketchers Women 13087BKRG 5.5,Sketchers Womens D'Lites Glamour Feels Black/Rose Gold 13087BKRG US Size 5.5,Default Ridgefield,20,20,0,0,0,0
Skechers,Sketchers Women 13087BKRG 6,Sketchers Womens D'Lites Glamour Feels Black/Rose Gold 13087BKRG US Size 6,Default Ridgefield,12,12,0,0,0,0
Skechers,Sketchers Women 13087BKRG 6,Sketchers Womens D'Lites Glamour Feels Black/Rose Gold 13087BKRG US Size 6,FBALYB Amazon,10,10,0,0,0,0
Skechers,Sketchers Women 13087BKRG 6.5,Sketchers Womens D'Lites Glamour Feels Black/Rose Gold 13087BKRG US Size 6.5,Default Ridgefield,11,11,0,0,0,0
Skechers,Sketchers Women 13087BKRG 6.5,Sketchers Womens D'Lites Glamour Feels Black/Rose Gold 13087BKRG US Size 6.5,FBALYB Amazon,10,10,0,0,0,0
Skechers,Sketchers Women 13087BKRG 7,Sketchers Womens D'Lites Glamour Feels Black/Rose Gold 13087BKRG US Size 7,Default Ridgefield,36,36,0,0,0,0
Skechers,Sketchers Women 13087BKRG 7,Sketchers Womens D'Lites Glamour Feels Black/Rose Gold 13087BKRG US Size 7,FBALYB Amazon,10,10,0,0,0,0
Skechers,Sketchers Women 13087BKRG 7.5,Sketchers Womens D'Lites Glamour Feels Black/Rose Gold 13087BKRG US Size 7.5,Default Ridgefield,32,32,0,0,0,0
Skechers,Sketchers Women 13087BKRG 7.5,Sketchers Womens D'Lites Glamour Feels Black/Rose Gold 13087BKRG US Size 7.5,FBALYB Amazon,15,15,0,0,0,0
Skechers,Sketchers Women 13087BKRG 8,Sketchers Womens D'Lites Glamour Feels Black/Rose Gold 13087BKRG US Size 8,Default Ridgefield,30,30,0,0,0,0
Skechers,Sketchers Women 13087BKRG 8,Sketchers Womens D'Lites Glamour Feels Black/Rose Gold 13087BKRG US Size 8,FBALYB Amazon,15,15,0,0,0,0
Skechers,Sketchers Women 13087BKRG 8.5,Sketchers Womens D'Lites Glamour Feels Black/Rose Gold 13087BKRG US Size 8.5,Default Ridgefield,19,19,0,0,0,0
Skechers,Sketchers Women 13087BKRG 8.5,Sketchers Womens D'Lites Glamour Feels Black/Rose Gold 13087BKRG US Size 8.5,FBALYB Amazon,15,15,0,0,0,0
Skechers,Sketchers Women 13087BKRG 9,Sketchers Womens D'Lites Glamour Feels Black/Rose Gold 13087BKRG US Size 9,FBALYB Amazon,12,12,0,0,0,0
Skechers,Sketchers Women 149115GYMN 11,Sketchers Womens Bountiful Brisk Stride Gray 149115GYMN US Size 11,Default Ridgefield,2,2,0,0,0,0
Skechers,Sketchers Women 149115GYMN 5,Sketchers Womens Bountiful Brisk Stride Gray 149115GYMN US Size 5,Default Ridgefield,5,5,0,0,0,0
Skechers,Sketchers Women 149115GYMN 5.5,Sketchers Womens Bountiful Brisk Stride Gray 149115GYMN US Size 5.5,Default Ridgefield,5,5,0,0,0,0
Skechers,Sketchers Women 149115GYMN 6,Sketchers Womens Bountiful Brisk Stride Gray 149115GYMN US Size 6,Default Ridgefield,30,30,0,0,0,0
Skechers,Sketchers Women 149115GYMN 7,Sketchers Womens Bountiful Brisk Stride Gray 149115GYMN US Size 7,Default Ridgefield,60,60,0,0,0,0
Skechers,Sketchers Women 149115GYMN 7.5,Sketchers Womens Bountiful Brisk Stride Gray 149115GYMN US Size 7.5,Default Ridgefield,30,30,0,0,0,0
Skechers,Sketchers Women 149115GYMN 8,Sketchers Womens Bountiful Brisk Stride Gray 149115GYMN US Size 8,Default Ridgefield,60,60,0,0,0,0
Skechers,Sketchers Women 149115GYMN 8.5,Sketchers Womens Bountiful Brisk Stride Gray 149115GYMN US Size 8.5,Default Ridgefield,60,60,0,0,0,0
Skechers,Sketchers Women 149115GYMN 9,Sketchers Womens Bountiful Brisk Stride Gray 149115GYMN US Size 9,Default Ridgefield,60,60,0,0,0,0
Skechers,Sketchers Women 149115GYMN 9.5,Sketchers Womens Bountiful Brisk Stride Gray 149115GYMN US Size 9.5,Default Ridgefield,3,3,0,0,0,0
Skechers,Sketchers Women 3423WML 5,Sketchers Womens Energy Timeless Vision White/Millennium 13423WML US Size 5,Default Ridgefield,5,5,0,0,0,0
Skechers,Sketchers Women 80578L-BBK 10.5,Sketchers Womens Skechers D'Lites Play On Black 80578L-BBK US Size 10.5,Default Ridgefield,12,12,0,0,0,0
Skechers,Sketchers Women 80578L-BBK 5,Sketchers Womens Skechers D'Lites Play On Black 80578L-BBK US Size 5,Default Ridgefield,10,10,0,0,0,0
Skechers,Sketchers Women 80578L-BBK 6,Sketchers Womens Skechers D'Lites Play On Black 80578L-BBK US Size 6,Default Ridgefield,9,9,0,0,0,0
Skechers,Sketchers Women 80578L-WHT 10.5,Sketchers Womens Skechers D'Lites Play On White 80578L-WHT US Size 10.5,Default Ridgefield,4,4,0,0,0,0
Skechers,Sketchers Women 80578L-WHT 5,Sketchers Womens Skechers D'Lites Play On White 80578L-WHT US Size 5,Default Ridgefield,6,6,0,0,0,0
Skechers,Sketchers Women 80578L-WHT 5.5,Sketchers Womens Skechers D'Lites Play On White 80578L-WHT US Size 5.5,Default Ridgefield,24,24,0,0,0,0
Skechers,Sketchers Women 80578L-WHT 6,Sketchers Womens Skechers D'Lites Play On White 80578L-WHT US Size 6,Default Ridgefield,8,8,0,0,0,0
Skechers,Sketchers Womens 124094BBK 6,Sketchers Womens Go Walk Joy Ecstatic Black 124094BBK US Size 6,Default Ridgefield,10,10,0,0,0,0
Skechers,Sketchers Womens 124094BBK 7,Sketchers Womens Go Walk Joy Ecstatic Black 124094BBK US Size 7,Default Ridgefield,10,10,0,0,0,0
Skechers,Sketchers Womens 124094BBK 8,Sketchers Womens Go Walk Joy Ecstatic Black 124094BBK US Size 8,Default Ridgefield,2,2,0,0,0,0
Skechers,Sketchers Womens 124094BBK 8,Sketchers Womens Go Walk Joy Ecstatic Black 124094BBK US Size 8,FBALYB Amazon,5,5,0,0,0,0
Skechers,Sketchers Womens 124094BBK 9,Sketchers Womens Go Walk Joy Ecstatic Black 124094BBK US Size 9,Default Ridgefield,1,1,0,0,0,0
South Of France,SOF Hand Wash Lemon Verbena 8oz.,South of France Hand Wash Lemon Verbena 8oz,Default Ridgefield,6,6,0,0,0,0
St Ives,St Ives Scrub 150ml Invig,St Ives Scrub 150ml Invig,Default Ridgefield,0,0,0,0,0,3168
Surya Brasil,Surya ClrFix Rstr HairMsk 7.94oz,Surya Brasil Color Fixation Restorative Hair Mask 7.94oz,Default Ridgefield,0,0,0,0,0,10
Surya Brasil,Surya EcoSilver Toning Hair Mask,Surya Brasil EcoSilver Toning Hair Mask,Default Ridgefield,0,0,0,0,0,10
Surya Brasil,Surya Hand Sanitiz/Henna Extract,Surya Brasil Hand Sanitizer with Henna Extract,Default Ridgefield,0,0,0,0,0,1
Surya Brasil,Surya Hna Pwdr SBRYBlonde 1.76oz,Surya Brasil Henna Powder Strawberry Blonde 1.76oz,Default Ridgefield,0,0,0,0,0,10
Surya Brasil,Surya Hna Pwdr SwedBlonde 1.76oz,Surya Brasil Henna Powder Swedish Blonde 1.76oz,Default Ridgefield,0,0,0,0,0,15
Surya Brasil,Surya Nail Polish Peacock 9.5ml,Surya Brasil 7-Free Nail Polish Peacock 9.5ml,Default Ridgefield,0,0,0,0,0,10
Surya Brasil,Surya Organic Face Mask,Surya Brasil Organic Face Mask Surya Brasil,Default Ridgefield,0,0,0,0,0,1
Surya Brasil,Surya Veg Tntd Lip Blm Sugar Fig,Surya Brasil Vegan Tinted Lip Balm Sugared Fig,Default Ridgefield,0,0,0,0,0,10
TerasWhey,Tera's Whey Bourbon Vanilla,Tera's Whey Organic Whey Protein Powder Bourbon Vanilla 21g Protein 0.75 Lb,FBALYB Amazon,12,12,0,0,0,0
TerasWhey,Teras Whey Goat Plain Unswtnd,Teras Whey Goat Whey Protein Powder Plain Unsweetened 22g Protein 0.75 Lb,Default Ridgefield,2,2,0,0,0,0
Teva,TEV-1003987-ZARN-050,Teva 1003987-ZARN Womens Original Universal Ziggy Arona US Size 5,Default Ridgefield,70,70,0,0,0,0
Teva,TEV-1003987-ZARN-060,Teva 1003987-ZARN Womens Original Universal Ziggy Arona US Size 6,Default Ridgefield,209,209,0,0,0,0
Teva,TEV-1003987-ZARN-070,Teva 1003987-ZARN Womens Original Universal Ziggy Arona US Size 7,Default Ridgefield,558,558,0,0,0,0
Teva,TEV-1003987-ZARN-080,Teva 1003987-ZARN Womens Original Universal Ziggy Arona US Size 8,Default Ridgefield,486,486,0,0,0,0
Teva,TEV-1003987-ZARN-080,Teva 1003987-ZARN Womens Original Universal Ziggy Arona US Size 8,FBALYB Amazon,0,0,0,72,0,0
Teva,TEV-1003987-ZARN-090,Teva 1003987-ZARN Womens Original Universal Ziggy Arona US Size 9,Default Ridgefield,279,279,0,0,0,0
Teva,TEV-1003987-ZARN-100,Teva 1003987-ZARN Womens Original Universal Ziggy Arona US Size 10,Default Ridgefield,347,347,0,0,0,0
Teva,TEV-1003987-ZARN-110,Teva 1003987-ZARN Womens Original Universal Ziggy Arona US Size 11,Default Ridgefield,35,35,0,0,0,0
Teva,TEV-1008844-LTML-050,Teva Midform Platform Universal 1008844-LTML US Size 5,Default Ridgefield,14,14,0,0,0,0
Teva,TEV-1008844-LTML-060,Teva Midform Platform Universal 1008844-LTML US Size 6,Default Ridgefield,27,27,0,0,0,0
Teva,TEV-1008844-LTML-070,Teva Midform Platform Universal 1008844-LTML US Size 7,Default Ridgefield,21,21,0,0,0,0
Teva,TEV-1008844-LTML-080,Teva Midform Platform Universal 1008844-LTML US Size 8,Default Ridgefield,35,35,0,0,0,0
Teva,TEV-1008844-LTML-090,Teva Midform Platform Universal 1008844-LTML US Size 9,Default Ridgefield,19,19,0,0,0,0
Teva,TEV-1008844-LTML-100,Teva Midform Platform Universal 1008844-LTML US Size 10,Default Ridgefield,14,14,0,0,0,0
Teva,TEV-1008844-LTML-110,Teva Midform Platform Universal 1008844-LTML US Size 11,Default Ridgefield,14,14,0,0,0,0
Teva,Teva 1003987 Sandal -BLK-120,Teva 1003987 Sandal -BLK-120,Default Ridgefield,10,10,0,0,0,0
The Grandpa Soap Co.,TGSC Pine Tar Conditioner 8oz,The Grandpa Soap Co. Pine Tar Conditioner 8oz,FBALYB Amazon,154,151,3,0,3,0
The Grandpa Soap Co.,TGSC Soap Bar Oatmeal 4.25oz,The Grandpa Soap Co. Soap Bar Oatmeal 4.25oz,FBALYB Amazon,75,75,0,0,0,0
Under Armour,UA Jet Grey 64oz UA70020-80006,Under Armour Jet Grey 64oz Playmaker Jug UA70020-80006,Default Ridgefield,4,4,0,0,0,0
Under Armour,UA Jet Grey 64oz UA70020-80006,Under Armour Jet Grey 64oz Playmaker Jug UA70020-80006,FBALYB Amazon,489,483,6,0,6,0
Vermints,Vermints Mints Cinnamon Tin,Vermints Breath Mints Cinnamon Tin,Default Ridgefield,6,6,0,0,0,0
Vermints,Vermints Mints Peppermint Tin,Vermints Breath Mints Peppermint Tin,Default Ridgefield,6,6,0,0,0,0
Wiley X,WILEY X  GRV PLRZ BLMR G/B CRSTL,WILEY X WX GRAVITY POLARIZED BLUE MIRROR GREEN/BLACK CRYSTAL # CCGRA04,Default Ridgefield,0,0,0,0,0,30
Wiley X,WILEY X REBL GRY LNS/MT BLK FRME,WILEY X REBEL GREY LENS/MATTE BLACK FRAME,Default Ridgefield,0,0,0,0,0,100
Wiley X,WILEY X ROMER 5 CLR/MT BLK #303,WILEY X ROMER 5 CLEAR/MATTE BLACK # 303,Default Ridgefield,0,0,0,0,0,500
Wiley X,WILEY X SBR ADV SKGRY/MTBLK #302,WILEY X SABER ADVANCED SMOKE GREY/MATTE BLACK # 302,Default Ridgefield,0,0,0,0,0,500
Wiley X,WILEY X VALR GRY LNS/MT BLK FRME,WILEY X VALOR GREY LENS/MATTE BLACK FRAME,Default Ridgefield,0,0,0,0,0,150
